context: Nothing holds his attention like an intense game. response:	Hey, Kohsaka.
context: Nothing holds his attention like an intense game.\Hey, Kohsaka. response:	Hmm?
context: Nothing holds his attention like an intense game.\Hey, Kohsaka.\Hmm? response:	Would you rather have been with a girl who plays games with you?
context: Nothing holds his attention like an intense game.\Hey, Kohsaka.\Hmm?\Would you rather have been with a girl who plays games with you? response:	That's not really important.
context: Nothing holds his attention like an intense game.\Hey, Kohsaka.\Hmm?\Would you rather have been with a girl who plays games with you?\That's not really important. response:	You don't choose a girl based on that...
context: Nothing holds his attention like an intense game.\Hey, Kohsaka.\Hmm?\Would you rather have been with a girl who plays games with you?\That's not really important.\You don't choose a girl based on that... response:	Well, maybe that's just what dating him is like...
context: Nothing holds his attention like an intense game.\Hey, Kohsaka.\Hmm?\Would you rather have been with a girl who plays games with you?\That's not really important.\You don't choose a girl based on that...\Well, maybe that's just what dating him is like... response:	But to be honest I feel miserable right now...
context: Nothing holds his attention like an intense game.\Hey, Kohsaka.\Hmm?\Would you rather have been with a girl who plays games with you?\That's not really important.\You don't choose a girl based on that...\Well, maybe that's just what dating him is like...\But to be honest I feel miserable right now... response:	He doesn't look at me at all, either...
context: Hey, Kohsaka.\Hmm?\Would you rather have been with a girl who plays games with you?\That's not really important.\You don't choose a girl based on that...\Well, maybe that's just what dating him is like...\But to be honest I feel miserable right now...\He doesn't look at me at all, either... response:	Oh, sorry, TV time.
context: Hmm?\Would you rather have been with a girl who plays games with you?\That's not really important.\You don't choose a girl based on that...\Well, maybe that's just what dating him is like...\But to be honest I feel miserable right now...\He doesn't look at me at all, either...\Oh, sorry, TV time. response:	Uh, you mean anime?
context: Would you rather have been with a girl who plays games with you?\That's not really important.\You don't choose a girl based on that...\Well, maybe that's just what dating him is like...\But to be honest I feel miserable right now...\He doesn't look at me at all, either...\Oh, sorry, TV time.\Uh, you mean anime? response:	Yeah, it's about to start.
context: That's not really important.\You don't choose a girl based on that...\Well, maybe that's just what dating him is like...\But to be honest I feel miserable right now...\He doesn't look at me at all, either...\Oh, sorry, TV time.\Uh, you mean anime?\Yeah, it's about to start. response:	I've been looking forward to it all day.
context: You don't choose a girl based on that...\Well, maybe that's just what dating him is like...\But to be honest I feel miserable right now...\He doesn't look at me at all, either...\Oh, sorry, TV time.\Uh, you mean anime?\Yeah, it's about to start.\I've been looking forward to it all day. response:	I'm sorry I'm gutless, but this is my limit.
context: Well, maybe that's just what dating him is like...\But to be honest I feel miserable right now...\He doesn't look at me at all, either...\Oh, sorry, TV time.\Uh, you mean anime?\Yeah, it's about to start.\I've been looking forward to it all day.\I'm sorry I'm gutless, but this is my limit. response:	Tokino!
context: But to be honest I feel miserable right now...\He doesn't look at me at all, either...\Oh, sorry, TV time.\Uh, you mean anime?\Yeah, it's about to start.\I've been looking forward to it all day.\I'm sorry I'm gutless, but this is my limit.\Tokino! response:	Outside, outside, outside, outside.
context: He doesn't look at me at all, either...\Oh, sorry, TV time.\Uh, you mean anime?\Yeah, it's about to start.\I've been looking forward to it all day.\I'm sorry I'm gutless, but this is my limit.\Tokino!\Outside, outside, outside, outside. response:	Just hold out a little longer!
context: Oh, sorry, TV time.\Uh, you mean anime?\Yeah, it's about to start.\I've been looking forward to it all day.\I'm sorry I'm gutless, but this is my limit.\Tokino!\Outside, outside, outside, outside.\Just hold out a little longer! response:	The heat must be getting to our opponents too.
context: Uh, you mean anime?\Yeah, it's about to start.\I've been looking forward to it all day.\I'm sorry I'm gutless, but this is my limit.\Tokino!\Outside, outside, outside, outside.\Just hold out a little longer!\The heat must be getting to our opponents too. response:	Let's talk about something...
context: Yeah, it's about to start.\I've been looking forward to it all day.\I'm sorry I'm gutless, but this is my limit.\Tokino!\Outside, outside, outside, outside.\Just hold out a little longer!\The heat must be getting to our opponents too.\Let's talk about something... response:	Genshiken
context: I've been looking forward to it all day.\I'm sorry I'm gutless, but this is my limit.\Tokino!\Outside, outside, outside, outside.\Just hold out a little longer!\The heat must be getting to our opponents too.\Let's talk about something...\Genshiken response:	I woke up and as usual forgot my cell and missed the Express.
context: I'm sorry I'm gutless, but this is my limit.\Tokino!\Outside, outside, outside, outside.\Just hold out a little longer!\The heat must be getting to our opponents too.\Let's talk about something...\Genshiken\I woke up and as usual forgot my cell and missed the Express. response:	My life reflected in the train window.
context: Tokino!\Outside, outside, outside, outside.\Just hold out a little longer!\The heat must be getting to our opponents too.\Let's talk about something...\Genshiken\I woke up and as usual forgot my cell and missed the Express.\My life reflected in the train window. response:	I'm sure I have something that I won't lose to anyone in Japan...
context: Outside, outside, outside, outside.\Just hold out a little longer!\The heat must be getting to our opponents too.\Let's talk about something...\Genshiken\I woke up and as usual forgot my cell and missed the Express.\My life reflected in the train window.\I'm sure I have something that I won't lose to anyone in Japan... response:	I can't run fast, though.
context: Just hold out a little longer!\The heat must be getting to our opponents too.\Let's talk about something...\Genshiken\I woke up and as usual forgot my cell and missed the Express.\My life reflected in the train window.\I'm sure I have something that I won't lose to anyone in Japan...\I can't run fast, though. response:	I'm not that strongly-built.
context: The heat must be getting to our opponents too.\Let's talk about something...\Genshiken\I woke up and as usual forgot my cell and missed the Express.\My life reflected in the train window.\I'm sure I have something that I won't lose to anyone in Japan...\I can't run fast, though.\I'm not that strongly-built. response:	Here I go, at my dauntless pace.
context: Let's talk about something...\Genshiken\I woke up and as usual forgot my cell and missed the Express.\My life reflected in the train window.\I'm sure I have something that I won't lose to anyone in Japan...\I can't run fast, though.\I'm not that strongly-built.\Here I go, at my dauntless pace. response:	Pass away, today's sadness, raining in the sun!
context: Genshiken\I woke up and as usual forgot my cell and missed the Express.\My life reflected in the train window.\I'm sure I have something that I won't lose to anyone in Japan...\I can't run fast, though.\I'm not that strongly-built.\Here I go, at my dauntless pace.\Pass away, today's sadness, raining in the sun! response:	Hesitation, repetition, dreaming all night, all night.
context: I woke up and as usual forgot my cell and missed the Express.\My life reflected in the train window.\I'm sure I have something that I won't lose to anyone in Japan...\I can't run fast, though.\I'm not that strongly-built.\Here I go, at my dauntless pace.\Pass away, today's sadness, raining in the sun!\Hesitation, repetition, dreaming all night, all night. response:	Farewell sadness, to outer space you go!
context: My life reflected in the train window.\I'm sure I have something that I won't lose to anyone in Japan...\I can't run fast, though.\I'm not that strongly-built.\Here I go, at my dauntless pace.\Pass away, today's sadness, raining in the sun!\Hesitation, repetition, dreaming all night, all night.\Farewell sadness, to outer space you go! response:	Look to the sky and shout at the top of your lungs!
context: I'm sure I have something that I won't lose to anyone in Japan...\I can't run fast, though.\I'm not that strongly-built.\Here I go, at my dauntless pace.\Pass away, today's sadness, raining in the sun!\Hesitation, repetition, dreaming all night, all night.\Farewell sadness, to outer space you go!\Look to the sky and shout at the top of your lungs! response:	At this tempo!
context: I can't run fast, though.\I'm not that strongly-built.\Here I go, at my dauntless pace.\Pass away, today's sadness, raining in the sun!\Hesitation, repetition, dreaming all night, all night.\Farewell sadness, to outer space you go!\Look to the sky and shout at the top of your lungs!\At this tempo! response:	Right now, at this tempo!
context: I'm not that strongly-built.\Here I go, at my dauntless pace.\Pass away, today's sadness, raining in the sun!\Hesitation, repetition, dreaming all night, all night.\Farewell sadness, to outer space you go!\Look to the sky and shout at the top of your lungs!\At this tempo!\Right now, at this tempo! response:	Genshiken Right now, at this tempo!
context: Here I go, at my dauntless pace.\Pass away, today's sadness, raining in the sun!\Hesitation, repetition, dreaming all night, all night.\Farewell sadness, to outer space you go!\Look to the sky and shout at the top of your lungs!\At this tempo!\Right now, at this tempo!\Genshiken Right now, at this tempo! response:	Genshiken
context: Pass away, today's sadness, raining in the sun!\Hesitation, repetition, dreaming all night, all night.\Farewell sadness, to outer space you go!\Look to the sky and shout at the top of your lungs!\At this tempo!\Right now, at this tempo!\Genshiken Right now, at this tempo!\Genshiken response:	That again!
context: Hesitation, repetition, dreaming all night, all night.\Farewell sadness, to outer space you go!\Look to the sky and shout at the top of your lungs!\At this tempo!\Right now, at this tempo!\Genshiken Right now, at this tempo!\Genshiken\That again! response:	That's pretty good, chaining a low light kick into a standing super.
context: Farewell sadness, to outer space you go!\Look to the sky and shout at the top of your lungs!\At this tempo!\Right now, at this tempo!\Genshiken Right now, at this tempo!\Genshiken\That again!\That's pretty good, chaining a low light kick into a standing super. response:	I can only pull it off about one in five tries though.
context: Look to the sky and shout at the top of your lungs!\At this tempo!\Right now, at this tempo!\Genshiken Right now, at this tempo!\Genshiken\That again!\That's pretty good, chaining a low light kick into a standing super.\I can only pull it off about one in five tries though. response:	These two sure are a trip to watch.
context: At this tempo!\Right now, at this tempo!\Genshiken Right now, at this tempo!\Genshiken\That again!\That's pretty good, chaining a low light kick into a standing super.\I can only pull it off about one in five tries though.\These two sure are a trip to watch. response:	Ohno.
context: Right now, at this tempo!\Genshiken Right now, at this tempo!\Genshiken\That again!\That's pretty good, chaining a low light kick into a standing super.\I can only pull it off about one in five tries though.\These two sure are a trip to watch.\Ohno. response:	Isn't your hair too long?
context: Genshiken Right now, at this tempo!\Genshiken\That again!\That's pretty good, chaining a low light kick into a standing super.\I can only pull it off about one in five tries though.\These two sure are a trip to watch.\Ohno.\Isn't your hair too long? response:	Huh?
context: Genshiken\That again!\That's pretty good, chaining a low light kick into a standing super.\I can only pull it off about one in five tries though.\These two sure are a trip to watch.\Ohno.\Isn't your hair too long?\Huh? response:	I mean, it makes you look kinda scary.
context: That again!\That's pretty good, chaining a low light kick into a standing super.\I can only pull it off about one in five tries though.\These two sure are a trip to watch.\Ohno.\Isn't your hair too long?\Huh?\I mean, it makes you look kinda scary. response:	Huh?
context: That's pretty good, chaining a low light kick into a standing super.\I can only pull it off about one in five tries though.\These two sure are a trip to watch.\Ohno.\Isn't your hair too long?\Huh?\I mean, it makes you look kinda scary.\Huh? response:	If you cut it, or even just added some color, it'd lighten up.
context: I can only pull it off about one in five tries though.\These two sure are a trip to watch.\Ohno.\Isn't your hair too long?\Huh?\I mean, it makes you look kinda scary.\Huh?\If you cut it, or even just added some color, it'd lighten up. response:	Is it like this for cosplay?
context: These two sure are a trip to watch.\Ohno.\Isn't your hair too long?\Huh?\I mean, it makes you look kinda scary.\Huh?\If you cut it, or even just added some color, it'd lighten up.\Is it like this for cosplay? response:	Hmm, that's part of it...
context: Ohno.\Isn't your hair too long?\Huh?\I mean, it makes you look kinda scary.\Huh?\If you cut it, or even just added some color, it'd lighten up.\Is it like this for cosplay?\Hmm, that's part of it... response:	People told me they envied how black and straight it was.
context: Isn't your hair too long?\Huh?\I mean, it makes you look kinda scary.\Huh?\If you cut it, or even just added some color, it'd lighten up.\Is it like this for cosplay?\Hmm, that's part of it...\People told me they envied how black and straight it was. response:	I guess they had a point, but this is Japan.
context: Huh?\I mean, it makes you look kinda scary.\Huh?\If you cut it, or even just added some color, it'd lighten up.\Is it like this for cosplay?\Hmm, that's part of it...\People told me they envied how black and straight it was.\I guess they had a point, but this is Japan. response:	That's true...
context: I mean, it makes you look kinda scary.\Huh?\If you cut it, or even just added some color, it'd lighten up.\Is it like this for cosplay?\Hmm, that's part of it...\People told me they envied how black and straight it was.\I guess they had a point, but this is Japan.\That's true... response:	So it's for cosplay?
context: Huh?\If you cut it, or even just added some color, it'd lighten up.\Is it like this for cosplay?\Hmm, that's part of it...\People told me they envied how black and straight it was.\I guess they had a point, but this is Japan.\That's true...\So it's for cosplay? response:	I guess so.
context: If you cut it, or even just added some color, it'd lighten up.\Is it like this for cosplay?\Hmm, that's part of it...\People told me they envied how black and straight it was.\I guess they had a point, but this is Japan.\That's true...\So it's for cosplay?\I guess so. response:	The salon I go to gives discounts for referrals.
context: Is it like this for cosplay?\Hmm, that's part of it...\People told me they envied how black and straight it was.\I guess they had a point, but this is Japan.\That's true...\So it's for cosplay?\I guess so.\The salon I go to gives discounts for referrals. response:	I'm not used to places like that, though...
context: Hmm, that's part of it...\People told me they envied how black and straight it was.\I guess they had a point, but this is Japan.\That's true...\So it's for cosplay?\I guess so.\The salon I go to gives discounts for referrals.\I'm not used to places like that, though... response:	Yeah, bring it on!
context: People told me they envied how black and straight it was.\I guess they had a point, but this is Japan.\That's true...\So it's for cosplay?\I guess so.\The salon I go to gives discounts for referrals.\I'm not used to places like that, though...\Yeah, bring it on! response:	Ohno.
context: I guess they had a point, but this is Japan.\That's true...\So it's for cosplay?\I guess so.\The salon I go to gives discounts for referrals.\I'm not used to places like that, though...\Yeah, bring it on!\Ohno. response:	Aren't your tits too big?
context: That's true...\So it's for cosplay?\I guess so.\The salon I go to gives discounts for referrals.\I'm not used to places like that, though...\Yeah, bring it on!\Ohno.\Aren't your tits too big? response:	Huh?
context: So it's for cosplay?\I guess so.\The salon I go to gives discounts for referrals.\I'm not used to places like that, though...\Yeah, bring it on!\Ohno.\Aren't your tits too big?\Huh? response:	What's your cup size again?
context: I guess so.\The salon I go to gives discounts for referrals.\I'm not used to places like that, though...\Yeah, bring it on!\Ohno.\Aren't your tits too big?\Huh?\What's your cup size again? response:	Don't you already know?
context: The salon I go to gives discounts for referrals.\I'm not used to places like that, though...\Yeah, bring it on!\Ohno.\Aren't your tits too big?\Huh?\What's your cup size again?\Don't you already know? response:	Yeah but I forgot.
context: I'm not used to places like that, though...\Yeah, bring it on!\Ohno.\Aren't your tits too big?\Huh?\What's your cup size again?\Don't you already know?\Yeah but I forgot. response:	What?
context: Yeah, bring it on!\Ohno.\Aren't your tits too big?\Huh?\What's your cup size again?\Don't you already know?\Yeah but I forgot.\What? response:	Oh my god, it takes cups that big to support those manga-sized tits?
context: Ohno.\Aren't your tits too big?\Huh?\What's your cup size again?\Don't you already know?\Yeah but I forgot.\What?\Oh my god, it takes cups that big to support those manga-sized tits? response:	Saki!
context: Aren't your tits too big?\Huh?\What's your cup size again?\Don't you already know?\Yeah but I forgot.\What?\Oh my god, it takes cups that big to support those manga-sized tits?\Saki! response:	It's just like that soccer...
context: Huh?\What's your cup size again?\Don't you already know?\Yeah but I forgot.\What?\Oh my god, it takes cups that big to support those manga-sized tits?\Saki!\It's just like that soccer... response:	W-World Cup?
context: What's your cup size again?\Don't you already know?\Yeah but I forgot.\What?\Oh my god, it takes cups that big to support those manga-sized tits?\Saki!\It's just like that soccer...\W-World Cup? response:	I'm going to claim sexual harassment.
context: Don't you already know?\Yeah but I forgot.\What?\Oh my god, it takes cups that big to support those manga-sized tits?\Saki!\It's just like that soccer...\W-World Cup?\I'm going to claim sexual harassment. response:	That's the scary you.
context: Yeah but I forgot.\What?\Oh my god, it takes cups that big to support those manga-sized tits?\Saki!\It's just like that soccer...\W-World Cup?\I'm going to claim sexual harassment.\That's the scary you. response:	Hey, are you ignoring me?
context: What?\Oh my god, it takes cups that big to support those manga-sized tits?\Saki!\It's just like that soccer...\W-World Cup?\I'm going to claim sexual harassment.\That's the scary you.\Hey, are you ignoring me? response:	W-What?
context: Oh my god, it takes cups that big to support those manga-sized tits?\Saki!\It's just like that soccer...\W-World Cup?\I'm going to claim sexual harassment.\That's the scary you.\Hey, are you ignoring me?\W-What? response:	Don't what me.
context: Saki!\It's just like that soccer...\W-World Cup?\I'm going to claim sexual harassment.\That's the scary you.\Hey, are you ignoring me?\W-What?\Don't what me. response:	I'm trying to get you to discuss something with me.
context: It's just like that soccer...\W-World Cup?\I'm going to claim sexual harassment.\That's the scary you.\Hey, are you ignoring me?\W-What?\Don't what me.\I'm trying to get you to discuss something with me. response:	Discuss?
context: W-World Cup?\I'm going to claim sexual harassment.\That's the scary you.\Hey, are you ignoring me?\W-What?\Don't what me.\I'm trying to get you to discuss something with me.\Discuss? response:	Well you see, this is about one of my high school friends.
context: I'm going to claim sexual harassment.\That's the scary you.\Hey, are you ignoring me?\W-What?\Don't what me.\I'm trying to get you to discuss something with me.\Discuss?\Well you see, this is about one of my high school friends. response:	She says she's been dating an otaku lately.
context: That's the scary you.\Hey, are you ignoring me?\W-What?\Don't what me.\I'm trying to get you to discuss something with me.\Discuss?\Well you see, this is about one of my high school friends.\She says she's been dating an otaku lately. response:	Oh yeah?
context: Hey, are you ignoring me?\W-What?\Don't what me.\I'm trying to get you to discuss something with me.\Discuss?\Well you see, this is about one of my high school friends.\She says she's been dating an otaku lately.\Oh yeah? response:	Well, at a glance he seems different from Kohsaka.
context: W-What?\Don't what me.\I'm trying to get you to discuss something with me.\Discuss?\Well you see, this is about one of my high school friends.\She says she's been dating an otaku lately.\Oh yeah?\Well, at a glance he seems different from Kohsaka. response:	So anyway, when they have sex at night they leave the TV on.
context: Don't what me.\I'm trying to get you to discuss something with me.\Discuss?\Well you see, this is about one of my high school friends.\She says she's been dating an otaku lately.\Oh yeah?\Well, at a glance he seems different from Kohsaka.\So anyway, when they have sex at night they leave the TV on. response:	The guy says it's to mask the noise since the walls are thin.
context: I'm trying to get you to discuss something with me.\Discuss?\Well you see, this is about one of my high school friends.\She says she's been dating an otaku lately.\Oh yeah?\Well, at a glance he seems different from Kohsaka.\So anyway, when they have sex at night they leave the TV on.\The guy says it's to mask the noise since the walls are thin. response:	But then last night...
context: Discuss?\Well you see, this is about one of my high school friends.\She says she's been dating an otaku lately.\Oh yeah?\Well, at a glance he seems different from Kohsaka.\So anyway, when they have sex at night they leave the TV on.\The guy says it's to mask the noise since the walls are thin.\But then last night... response:	Some anime came on during it...
context: Well you see, this is about one of my high school friends.\She says she's been dating an otaku lately.\Oh yeah?\Well, at a glance he seems different from Kohsaka.\So anyway, when they have sex at night they leave the TV on.\The guy says it's to mask the noise since the walls are thin.\But then last night...\Some anime came on during it... response:	And just before that, they had switched to doggy style.
context: She says she's been dating an otaku lately.\Oh yeah?\Well, at a glance he seems different from Kohsaka.\So anyway, when they have sex at night they leave the TV on.\The guy says it's to mask the noise since the walls are thin.\But then last night...\Some anime came on during it...\And just before that, they had switched to doggy style. response:	I wonder if he was back where she couldn't see him watching it...
context: Oh yeah?\Well, at a glance he seems different from Kohsaka.\So anyway, when they have sex at night they leave the TV on.\The guy says it's to mask the noise since the walls are thin.\But then last night...\Some anime came on during it...\And just before that, they had switched to doggy style.\I wonder if he was back where she couldn't see him watching it... response:	What do you think, Ohno?
context: Well, at a glance he seems different from Kohsaka.\So anyway, when they have sex at night they leave the TV on.\The guy says it's to mask the noise since the walls are thin.\But then last night...\Some anime came on during it...\And just before that, they had switched to doggy style.\I wonder if he was back where she couldn't see him watching it...\What do you think, Ohno? response:	Um, well...
context: So anyway, when they have sex at night they leave the TV on.\The guy says it's to mask the noise since the walls are thin.\But then last night...\Some anime came on during it...\And just before that, they had switched to doggy style.\I wonder if he was back where she couldn't see him watching it...\What do you think, Ohno?\Um, well... response:	Lasting more than 30 minutes is amazing!
context: The guy says it's to mask the noise since the walls are thin.\But then last night...\Some anime came on during it...\And just before that, they had switched to doggy style.\I wonder if he was back where she couldn't see him watching it...\What do you think, Ohno?\Um, well...\Lasting more than 30 minutes is amazing! response:	Laughing about it only digs your own grave.
context: But then last night...\Some anime came on during it...\And just before that, they had switched to doggy style.\I wonder if he was back where she couldn't see him watching it...\What do you think, Ohno?\Um, well...\Lasting more than 30 minutes is amazing!\Laughing about it only digs your own grave. response:	What about you guys?
context: Some anime came on during it...\And just before that, they had switched to doggy style.\I wonder if he was back where she couldn't see him watching it...\What do you think, Ohno?\Um, well...\Lasting more than 30 minutes is amazing!\Laughing about it only digs your own grave.\What about you guys? response:	Yesterday, you said? What time?
context: And just before that, they had switched to doggy style.\I wonder if he was back where she couldn't see him watching it...\What do you think, Ohno?\Um, well...\Lasting more than 30 minutes is amazing!\Laughing about it only digs your own grave.\What about you guys?\Yesterday, you said? What time? response:	12:30, she said.
context: I wonder if he was back where she couldn't see him watching it...\What do you think, Ohno?\Um, well...\Lasting more than 30 minutes is amazing!\Laughing about it only digs your own grave.\What about you guys?\Yesterday, you said? What time?\12:30, she said. response:	Oh, that!
context: What do you think, Ohno?\Um, well...\Lasting more than 30 minutes is amazing!\Laughing about it only digs your own grave.\What about you guys?\Yesterday, you said? What time?\12:30, she said.\Oh, that! response:	You saw it, didn't you?
context: Um, well...\Lasting more than 30 minutes is amazing!\Laughing about it only digs your own grave.\What about you guys?\Yesterday, you said? What time?\12:30, she said.\Oh, that!\You saw it, didn't you? response:	Yes, that.
context: Lasting more than 30 minutes is amazing!\Laughing about it only digs your own grave.\What about you guys?\Yesterday, you said? What time?\12:30, she said.\Oh, that!\You saw it, didn't you?\Yes, that. response:	Kujibiki Unbalance
context: Laughing about it only digs your own grave.\What about you guys?\Yesterday, you said? What time?\12:30, she said.\Oh, that!\You saw it, didn't you?\Yes, that.\Kujibiki Unbalance response:	It's quite a highly rated anime right now.
context: What about you guys?\Yesterday, you said? What time?\12:30, she said.\Oh, that!\You saw it, didn't you?\Yes, that.\Kujibiki Unbalance\It's quite a highly rated anime right now. response:	I watched it too.
context: Yesterday, you said? What time?\12:30, she said.\Oh, that!\You saw it, didn't you?\Yes, that.\Kujibiki Unbalance\It's quite a highly rated anime right now.\I watched it too. response:	So did I.
context: 12:30, she said.\Oh, that!\You saw it, didn't you?\Yes, that.\Kujibiki Unbalance\It's quite a highly rated anime right now.\I watched it too.\So did I. response:	You don't say...
context: Oh, that!\You saw it, didn't you?\Yes, that.\Kujibiki Unbalance\It's quite a highly rated anime right now.\I watched it too.\So did I.\You don't say... response:	Then maybe it'd be best if she cosplayed after all!
context: You saw it, didn't you?\Yes, that.\Kujibiki Unbalance\It's quite a highly rated anime right now.\I watched it too.\So did I.\You don't say...\Then maybe it'd be best if she cosplayed after all! response:	I mean, she got a reaction from cat ears a while back.
context: Yes, that.\Kujibiki Unbalance\It's quite a highly rated anime right now.\I watched it too.\So did I.\You don't say...\Then maybe it'd be best if she cosplayed after all!\I mean, she got a reaction from cat ears a while back. response:	A-All right, why don't I lend her a costume?
context: Kujibiki Unbalance\It's quite a highly rated anime right now.\I watched it too.\So did I.\You don't say...\Then maybe it'd be best if she cosplayed after all!\I mean, she got a reaction from cat ears a while back.\A-All right, why don't I lend her a costume? response:	I'm sure the size difference would just make her feel bad.
context: It's quite a highly rated anime right now.\I watched it too.\So did I.\You don't say...\Then maybe it'd be best if she cosplayed after all!\I mean, she got a reaction from cat ears a while back.\A-All right, why don't I lend her a costume?\I'm sure the size difference would just make her feel bad. response:	Besides, I don't think you want it being used for that.
context: I watched it too.\So did I.\You don't say...\Then maybe it'd be best if she cosplayed after all!\I mean, she got a reaction from cat ears a while back.\A-All right, why don't I lend her a costume?\I'm sure the size difference would just make her feel bad.\Besides, I don't think you want it being used for that. response:	I see your point.
context: So did I.\You don't say...\Then maybe it'd be best if she cosplayed after all!\I mean, she got a reaction from cat ears a while back.\A-All right, why don't I lend her a costume?\I'm sure the size difference would just make her feel bad.\Besides, I don't think you want it being used for that.\I see your point. response:	Um...
context: You don't say...\Then maybe it'd be best if she cosplayed after all!\I mean, she got a reaction from cat ears a while back.\A-All right, why don't I lend her a costume?\I'm sure the size difference would just make her feel bad.\Besides, I don't think you want it being used for that.\I see your point.\Um... response:	You were talking about a friend?
context: Then maybe it'd be best if she cosplayed after all!\I mean, she got a reaction from cat ears a while back.\A-All right, why don't I lend her a costume?\I'm sure the size difference would just make her feel bad.\Besides, I don't think you want it being used for that.\I see your point.\Um...\You were talking about a friend? response:	Of course I was.
context: I mean, she got a reaction from cat ears a while back.\A-All right, why don't I lend her a costume?\I'm sure the size difference would just make her feel bad.\Besides, I don't think you want it being used for that.\I see your point.\Um...\You were talking about a friend?\Of course I was. response:	But what about you two?
context: A-All right, why don't I lend her a costume?\I'm sure the size difference would just make her feel bad.\Besides, I don't think you want it being used for that.\I see your point.\Um...\You were talking about a friend?\Of course I was.\But what about you two? response:	If you had a girlfriend, would you want to have sex in costume?
context: I'm sure the size difference would just make her feel bad.\Besides, I don't think you want it being used for that.\I see your point.\Um...\You were talking about a friend?\Of course I was.\But what about you two?\If you had a girlfriend, would you want to have sex in costume? response:	Uh, well...
context: Besides, I don't think you want it being used for that.\I see your point.\Um...\You were talking about a friend?\Of course I was.\But what about you two?\If you had a girlfriend, would you want to have sex in costume?\Uh, well... response:	I don't even think about that kind of thing, not having a girlfriend.
context: I see your point.\Um...\You were talking about a friend?\Of course I was.\But what about you two?\If you had a girlfriend, would you want to have sex in costume?\Uh, well...\I don't even think about that kind of thing, not having a girlfriend. response:	Ah, but I have seen cosplay scenes in adult videos...
context: Um...\You were talking about a friend?\Of course I was.\But what about you two?\If you had a girlfriend, would you want to have sex in costume?\Uh, well...\I don't even think about that kind of thing, not having a girlfriend.\Ah, but I have seen cosplay scenes in adult videos... response:	They're not very interesting, though.
context: You were talking about a friend?\Of course I was.\But what about you two?\If you had a girlfriend, would you want to have sex in costume?\Uh, well...\I don't even think about that kind of thing, not having a girlfriend.\Ah, but I have seen cosplay scenes in adult videos...\They're not very interesting, though. response:	The women are just porn actresses, after all.
context: Of course I was.\But what about you two?\If you had a girlfriend, would you want to have sex in costume?\Uh, well...\I don't even think about that kind of thing, not having a girlfriend.\Ah, but I have seen cosplay scenes in adult videos...\They're not very interesting, though.\The women are just porn actresses, after all. response:	There are also cosplay dojinshi, erotic ones.
context: But what about you two?\If you had a girlfriend, would you want to have sex in costume?\Uh, well...\I don't even think about that kind of thing, not having a girlfriend.\Ah, but I have seen cosplay scenes in adult videos...\They're not very interesting, though.\The women are just porn actresses, after all.\There are also cosplay dojinshi, erotic ones. response:	Yeah, I saw some in a catalog at Comic Fest.
context: If you had a girlfriend, would you want to have sex in costume?\Uh, well...\I don't even think about that kind of thing, not having a girlfriend.\Ah, but I have seen cosplay scenes in adult videos...\They're not very interesting, though.\The women are just porn actresses, after all.\There are also cosplay dojinshi, erotic ones.\Yeah, I saw some in a catalog at Comic Fest. response:	I wonder if they're on CD-ROM.
context: Uh, well...\I don't even think about that kind of thing, not having a girlfriend.\Ah, but I have seen cosplay scenes in adult videos...\They're not very interesting, though.\The women are just porn actresses, after all.\There are also cosplay dojinshi, erotic ones.\Yeah, I saw some in a catalog at Comic Fest.\I wonder if they're on CD-ROM. response:	Look at me when you're talking.
context: I don't even think about that kind of thing, not having a girlfriend.\Ah, but I have seen cosplay scenes in adult videos...\They're not very interesting, though.\The women are just porn actresses, after all.\There are also cosplay dojinshi, erotic ones.\Yeah, I saw some in a catalog at Comic Fest.\I wonder if they're on CD-ROM.\Look at me when you're talking. response:	So anyway, you're going to have to ask Tanaka about stuff like that.
context: Ah, but I have seen cosplay scenes in adult videos...\They're not very interesting, though.\The women are just porn actresses, after all.\There are also cosplay dojinshi, erotic ones.\Yeah, I saw some in a catalog at Comic Fest.\I wonder if they're on CD-ROM.\Look at me when you're talking.\So anyway, you're going to have to ask Tanaka about stuff like that. response:	Hmm...
context: They're not very interesting, though.\The women are just porn actresses, after all.\There are also cosplay dojinshi, erotic ones.\Yeah, I saw some in a catalog at Comic Fest.\I wonder if they're on CD-ROM.\Look at me when you're talking.\So anyway, you're going to have to ask Tanaka about stuff like that.\Hmm... response:	Then I suppose...
context: The women are just porn actresses, after all.\There are also cosplay dojinshi, erotic ones.\Yeah, I saw some in a catalog at Comic Fest.\I wonder if they're on CD-ROM.\Look at me when you're talking.\So anyway, you're going to have to ask Tanaka about stuff like that.\Hmm...\Then I suppose... response:	if she liked to cosplay...
context: There are also cosplay dojinshi, erotic ones.\Yeah, I saw some in a catalog at Comic Fest.\I wonder if they're on CD-ROM.\Look at me when you're talking.\So anyway, you're going to have to ask Tanaka about stuff like that.\Hmm...\Then I suppose...\if she liked to cosplay... response:	Like Ohno?
context: Yeah, I saw some in a catalog at Comic Fest.\I wonder if they're on CD-ROM.\Look at me when you're talking.\So anyway, you're going to have to ask Tanaka about stuff like that.\Hmm...\Then I suppose...\if she liked to cosplay...\Like Ohno? response:	Saki...
context: I wonder if they're on CD-ROM.\Look at me when you're talking.\So anyway, you're going to have to ask Tanaka about stuff like that.\Hmm...\Then I suppose...\if she liked to cosplay...\Like Ohno?\Saki... response:	Well, you know...
context: Look at me when you're talking.\So anyway, you're going to have to ask Tanaka about stuff like that.\Hmm...\Then I suppose...\if she liked to cosplay...\Like Ohno?\Saki...\Well, you know... response:	But you wouldn't be able to do that...
context: So anyway, you're going to have to ask Tanaka about stuff like that.\Hmm...\Then I suppose...\if she liked to cosplay...\Like Ohno?\Saki...\Well, you know...\But you wouldn't be able to do that... response:	Not me, it's a friend of mine.
context: Hmm...\Then I suppose...\if she liked to cosplay...\Like Ohno?\Saki...\Well, you know...\But you wouldn't be able to do that...\Not me, it's a friend of mine. response:	Hey, either way.
context: Then I suppose...\if she liked to cosplay...\Like Ohno?\Saki...\Well, you know...\But you wouldn't be able to do that...\Not me, it's a friend of mine.\Hey, either way. response:	The more fundamental question is...
context: if she liked to cosplay...\Like Ohno?\Saki...\Well, you know...\But you wouldn't be able to do that...\Not me, it's a friend of mine.\Hey, either way.\The more fundamental question is... response:	That's impossible.
context: Like Ohno?\Saki...\Well, you know...\But you wouldn't be able to do that...\Not me, it's a friend of mine.\Hey, either way.\The more fundamental question is...\That's impossible. response:	But that's what we're thinking about almost all the time.
context: Saki...\Well, you know...\But you wouldn't be able to do that...\Not me, it's a friend of mine.\Hey, either way.\The more fundamental question is...\That's impossible.\But that's what we're thinking about almost all the time. response:	Anime, games, not much else.
context: Well, you know...\But you wouldn't be able to do that...\Not me, it's a friend of mine.\Hey, either way.\The more fundamental question is...\That's impossible.\But that's what we're thinking about almost all the time.\Anime, games, not much else. response:	Even Kohsaka shouldn't be any exception to the rule.
context: But you wouldn't be able to do that...\Not me, it's a friend of mine.\Hey, either way.\The more fundamental question is...\That's impossible.\But that's what we're thinking about almost all the time.\Anime, games, not much else.\Even Kohsaka shouldn't be any exception to the rule. response:	You think so?
context: Not me, it's a friend of mine.\Hey, either way.\The more fundamental question is...\That's impossible.\But that's what we're thinking about almost all the time.\Anime, games, not much else.\Even Kohsaka shouldn't be any exception to the rule.\You think so? response:	Otherwise he wouldn't be such a good gamer.
context: Hey, either way.\The more fundamental question is...\That's impossible.\But that's what we're thinking about almost all the time.\Anime, games, not much else.\Even Kohsaka shouldn't be any exception to the rule.\You think so?\Otherwise he wouldn't be such a good gamer. response:	Not to mention, he knows a lot of system-related info.
context: The more fundamental question is...\That's impossible.\But that's what we're thinking about almost all the time.\Anime, games, not much else.\Even Kohsaka shouldn't be any exception to the rule.\You think so?\Otherwise he wouldn't be such a good gamer.\Not to mention, he knows a lot of system-related info. response:	Hmm, video games...
context: That's impossible.\But that's what we're thinking about almost all the time.\Anime, games, not much else.\Even Kohsaka shouldn't be any exception to the rule.\You think so?\Otherwise he wouldn't be such a good gamer.\Not to mention, he knows a lot of system-related info.\Hmm, video games... response:	I guess games really are his thing.
context: But that's what we're thinking about almost all the time.\Anime, games, not much else.\Even Kohsaka shouldn't be any exception to the rule.\You think so?\Otherwise he wouldn't be such a good gamer.\Not to mention, he knows a lot of system-related info.\Hmm, video games...\I guess games really are his thing. response:	I couldn't possibly become an otaku...
context: Anime, games, not much else.\Even Kohsaka shouldn't be any exception to the rule.\You think so?\Otherwise he wouldn't be such a good gamer.\Not to mention, he knows a lot of system-related info.\Hmm, video games...\I guess games really are his thing.\I couldn't possibly become an otaku... response:	Heh, you will?
context: Even Kohsaka shouldn't be any exception to the rule.\You think so?\Otherwise he wouldn't be such a good gamer.\Not to mention, he knows a lot of system-related info.\Hmm, video games...\I guess games really are his thing.\I couldn't possibly become an otaku...\Heh, you will? response:	It's better than trying to get his attention with shabby cosplay.
context: You think so?\Otherwise he wouldn't be such a good gamer.\Not to mention, he knows a lot of system-related info.\Hmm, video games...\I guess games really are his thing.\I couldn't possibly become an otaku...\Heh, you will?\It's better than trying to get his attention with shabby cosplay. response:	She might find she's an otaku before she knows it.
context: Otherwise he wouldn't be such a good gamer.\Not to mention, he knows a lot of system-related info.\Hmm, video games...\I guess games really are his thing.\I couldn't possibly become an otaku...\Heh, you will?\It's better than trying to get his attention with shabby cosplay.\She might find she's an otaku before she knows it. response:	Shut up.
context: Not to mention, he knows a lot of system-related info.\Hmm, video games...\I guess games really are his thing.\I couldn't possibly become an otaku...\Heh, you will?\It's better than trying to get his attention with shabby cosplay.\She might find she's an otaku before she knows it.\Shut up. response:	After careful consideration, the game of choice is Puyo Pop Fever.
context: Hmm, video games...\I guess games really are his thing.\I couldn't possibly become an otaku...\Heh, you will?\It's better than trying to get his attention with shabby cosplay.\She might find she's an otaku before she knows it.\Shut up.\After careful consideration, the game of choice is Puyo Pop Fever. response:	You connect and pop falling puyos in this latest of the hit puzzle game series.
context: I guess games really are his thing.\I couldn't possibly become an otaku...\Heh, you will?\It's better than trying to get his attention with shabby cosplay.\She might find she's an otaku before she knows it.\Shut up.\After careful consideration, the game of choice is Puyo Pop Fever.\You connect and pop falling puyos in this latest of the hit puzzle game series. response:	That's why you rotate it here like this.
context: I couldn't possibly become an otaku...\Heh, you will?\It's better than trying to get his attention with shabby cosplay.\She might find she's an otaku before she knows it.\Shut up.\After careful consideration, the game of choice is Puyo Pop Fever.\You connect and pop falling puyos in this latest of the hit puzzle game series.\That's why you rotate it here like this. response:	Rotate?
context: Heh, you will?\It's better than trying to get his attention with shabby cosplay.\She might find she's an otaku before she knows it.\Shut up.\After careful consideration, the game of choice is Puyo Pop Fever.\You connect and pop falling puyos in this latest of the hit puzzle game series.\That's why you rotate it here like this.\Rotate? response:	You insert it here, these pop, and these shift down.
context: It's better than trying to get his attention with shabby cosplay.\She might find she's an otaku before she knows it.\Shut up.\After careful consideration, the game of choice is Puyo Pop Fever.\You connect and pop falling puyos in this latest of the hit puzzle game series.\That's why you rotate it here like this.\Rotate?\You insert it here, these pop, and these shift down. response:	Why?
context: She might find she's an otaku before she knows it.\Shut up.\After careful consideration, the game of choice is Puyo Pop Fever.\You connect and pop falling puyos in this latest of the hit puzzle game series.\That's why you rotate it here like this.\Rotate?\You insert it here, these pop, and these shift down.\Why? response:	She did it.
context: Shut up.\After careful consideration, the game of choice is Puyo Pop Fever.\You connect and pop falling puyos in this latest of the hit puzzle game series.\That's why you rotate it here like this.\Rotate?\You insert it here, these pop, and these shift down.\Why?\She did it. response:	Finally.
context: After careful consideration, the game of choice is Puyo Pop Fever.\You connect and pop falling puyos in this latest of the hit puzzle game series.\That's why you rotate it here like this.\Rotate?\You insert it here, these pop, and these shift down.\Why?\She did it.\Finally. response:	What?
context: You connect and pop falling puyos in this latest of the hit puzzle game series.\That's why you rotate it here like this.\Rotate?\You insert it here, these pop, and these shift down.\Why?\She did it.\Finally.\What? response:	What? What?
context: That's why you rotate it here like this.\Rotate?\You insert it here, these pop, and these shift down.\Why?\She did it.\Finally.\What?\What? What? response:	Oh yeah!
context: Rotate?\You insert it here, these pop, and these shift down.\Why?\She did it.\Finally.\What?\What? What?\Oh yeah! response:	Thuddy thud. Oh yeah!
context: You insert it here, these pop, and these shift down.\Why?\She did it.\Finally.\What?\What? What?\Oh yeah!\Thuddy thud. Oh yeah! response:	No way!
context: Why?\She did it.\Finally.\What?\What? What?\Oh yeah!\Thuddy thud. Oh yeah!\No way! response:	What the hell's with that?
context: She did it.\Finally.\What?\What? What?\Oh yeah!\Thuddy thud. Oh yeah!\No way!\What the hell's with that? response:	It's no use asking us.
context: Finally.\What?\What? What?\Oh yeah!\Thuddy thud. Oh yeah!\No way!\What the hell's with that?\It's no use asking us. response:	Okay, I'll give it a shot tonight.
context: What?\What? What?\Oh yeah!\Thuddy thud. Oh yeah!\No way!\What the hell's with that?\It's no use asking us.\Okay, I'll give it a shot tonight. response:	Now that was weird.
context: What? What?\Oh yeah!\Thuddy thud. Oh yeah!\No way!\What the hell's with that?\It's no use asking us.\Okay, I'll give it a shot tonight.\Now that was weird. response:	Kasukabe played a video game.
context: Oh yeah!\Thuddy thud. Oh yeah!\No way!\What the hell's with that?\It's no use asking us.\Okay, I'll give it a shot tonight.\Now that was weird.\Kasukabe played a video game. response:	Stop the world so I can get off.
context: Thuddy thud. Oh yeah!\No way!\What the hell's with that?\It's no use asking us.\Okay, I'll give it a shot tonight.\Now that was weird.\Kasukabe played a video game.\Stop the world so I can get off. response:	But, thank goodness she got to where she can do it.
context: No way!\What the hell's with that?\It's no use asking us.\Okay, I'll give it a shot tonight.\Now that was weird.\Kasukabe played a video game.\Stop the world so I can get off.\But, thank goodness she got to where she can do it. response:	Playing against Kohsaka, though...
context: What the hell's with that?\It's no use asking us.\Okay, I'll give it a shot tonight.\Now that was weird.\Kasukabe played a video game.\Stop the world so I can get off.\But, thank goodness she got to where she can do it.\Playing against Kohsaka, though... response:	You're right.
context: It's no use asking us.\Okay, I'll give it a shot tonight.\Now that was weird.\Kasukabe played a video game.\Stop the world so I can get off.\But, thank goodness she got to where she can do it.\Playing against Kohsaka, though...\You're right. response:	He'll have a 5-chain put together in no time.
context: Okay, I'll give it a shot tonight.\Now that was weird.\Kasukabe played a video game.\Stop the world so I can get off.\But, thank goodness she got to where she can do it.\Playing against Kohsaka, though...\You're right.\He'll have a 5-chain put together in no time. response:	Hopefully he'll hold back against her a little...
context: Now that was weird.\Kasukabe played a video game.\Stop the world so I can get off.\But, thank goodness she got to where she can do it.\Playing against Kohsaka, though...\You're right.\He'll have a 5-chain put together in no time.\Hopefully he'll hold back against her a little... response:	Know what, though, she was talking about herself before...
context: Kasukabe played a video game.\Stop the world so I can get off.\But, thank goodness she got to where she can do it.\Playing against Kohsaka, though...\You're right.\He'll have a 5-chain put together in no time.\Hopefully he'll hold back against her a little...\Know what, though, she was talking about herself before... response:	So tonight...
context: Stop the world so I can get off.\But, thank goodness she got to where she can do it.\Playing against Kohsaka, though...\You're right.\He'll have a 5-chain put together in no time.\Hopefully he'll hold back against her a little...\Know what, though, she was talking about herself before...\So tonight... response:	I don't like this vibe...
context: But, thank goodness she got to where she can do it.\Playing against Kohsaka, though...\You're right.\He'll have a 5-chain put together in no time.\Hopefully he'll hold back against her a little...\Know what, though, she was talking about herself before...\So tonight...\I don't like this vibe... response:	Let's play Puyo Pop!
context: Playing against Kohsaka, though...\You're right.\He'll have a 5-chain put together in no time.\Hopefully he'll hold back against her a little...\Know what, though, she was talking about herself before...\So tonight...\I don't like this vibe...\Let's play Puyo Pop! response:	Huh?
context: You're right.\He'll have a 5-chain put together in no time.\Hopefully he'll hold back against her a little...\Know what, though, she was talking about herself before...\So tonight...\I don't like this vibe...\Let's play Puyo Pop!\Huh? response:	Play me in Puyo Pop.
context: He'll have a 5-chain put together in no time.\Hopefully he'll hold back against her a little...\Know what, though, she was talking about herself before...\So tonight...\I don't like this vibe...\Let's play Puyo Pop!\Huh?\Play me in Puyo Pop. response:	What's with you?
context: Hopefully he'll hold back against her a little...\Know what, though, she was talking about herself before...\So tonight...\I don't like this vibe...\Let's play Puyo Pop!\Huh?\Play me in Puyo Pop.\What's with you? response:	I played it today at Genshiken, it was kind of fun.
context: Know what, though, she was talking about herself before...\So tonight...\I don't like this vibe...\Let's play Puyo Pop!\Huh?\Play me in Puyo Pop.\What's with you?\I played it today at Genshiken, it was kind of fun. response:	Wow...
context: So tonight...\I don't like this vibe...\Let's play Puyo Pop!\Huh?\Play me in Puyo Pop.\What's with you?\I played it today at Genshiken, it was kind of fun.\Wow... response:	Here we go!
context: I don't like this vibe...\Let's play Puyo Pop!\Huh?\Play me in Puyo Pop.\What's with you?\I played it today at Genshiken, it was kind of fun.\Wow...\Here we go! response:	Whadda ya think?
context: Let's play Puyo Pop!\Huh?\Play me in Puyo Pop.\What's with you?\I played it today at Genshiken, it was kind of fun.\Wow...\Here we go!\Whadda ya think? response:	Huh?
context: Huh?\Play me in Puyo Pop.\What's with you?\I played it today at Genshiken, it was kind of fun.\Wow...\Here we go!\Whadda ya think?\Huh? response:	Oh?
context: Play me in Puyo Pop.\What's with you?\I played it today at Genshiken, it was kind of fun.\Wow...\Here we go!\Whadda ya think?\Huh?\Oh? response:	Yeah!
context: What's with you?\I played it today at Genshiken, it was kind of fun.\Wow...\Here we go!\Whadda ya think?\Huh?\Oh?\Yeah! response:	Here I go!
context: I played it today at Genshiken, it was kind of fun.\Wow...\Here we go!\Whadda ya think?\Huh?\Oh?\Yeah!\Here I go! response:	Ice Storm!
context: Wow...\Here we go!\Whadda ya think?\Huh?\Oh?\Yeah!\Here I go!\Ice Storm! response:	Take that!
context: Here we go!\Whadda ya think?\Huh?\Oh?\Yeah!\Here I go!\Ice Storm!\Take that! response:	You're done for!
context: Whadda ya think?\Huh?\Oh?\Yeah!\Here I go!\Ice Storm!\Take that!\You're done for! response:	You're done for!
context: Huh?\Oh?\Yeah!\Here I go!\Ice Storm!\Take that!\You're done for!\You're done for! response:	Ha ha, you suck!
context: Oh?\Yeah!\Here I go!\Ice Storm!\Take that!\You're done for!\You're done for!\Ha ha, you suck! response:	What?
context: Yeah!\Here I go!\Ice Storm!\Take that!\You're done for!\You're done for!\Ha ha, you suck!\What? response:	What?
context: Here I go!\Ice Storm!\Take that!\You're done for!\You're done for!\Ha ha, you suck!\What?\What? response:	Oh yeah!
context: Ice Storm!\Take that!\You're done for!\You're done for!\Ha ha, you suck!\What?\What?\Oh yeah! response:	Thuddy thud. Oh yeah!
context: Take that!\You're done for!\You're done for!\Ha ha, you suck!\What?\What?\Oh yeah!\Thuddy thud. Oh yeah! response:	All right!
context: You're done for!\You're done for!\Ha ha, you suck!\What?\What?\Oh yeah!\Thuddy thud. Oh yeah!\All right! response:	Puyo Pop cosplay.
context: You're done for!\Ha ha, you suck!\What?\What?\Oh yeah!\Thuddy thud. Oh yeah!\All right!\Puyo Pop cosplay. response:	Does it turn you on?
context: Ha ha, you suck!\What?\What?\Oh yeah!\Thuddy thud. Oh yeah!\All right!\Puyo Pop cosplay.\Does it turn you on? response:	Well, I mean, you're a puyo.
context: What?\What?\Oh yeah!\Thuddy thud. Oh yeah!\All right!\Puyo Pop cosplay.\Does it turn you on?\Well, I mean, you're a puyo. response:	That night was the last time Saki Kasukabe ever played a video game...
context: What?\Oh yeah!\Thuddy thud. Oh yeah!\All right!\Puyo Pop cosplay.\Does it turn you on?\Well, I mean, you're a puyo.\That night was the last time Saki Kasukabe ever played a video game... response:	Hello.
context: Oh yeah!\Thuddy thud. Oh yeah!\All right!\Puyo Pop cosplay.\Does it turn you on?\Well, I mean, you're a puyo.\That night was the last time Saki Kasukabe ever played a video game...\Hello. response:	Where's Kohsaka?
context: Thuddy thud. Oh yeah!\All right!\Puyo Pop cosplay.\Does it turn you on?\Well, I mean, you're a puyo.\That night was the last time Saki Kasukabe ever played a video game...\Hello.\Where's Kohsaka? response:	In Akihabara...
context: All right!\Puyo Pop cosplay.\Does it turn you on?\Well, I mean, you're a puyo.\That night was the last time Saki Kasukabe ever played a video game...\Hello.\Where's Kohsaka?\In Akihabara... response:	What, aren't you playing league matches today?
context: Puyo Pop cosplay.\Does it turn you on?\Well, I mean, you're a puyo.\That night was the last time Saki Kasukabe ever played a video game...\Hello.\Where's Kohsaka?\In Akihabara...\What, aren't you playing league matches today? response:	Looks like it's best not to pour any more fuel on the fire.
context: Does it turn you on?\Well, I mean, you're a puyo.\That night was the last time Saki Kasukabe ever played a video game...\Hello.\Where's Kohsaka?\In Akihabara...\What, aren't you playing league matches today?\Looks like it's best not to pour any more fuel on the fire. response:	Dammit, if Kohsaka were here, she could just leave with him.
context: Well, I mean, you're a puyo.\That night was the last time Saki Kasukabe ever played a video game...\Hello.\Where's Kohsaka?\In Akihabara...\What, aren't you playing league matches today?\Looks like it's best not to pour any more fuel on the fire.\Dammit, if Kohsaka were here, she could just leave with him. response:	Oh yeah, that's right.
context: That night was the last time Saki Kasukabe ever played a video game...\Hello.\Where's Kohsaka?\In Akihabara...\What, aren't you playing league matches today?\Looks like it's best not to pour any more fuel on the fire.\Dammit, if Kohsaka were here, she could just leave with him.\Oh yeah, that's right. response:	It's almost been a year since you joined, Sasahara.
context: Hello.\Where's Kohsaka?\In Akihabara...\What, aren't you playing league matches today?\Looks like it's best not to pour any more fuel on the fire.\Dammit, if Kohsaka were here, she could just leave with him.\Oh yeah, that's right.\It's almost been a year since you joined, Sasahara. response:	Y-Yeah.
context: Where's Kohsaka?\In Akihabara...\What, aren't you playing league matches today?\Looks like it's best not to pour any more fuel on the fire.\Dammit, if Kohsaka were here, she could just leave with him.\Oh yeah, that's right.\It's almost been a year since you joined, Sasahara.\Y-Yeah. response:	So? Have you grown at all?
context: In Akihabara...\What, aren't you playing league matches today?\Looks like it's best not to pour any more fuel on the fire.\Dammit, if Kohsaka were here, she could just leave with him.\Oh yeah, that's right.\It's almost been a year since you joined, Sasahara.\Y-Yeah.\So? Have you grown at all? response:	Grown?
context: What, aren't you playing league matches today?\Looks like it's best not to pour any more fuel on the fire.\Dammit, if Kohsaka were here, she could just leave with him.\Oh yeah, that's right.\It's almost been a year since you joined, Sasahara.\Y-Yeah.\So? Have you grown at all?\Grown? response:	What do you mean by growth in this case?
context: Looks like it's best not to pour any more fuel on the fire.\Dammit, if Kohsaka were here, she could just leave with him.\Oh yeah, that's right.\It's almost been a year since you joined, Sasahara.\Y-Yeah.\So? Have you grown at all?\Grown?\What do you mean by growth in this case? response:	Well, I spend a lot more money now.
context: Dammit, if Kohsaka were here, she could just leave with him.\Oh yeah, that's right.\It's almost been a year since you joined, Sasahara.\Y-Yeah.\So? Have you grown at all?\Grown?\What do you mean by growth in this case?\Well, I spend a lot more money now. response:	But I get the feeling that's just me being out of control...
context: Oh yeah, that's right.\It's almost been a year since you joined, Sasahara.\Y-Yeah.\So? Have you grown at all?\Grown?\What do you mean by growth in this case?\Well, I spend a lot more money now.\But I get the feeling that's just me being out of control... response:	I can't call myself an otaku when I don't have my own computer.
context: It's almost been a year since you joined, Sasahara.\Y-Yeah.\So? Have you grown at all?\Grown?\What do you mean by growth in this case?\Well, I spend a lot more money now.\But I get the feeling that's just me being out of control...\I can't call myself an otaku when I don't have my own computer. response:	Whoa, you say you're not otaku?
context: Y-Yeah.\So? Have you grown at all?\Grown?\What do you mean by growth in this case?\Well, I spend a lot more money now.\But I get the feeling that's just me being out of control...\I can't call myself an otaku when I don't have my own computer.\Whoa, you say you're not otaku? response:	No, it's not that.
context: So? Have you grown at all?\Grown?\What do you mean by growth in this case?\Well, I spend a lot more money now.\But I get the feeling that's just me being out of control...\I can't call myself an otaku when I don't have my own computer.\Whoa, you say you're not otaku?\No, it's not that. response:	Maybe I just have a ways to go...
context: Grown?\What do you mean by growth in this case?\Well, I spend a lot more money now.\But I get the feeling that's just me being out of control...\I can't call myself an otaku when I don't have my own computer.\Whoa, you say you're not otaku?\No, it's not that.\Maybe I just have a ways to go... response:	Why don't you buy a computer?
context: What do you mean by growth in this case?\Well, I spend a lot more money now.\But I get the feeling that's just me being out of control...\I can't call myself an otaku when I don't have my own computer.\Whoa, you say you're not otaku?\No, it's not that.\Maybe I just have a ways to go...\Why don't you buy a computer? response:	Have you got some mental block against it?
context: Well, I spend a lot more money now.\But I get the feeling that's just me being out of control...\I can't call myself an otaku when I don't have my own computer.\Whoa, you say you're not otaku?\No, it's not that.\Maybe I just have a ways to go...\Why don't you buy a computer?\Have you got some mental block against it? response:	Not at all.
context: But I get the feeling that's just me being out of control...\I can't call myself an otaku when I don't have my own computer.\Whoa, you say you're not otaku?\No, it's not that.\Maybe I just have a ways to go...\Why don't you buy a computer?\Have you got some mental block against it?\Not at all. response:	Like I said before, I spent all my money.
context: I can't call myself an otaku when I don't have my own computer.\Whoa, you say you're not otaku?\No, it's not that.\Maybe I just have a ways to go...\Why don't you buy a computer?\Have you got some mental block against it?\Not at all.\Like I said before, I spent all my money. response:	No, you can buy one!
context: Whoa, you say you're not otaku?\No, it's not that.\Maybe I just have a ways to go...\Why don't you buy a computer?\Have you got some mental block against it?\Not at all.\Like I said before, I spent all my money.\No, you can buy one! response:	If you put your mind to it, you'll find a way.
context: No, it's not that.\Maybe I just have a ways to go...\Why don't you buy a computer?\Have you got some mental block against it?\Not at all.\Like I said before, I spent all my money.\No, you can buy one!\If you put your mind to it, you'll find a way. response:	It's like that proverb...
context: Maybe I just have a ways to go...\Why don't you buy a computer?\Have you got some mental block against it?\Not at all.\Like I said before, I spent all my money.\No, you can buy one!\If you put your mind to it, you'll find a way.\It's like that proverb... response:	Think after you buy!
context: Why don't you buy a computer?\Have you got some mental block against it?\Not at all.\Like I said before, I spent all my money.\No, you can buy one!\If you put your mind to it, you'll find a way.\It's like that proverb...\Think after you buy! response:	Th-This would be the part where s-someone smacks you down.
context: Have you got some mental block against it?\Not at all.\Like I said before, I spent all my money.\No, you can buy one!\If you put your mind to it, you'll find a way.\It's like that proverb...\Think after you buy!\Th-This would be the part where s-someone smacks you down. response:	But, that's exactly why I don't have any money right now.
context: Not at all.\Like I said before, I spent all my money.\No, you can buy one!\If you put your mind to it, you'll find a way.\It's like that proverb...\Think after you buy!\Th-This would be the part where s-someone smacks you down.\But, that's exactly why I don't have any money right now. response:	True.
context: Like I said before, I spent all my money.\No, you can buy one!\If you put your mind to it, you'll find a way.\It's like that proverb...\Think after you buy!\Th-This would be the part where s-someone smacks you down.\But, that's exactly why I don't have any money right now.\True. response:	Oh, that's me.
context: No, you can buy one!\If you put your mind to it, you'll find a way.\It's like that proverb...\Think after you buy!\Th-This would be the part where s-someone smacks you down.\But, that's exactly why I don't have any money right now.\True.\Oh, that's me. response:	I don't know this number...
context: If you put your mind to it, you'll find a way.\It's like that proverb...\Think after you buy!\Th-This would be the part where s-someone smacks you down.\But, that's exactly why I don't have any money right now.\True.\Oh, that's me.\I don't know this number... response:	Then don't answer it.
context: It's like that proverb...\Think after you buy!\Th-This would be the part where s-someone smacks you down.\But, that's exactly why I don't have any money right now.\True.\Oh, that's me.\I don't know this number...\Then don't answer it. response:	I couldn't do that.
context: Think after you buy!\Th-This would be the part where s-someone smacks you down.\But, that's exactly why I don't have any money right now.\True.\Oh, that's me.\I don't know this number...\Then don't answer it.\I couldn't do that. response:	Hello...
context: Th-This would be the part where s-someone smacks you down.\But, that's exactly why I don't have any money right now.\True.\Oh, that's me.\I don't know this number...\Then don't answer it.\I couldn't do that.\Hello... response:	Oh hell, it's you!
context: But, that's exactly why I don't have any money right now.\True.\Oh, that's me.\I don't know this number...\Then don't answer it.\I couldn't do that.\Hello...\Oh hell, it's you! response:	What's with this big time un-Sasahara-like attitude?
context: True.\Oh, that's me.\I don't know this number...\Then don't answer it.\I couldn't do that.\Hello...\Oh hell, it's you!\What's with this big time un-Sasahara-like attitude? response:	You switched cell phones again?
context: Oh, that's me.\I don't know this number...\Then don't answer it.\I couldn't do that.\Hello...\Oh hell, it's you!\What's with this big time un-Sasahara-like attitude?\You switched cell phones again? response:	Yeah, yeah...
context: I don't know this number...\Then don't answer it.\I couldn't do that.\Hello...\Oh hell, it's you!\What's with this big time un-Sasahara-like attitude?\You switched cell phones again?\Yeah, yeah... response:	Wait a minute!
context: Then don't answer it.\I couldn't do that.\Hello...\Oh hell, it's you!\What's with this big time un-Sasahara-like attitude?\You switched cell phones again?\Yeah, yeah...\Wait a minute! response:	No, I'm on my way!
context: I couldn't do that.\Hello...\Oh hell, it's you!\What's with this big time un-Sasahara-like attitude?\You switched cell phones again?\Yeah, yeah...\Wait a minute!\No, I'm on my way! response:	Don't move.
context: Hello...\Oh hell, it's you!\What's with this big time un-Sasahara-like attitude?\You switched cell phones again?\Yeah, yeah...\Wait a minute!\No, I'm on my way!\Don't move. response:	No, not that...
context: Oh hell, it's you!\What's with this big time un-Sasahara-like attitude?\You switched cell phones again?\Yeah, yeah...\Wait a minute!\No, I'm on my way!\Don't move.\No, not that... response:	Yeah...
context: What's with this big time un-Sasahara-like attitude?\You switched cell phones again?\Yeah, yeah...\Wait a minute!\No, I'm on my way!\Don't move.\No, not that...\Yeah... response:	May I ask who?
context: You switched cell phones again?\Yeah, yeah...\Wait a minute!\No, I'm on my way!\Don't move.\No, not that...\Yeah...\May I ask who? response:	My little sister's at the train station...
context: Yeah, yeah...\Wait a minute!\No, I'm on my way!\Don't move.\No, not that...\Yeah...\May I ask who?\My little sister's at the train station... response:	Wow, you've got a sister!
context: Wait a minute!\No, I'm on my way!\Don't move.\No, not that...\Yeah...\May I ask who?\My little sister's at the train station...\Wow, you've got a sister! response:	Trippy.
context: No, I'm on my way!\Don't move.\No, not that...\Yeah...\May I ask who?\My little sister's at the train station...\Wow, you've got a sister!\Trippy. response:	First a childhood friend, now a sister!
context: Don't move.\No, not that...\Yeah...\May I ask who?\My little sister's at the train station...\Wow, you've got a sister!\Trippy.\First a childhood friend, now a sister! response:	I feel s-so moved.
context: No, not that...\Yeah...\May I ask who?\My little sister's at the train station...\Wow, you've got a sister!\Trippy.\First a childhood friend, now a sister!\I feel s-so moved. response:	No, you've got the wrong idea!
context: Yeah...\May I ask who?\My little sister's at the train station...\Wow, you've got a sister!\Trippy.\First a childhood friend, now a sister!\I feel s-so moved.\No, you've got the wrong idea! response:	She's a fashion slave, a trashy high school chick.
context: May I ask who?\My little sister's at the train station...\Wow, you've got a sister!\Trippy.\First a childhood friend, now a sister!\I feel s-so moved.\No, you've got the wrong idea!\She's a fashion slave, a trashy high school chick. response:	She wouldn't understand us, in fact it's best if you don't meet her.
context: My little sister's at the train station...\Wow, you've got a sister!\Trippy.\First a childhood friend, now a sister!\I feel s-so moved.\No, you've got the wrong idea!\She's a fashion slave, a trashy high school chick.\She wouldn't understand us, in fact it's best if you don't meet her. response:	On that note, you don't go for the little sister look at all.
context: Wow, you've got a sister!\Trippy.\First a childhood friend, now a sister!\I feel s-so moved.\No, you've got the wrong idea!\She's a fashion slave, a trashy high school chick.\She wouldn't understand us, in fact it's best if you don't meet her.\On that note, you don't go for the little sister look at all. response:	In fighting games you always use the sexy older female characters.
context: Trippy.\First a childhood friend, now a sister!\I feel s-so moved.\No, you've got the wrong idea!\She's a fashion slave, a trashy high school chick.\She wouldn't understand us, in fact it's best if you don't meet her.\On that note, you don't go for the little sister look at all.\In fighting games you always use the sexy older female characters. response:	You're right.
context: First a childhood friend, now a sister!\I feel s-so moved.\No, you've got the wrong idea!\She's a fashion slave, a trashy high school chick.\She wouldn't understand us, in fact it's best if you don't meet her.\On that note, you don't go for the little sister look at all.\In fighting games you always use the sexy older female characters.\You're right. response:	I can say for a fact that fad's just an illusion for those...
context: I feel s-so moved.\No, you've got the wrong idea!\She's a fashion slave, a trashy high school chick.\She wouldn't understand us, in fact it's best if you don't meet her.\On that note, you don't go for the little sister look at all.\In fighting games you always use the sexy older female characters.\You're right.\I can say for a fact that fad's just an illusion for those... response:	You're such a fool, Sasahara.
context: No, you've got the wrong idea!\She's a fashion slave, a trashy high school chick.\She wouldn't understand us, in fact it's best if you don't meet her.\On that note, you don't go for the little sister look at all.\In fighting games you always use the sexy older female characters.\You're right.\I can say for a fact that fad's just an illusion for those...\You're such a fool, Sasahara. response:	Why would I ever need a little sister I'm related to?
context: She's a fashion slave, a trashy high school chick.\She wouldn't understand us, in fact it's best if you don't meet her.\On that note, you don't go for the little sister look at all.\In fighting games you always use the sexy older female characters.\You're right.\I can say for a fact that fad's just an illusion for those...\You're such a fool, Sasahara.\Why would I ever need a little sister I'm related to? response:	he's not pulling any punches.
context: She wouldn't understand us, in fact it's best if you don't meet her.\On that note, you don't go for the little sister look at all.\In fighting games you always use the sexy older female characters.\You're right.\I can say for a fact that fad's just an illusion for those...\You're such a fool, Sasahara.\Why would I ever need a little sister I'm related to?\he's not pulling any punches. response:	B-But, in a way it's normal.
context: On that note, you don't go for the little sister look at all.\In fighting games you always use the sexy older female characters.\You're right.\I can say for a fact that fad's just an illusion for those...\You're such a fool, Sasahara.\Why would I ever need a little sister I'm related to?\he's not pulling any punches.\B-But, in a way it's normal. response:	You'll think she's from another planet if you see her.
context: In fighting games you always use the sexy older female characters.\You're right.\I can say for a fact that fad's just an illusion for those...\You're such a fool, Sasahara.\Why would I ever need a little sister I'm related to?\he's not pulling any punches.\B-But, in a way it's normal.\You'll think she's from another planet if you see her. response:	Well, that's how it goes.
context: You're right.\I can say for a fact that fad's just an illusion for those...\You're such a fool, Sasahara.\Why would I ever need a little sister I'm related to?\he's not pulling any punches.\B-But, in a way it's normal.\You'll think she's from another planet if you see her.\Well, that's how it goes. response:	Please don't follow me!
context: I can say for a fact that fad's just an illusion for those...\You're such a fool, Sasahara.\Why would I ever need a little sister I'm related to?\he's not pulling any punches.\B-But, in a way it's normal.\You'll think she's from another planet if you see her.\Well, that's how it goes.\Please don't follow me! response:	We won't.
context: You're such a fool, Sasahara.\Why would I ever need a little sister I'm related to?\he's not pulling any punches.\B-But, in a way it's normal.\You'll think she's from another planet if you see her.\Well, that's how it goes.\Please don't follow me!\We won't. response:	The station, you said?
context: Why would I ever need a little sister I'm related to?\he's not pulling any punches.\B-But, in a way it's normal.\You'll think she's from another planet if you see her.\Well, that's how it goes.\Please don't follow me!\We won't.\The station, you said? response:	So that's her...
context: he's not pulling any punches.\B-But, in a way it's normal.\You'll think she's from another planet if you see her.\Well, that's how it goes.\Please don't follow me!\We won't.\The station, you said?\So that's her... response:	Yup, she's got nothing in common with us...
context: B-But, in a way it's normal.\You'll think she's from another planet if you see her.\Well, that's how it goes.\Please don't follow me!\We won't.\The station, you said?\So that's her...\Yup, she's got nothing in common with us... response:	You can't even see her face through the make-up.
context: You'll think she's from another planet if you see her.\Well, that's how it goes.\Please don't follow me!\We won't.\The station, you said?\So that's her...\Yup, she's got nothing in common with us...\You can't even see her face through the make-up. response:	T-They all look the same.
context: Well, that's how it goes.\Please don't follow me!\We won't.\The station, you said?\So that's her...\Yup, she's got nothing in common with us...\You can't even see her face through the make-up.\T-They all look the same. response:	What do you think she calls him?
context: Please don't follow me!\We won't.\The station, you said?\So that's her...\Yup, she's got nothing in common with us...\You can't even see her face through the make-up.\T-They all look the same.\What do you think she calls him? response:	Big Brother is right out.
context: We won't.\The station, you said?\So that's her...\Yup, she's got nothing in common with us...\You can't even see her face through the make-up.\T-They all look the same.\What do you think she calls him?\Big Brother is right out. response:	With her, probably bro.
context: The station, you said?\So that's her...\Yup, she's got nothing in common with us...\You can't even see her face through the make-up.\T-They all look the same.\What do you think she calls him?\Big Brother is right out.\With her, probably bro. response:	Or else h-hey you...
context: So that's her...\Yup, she's got nothing in common with us...\You can't even see her face through the make-up.\T-They all look the same.\What do you think she calls him?\Big Brother is right out.\With her, probably bro.\Or else h-hey you... response:	What's with you guys?
context: Yup, she's got nothing in common with us...\You can't even see her face through the make-up.\T-They all look the same.\What do you think she calls him?\Big Brother is right out.\With her, probably bro.\Or else h-hey you...\What's with you guys? response:	Took you long enough, monkey!
context: You can't even see her face through the make-up.\T-They all look the same.\What do you think she calls him?\Big Brother is right out.\With her, probably bro.\Or else h-hey you...\What's with you guys?\Took you long enough, monkey! response:	Monkey...
context: T-They all look the same.\What do you think she calls him?\Big Brother is right out.\With her, probably bro.\Or else h-hey you...\What's with you guys?\Took you long enough, monkey!\Monkey... response:	Pity...
context: What do you think she calls him?\Big Brother is right out.\With her, probably bro.\Or else h-hey you...\What's with you guys?\Took you long enough, monkey!\Monkey...\Pity... response:	You're still saying that?
context: Big Brother is right out.\With her, probably bro.\Or else h-hey you...\What's with you guys?\Took you long enough, monkey!\Monkey...\Pity...\You're still saying that? response:	Whatever, lend me some money.
context: With her, probably bro.\Or else h-hey you...\What's with you guys?\Took you long enough, monkey!\Monkey...\Pity...\You're still saying that?\Whatever, lend me some money. response:	You mean you came all this way for that?
context: Or else h-hey you...\What's with you guys?\Took you long enough, monkey!\Monkey...\Pity...\You're still saying that?\Whatever, lend me some money.\You mean you came all this way for that? response:	My boyfriend and I went to the park zoo in his car...
context: What's with you guys?\Took you long enough, monkey!\Monkey...\Pity...\You're still saying that?\Whatever, lend me some money.\You mean you came all this way for that?\My boyfriend and I went to the park zoo in his car... response:	My purse's in his car.
context: Took you long enough, monkey!\Monkey...\Pity...\You're still saying that?\Whatever, lend me some money.\You mean you came all this way for that?\My boyfriend and I went to the park zoo in his car...\My purse's in his car. response:	Weren't you the one who said...
context: Monkey...\Pity...\You're still saying that?\Whatever, lend me some money.\You mean you came all this way for that?\My boyfriend and I went to the park zoo in his car...\My purse's in his car.\Weren't you the one who said... response:	I know, but it's no use.
context: Pity...\You're still saying that?\Whatever, lend me some money.\You mean you came all this way for that?\My boyfriend and I went to the park zoo in his car...\My purse's in his car.\Weren't you the one who said...\I know, but it's no use. response:	I can't stand homely guys.
context: You're still saying that?\Whatever, lend me some money.\You mean you came all this way for that?\My boyfriend and I went to the park zoo in his car...\My purse's in his car.\Weren't you the one who said...\I know, but it's no use.\I can't stand homely guys. response:	My friends are all the same way too.
context: Whatever, lend me some money.\You mean you came all this way for that?\My boyfriend and I went to the park zoo in his car...\My purse's in his car.\Weren't you the one who said...\I know, but it's no use.\I can't stand homely guys.\My friends are all the same way too. response:	Besides, this is normal.
context: You mean you came all this way for that?\My boyfriend and I went to the park zoo in his car...\My purse's in his car.\Weren't you the one who said...\I know, but it's no use.\I can't stand homely guys.\My friends are all the same way too.\Besides, this is normal. response:	Now I go home on my own and we make up big time.
context: My boyfriend and I went to the park zoo in his car...\My purse's in his car.\Weren't you the one who said...\I know, but it's no use.\I can't stand homely guys.\My friends are all the same way too.\Besides, this is normal.\Now I go home on my own and we make up big time. response:	It's the big in thing right now, this whole test thing.
context: My purse's in his car.\Weren't you the one who said...\I know, but it's no use.\I can't stand homely guys.\My friends are all the same way too.\Besides, this is normal.\Now I go home on my own and we make up big time.\It's the big in thing right now, this whole test thing. response:	I don't get it.
context: Weren't you the one who said...\I know, but it's no use.\I can't stand homely guys.\My friends are all the same way too.\Besides, this is normal.\Now I go home on my own and we make up big time.\It's the big in thing right now, this whole test thing.\I don't get it. response:	So give me some money.
context: I know, but it's no use.\I can't stand homely guys.\My friends are all the same way too.\Besides, this is normal.\Now I go home on my own and we make up big time.\It's the big in thing right now, this whole test thing.\I don't get it.\So give me some money. response:	That wouldn't make it on your own...
context: I can't stand homely guys.\My friends are all the same way too.\Besides, this is normal.\Now I go home on my own and we make up big time.\It's the big in thing right now, this whole test thing.\I don't get it.\So give me some money.\That wouldn't make it on your own... response:	I'll bet she's the type who's easily influenced by friends.
context: My friends are all the same way too.\Besides, this is normal.\Now I go home on my own and we make up big time.\It's the big in thing right now, this whole test thing.\I don't get it.\So give me some money.\That wouldn't make it on your own...\I'll bet she's the type who's easily influenced by friends. response:	Is she?
context: Besides, this is normal.\Now I go home on my own and we make up big time.\It's the big in thing right now, this whole test thing.\I don't get it.\So give me some money.\That wouldn't make it on your own...\I'll bet she's the type who's easily influenced by friends.\Is she? response:	And it only takes an instant.
context: Now I go home on my own and we make up big time.\It's the big in thing right now, this whole test thing.\I don't get it.\So give me some money.\That wouldn't make it on your own...\I'll bet she's the type who's easily influenced by friends.\Is she?\And it only takes an instant. response:	I can't see her growing up in the same household as Sasahara.
context: It's the big in thing right now, this whole test thing.\I don't get it.\So give me some money.\That wouldn't make it on your own...\I'll bet she's the type who's easily influenced by friends.\Is she?\And it only takes an instant.\I can't see her growing up in the same household as Sasahara. response:	What was Sasahara's first name again?
context: I don't get it.\So give me some money.\That wouldn't make it on your own...\I'll bet she's the type who's easily influenced by friends.\Is she?\And it only takes an instant.\I can't see her growing up in the same household as Sasahara.\What was Sasahara's first name again? response:	I think it's Kanji...
context: So give me some money.\That wouldn't make it on your own...\I'll bet she's the type who's easily influenced by friends.\Is she?\And it only takes an instant.\I can't see her growing up in the same household as Sasahara.\What was Sasahara's first name again?\I think it's Kanji... response:	Y-You can't be...
context: That wouldn't make it on your own...\I'll bet she's the type who's easily influenced by friends.\Is she?\And it only takes an instant.\I can't see her growing up in the same household as Sasahara.\What was Sasahara's first name again?\I think it's Kanji...\Y-You can't be... response:	Hey Kanji!
context: I'll bet she's the type who's easily influenced by friends.\Is she?\And it only takes an instant.\I can't see her growing up in the same household as Sasahara.\What was Sasahara's first name again?\I think it's Kanji...\Y-You can't be...\Hey Kanji! response:	What're you up to?
context: Is she?\And it only takes an instant.\I can't see her growing up in the same household as Sasahara.\What was Sasahara's first name again?\I think it's Kanji...\Y-You can't be...\Hey Kanji!\What're you up to? response:	I thought you were gonna hang out with me.
context: And it only takes an instant.\I can't see her growing up in the same household as Sasahara.\What was Sasahara's first name again?\I think it's Kanji...\Y-You can't be...\Hey Kanji!\What're you up to?\I thought you were gonna hang out with me. response:	What?
context: I can't see her growing up in the same household as Sasahara.\What was Sasahara's first name again?\I think it's Kanji...\Y-You can't be...\Hey Kanji!\What're you up to?\I thought you were gonna hang out with me.\What? response:	Oh, who's she?
context: What was Sasahara's first name again?\I think it's Kanji...\Y-You can't be...\Hey Kanji!\What're you up to?\I thought you were gonna hang out with me.\What?\Oh, who's she? response:	Huh? Eh?
context: I think it's Kanji...\Y-You can't be...\Hey Kanji!\What're you up to?\I thought you were gonna hang out with me.\What?\Oh, who's she?\Huh? Eh? response:	Kasukabe, look...
context: Y-You can't be...\Hey Kanji!\What're you up to?\I thought you were gonna hang out with me.\What?\Oh, who's she?\Huh? Eh?\Kasukabe, look... response:	I asked you not to follow me because you do things like this.
context: Hey Kanji!\What're you up to?\I thought you were gonna hang out with me.\What?\Oh, who's she?\Huh? Eh?\Kasukabe, look...\I asked you not to follow me because you do things like this. response:	Way to kill the mood!
context: What're you up to?\I thought you were gonna hang out with me.\What?\Oh, who's she?\Huh? Eh?\Kasukabe, look...\I asked you not to follow me because you do things like this.\Way to kill the mood! response:	You really are a boring guy.
context: I thought you were gonna hang out with me.\What?\Oh, who's she?\Huh? Eh?\Kasukabe, look...\I asked you not to follow me because you do things like this.\Way to kill the mood!\You really are a boring guy. response:	My friend's girlfriend...
context: What?\Oh, who's she?\Huh? Eh?\Kasukabe, look...\I asked you not to follow me because you do things like this.\Way to kill the mood!\You really are a boring guy.\My friend's girlfriend... response:	You see how she is...
context: Oh, who's she?\Huh? Eh?\Kasukabe, look...\I asked you not to follow me because you do things like this.\Way to kill the mood!\You really are a boring guy.\My friend's girlfriend...\You see how she is... response:	An otaku?
context: Huh? Eh?\Kasukabe, look...\I asked you not to follow me because you do things like this.\Way to kill the mood!\You really are a boring guy.\My friend's girlfriend...\You see how she is...\An otaku? response:	Don't hit her for that just because she's my sister...
context: Kasukabe, look...\I asked you not to follow me because you do things like this.\Way to kill the mood!\You really are a boring guy.\My friend's girlfriend...\You see how she is...\An otaku?\Don't hit her for that just because she's my sister... response:	You two look identical in the face.
context: I asked you not to follow me because you do things like this.\Way to kill the mood!\You really are a boring guy.\My friend's girlfriend...\You see how she is...\An otaku?\Don't hit her for that just because she's my sister...\You two look identical in the face. response:	What the? Is she, like, always this rude?
context: Way to kill the mood!\You really are a boring guy.\My friend's girlfriend...\You see how she is...\An otaku?\Don't hit her for that just because she's my sister...\You two look identical in the face.\What the? Is she, like, always this rude? response:	Something tells me this is going to end ugly...
context: You really are a boring guy.\My friend's girlfriend...\You see how she is...\An otaku?\Don't hit her for that just because she's my sister...\You two look identical in the face.\What the? Is she, like, always this rude?\Something tells me this is going to end ugly... response:	Come on, that's enough, Kasukabe.
context: My friend's girlfriend...\You see how she is...\An otaku?\Don't hit her for that just because she's my sister...\You two look identical in the face.\What the? Is she, like, always this rude?\Something tells me this is going to end ugly...\Come on, that's enough, Kasukabe. response:	You too, Keiko.
context: You see how she is...\An otaku?\Don't hit her for that just because she's my sister...\You two look identical in the face.\What the? Is she, like, always this rude?\Something tells me this is going to end ugly...\Come on, that's enough, Kasukabe.\You too, Keiko. response:	What are you guys up to?
context: An otaku?\Don't hit her for that just because she's my sister...\You two look identical in the face.\What the? Is she, like, always this rude?\Something tells me this is going to end ugly...\Come on, that's enough, Kasukabe.\You too, Keiko.\What are you guys up to? response:	They said he went to Akihabara...
context: Don't hit her for that just because she's my sister...\You two look identical in the face.\What the? Is she, like, always this rude?\Something tells me this is going to end ugly...\Come on, that's enough, Kasukabe.\You too, Keiko.\What are you guys up to?\They said he went to Akihabara... response:	That means he went and bought more pain in the ass otaku crap.
context: You two look identical in the face.\What the? Is she, like, always this rude?\Something tells me this is going to end ugly...\Come on, that's enough, Kasukabe.\You too, Keiko.\What are you guys up to?\They said he went to Akihabara...\That means he went and bought more pain in the ass otaku crap. response:	Hello!
context: What the? Is she, like, always this rude?\Something tells me this is going to end ugly...\Come on, that's enough, Kasukabe.\You too, Keiko.\What are you guys up to?\They said he went to Akihabara...\That means he went and bought more pain in the ass otaku crap.\Hello! response:	My sister.
context: Something tells me this is going to end ugly...\Come on, that's enough, Kasukabe.\You too, Keiko.\What are you guys up to?\They said he went to Akihabara...\That means he went and bought more pain in the ass otaku crap.\Hello!\My sister. response:	Hello.
context: Come on, that's enough, Kasukabe.\You too, Keiko.\What are you guys up to?\They said he went to Akihabara...\That means he went and bought more pain in the ass otaku crap.\Hello!\My sister.\Hello. response:	Let's get going, Kohsaka.
context: You too, Keiko.\What are you guys up to?\They said he went to Akihabara...\That means he went and bought more pain in the ass otaku crap.\Hello!\My sister.\Hello.\Let's get going, Kohsaka. response:	This is her real boyfriend.
context: What are you guys up to?\They said he went to Akihabara...\That means he went and bought more pain in the ass otaku crap.\Hello!\My sister.\Hello.\Let's get going, Kohsaka.\This is her real boyfriend. response:	Huh?
context: They said he went to Akihabara...\That means he went and bought more pain in the ass otaku crap.\Hello!\My sister.\Hello.\Let's get going, Kohsaka.\This is her real boyfriend.\Huh? response:	Oh, right!
context: That means he went and bought more pain in the ass otaku crap.\Hello!\My sister.\Hello.\Let's get going, Kohsaka.\This is her real boyfriend.\Huh?\Oh, right! response:	These are the ones we had on order.
context: Hello!\My sister.\Hello.\Let's get going, Kohsaka.\This is her real boyfriend.\Huh?\Oh, right!\These are the ones we had on order. response:	Here's yours.
context: My sister.\Hello.\Let's get going, Kohsaka.\This is her real boyfriend.\Huh?\Oh, right!\These are the ones we had on order.\Here's yours. response:	Thanks...
context: Hello.\Let's get going, Kohsaka.\This is her real boyfriend.\Huh?\Oh, right!\These are the ones we had on order.\Here's yours.\Thanks... response:	What a coincidence, they delivered it right before my eyes.
context: Let's get going, Kohsaka.\This is her real boyfriend.\Huh?\Oh, right!\These are the ones we had on order.\Here's yours.\Thanks...\What a coincidence, they delivered it right before my eyes. response:	What's that? Looks big, must be cool.
context: This is her real boyfriend.\Huh?\Oh, right!\These are the ones we had on order.\Here's yours.\Thanks...\What a coincidence, they delivered it right before my eyes.\What's that? Looks big, must be cool. response:	Well, y'know...
context: Huh?\Oh, right!\These are the ones we had on order.\Here's yours.\Thanks...\What a coincidence, they delivered it right before my eyes.\What's that? Looks big, must be cool.\Well, y'know... response:	It's about as tall as I am.
context: Oh, right!\These are the ones we had on order.\Here's yours.\Thanks...\What a coincidence, they delivered it right before my eyes.\What's that? Looks big, must be cool.\Well, y'know...\It's about as tall as I am. response:	Want to see it? They're both the same.
context: These are the ones we had on order.\Here's yours.\Thanks...\What a coincidence, they delivered it right before my eyes.\What's that? Looks big, must be cool.\Well, y'know...\It's about as tall as I am.\Want to see it? They're both the same. response:	No, don't sweat it. Not here, Kohsaka!
context: Here's yours.\Thanks...\What a coincidence, they delivered it right before my eyes.\What's that? Looks big, must be cool.\Well, y'know...\It's about as tall as I am.\Want to see it? They're both the same.\No, don't sweat it. Not here, Kohsaka! response:	That'd do it...
context: Thanks...\What a coincidence, they delivered it right before my eyes.\What's that? Looks big, must be cool.\Well, y'know...\It's about as tall as I am.\Want to see it? They're both the same.\No, don't sweat it. Not here, Kohsaka!\That'd do it... response:	Y-You called it...
context: What a coincidence, they delivered it right before my eyes.\What's that? Looks big, must be cool.\Well, y'know...\It's about as tall as I am.\Want to see it? They're both the same.\No, don't sweat it. Not here, Kohsaka!\That'd do it...\Y-You called it... response:	Here it comes...
context: What's that? Looks big, must be cool.\Well, y'know...\It's about as tall as I am.\Want to see it? They're both the same.\No, don't sweat it. Not here, Kohsaka!\That'd do it...\Y-You called it...\Here it comes... response:	Kohsaka, let's go.
context: Well, y'know...\It's about as tall as I am.\Want to see it? They're both the same.\No, don't sweat it. Not here, Kohsaka!\That'd do it...\Y-You called it...\Here it comes...\Kohsaka, let's go. response:	Sasahara's sister needs to talk to him.
context: It's about as tall as I am.\Want to see it? They're both the same.\No, don't sweat it. Not here, Kohsaka!\That'd do it...\Y-You called it...\Here it comes...\Kohsaka, let's go.\Sasahara's sister needs to talk to him. response:	Oh, okay.
context: Want to see it? They're both the same.\No, don't sweat it. Not here, Kohsaka!\That'd do it...\Y-You called it...\Here it comes...\Kohsaka, let's go.\Sasahara's sister needs to talk to him.\Oh, okay. response:	Unrolling this huge thing would get in the way, anyway.
context: No, don't sweat it. Not here, Kohsaka!\That'd do it...\Y-You called it...\Here it comes...\Kohsaka, let's go.\Sasahara's sister needs to talk to him.\Oh, okay.\Unrolling this huge thing would get in the way, anyway. response:	There's no one around, though.
context: That'd do it...\Y-You called it...\Here it comes...\Kohsaka, let's go.\Sasahara's sister needs to talk to him.\Oh, okay.\Unrolling this huge thing would get in the way, anyway.\There's no one around, though. response:	She needs to hurry home, too.
context: Y-You called it...\Here it comes...\Kohsaka, let's go.\Sasahara's sister needs to talk to him.\Oh, okay.\Unrolling this huge thing would get in the way, anyway.\There's no one around, though.\She needs to hurry home, too. response:	There's a test that needs passing, right?
context: Here it comes...\Kohsaka, let's go.\Sasahara's sister needs to talk to him.\Oh, okay.\Unrolling this huge thing would get in the way, anyway.\There's no one around, though.\She needs to hurry home, too.\There's a test that needs passing, right? response:	Huh?
context: Kohsaka, let's go.\Sasahara's sister needs to talk to him.\Oh, okay.\Unrolling this huge thing would get in the way, anyway.\There's no one around, though.\She needs to hurry home, too.\There's a test that needs passing, right?\Huh? response:	That's right.
context: Sasahara's sister needs to talk to him.\Oh, okay.\Unrolling this huge thing would get in the way, anyway.\There's no one around, though.\She needs to hurry home, too.\There's a test that needs passing, right?\Huh?\That's right. response:	Here's some money, now scram.
context: Oh, okay.\Unrolling this huge thing would get in the way, anyway.\There's no one around, though.\She needs to hurry home, too.\There's a test that needs passing, right?\Huh?\That's right.\Here's some money, now scram. response:	I'm in no real hurry.
context: Unrolling this huge thing would get in the way, anyway.\There's no one around, though.\She needs to hurry home, too.\There's a test that needs passing, right?\Huh?\That's right.\Here's some money, now scram.\I'm in no real hurry. response:	Right now I want to see this.
context: There's no one around, though.\She needs to hurry home, too.\There's a test that needs passing, right?\Huh?\That's right.\Here's some money, now scram.\I'm in no real hurry.\Right now I want to see this. response:	Okay, just for a bit.
context: She needs to hurry home, too.\There's a test that needs passing, right?\Huh?\That's right.\Here's some money, now scram.\I'm in no real hurry.\Right now I want to see this.\Okay, just for a bit. response:	Ah, not here...
context: There's a test that needs passing, right?\Huh?\That's right.\Here's some money, now scram.\I'm in no real hurry.\Right now I want to see this.\Okay, just for a bit.\Ah, not here... response:	Please wait a moment.
context: Huh?\That's right.\Here's some money, now scram.\I'm in no real hurry.\Right now I want to see this.\Okay, just for a bit.\Ah, not here...\Please wait a moment. response:	W-What a cute picture.
context: That's right.\Here's some money, now scram.\I'm in no real hurry.\Right now I want to see this.\Okay, just for a bit.\Ah, not here...\Please wait a moment.\W-What a cute picture. response:	So looks win out, huh Keiko?
context: Here's some money, now scram.\I'm in no real hurry.\Right now I want to see this.\Okay, just for a bit.\Ah, not here...\Please wait a moment.\W-What a cute picture.\So looks win out, huh Keiko? response:	That's really nice.
context: I'm in no real hurry.\Right now I want to see this.\Okay, just for a bit.\Ah, not here...\Please wait a moment.\W-What a cute picture.\So looks win out, huh Keiko?\That's really nice. response:	Isn't it?
context: Right now I want to see this.\Okay, just for a bit.\Ah, not here...\Please wait a moment.\W-What a cute picture.\So looks win out, huh Keiko?\That's really nice.\Isn't it? response:	She's from a game I really like.
context: Okay, just for a bit.\Ah, not here...\Please wait a moment.\W-What a cute picture.\So looks win out, huh Keiko?\That's really nice.\Isn't it?\She's from a game I really like. response:	K-Kill me now...
context: Ah, not here...\Please wait a moment.\W-What a cute picture.\So looks win out, huh Keiko?\That's really nice.\Isn't it?\She's from a game I really like.\K-Kill me now... response:	There's no escape now...
context: Please wait a moment.\W-What a cute picture.\So looks win out, huh Keiko?\That's really nice.\Isn't it?\She's from a game I really like.\K-Kill me now...\There's no escape now... response:	She's so not ready for us.
context: W-What a cute picture.\So looks win out, huh Keiko?\That's really nice.\Isn't it?\She's from a game I really like.\K-Kill me now...\There's no escape now...\She's so not ready for us. response:	9000 for the tapestry, then 5000 loaned to my sister...
context: So looks win out, huh Keiko?\That's really nice.\Isn't it?\She's from a game I really like.\K-Kill me now...\There's no escape now...\She's so not ready for us.\9000 for the tapestry, then 5000 loaned to my sister... response:	See ya.
context: That's really nice.\Isn't it?\She's from a game I really like.\K-Kill me now...\There's no escape now...\She's so not ready for us.\9000 for the tapestry, then 5000 loaned to my sister...\See ya. response:	Sure.
context: Isn't it?\She's from a game I really like.\K-Kill me now...\There's no escape now...\She's so not ready for us.\9000 for the tapestry, then 5000 loaned to my sister...\See ya.\Sure. response:	Is there any chance Kohsaka would quit being an otaku?
context: She's from a game I really like.\K-Kill me now...\There's no escape now...\She's so not ready for us.\9000 for the tapestry, then 5000 loaned to my sister...\See ya.\Sure.\Is there any chance Kohsaka would quit being an otaku? response:	Not at all, he's way more otaku than I am.
context: K-Kill me now...\There's no escape now...\She's so not ready for us.\9000 for the tapestry, then 5000 loaned to my sister...\See ya.\Sure.\Is there any chance Kohsaka would quit being an otaku?\Not at all, he's way more otaku than I am. response:	He sure doesn't look it!
context: There's no escape now...\She's so not ready for us.\9000 for the tapestry, then 5000 loaned to my sister...\See ya.\Sure.\Is there any chance Kohsaka would quit being an otaku?\Not at all, he's way more otaku than I am.\He sure doesn't look it! response:	Kasukabe over there is also trying to make him quit...
context: She's so not ready for us.\9000 for the tapestry, then 5000 loaned to my sister...\See ya.\Sure.\Is there any chance Kohsaka would quit being an otaku?\Not at all, he's way more otaku than I am.\He sure doesn't look it!\Kasukabe over there is also trying to make him quit... response:	Give it a rest and stop dwelling on looks.
context: 9000 for the tapestry, then 5000 loaned to my sister...\See ya.\Sure.\Is there any chance Kohsaka would quit being an otaku?\Not at all, he's way more otaku than I am.\He sure doesn't look it!\Kasukabe over there is also trying to make him quit...\Give it a rest and stop dwelling on looks. response:	Just leave it to Kohsaka to spice up the situation.
context: See ya.\Sure.\Is there any chance Kohsaka would quit being an otaku?\Not at all, he's way more otaku than I am.\He sure doesn't look it!\Kasukabe over there is also trying to make him quit...\Give it a rest and stop dwelling on looks.\Just leave it to Kohsaka to spice up the situation. response:	That poor little sister.
context: Sure.\Is there any chance Kohsaka would quit being an otaku?\Not at all, he's way more otaku than I am.\He sure doesn't look it!\Kasukabe over there is also trying to make him quit...\Give it a rest and stop dwelling on looks.\Just leave it to Kohsaka to spice up the situation.\That poor little sister. response:	What do you mean?
context: Is there any chance Kohsaka would quit being an otaku?\Not at all, he's way more otaku than I am.\He sure doesn't look it!\Kasukabe over there is also trying to make him quit...\Give it a rest and stop dwelling on looks.\Just leave it to Kohsaka to spice up the situation.\That poor little sister.\What do you mean? response:	That was 9000 yen, though?
context: Not at all, he's way more otaku than I am.\He sure doesn't look it!\Kasukabe over there is also trying to make him quit...\Give it a rest and stop dwelling on looks.\Just leave it to Kohsaka to spice up the situation.\That poor little sister.\What do you mean?\That was 9000 yen, though? response:	If that's how you spend money, you'll never afford a computer.
context: He sure doesn't look it!\Kasukabe over there is also trying to make him quit...\Give it a rest and stop dwelling on looks.\Just leave it to Kohsaka to spice up the situation.\That poor little sister.\What do you mean?\That was 9000 yen, though?\If that's how you spend money, you'll never afford a computer. response:	Yeah, although...
context: Kasukabe over there is also trying to make him quit...\Give it a rest and stop dwelling on looks.\Just leave it to Kohsaka to spice up the situation.\That poor little sister.\What do you mean?\That was 9000 yen, though?\If that's how you spend money, you'll never afford a computer.\Yeah, although... response:	To not buy what one likes is to deny oneself.
context: Give it a rest and stop dwelling on looks.\Just leave it to Kohsaka to spice up the situation.\That poor little sister.\What do you mean?\That was 9000 yen, though?\If that's how you spend money, you'll never afford a computer.\Yeah, although...\To not buy what one likes is to deny oneself. response:	Sasahara...
context: Just leave it to Kohsaka to spice up the situation.\That poor little sister.\What do you mean?\That was 9000 yen, though?\If that's how you spend money, you'll never afford a computer.\Yeah, although...\To not buy what one likes is to deny oneself.\Sasahara... response:	While that's true, we're all aware that you don't own that adult game!
context: That poor little sister.\What do you mean?\That was 9000 yen, though?\If that's how you spend money, you'll never afford a computer.\Yeah, although...\To not buy what one likes is to deny oneself.\Sasahara...\While that's true, we're all aware that you don't own that adult game! response:	You probably play it at Kohsaka's!
context: What do you mean?\That was 9000 yen, though?\If that's how you spend money, you'll never afford a computer.\Yeah, although...\To not buy what one likes is to deny oneself.\Sasahara...\While that's true, we're all aware that you don't own that adult game!\You probably play it at Kohsaka's! response:	Just buy a computer already!
context: That was 9000 yen, though?\If that's how you spend money, you'll never afford a computer.\Yeah, although...\To not buy what one likes is to deny oneself.\Sasahara...\While that's true, we're all aware that you don't own that adult game!\You probably play it at Kohsaka's!\Just buy a computer already! response:	Don't eat for three months!
context: If that's how you spend money, you'll never afford a computer.\Yeah, although...\To not buy what one likes is to deny oneself.\Sasahara...\While that's true, we're all aware that you don't own that adult game!\You probably play it at Kohsaka's!\Just buy a computer already!\Don't eat for three months! response:	That's ridiculous...
context: Yeah, although...\To not buy what one likes is to deny oneself.\Sasahara...\While that's true, we're all aware that you don't own that adult game!\You probably play it at Kohsaka's!\Just buy a computer already!\Don't eat for three months!\That's ridiculous... response:	W-Why not try cutting back on games and DVDs for now?
context: To not buy what one likes is to deny oneself.\Sasahara...\While that's true, we're all aware that you don't own that adult game!\You probably play it at Kohsaka's!\Just buy a computer already!\Don't eat for three months!\That's ridiculous...\W-Why not try cutting back on games and DVDs for now? response:	PCs are cheap these days.
context: Sasahara...\While that's true, we're all aware that you don't own that adult game!\You probably play it at Kohsaka's!\Just buy a computer already!\Don't eat for three months!\That's ridiculous...\W-Why not try cutting back on games and DVDs for now?\PCs are cheap these days. response:	Hey, Kohsaka.
context: While that's true, we're all aware that you don't own that adult game!\You probably play it at Kohsaka's!\Just buy a computer already!\Don't eat for three months!\That's ridiculous...\W-Why not try cutting back on games and DVDs for now?\PCs are cheap these days.\Hey, Kohsaka. response:	Hmm?
context: You probably play it at Kohsaka's!\Just buy a computer already!\Don't eat for three months!\That's ridiculous...\W-Why not try cutting back on games and DVDs for now?\PCs are cheap these days.\Hey, Kohsaka.\Hmm? response:	Will you watch anime again today?
context: Just buy a computer already!\Don't eat for three months!\That's ridiculous...\W-Why not try cutting back on games and DVDs for now?\PCs are cheap these days.\Hey, Kohsaka.\Hmm?\Will you watch anime again today? response:	Uh-uh.
context: Don't eat for three months!\That's ridiculous...\W-Why not try cutting back on games and DVDs for now?\PCs are cheap these days.\Hey, Kohsaka.\Hmm?\Will you watch anime again today?\Uh-uh. response:	Not today.
context: That's ridiculous...\W-Why not try cutting back on games and DVDs for now?\PCs are cheap these days.\Hey, Kohsaka.\Hmm?\Will you watch anime again today?\Uh-uh.\Not today. response:	We took no detours or shortcuts...
context: W-Why not try cutting back on games and DVDs for now?\PCs are cheap these days.\Hey, Kohsaka.\Hmm?\Will you watch anime again today?\Uh-uh.\Not today.\We took no detours or shortcuts... response:	Only vivid dreams extended deep into the shadows.
context: PCs are cheap these days.\Hey, Kohsaka.\Hmm?\Will you watch anime again today?\Uh-uh.\Not today.\We took no detours or shortcuts...\Only vivid dreams extended deep into the shadows. response:	We aren't quite grown up.
context: Hey, Kohsaka.\Hmm?\Will you watch anime again today?\Uh-uh.\Not today.\We took no detours or shortcuts...\Only vivid dreams extended deep into the shadows.\We aren't quite grown up. response:	Simple but complicated glistening like marbles.
context: Hmm?\Will you watch anime again today?\Uh-uh.\Not today.\We took no detours or shortcuts...\Only vivid dreams extended deep into the shadows.\We aren't quite grown up.\Simple but complicated glistening like marbles. response:	The time we could see from there sparkled, even if nothing big happened.
context: Will you watch anime again today?\Uh-uh.\Not today.\We took no detours or shortcuts...\Only vivid dreams extended deep into the shadows.\We aren't quite grown up.\Simple but complicated glistening like marbles.\The time we could see from there sparkled, even if nothing big happened. response:	What we see from the marbles in our hands now is a little different...
context: Uh-uh.\Not today.\We took no detours or shortcuts...\Only vivid dreams extended deep into the shadows.\We aren't quite grown up.\Simple but complicated glistening like marbles.\The time we could see from there sparkled, even if nothing big happened.\What we see from the marbles in our hands now is a little different... response:	Suioh University
context: Not today.\We took no detours or shortcuts...\Only vivid dreams extended deep into the shadows.\We aren't quite grown up.\Simple but complicated glistening like marbles.\The time we could see from there sparkled, even if nothing big happened.\What we see from the marbles in our hands now is a little different...\Suioh University response:	Hey, do you know much about SM?
context: We took no detours or shortcuts...\Only vivid dreams extended deep into the shadows.\We aren't quite grown up.\Simple but complicated glistening like marbles.\The time we could see from there sparkled, even if nothing big happened.\What we see from the marbles in our hands now is a little different...\Suioh University\Hey, do you know much about SM? response:	Huh?
context: Only vivid dreams extended deep into the shadows.\We aren't quite grown up.\Simple but complicated glistening like marbles.\The time we could see from there sparkled, even if nothing big happened.\What we see from the marbles in our hands now is a little different...\Suioh University\Hey, do you know much about SM?\Huh? response:	What?
context: We aren't quite grown up.\Simple but complicated glistening like marbles.\The time we could see from there sparkled, even if nothing big happened.\What we see from the marbles in our hands now is a little different...\Suioh University\Hey, do you know much about SM?\Huh?\What? response:	Heartache's been feeling good to me recently...
context: Simple but complicated glistening like marbles.\The time we could see from there sparkled, even if nothing big happened.\What we see from the marbles in our hands now is a little different...\Suioh University\Hey, do you know much about SM?\Huh?\What?\Heartache's been feeling good to me recently... response:	I wonder if that's a kind of SM...
context: The time we could see from there sparkled, even if nothing big happened.\What we see from the marbles in our hands now is a little different...\Suioh University\Hey, do you know much about SM?\Huh?\What?\Heartache's been feeling good to me recently...\I wonder if that's a kind of SM... response:	Hey Ohno, is cosplay fun?
context: What we see from the marbles in our hands now is a little different...\Suioh University\Hey, do you know much about SM?\Huh?\What?\Heartache's been feeling good to me recently...\I wonder if that's a kind of SM...\Hey Ohno, is cosplay fun? response:	Will you do it?
context: Suioh University\Hey, do you know much about SM?\Huh?\What?\Heartache's been feeling good to me recently...\I wonder if that's a kind of SM...\Hey Ohno, is cosplay fun?\Will you do it? response:	No, I won't!
context: Hey, do you know much about SM?\Huh?\What?\Heartache's been feeling good to me recently...\I wonder if that's a kind of SM...\Hey Ohno, is cosplay fun?\Will you do it?\No, I won't! response:	I can understand if foreigners do it.
context: Huh?\What?\Heartache's been feeling good to me recently...\I wonder if that's a kind of SM...\Hey Ohno, is cosplay fun?\Will you do it?\No, I won't!\I can understand if foreigners do it. response:	So much is based on western culture and clothing...
context: What?\Heartache's been feeling good to me recently...\I wonder if that's a kind of SM...\Hey Ohno, is cosplay fun?\Will you do it?\No, I won't!\I can understand if foreigners do it.\So much is based on western culture and clothing... response:	But it just doesn't work for Japanese.
context: Heartache's been feeling good to me recently...\I wonder if that's a kind of SM...\Hey Ohno, is cosplay fun?\Will you do it?\No, I won't!\I can understand if foreigners do it.\So much is based on western culture and clothing...\But it just doesn't work for Japanese. response:	Um...
context: I wonder if that's a kind of SM...\Hey Ohno, is cosplay fun?\Will you do it?\No, I won't!\I can understand if foreigners do it.\So much is based on western culture and clothing...\But it just doesn't work for Japanese.\Um... response:	And then these cosplay names, why are they in kanji!?
context: Hey Ohno, is cosplay fun?\Will you do it?\No, I won't!\I can understand if foreigners do it.\So much is based on western culture and clothing...\But it just doesn't work for Japanese.\Um...\And then these cosplay names, why are they in kanji!? response:	And it's names like Reika and Sakuya with high stroke counts!
context: Will you do it?\No, I won't!\I can understand if foreigners do it.\So much is based on western culture and clothing...\But it just doesn't work for Japanese.\Um...\And then these cosplay names, why are they in kanji!?\And it's names like Reika and Sakuya with high stroke counts! response:	Then their surnames sound like some court noble. I mean, Ayanokouji?
context: No, I won't!\I can understand if foreigners do it.\So much is based on western culture and clothing...\But it just doesn't work for Japanese.\Um...\And then these cosplay names, why are they in kanji!?\And it's names like Reika and Sakuya with high stroke counts!\Then their surnames sound like some court noble. I mean, Ayanokouji? response:	I mean, it's like get a grip and know thyself.
context: I can understand if foreigners do it.\So much is based on western culture and clothing...\But it just doesn't work for Japanese.\Um...\And then these cosplay names, why are they in kanji!?\And it's names like Reika and Sakuya with high stroke counts!\Then their surnames sound like some court noble. I mean, Ayanokouji?\I mean, it's like get a grip and know thyself. response:	Saki, you just made enemies of a million cosplayers nationwide.
context: So much is based on western culture and clothing...\But it just doesn't work for Japanese.\Um...\And then these cosplay names, why are they in kanji!?\And it's names like Reika and Sakuya with high stroke counts!\Then their surnames sound like some court noble. I mean, Ayanokouji?\I mean, it's like get a grip and know thyself.\Saki, you just made enemies of a million cosplayers nationwide. response:	Huh? Why?