context: So we need your songs to response:	heal the Star Whale's sickness!
context: So we need your songs to\heal the Star Whale's sickness! response:	All right.
context: So we need your songs to\heal the Star Whale's sickness!\All right. response:	If that's the situation, I'll head there now.
context: So we need your songs to\heal the Star Whale's sickness!\All right.\If that's the situation, I'll head there now. response:	Will you be okay, too, Cou-sama?
context: So we need your songs to\heal the Star Whale's sickness!\All right.\If that's the situation, I'll head there now.\Will you be okay, too, Cou-sama? response:	Of course!
context: So we need your songs to\heal the Star Whale's sickness!\All right.\If that's the situation, I'll head there now.\Will you be okay, too, Cou-sama?\Of course! response:	We'll head up into the sky right away!
context: So we need your songs to\heal the Star Whale's sickness!\All right.\If that's the situation, I'll head there now.\Will you be okay, too, Cou-sama?\Of course!\We'll head up into the sky right away! response:	Okay, thanks!
context: So we need your songs to\heal the Star Whale's sickness!\All right.\If that's the situation, I'll head there now.\Will you be okay, too, Cou-sama?\Of course!\We'll head up into the sky right away!\Okay, thanks! response:	We'll come get you now.
context: heal the Star Whale's sickness!\All right.\If that's the situation, I'll head there now.\Will you be okay, too, Cou-sama?\Of course!\We'll head up into the sky right away!\Okay, thanks!\We'll come get you now. response:	There's no time, so let's meet in the sky.
context: All right.\If that's the situation, I'll head there now.\Will you be okay, too, Cou-sama?\Of course!\We'll head up into the sky right away!\Okay, thanks!\We'll come get you now.\There's no time, so let's meet in the sky. response:	Right!
context: If that's the situation, I'll head there now.\Will you be okay, too, Cou-sama?\Of course!\We'll head up into the sky right away!\Okay, thanks!\We'll come get you now.\There's no time, so let's meet in the sky.\Right! response:	Roger!
context: Will you be okay, too, Cou-sama?\Of course!\We'll head up into the sky right away!\Okay, thanks!\We'll come get you now.\There's no time, so let's meet in the sky.\Right!\Roger! response:	Let's meet up with the princesses and head back to the sky.
context: Of course!\We'll head up into the sky right away!\Okay, thanks!\We'll come get you now.\There's no time, so let's meet in the sky.\Right!\Roger!\Let's meet up with the princesses and head back to the sky. response:	I've got a bad feeling somehow.
context: We'll head up into the sky right away!\Okay, thanks!\We'll come get you now.\There's no time, so let's meet in the sky.\Right!\Roger!\Let's meet up with the princesses and head back to the sky.\I've got a bad feeling somehow. response:	Song of the Stars
context: Okay, thanks!\We'll come get you now.\There's no time, so let's meet in the sky.\Right!\Roger!\Let's meet up with the princesses and head back to the sky.\I've got a bad feeling somehow.\Song of the Stars response:	Aria...
context: We'll come get you now.\There's no time, so let's meet in the sky.\Right!\Roger!\Let's meet up with the princesses and head back to the sky.\I've got a bad feeling somehow.\Song of the Stars\Aria... response:	I'm sorry... oww.
context: There's no time, so let's meet in the sky.\Right!\Roger!\Let's meet up with the princesses and head back to the sky.\I've got a bad feeling somehow.\Song of the Stars\Aria...\I'm sorry... oww. response:	Sorry.
context: Right!\Roger!\Let's meet up with the princesses and head back to the sky.\I've got a bad feeling somehow.\Song of the Stars\Aria...\I'm sorry... oww.\Sorry. response:	This will hurt a bit.
context: Roger!\Let's meet up with the princesses and head back to the sky.\I've got a bad feeling somehow.\Song of the Stars\Aria...\I'm sorry... oww.\Sorry.\This will hurt a bit. response:	I was caught off guard.
context: Let's meet up with the princesses and head back to the sky.\I've got a bad feeling somehow.\Song of the Stars\Aria...\I'm sorry... oww.\Sorry.\This will hurt a bit.\I was caught off guard. response:	I'm sorry I couldn't do more.
context: I've got a bad feeling somehow.\Song of the Stars\Aria...\I'm sorry... oww.\Sorry.\This will hurt a bit.\I was caught off guard.\I'm sorry I couldn't do more. response:	Me, too... I couldn't do anything.
context: Song of the Stars\Aria...\I'm sorry... oww.\Sorry.\This will hurt a bit.\I was caught off guard.\I'm sorry I couldn't do more.\Me, too... I couldn't do anything. response:	They must be pretty good to do
context: Aria...\I'm sorry... oww.\Sorry.\This will hurt a bit.\I was caught off guard.\I'm sorry I couldn't do more.\Me, too... I couldn't do anything.\They must be pretty good to do response:	this much to Sharl and the chief.
context: I'm sorry... oww.\Sorry.\This will hurt a bit.\I was caught off guard.\I'm sorry I couldn't do more.\Me, too... I couldn't do anything.\They must be pretty good to do\this much to Sharl and the chief. response:	It looked like a kid.
context: Sorry.\This will hurt a bit.\I was caught off guard.\I'm sorry I couldn't do more.\Me, too... I couldn't do anything.\They must be pretty good to do\this much to Sharl and the chief.\It looked like a kid. response:	It had human form, but that wasn't human.
context: This will hurt a bit.\I was caught off guard.\I'm sorry I couldn't do more.\Me, too... I couldn't do anything.\They must be pretty good to do\this much to Sharl and the chief.\It looked like a kid.\It had human form, but that wasn't human. response:	It was a type of demon.
context: I was caught off guard.\I'm sorry I couldn't do more.\Me, too... I couldn't do anything.\They must be pretty good to do\this much to Sharl and the chief.\It looked like a kid.\It had human form, but that wasn't human.\It was a type of demon. response:	A humanoid demon.
context: I'm sorry I couldn't do more.\Me, too... I couldn't do anything.\They must be pretty good to do\this much to Sharl and the chief.\It looked like a kid.\It had human form, but that wasn't human.\It was a type of demon.\A humanoid demon. response:	Is there such a thing?
context: Me, too... I couldn't do anything.\They must be pretty good to do\this much to Sharl and the chief.\It looked like a kid.\It had human form, but that wasn't human.\It was a type of demon.\A humanoid demon.\Is there such a thing? response:	A disciple, yes?
context: They must be pretty good to do\this much to Sharl and the chief.\It looked like a kid.\It had human form, but that wasn't human.\It was a type of demon.\A humanoid demon.\Is there such a thing?\A disciple, yes? response:	Yes.
context: this much to Sharl and the chief.\It looked like a kid.\It had human form, but that wasn't human.\It was a type of demon.\A humanoid demon.\Is there such a thing?\A disciple, yes?\Yes. response:	Demons who took the form of
context: It looked like a kid.\It had human form, but that wasn't human.\It was a type of demon.\A humanoid demon.\Is there such a thing?\A disciple, yes?\Yes.\Demons who took the form of response:	humans existed in the distant past.
context: It had human form, but that wasn't human.\It was a type of demon.\A humanoid demon.\Is there such a thing?\A disciple, yes?\Yes.\Demons who took the form of\humans existed in the distant past. response:	They were highly intelligent, wielding power that
context: It was a type of demon.\A humanoid demon.\Is there such a thing?\A disciple, yes?\Yes.\Demons who took the form of\humans existed in the distant past.\They were highly intelligent, wielding power that response:	was a manifestation of greed and disaster.
context: A humanoid demon.\Is there such a thing?\A disciple, yes?\Yes.\Demons who took the form of\humans existed in the distant past.\They were highly intelligent, wielding power that\was a manifestation of greed and disaster. response:	That must be the Disciple of Illness.
context: Is there such a thing?\A disciple, yes?\Yes.\Demons who took the form of\humans existed in the distant past.\They were highly intelligent, wielding power that\was a manifestation of greed and disaster.\That must be the Disciple of Illness. response:	We must bring back Aria-dono.
context: A disciple, yes?\Yes.\Demons who took the form of\humans existed in the distant past.\They were highly intelligent, wielding power that\was a manifestation of greed and disaster.\That must be the Disciple of Illness.\We must bring back Aria-dono. response:	No, chief!
context: Yes.\Demons who took the form of\humans existed in the distant past.\They were highly intelligent, wielding power that\was a manifestation of greed and disaster.\That must be the Disciple of Illness.\We must bring back Aria-dono.\No, chief! response:	We'll follow him
context: Demons who took the form of\humans existed in the distant past.\They were highly intelligent, wielding power that\was a manifestation of greed and disaster.\That must be the Disciple of Illness.\We must bring back Aria-dono.\No, chief!\We'll follow him response:	and kick his butt!
context: humans existed in the distant past.\They were highly intelligent, wielding power that\was a manifestation of greed and disaster.\That must be the Disciple of Illness.\We must bring back Aria-dono.\No, chief!\We'll follow him\and kick his butt! response:	We need to save Aria, after all.
context: They were highly intelligent, wielding power that\was a manifestation of greed and disaster.\That must be the Disciple of Illness.\We must bring back Aria-dono.\No, chief!\We'll follow him\and kick his butt!\We need to save Aria, after all. response:	Yeah.
context: was a manifestation of greed and disaster.\That must be the Disciple of Illness.\We must bring back Aria-dono.\No, chief!\We'll follow him\and kick his butt!\We need to save Aria, after all.\Yeah. response:	This way. I hear the sound this way.
context: That must be the Disciple of Illness.\We must bring back Aria-dono.\No, chief!\We'll follow him\and kick his butt!\We need to save Aria, after all.\Yeah.\This way. I hear the sound this way. response:	The presence is getting stronger, too.
context: We must bring back Aria-dono.\No, chief!\We'll follow him\and kick his butt!\We need to save Aria, after all.\Yeah.\This way. I hear the sound this way.\The presence is getting stronger, too. response:	Leave.
context: No, chief!\We'll follow him\and kick his butt!\We need to save Aria, after all.\Yeah.\This way. I hear the sound this way.\The presence is getting stronger, too.\Leave. response:	Leave. Humans... Leave.
context: We'll follow him\and kick his butt!\We need to save Aria, after all.\Yeah.\This way. I hear the sound this way.\The presence is getting stronger, too.\Leave.\Leave. Humans... Leave. response:	It talked?
context: and kick his butt!\We need to save Aria, after all.\Yeah.\This way. I hear the sound this way.\The presence is getting stronger, too.\Leave.\Leave. Humans... Leave.\It talked? response:	These things aren't talking.
context: We need to save Aria, after all.\Yeah.\This way. I hear the sound this way.\The presence is getting stronger, too.\Leave.\Leave. Humans... Leave.\It talked?\These things aren't talking. response:	They're just sharing the Disciple's voice.
context: Yeah.\This way. I hear the sound this way.\The presence is getting stronger, too.\Leave.\Leave. Humans... Leave.\It talked?\These things aren't talking.\They're just sharing the Disciple's voice. response:	You're in Aria's way.
context: This way. I hear the sound this way.\The presence is getting stronger, too.\Leave.\Leave. Humans... Leave.\It talked?\These things aren't talking.\They're just sharing the Disciple's voice.\You're in Aria's way. response:	Leave!
context: The presence is getting stronger, too.\Leave.\Leave. Humans... Leave.\It talked?\These things aren't talking.\They're just sharing the Disciple's voice.\You're in Aria's way.\Leave! response:	Not happening.
context: Leave.\Leave. Humans... Leave.\It talked?\These things aren't talking.\They're just sharing the Disciple's voice.\You're in Aria's way.\Leave!\Not happening. response:	We have something we have to do.
context: Leave. Humans... Leave.\It talked?\These things aren't talking.\They're just sharing the Disciple's voice.\You're in Aria's way.\Leave!\Not happening.\We have something we have to do. response:	Prince!
context: It talked?\These things aren't talking.\They're just sharing the Disciple's voice.\You're in Aria's way.\Leave!\Not happening.\We have something we have to do.\Prince! response:	You're the one I can least forgive!
context: These things aren't talking.\They're just sharing the Disciple's voice.\You're in Aria's way.\Leave!\Not happening.\We have something we have to do.\Prince!\You're the one I can least forgive! response:	There are two princes here.
context: They're just sharing the Disciple's voice.\You're in Aria's way.\Leave!\Not happening.\We have something we have to do.\Prince!\You're the one I can least forgive!\There are two princes here. response:	Well, you mean me, right?
context: You're in Aria's way.\Leave!\Not happening.\We have something we have to do.\Prince!\You're the one I can least forgive!\There are two princes here.\Well, you mean me, right? response:	If you want to talk, let's talk.
context: Leave!\Not happening.\We have something we have to do.\Prince!\You're the one I can least forgive!\There are two princes here.\Well, you mean me, right?\If you want to talk, let's talk. response:	Aria's safe, right?
context: Not happening.\We have something we have to do.\Prince!\You're the one I can least forgive!\There are two princes here.\Well, you mean me, right?\If you want to talk, let's talk.\Aria's safe, right? response:	Don't you say
context: We have something we have to do.\Prince!\You're the one I can least forgive!\There are two princes here.\Well, you mean me, right?\If you want to talk, let's talk.\Aria's safe, right?\Don't you say response:	Aria's name!
context: Prince!\You're the one I can least forgive!\There are two princes here.\Well, you mean me, right?\If you want to talk, let's talk.\Aria's safe, right?\Don't you say\Aria's name! response:	Idiot!
context: You're the one I can least forgive!\There are two princes here.\Well, you mean me, right?\If you want to talk, let's talk.\Aria's safe, right?\Don't you say\Aria's name!\Idiot! response:	I don't have even know what the heck's going on!
context: There are two princes here.\Well, you mean me, right?\If you want to talk, let's talk.\Aria's safe, right?\Don't you say\Aria's name!\Idiot!\I don't have even know what the heck's going on! response:	Can we calm down and talk?
context: Well, you mean me, right?\If you want to talk, let's talk.\Aria's safe, right?\Don't you say\Aria's name!\Idiot!\I don't have even know what the heck's going on!\Can we calm down and talk? response:	I don't get you!
context: If you want to talk, let's talk.\Aria's safe, right?\Don't you say\Aria's name!\Idiot!\I don't have even know what the heck's going on!\Can we calm down and talk?\I don't get you! response:	Vert, where is he?
context: Aria's safe, right?\Don't you say\Aria's name!\Idiot!\I don't have even know what the heck's going on!\Can we calm down and talk?\I don't get you!\Vert, where is he? response:	I can hear a sound that sounds like his main body.
context: Don't you say\Aria's name!\Idiot!\I don't have even know what the heck's going on!\Can we calm down and talk?\I don't get you!\Vert, where is he?\I can hear a sound that sounds like his main body. response:	I think I can follow it.
context: Aria's name!\Idiot!\I don't have even know what the heck's going on!\Can we calm down and talk?\I don't get you!\Vert, where is he?\I can hear a sound that sounds like his main body.\I think I can follow it. response:	Then leave this to me!
context: Idiot!\I don't have even know what the heck's going on!\Can we calm down and talk?\I don't get you!\Vert, where is he?\I can hear a sound that sounds like his main body.\I think I can follow it.\Then leave this to me! response:	Vert and the others take Gaul to the main body!
context: I don't have even know what the heck's going on!\Can we calm down and talk?\I don't get you!\Vert, where is he?\I can hear a sound that sounds like his main body.\I think I can follow it.\Then leave this to me!\Vert and the others take Gaul to the main body! response:	I'll stay here!
context: Can we calm down and talk?\I don't get you!\Vert, where is he?\I can hear a sound that sounds like his main body.\I think I can follow it.\Then leave this to me!\Vert and the others take Gaul to the main body!\I'll stay here! response:	I'll help Nanami-san!
context: I don't get you!\Vert, where is he?\I can hear a sound that sounds like his main body.\I think I can follow it.\Then leave this to me!\Vert and the others take Gaul to the main body!\I'll stay here!\I'll help Nanami-san! response:	Thanks! I'll let you guys handle it!
context: Vert, where is he?\I can hear a sound that sounds like his main body.\I think I can follow it.\Then leave this to me!\Vert and the others take Gaul to the main body!\I'll stay here!\I'll help Nanami-san!\Thanks! I'll let you guys handle it! response:	Transform!
context: I can hear a sound that sounds like his main body.\I think I can follow it.\Then leave this to me!\Vert and the others take Gaul to the main body!\I'll stay here!\I'll help Nanami-san!\Thanks! I'll let you guys handle it!\Transform! response:	Just you wait, damn it!
context: I think I can follow it.\Then leave this to me!\Vert and the others take Gaul to the main body!\I'll stay here!\I'll help Nanami-san!\Thanks! I'll let you guys handle it!\Transform!\Just you wait, damn it! response:	Aria.
context: Then leave this to me!\Vert and the others take Gaul to the main body!\I'll stay here!\I'll help Nanami-san!\Thanks! I'll let you guys handle it!\Transform!\Just you wait, damn it!\Aria. response:	Aria.
context: Vert and the others take Gaul to the main body!\I'll stay here!\I'll help Nanami-san!\Thanks! I'll let you guys handle it!\Transform!\Just you wait, damn it!\Aria.\Aria. response:	Aria.
context: I'll stay here!\I'll help Nanami-san!\Thanks! I'll let you guys handle it!\Transform!\Just you wait, damn it!\Aria.\Aria.\Aria. response:	Verde?
context: I'll help Nanami-san!\Thanks! I'll let you guys handle it!\Transform!\Just you wait, damn it!\Aria.\Aria.\Aria.\Verde? response:	Verde...
context: Thanks! I'll let you guys handle it!\Transform!\Just you wait, damn it!\Aria.\Aria.\Aria.\Verde?\Verde... response:	it's you, right?
context: Transform!\Just you wait, damn it!\Aria.\Aria.\Aria.\Verde?\Verde...\it's you, right? response:	I'll give you back your voice.
context: Just you wait, damn it!\Aria.\Aria.\Aria.\Verde?\Verde...\it's you, right?\I'll give you back your voice. response:	I remember.
context: Aria.\Aria.\Aria.\Verde?\Verde...\it's you, right?\I'll give you back your voice.\I remember. response:	I remember everything!
context: Aria.\Aria.\Verde?\Verde...\it's you, right?\I'll give you back your voice.\I remember.\I remember everything! response:	Aria!
context: Aria.\Verde?\Verde...\it's you, right?\I'll give you back your voice.\I remember.\I remember everything!\Aria! response:	You've gotten used to this form now, haven't you?
context: Verde?\Verde...\it's you, right?\I'll give you back your voice.\I remember.\I remember everything!\Aria!\You've gotten used to this form now, haven't you? response:	Yeah.
context: Verde...\it's you, right?\I'll give you back your voice.\I remember.\I remember everything!\Aria!\You've gotten used to this form now, haven't you?\Yeah. response:	I'm used to it now.
context: it's you, right?\I'll give you back your voice.\I remember.\I remember everything!\Aria!\You've gotten used to this form now, haven't you?\Yeah.\I'm used to it now. response:	And you're with Verde again?
context: I'll give you back your voice.\I remember.\I remember everything!\Aria!\You've gotten used to this form now, haven't you?\Yeah.\I'm used to it now.\And you're with Verde again? response:	Yup!
context: I remember.\I remember everything!\Aria!\You've gotten used to this form now, haven't you?\Yeah.\I'm used to it now.\And you're with Verde again?\Yup! response:	He's strange for a sky person.
context: I remember everything!\Aria!\You've gotten used to this form now, haven't you?\Yeah.\I'm used to it now.\And you're with Verde again?\Yup!\He's strange for a sky person. response:	He seems strangely human, somehow.
context: Aria!\You've gotten used to this form now, haven't you?\Yeah.\I'm used to it now.\And you're with Verde again?\Yup!\He's strange for a sky person.\He seems strangely human, somehow. response:	But isn't he cute?
context: You've gotten used to this form now, haven't you?\Yeah.\I'm used to it now.\And you're with Verde again?\Yup!\He's strange for a sky person.\He seems strangely human, somehow.\But isn't he cute? response:	He's always nice to me.
context: Yeah.\I'm used to it now.\And you're with Verde again?\Yup!\He's strange for a sky person.\He seems strangely human, somehow.\But isn't he cute?\He's always nice to me. response:	Right, Verde?
context: I'm used to it now.\And you're with Verde again?\Yup!\He's strange for a sky person.\He seems strangely human, somehow.\But isn't he cute?\He's always nice to me.\Right, Verde? response:	Aria?
context: And you're with Verde again?\Yup!\He's strange for a sky person.\He seems strangely human, somehow.\But isn't he cute?\He's always nice to me.\Right, Verde?\Aria? response:	Were you watching the surface again?
context: Yup!\He's strange for a sky person.\He seems strangely human, somehow.\But isn't he cute?\He's always nice to me.\Right, Verde?\Aria?\Were you watching the surface again? response:	J-Just a little.
context: He's strange for a sky person.\He seems strangely human, somehow.\But isn't he cute?\He's always nice to me.\Right, Verde?\Aria?\Were you watching the surface again?\J-Just a little. response:	The heroes and the princesses are so cool.
context: He seems strangely human, somehow.\But isn't he cute?\He's always nice to me.\Right, Verde?\Aria?\Were you watching the surface again?\J-Just a little.\The heroes and the princesses are so cool. response:	And there's a wonderful prince, isn't there?
context: But isn't he cute?\He's always nice to me.\Right, Verde?\Aria?\Were you watching the surface again?\J-Just a little.\The heroes and the princesses are so cool.\And there's a wonderful prince, isn't there? response:	Th-That's not all, but...
context: He's always nice to me.\Right, Verde?\Aria?\Were you watching the surface again?\J-Just a little.\The heroes and the princesses are so cool.\And there's a wonderful prince, isn't there?\Th-That's not all, but... response:	What do you mean?
context: Right, Verde?\Aria?\Were you watching the surface again?\J-Just a little.\The heroes and the princesses are so cool.\And there's a wonderful prince, isn't there?\Th-That's not all, but...\What do you mean? response:	I like to think about what I'd do
context: Aria?\Were you watching the surface again?\J-Just a little.\The heroes and the princesses are so cool.\And there's a wonderful prince, isn't there?\Th-That's not all, but...\What do you mean?\I like to think about what I'd do response:	if I went to the surface.
context: Were you watching the surface again?\J-Just a little.\The heroes and the princesses are so cool.\And there's a wonderful prince, isn't there?\Th-That's not all, but...\What do you mean?\I like to think about what I'd do\if I went to the surface. response:	That's fun, too.
context: J-Just a little.\The heroes and the princesses are so cool.\And there's a wonderful prince, isn't there?\Th-That's not all, but...\What do you mean?\I like to think about what I'd do\if I went to the surface.\That's fun, too. response:	You can have the same form as a surface person.
context: The heroes and the princesses are so cool.\And there's a wonderful prince, isn't there?\Th-That's not all, but...\What do you mean?\I like to think about what I'd do\if I went to the surface.\That's fun, too.\You can have the same form as a surface person. response:	Couldn't you go if you wanted?
context: And there's a wonderful prince, isn't there?\Th-That's not all, but...\What do you mean?\I like to think about what I'd do\if I went to the surface.\That's fun, too.\You can have the same form as a surface person.\Couldn't you go if you wanted? response:	Even in this form,
context: Th-That's not all, but...\What do you mean?\I like to think about what I'd do\if I went to the surface.\That's fun, too.\You can have the same form as a surface person.\Couldn't you go if you wanted?\Even in this form, response:	I can't get far from water, just like you guys.
context: What do you mean?\I like to think about what I'd do\if I went to the surface.\That's fun, too.\You can have the same form as a surface person.\Couldn't you go if you wanted?\Even in this form,\I can't get far from water, just like you guys. response:	And this year I was chosen to be the songstress.
context: I like to think about what I'd do\if I went to the surface.\That's fun, too.\You can have the same form as a surface person.\Couldn't you go if you wanted?\Even in this form,\I can't get far from water, just like you guys.\And this year I was chosen to be the songstress. response:	I won't go.
context: if I went to the surface.\That's fun, too.\You can have the same form as a surface person.\Couldn't you go if you wanted?\Even in this form,\I can't get far from water, just like you guys.\And this year I was chosen to be the songstress.\I won't go. response:	For the Priestess and the Star Whale's sake, as well.
context: That's fun, too.\You can have the same form as a surface person.\Couldn't you go if you wanted?\Even in this form,\I can't get far from water, just like you guys.\And this year I was chosen to be the songstress.\I won't go.\For the Priestess and the Star Whale's sake, as well. response:	And for everyone's sake.
context: You can have the same form as a surface person.\Couldn't you go if you wanted?\Even in this form,\I can't get far from water, just like you guys.\And this year I was chosen to be the songstress.\I won't go.\For the Priestess and the Star Whale's sake, as well.\And for everyone's sake. response:	My life in the village is so peaceful and quiet,
context: Couldn't you go if you wanted?\Even in this form,\I can't get far from water, just like you guys.\And this year I was chosen to be the songstress.\I won't go.\For the Priestess and the Star Whale's sake, as well.\And for everyone's sake.\My life in the village is so peaceful and quiet, response:	but it's just a little boring.
context: Even in this form,\I can't get far from water, just like you guys.\And this year I was chosen to be the songstress.\I won't go.\For the Priestess and the Star Whale's sake, as well.\And for everyone's sake.\My life in the village is so peaceful and quiet,\but it's just a little boring. response:	My love for the surface is just a dream.
context: I can't get far from water, just like you guys.\And this year I was chosen to be the songstress.\I won't go.\For the Priestess and the Star Whale's sake, as well.\And for everyone's sake.\My life in the village is so peaceful and quiet,\but it's just a little boring.\My love for the surface is just a dream. response:	But...
context: And this year I was chosen to be the songstress.\I won't go.\For the Priestess and the Star Whale's sake, as well.\And for everyone's sake.\My life in the village is so peaceful and quiet,\but it's just a little boring.\My love for the surface is just a dream.\But... response:	Someday I'd love to
context: I won't go.\For the Priestess and the Star Whale's sake, as well.\And for everyone's sake.\My life in the village is so peaceful and quiet,\but it's just a little boring.\My love for the surface is just a dream.\But...\Someday I'd love to response:	go to the surface...
context: For the Priestess and the Star Whale's sake, as well.\And for everyone's sake.\My life in the village is so peaceful and quiet,\but it's just a little boring.\My love for the surface is just a dream.\But...\Someday I'd love to\go to the surface... response:	It can come true.
context: And for everyone's sake.\My life in the village is so peaceful and quiet,\but it's just a little boring.\My love for the surface is just a dream.\But...\Someday I'd love to\go to the surface...\It can come true. response:	I'll grant your wish.
context: My life in the village is so peaceful and quiet,\but it's just a little boring.\My love for the surface is just a dream.\But...\Someday I'd love to\go to the surface...\It can come true.\I'll grant your wish. response:	Verde... wow!
context: but it's just a little boring.\My love for the surface is just a dream.\But...\Someday I'd love to\go to the surface...\It can come true.\I'll grant your wish.\Verde... wow! response:	You can talk now!
context: My love for the surface is just a dream.\But...\Someday I'd love to\go to the surface...\It can come true.\I'll grant your wish.\Verde... wow!\You can talk now! response:	I'll make your dream come true.
context: But...\Someday I'd love to\go to the surface...\It can come true.\I'll grant your wish.\Verde... wow!\You can talk now!\I'll make your dream come true. response:	Let's go to the surface and keep it a secret from everyone.
context: Someday I'd love to\go to the surface...\It can come true.\I'll grant your wish.\Verde... wow!\You can talk now!\I'll make your dream come true.\Let's go to the surface and keep it a secret from everyone. response:	You're right.
context: go to the surface...\It can come true.\I'll grant your wish.\Verde... wow!\You can talk now!\I'll make your dream come true.\Let's go to the surface and keep it a secret from everyone.\You're right. response:	It would be wonderful if I could go with you.
context: It can come true.\I'll grant your wish.\Verde... wow!\You can talk now!\I'll make your dream come true.\Let's go to the surface and keep it a secret from everyone.\You're right.\It would be wonderful if I could go with you. response:	If I grant your wish,
context: I'll grant your wish.\Verde... wow!\You can talk now!\I'll make your dream come true.\Let's go to the surface and keep it a secret from everyone.\You're right.\It would be wonderful if I could go with you.\If I grant your wish, response:	will you sing for me?
context: Verde... wow!\You can talk now!\I'll make your dream come true.\Let's go to the surface and keep it a secret from everyone.\You're right.\It would be wonderful if I could go with you.\If I grant your wish,\will you sing for me? response:	Of course!
context: You can talk now!\I'll make your dream come true.\Let's go to the surface and keep it a secret from everyone.\You're right.\It would be wonderful if I could go with you.\If I grant your wish,\will you sing for me?\Of course! response:	Promise?
context: I'll make your dream come true.\Let's go to the surface and keep it a secret from everyone.\You're right.\It would be wonderful if I could go with you.\If I grant your wish,\will you sing for me?\Of course!\Promise? response:	Of course.
context: Let's go to the surface and keep it a secret from everyone.\You're right.\It would be wonderful if I could go with you.\If I grant your wish,\will you sing for me?\Of course!\Promise?\Of course. response:	It's a promise.
context: You're right.\It would be wonderful if I could go with you.\If I grant your wish,\will you sing for me?\Of course!\Promise?\Of course.\It's a promise. response:	I know where the power to
context: It would be wonderful if I could go with you.\If I grant your wish,\will you sing for me?\Of course!\Promise?\Of course.\It's a promise.\I know where the power to response:	make Aria's dream
context: If I grant your wish,\will you sing for me?\Of course!\Promise?\Of course.\It's a promise.\I know where the power to\make Aria's dream response:	come true is.
context: will you sing for me?\Of course!\Promise?\Of course.\It's a promise.\I know where the power to\make Aria's dream\come true is. response:	The reason I was born.
context: Of course!\Promise?\Of course.\It's a promise.\I know where the power to\make Aria's dream\come true is.\The reason I was born. response:	My true form...
context: Promise?\Of course.\It's a promise.\I know where the power to\make Aria's dream\come true is.\The reason I was born.\My true form... response:	I'll make Aria's dream
context: Of course.\It's a promise.\I know where the power to\make Aria's dream\come true is.\The reason I was born.\My true form...\I'll make Aria's dream response:	come true.
context: It's a promise.\I know where the power to\make Aria's dream\come true is.\The reason I was born.\My true form...\I'll make Aria's dream\come true. response:	Now I can make her dream come true.
context: I know where the power to\make Aria's dream\come true is.\The reason I was born.\My true form...\I'll make Aria's dream\come true.\Now I can make her dream come true. response:	The Star Whale that locks Aria away...
context: make Aria's dream\come true is.\The reason I was born.\My true form...\I'll make Aria's dream\come true.\Now I can make her dream come true.\The Star Whale that locks Aria away... response:	The village and priestess that hold her back...
context: come true is.\The reason I was born.\My true form...\I'll make Aria's dream\come true.\Now I can make her dream come true.\The Star Whale that locks Aria away...\The village and priestess that hold her back... response:	I can make them all go to sleep.
context: The reason I was born.\My true form...\I'll make Aria's dream\come true.\Now I can make her dream come true.\The Star Whale that locks Aria away...\The village and priestess that hold her back...\I can make them all go to sleep. response:	What's this?
context: My true form...\I'll make Aria's dream\come true.\Now I can make her dream come true.\The Star Whale that locks Aria away...\The village and priestess that hold her back...\I can make them all go to sleep.\What's this? response:	What happened, everyone?
context: I'll make Aria's dream\come true.\Now I can make her dream come true.\The Star Whale that locks Aria away...\The village and priestess that hold her back...\I can make them all go to sleep.\What's this?\What happened, everyone? response:	Aria.
context: come true.\Now I can make her dream come true.\The Star Whale that locks Aria away...\The village and priestess that hold her back...\I can make them all go to sleep.\What's this?\What happened, everyone?\Aria. response:	Verde... Is that you?
context: Now I can make her dream come true.\The Star Whale that locks Aria away...\The village and priestess that hold her back...\I can make them all go to sleep.\What's this?\What happened, everyone?\Aria.\Verde... Is that you? response:	You promised, Aria.
context: The Star Whale that locks Aria away...\The village and priestess that hold her back...\I can make them all go to sleep.\What's this?\What happened, everyone?\Aria.\Verde... Is that you?\You promised, Aria. response:	We'd go to the surface in secret.
context: The village and priestess that hold her back...\I can make them all go to sleep.\What's this?\What happened, everyone?\Aria.\Verde... Is that you?\You promised, Aria.\We'd go to the surface in secret. response:	Verde, it's you, right?
context: I can make them all go to sleep.\What's this?\What happened, everyone?\Aria.\Verde... Is that you?\You promised, Aria.\We'd go to the surface in secret.\Verde, it's you, right? response:	No... this isn't what I wanted.
context: What's this?\What happened, everyone?\Aria.\Verde... Is that you?\You promised, Aria.\We'd go to the surface in secret.\Verde, it's you, right?\No... this isn't what I wanted. response:	Aria... you promised,
context: What happened, everyone?\Aria.\Verde... Is that you?\You promised, Aria.\We'd go to the surface in secret.\Verde, it's you, right?\No... this isn't what I wanted.\Aria... you promised, response:	but you lied?
context: Aria.\Verde... Is that you?\You promised, Aria.\We'd go to the surface in secret.\Verde, it's you, right?\No... this isn't what I wanted.\Aria... you promised,\but you lied? response:	I didn't lie!
context: Verde... Is that you?\You promised, Aria.\We'd go to the surface in secret.\Verde, it's you, right?\No... this isn't what I wanted.\Aria... you promised,\but you lied?\I didn't lie! response:	I didn't lie, but...
context: You promised, Aria.\We'd go to the surface in secret.\Verde, it's you, right?\No... this isn't what I wanted.\Aria... you promised,\but you lied?\I didn't lie!\I didn't lie, but... response:	But this wasn't...
context: We'd go to the surface in secret.\Verde, it's you, right?\No... this isn't what I wanted.\Aria... you promised,\but you lied?\I didn't lie!\I didn't lie, but...\But this wasn't... response:	Don't cry.
context: Verde, it's you, right?\No... this isn't what I wanted.\Aria... you promised,\but you lied?\I didn't lie!\I didn't lie, but...\But this wasn't...\Don't cry. response:	I'll protect your songs and voice.
context: No... this isn't what I wanted.\Aria... you promised,\but you lied?\I didn't lie!\I didn't lie, but...\But this wasn't...\Don't cry.\I'll protect your songs and voice. response:	Let's go together.
context: Aria... you promised,\but you lied?\I didn't lie!\I didn't lie, but...\But this wasn't...\Don't cry.\I'll protect your songs and voice.\Let's go together. response:	We can go anywhere
context: but you lied?\I didn't lie!\I didn't lie, but...\But this wasn't...\Don't cry.\I'll protect your songs and voice.\Let's go together.\We can go anywhere response:	you want.
context: I didn't lie!\I didn't lie, but...\But this wasn't...\Don't cry.\I'll protect your songs and voice.\Let's go together.\We can go anywhere\you want. response:	The Star Whale...
context: I didn't lie, but...\But this wasn't...\Don't cry.\I'll protect your songs and voice.\Let's go together.\We can go anywhere\you want.\The Star Whale... response:	You're trying to stop me?
context: But this wasn't...\Don't cry.\I'll protect your songs and voice.\Let's go together.\We can go anywhere\you want.\The Star Whale...\You're trying to stop me? response:	What am I doing here?
context: Don't cry.\I'll protect your songs and voice.\Let's go together.\We can go anywhere\you want.\The Star Whale...\You're trying to stop me?\What am I doing here? response:	I can't remember.
context: I'll protect your songs and voice.\Let's go together.\We can go anywhere\you want.\The Star Whale...\You're trying to stop me?\What am I doing here?\I can't remember. response:	Who's there?
context: Let's go together.\We can go anywhere\you want.\The Star Whale...\You're trying to stop me?\What am I doing here?\I can't remember.\Who's there? response:	I have to help them!
context: We can go anywhere\you want.\The Star Whale...\You're trying to stop me?\What am I doing here?\I can't remember.\Who's there?\I have to help them! response:	Aria...
context: you want.\The Star Whale...\You're trying to stop me?\What am I doing here?\I can't remember.\Who's there?\I have to help them!\Aria... response:	Don't go...
context: The Star Whale...\You're trying to stop me?\What am I doing here?\I can't remember.\Who's there?\I have to help them!\Aria...\Don't go... response:	Find me... and stay by me.
context: You're trying to stop me?\What am I doing here?\I can't remember.\Who's there?\I have to help them!\Aria...\Don't go...\Find me... and stay by me. response:	This way!
context: What am I doing here?\I can't remember.\Who's there?\I have to help them!\Aria...\Don't go...\Find me... and stay by me.\This way! response:	There's a door!
context: I can't remember.\Who's there?\I have to help them!\Aria...\Don't go...\Find me... and stay by me.\This way!\There's a door! response:	Yeah!
context: Who's there?\I have to help them!\Aria...\Don't go...\Find me... and stay by me.\This way!\There's a door!\Yeah! response:	Aria...
context: I have to help them!\Aria...\Don't go...\Find me... and stay by me.\This way!\There's a door!\Yeah!\Aria... response:	Gaul!
context: Aria...\Don't go...\Find me... and stay by me.\This way!\There's a door!\Yeah!\Aria...\Gaul! response:	You...
context: Don't go...\Find me... and stay by me.\This way!\There's a door!\Yeah!\Aria...\Gaul!\You... response:	Is it you?
context: Find me... and stay by me.\This way!\There's a door!\Yeah!\Aria...\Gaul!\You...\Is it you? response:	My guards are famous for appearing and
context: This way!\There's a door!\Yeah!\Aria...\Gaul!\You...\Is it you?\My guards are famous for appearing and response:	disappearing when you least expect it.
context: There's a door!\Yeah!\Aria...\Gaul!\You...\Is it you?\My guards are famous for appearing and\disappearing when you least expect it. response:	They can chase and run faster than anybody.
context: Yeah!\Aria...\Gaul!\You...\Is it you?\My guards are famous for appearing and\disappearing when you least expect it.\They can chase and run faster than anybody. response:	Y-Y-You...
context: Aria...\Gaul!\You...\Is it you?\My guards are famous for appearing and\disappearing when you least expect it.\They can chase and run faster than anybody.\Y-Y-You... response:	Don't get in
context: Gaul!\You...\Is it you?\My guards are famous for appearing and\disappearing when you least expect it.\They can chase and run faster than anybody.\Y-Y-You...\Don't get in response:	our way, human!
context: You...\Is it you?\My guards are famous for appearing and\disappearing when you least expect it.\They can chase and run faster than anybody.\Y-Y-You...\Don't get in\our way, human! response:	Just like I thought, you're just a kid.
context: Is it you?\My guards are famous for appearing and\disappearing when you least expect it.\They can chase and run faster than anybody.\Y-Y-You...\Don't get in\our way, human!\Just like I thought, you're just a kid. response:	Don't think you can get by in the world...
context: My guards are famous for appearing and\disappearing when you least expect it.\They can chase and run faster than anybody.\Y-Y-You...\Don't get in\our way, human!\Just like I thought, you're just a kid.\Don't think you can get by in the world... response:	Just by being a selfish brat!
context: disappearing when you least expect it.\They can chase and run faster than anybody.\Y-Y-You...\Don't get in\our way, human!\Just like I thought, you're just a kid.\Don't think you can get by in the world...\Just by being a selfish brat! response:	Let me go!
context: They can chase and run faster than anybody.\Y-Y-You...\Don't get in\our way, human!\Just like I thought, you're just a kid.\Don't think you can get by in the world...\Just by being a selfish brat!\Let me go! response:	Sorry, I can't.
context: Y-Y-You...\Don't get in\our way, human!\Just like I thought, you're just a kid.\Don't think you can get by in the world...\Just by being a selfish brat!\Let me go!\Sorry, I can't. response:	It's our boss's orders.
context: Don't get in\our way, human!\Just like I thought, you're just a kid.\Don't think you can get by in the world...\Just by being a selfish brat!\Let me go!\Sorry, I can't.\It's our boss's orders. response:	It's my fault.
context: our way, human!\Just like I thought, you're just a kid.\Don't think you can get by in the world...\Just by being a selfish brat!\Let me go!\Sorry, I can't.\It's our boss's orders.\It's my fault. response:	I made him like that.
context: Just like I thought, you're just a kid.\Don't think you can get by in the world...\Just by being a selfish brat!\Let me go!\Sorry, I can't.\It's our boss's orders.\It's my fault.\I made him like that. response:	I don't know the reason,
context: Don't think you can get by in the world...\Just by being a selfish brat!\Let me go!\Sorry, I can't.\It's our boss's orders.\It's my fault.\I made him like that.\I don't know the reason, response:	but you can't handle him anymore.
context: Just by being a selfish brat!\Let me go!\Sorry, I can't.\It's our boss's orders.\It's my fault.\I made him like that.\I don't know the reason,\but you can't handle him anymore. response:	I guess that's a really troublesome type of demon.
context: Let me go!\Sorry, I can't.\It's our boss's orders.\It's my fault.\I made him like that.\I don't know the reason,\but you can't handle him anymore.\I guess that's a really troublesome type of demon. response:	If I go back, he'll do what I say.
context: Sorry, I can't.\It's our boss's orders.\It's my fault.\I made him like that.\I don't know the reason,\but you can't handle him anymore.\I guess that's a really troublesome type of demon.\If I go back, he'll do what I say. response:	But that would mean
context: It's our boss's orders.\It's my fault.\I made him like that.\I don't know the reason,\but you can't handle him anymore.\I guess that's a really troublesome type of demon.\If I go back, he'll do what I say.\But that would mean response:	we're abandoning you.
context: It's my fault.\I made him like that.\I don't know the reason,\but you can't handle him anymore.\I guess that's a really troublesome type of demon.\If I go back, he'll do what I say.\But that would mean\we're abandoning you. response:	Our boss wouldn't let that happen,
context: I made him like that.\I don't know the reason,\but you can't handle him anymore.\I guess that's a really troublesome type of demon.\If I go back, he'll do what I say.\But that would mean\we're abandoning you.\Our boss wouldn't let that happen, response:	nor would any of our friends.
context: I don't know the reason,\but you can't handle him anymore.\I guess that's a really troublesome type of demon.\If I go back, he'll do what I say.\But that would mean\we're abandoning you.\Our boss wouldn't let that happen,\nor would any of our friends. response:	But...
context: but you can't handle him anymore.\I guess that's a really troublesome type of demon.\If I go back, he'll do what I say.\But that would mean\we're abandoning you.\Our boss wouldn't let that happen,\nor would any of our friends.\But... response:	Our biggest goal is to save the Star Whale
context: I guess that's a really troublesome type of demon.\If I go back, he'll do what I say.\But that would mean\we're abandoning you.\Our boss wouldn't let that happen,\nor would any of our friends.\But...\Our biggest goal is to save the Star Whale response:	and all the Star People, including you.
context: If I go back, he'll do what I say.\But that would mean\we're abandoning you.\Our boss wouldn't let that happen,\nor would any of our friends.\But...\Our biggest goal is to save the Star Whale\and all the Star People, including you. response:	But I'm also training to be a specialist
context: But that would mean\we're abandoning you.\Our boss wouldn't let that happen,\nor would any of our friends.\But...\Our biggest goal is to save the Star Whale\and all the Star People, including you.\But I'm also training to be a specialist response:	in dealing with demons.
context: we're abandoning you.\Our boss wouldn't let that happen,\nor would any of our friends.\But...\Our biggest goal is to save the Star Whale\and all the Star People, including you.\But I'm also training to be a specialist\in dealing with demons. response:	Even if he's a Disciple, if he can be saved, I want to save him.
context: Our boss wouldn't let that happen,\nor would any of our friends.\But...\Our biggest goal is to save the Star Whale\and all the Star People, including you.\But I'm also training to be a specialist\in dealing with demons.\Even if he's a Disciple, if he can be saved, I want to save him. response:	What we need isn't sacrifice and dedication,
context: nor would any of our friends.\But...\Our biggest goal is to save the Star Whale\and all the Star People, including you.\But I'm also training to be a specialist\in dealing with demons.\Even if he's a Disciple, if he can be saved, I want to save him.\What we need isn't sacrifice and dedication, response:	it's information and a plan!
context: But...\Our biggest goal is to save the Star Whale\and all the Star People, including you.\But I'm also training to be a specialist\in dealing with demons.\Even if he's a Disciple, if he can be saved, I want to save him.\What we need isn't sacrifice and dedication,\it's information and a plan! response:	Would you tell us the details?
context: Our biggest goal is to save the Star Whale\and all the Star People, including you.\But I'm also training to be a specialist\in dealing with demons.\Even if he's a Disciple, if he can be saved, I want to save him.\What we need isn't sacrifice and dedication,\it's information and a plan!\Would you tell us the details? response:	What happened between you and him?
context: and all the Star People, including you.\But I'm also training to be a specialist\in dealing with demons.\Even if he's a Disciple, if he can be saved, I want to save him.\What we need isn't sacrifice and dedication,\it's information and a plan!\Would you tell us the details?\What happened between you and him? response:	Aria said she wanted to go to the surface.
context: But I'm also training to be a specialist\in dealing with demons.\Even if he's a Disciple, if he can be saved, I want to save him.\What we need isn't sacrifice and dedication,\it's information and a plan!\Would you tell us the details?\What happened between you and him?\Aria said she wanted to go to the surface. response:	I'm going to make that dream come true!
context: in dealing with demons.\Even if he's a Disciple, if he can be saved, I want to save him.\What we need isn't sacrifice and dedication,\it's information and a plan!\Would you tell us the details?\What happened between you and him?\Aria said she wanted to go to the surface.\I'm going to make that dream come true! response:	You don't have to do this; we'll take her!
context: Even if he's a Disciple, if he can be saved, I want to save him.\What we need isn't sacrifice and dedication,\it's information and a plan!\Would you tell us the details?\What happened between you and him?\Aria said she wanted to go to the surface.\I'm going to make that dream come true!\You don't have to do this; we'll take her! response:	If you promise not to be bad, we'll take you, too!
context: What we need isn't sacrifice and dedication,\it's information and a plan!\Would you tell us the details?\What happened between you and him?\Aria said she wanted to go to the surface.\I'm going to make that dream come true!\You don't have to do this; we'll take her!\If you promise not to be bad, we'll take you, too! response:	I won't believe that!
context: it's information and a plan!\Would you tell us the details?\What happened between you and him?\Aria said she wanted to go to the surface.\I'm going to make that dream come true!\You don't have to do this; we'll take her!\If you promise not to be bad, we'll take you, too!\I won't believe that! response:	The people of the surface refuse to accept us.
context: Would you tell us the details?\What happened between you and him?\Aria said she wanted to go to the surface.\I'm going to make that dream come true!\You don't have to do this; we'll take her!\If you promise not to be bad, we'll take you, too!\I won't believe that!\The people of the surface refuse to accept us. response:	Even in the distant past,
context: What happened between you and him?\Aria said she wanted to go to the surface.\I'm going to make that dream come true!\You don't have to do this; we'll take her!\If you promise not to be bad, we'll take you, too!\I won't believe that!\The people of the surface refuse to accept us.\Even in the distant past, response:	they tried to exterminate us, even though we didn't do anything wrong.
context: Aria said she wanted to go to the surface.\I'm going to make that dream come true!\You don't have to do this; we'll take her!\If you promise not to be bad, we'll take you, too!\I won't believe that!\The people of the surface refuse to accept us.\Even in the distant past,\they tried to exterminate us, even though we didn't do anything wrong. response:	I see.
context: I'm going to make that dream come true!\You don't have to do this; we'll take her!\If you promise not to be bad, we'll take you, too!\I won't believe that!\The people of the surface refuse to accept us.\Even in the distant past,\they tried to exterminate us, even though we didn't do anything wrong.\I see. response:	I won't believe in the star people
context: You don't have to do this; we'll take her!\If you promise not to be bad, we'll take you, too!\I won't believe that!\The people of the surface refuse to accept us.\Even in the distant past,\they tried to exterminate us, even though we didn't do anything wrong.\I see.\I won't believe in the star people response:	or the humans of the surface.
context: If you promise not to be bad, we'll take you, too!\I won't believe that!\The people of the surface refuse to accept us.\Even in the distant past,\they tried to exterminate us, even though we didn't do anything wrong.\I see.\I won't believe in the star people\or the humans of the surface. response:	I'll make them all sleep with my power,
context: I won't believe that!\The people of the surface refuse to accept us.\Even in the distant past,\they tried to exterminate us, even though we didn't do anything wrong.\I see.\I won't believe in the star people\or the humans of the surface.\I'll make them all sleep with my power, response:	and make a peaceful and gentle world.
context: The people of the surface refuse to accept us.\Even in the distant past,\they tried to exterminate us, even though we didn't do anything wrong.\I see.\I won't believe in the star people\or the humans of the surface.\I'll make them all sleep with my power,\and make a peaceful and gentle world. response:	Wait. Wait a second!
context: Even in the distant past,\they tried to exterminate us, even though we didn't do anything wrong.\I see.\I won't believe in the star people\or the humans of the surface.\I'll make them all sleep with my power,\and make a peaceful and gentle world.\Wait. Wait a second! response:	I won't wait!
context: they tried to exterminate us, even though we didn't do anything wrong.\I see.\I won't believe in the star people\or the humans of the surface.\I'll make them all sleep with my power,\and make a peaceful and gentle world.\Wait. Wait a second!\I won't wait! response:	Once all the humans
context: I see.\I won't believe in the star people\or the humans of the surface.\I'll make them all sleep with my power,\and make a peaceful and gentle world.\Wait. Wait a second!\I won't wait!\Once all the humans response:	in our way are gone,
context: I won't believe in the star people\or the humans of the surface.\I'll make them all sleep with my power,\and make a peaceful and gentle world.\Wait. Wait a second!\I won't wait!\Once all the humans\in our way are gone, response:	Aria can go to the surface to play in peace.
context: or the humans of the surface.\I'll make them all sleep with my power,\and make a peaceful and gentle world.\Wait. Wait a second!\I won't wait!\Once all the humans\in our way are gone,\Aria can go to the surface to play in peace. response:	She'll let me be the only one to hear her songs.
context: I'll make them all sleep with my power,\and make a peaceful and gentle world.\Wait. Wait a second!\I won't wait!\Once all the humans\in our way are gone,\Aria can go to the surface to play in peace.\She'll let me be the only one to hear her songs. response:	So human...
context: and make a peaceful and gentle world.\Wait. Wait a second!\I won't wait!\Once all the humans\in our way are gone,\Aria can go to the surface to play in peace.\She'll let me be the only one to hear her songs.\So human... response:	Sleep here.
context: Wait. Wait a second!\I won't wait!\Once all the humans\in our way are gone,\Aria can go to the surface to play in peace.\She'll let me be the only one to hear her songs.\So human...\Sleep here. response:	The Hero Shinku
context: I won't wait!\Once all the humans\in our way are gone,\Aria can go to the surface to play in peace.\She'll let me be the only one to hear her songs.\So human...\Sleep here.\The Hero Shinku response:	is here in Hero Mode!
context: Once all the humans\in our way are gone,\Aria can go to the surface to play in peace.\She'll let me be the only one to hear her songs.\So human...\Sleep here.\The Hero Shinku\is here in Hero Mode! response:	Don't get in
context: in our way are gone,\Aria can go to the surface to play in peace.\She'll let me be the only one to hear her songs.\So human...\Sleep here.\The Hero Shinku\is here in Hero Mode!\Don't get in response:	my way!
context: Aria can go to the surface to play in peace.\She'll let me be the only one to hear her songs.\So human...\Sleep here.\The Hero Shinku\is here in Hero Mode!\Don't get in\my way! response:	Seems like
context: She'll let me be the only one to hear her songs.\So human...\Sleep here.\The Hero Shinku\is here in Hero Mode!\Don't get in\my way!\Seems like response:	the situation's worse than we imagined.
context: So human...\Sleep here.\The Hero Shinku\is here in Hero Mode!\Don't get in\my way!\Seems like\the situation's worse than we imagined. response:	We'll just have to cut open a path.
context: Sleep here.\The Hero Shinku\is here in Hero Mode!\Don't get in\my way!\Seems like\the situation's worse than we imagined.\We'll just have to cut open a path. response:	Alliance knights and medics!
context: The Hero Shinku\is here in Hero Mode!\Don't get in\my way!\Seems like\the situation's worse than we imagined.\We'll just have to cut open a path.\Alliance knights and medics! response:	Hang on!
context: is here in Hero Mode!\Don't get in\my way!\Seems like\the situation's worse than we imagined.\We'll just have to cut open a path.\Alliance knights and medics!\Hang on! response:	Right!
context: Don't get in\my way!\Seems like\the situation's worse than we imagined.\We'll just have to cut open a path.\Alliance knights and medics!\Hang on!\Right! response:	Princess, I'm going to up our speed!
context: my way!\Seems like\the situation's worse than we imagined.\We'll just have to cut open a path.\Alliance knights and medics!\Hang on!\Right!\Princess, I'm going to up our speed! response:	Okay! Please do!
context: Seems like\the situation's worse than we imagined.\We'll just have to cut open a path.\Alliance knights and medics!\Hang on!\Right!\Princess, I'm going to up our speed!\Okay! Please do! response:	Everybody's here!
context: the situation's worse than we imagined.\We'll just have to cut open a path.\Alliance knights and medics!\Hang on!\Right!\Princess, I'm going to up our speed!\Okay! Please do!\Everybody's here! response:	The songstress from the surface is here, isn't she?
context: We'll just have to cut open a path.\Alliance knights and medics!\Hang on!\Right!\Princess, I'm going to up our speed!\Okay! Please do!\Everybody's here!\The songstress from the surface is here, isn't she? response:	Everybody, get the dais for the Star Festival ready!
context: Alliance knights and medics!\Hang on!\Right!\Princess, I'm going to up our speed!\Okay! Please do!\Everybody's here!\The songstress from the surface is here, isn't she?\Everybody, get the dais for the Star Festival ready! response:	Right!
context: Hang on!\Right!\Princess, I'm going to up our speed!\Okay! Please do!\Everybody's here!\The songstress from the surface is here, isn't she?\Everybody, get the dais for the Star Festival ready!\Right! response:	I have to go, too.
context: Right!\Princess, I'm going to up our speed!\Okay! Please do!\Everybody's here!\The songstress from the surface is here, isn't she?\Everybody, get the dais for the Star Festival ready!\Right!\I have to go, too. response:	Pega, this way.
context: Princess, I'm going to up our speed!\Okay! Please do!\Everybody's here!\The songstress from the surface is here, isn't she?\Everybody, get the dais for the Star Festival ready!\Right!\I have to go, too.\Pega, this way. response:	Your wings may be the key to saving everyone.
context: Okay! Please do!\Everybody's here!\The songstress from the surface is here, isn't she?\Everybody, get the dais for the Star Festival ready!\Right!\I have to go, too.\Pega, this way.\Your wings may be the key to saving everyone. response:	Show the dragon priestess Sharl and everyone else
context: Everybody's here!\The songstress from the surface is here, isn't she?\Everybody, get the dais for the Star Festival ready!\Right!\I have to go, too.\Pega, this way.\Your wings may be the key to saving everyone.\Show the dragon priestess Sharl and everyone else response:	your true form.
context: The songstress from the surface is here, isn't she?\Everybody, get the dais for the Star Festival ready!\Right!\I have to go, too.\Pega, this way.\Your wings may be the key to saving everyone.\Show the dragon priestess Sharl and everyone else\your true form. response:	I'm sorry princess, to ask you to sing in all this chaos.
context: Everybody, get the dais for the Star Festival ready!\Right!\I have to go, too.\Pega, this way.\Your wings may be the key to saving everyone.\Show the dragon priestess Sharl and everyone else\your true form.\I'm sorry princess, to ask you to sing in all this chaos. response:	Not at all.
context: Right!\I have to go, too.\Pega, this way.\Your wings may be the key to saving everyone.\Show the dragon priestess Sharl and everyone else\your true form.\I'm sorry princess, to ask you to sing in all this chaos.\Not at all. response:	I'll sing anywhere, at any time.
context: I have to go, too.\Pega, this way.\Your wings may be the key to saving everyone.\Show the dragon priestess Sharl and everyone else\your true form.\I'm sorry princess, to ask you to sing in all this chaos.\Not at all.\I'll sing anywhere, at any time. response:	Especially if it can help keep the Sky Sea safe.
context: Pega, this way.\Your wings may be the key to saving everyone.\Show the dragon priestess Sharl and everyone else\your true form.\I'm sorry princess, to ask you to sing in all this chaos.\Not at all.\I'll sing anywhere, at any time.\Especially if it can help keep the Sky Sea safe. response:	There's nothing that would make me happier as a singer.
context: Your wings may be the key to saving everyone.\Show the dragon priestess Sharl and everyone else\your true form.\I'm sorry princess, to ask you to sing in all this chaos.\Not at all.\I'll sing anywhere, at any time.\Especially if it can help keep the Sky Sea safe.\There's nothing that would make me happier as a singer. response:	No way!
context: Show the dragon priestess Sharl and everyone else\your true form.\I'm sorry princess, to ask you to sing in all this chaos.\Not at all.\I'll sing anywhere, at any time.\Especially if it can help keep the Sky Sea safe.\There's nothing that would make me happier as a singer.\No way! response:	Princess of Biscotti, Hero Rebecca,
context: your true form.\I'm sorry princess, to ask you to sing in all this chaos.\Not at all.\I'll sing anywhere, at any time.\Especially if it can help keep the Sky Sea safe.\There's nothing that would make me happier as a singer.\No way!\Princess of Biscotti, Hero Rebecca, response:	I'm glad you're safe.
context: I'm sorry princess, to ask you to sing in all this chaos.\Not at all.\I'll sing anywhere, at any time.\Especially if it can help keep the Sky Sea safe.\There's nothing that would make me happier as a singer.\No way!\Princess of Biscotti, Hero Rebecca,\I'm glad you're safe. response:	Priestess!
context: Not at all.\I'll sing anywhere, at any time.\Especially if it can help keep the Sky Sea safe.\There's nothing that would make me happier as a singer.\No way!\Princess of Biscotti, Hero Rebecca,\I'm glad you're safe.\Priestess! response:	Who's that?
context: I'll sing anywhere, at any time.\Especially if it can help keep the Sky Sea safe.\There's nothing that would make me happier as a singer.\No way!\Princess of Biscotti, Hero Rebecca,\I'm glad you're safe.\Priestess!\Who's that? response:	It's Pega.
context: Especially if it can help keep the Sky Sea safe.\There's nothing that would make me happier as a singer.\No way!\Princess of Biscotti, Hero Rebecca,\I'm glad you're safe.\Priestess!\Who's that?\It's Pega. response:	This is his true form.
context: There's nothing that would make me happier as a singer.\No way!\Princess of Biscotti, Hero Rebecca,\I'm glad you're safe.\Priestess!\Who's that?\It's Pega.\This is his true form. response:	Let's hurry.
context: No way!\Princess of Biscotti, Hero Rebecca,\I'm glad you're safe.\Priestess!\Who's that?\It's Pega.\This is his true form.\Let's hurry. response:	The star festival will be ready soon.
context: Princess of Biscotti, Hero Rebecca,\I'm glad you're safe.\Priestess!\Who's that?\It's Pega.\This is his true form.\Let's hurry.\The star festival will be ready soon. response:	Right!
context: I'm glad you're safe.\Priestess!\Who's that?\It's Pega.\This is his true form.\Let's hurry.\The star festival will be ready soon.\Right! response:	Stay sharp!
context: Priestess!\Who's that?\It's Pega.\This is his true form.\Let's hurry.\The star festival will be ready soon.\Right!\Stay sharp! response:	There's still more!
context: Who's that?\It's Pega.\This is his true form.\Let's hurry.\The star festival will be ready soon.\Right!\Stay sharp!\There's still more! response:	Right!
context: It's Pega.\This is his true form.\Let's hurry.\The star festival will be ready soon.\Right!\Stay sharp!\There's still more!\Right! response:	There's no end to them!
context: This is his true form.\Let's hurry.\The star festival will be ready soon.\Right!\Stay sharp!\There's still more!\Right!\There's no end to them! response:	No army is infinite.
context: Let's hurry.\The star festival will be ready soon.\Right!\Stay sharp!\There's still more!\Right!\There's no end to them!\No army is infinite. response:	Right!
context: The star festival will be ready soon.\Right!\Stay sharp!\There's still more!\Right!\There's no end to them!\No army is infinite.\Right! response:	Let's go, Shinku!
context: Right!\Stay sharp!\There's still more!\Right!\There's no end to them!\No army is infinite.\Right!\Let's go, Shinku! response:	Yeah, Gaul!
context: Stay sharp!\There's still more!\Right!\There's no end to them!\No army is infinite.\Right!\Let's go, Shinku!\Yeah, Gaul! response:	Divine Rule: Glorious Flying Slash!
context: There's still more!\Right!\There's no end to them!\No army is infinite.\Right!\Let's go, Shinku!\Yeah, Gaul!\Divine Rule: Glorious Flying Slash! response:	This is it.
context: Right!\There's no end to them!\No army is infinite.\Right!\Let's go, Shinku!\Yeah, Gaul!\Divine Rule: Glorious Flying Slash!\This is it. response:	Not yet.
context: There's no end to them!\No army is infinite.\Right!\Let's go, Shinku!\Yeah, Gaul!\Divine Rule: Glorious Flying Slash!\This is it.\Not yet. response:	No, this is the end.
context: No army is infinite.\Right!\Let's go, Shinku!\Yeah, Gaul!\Divine Rule: Glorious Flying Slash!\This is it.\Not yet.\No, this is the end. response:	This song...
context: Right!\Let's go, Shinku!\Yeah, Gaul!\Divine Rule: Glorious Flying Slash!\This is it.\Not yet.\No, this is the end.\This song... response:	It's starting...
context: Let's go, Shinku!\Yeah, Gaul!\Divine Rule: Glorious Flying Slash!\This is it.\Not yet.\No, this is the end.\This song...\It's starting... response:	The princess' song.
context: Yeah, Gaul!\Divine Rule: Glorious Flying Slash!\This is it.\Not yet.\No, this is the end.\This song...\It's starting...\The princess' song. response:	Everyone!
context: Divine Rule: Glorious Flying Slash!\This is it.\Not yet.\No, this is the end.\This song...\It's starting...\The princess' song.\Everyone! response:	Let's sing a song of healing to the Star Whale, too!
context: This is it.\Not yet.\No, this is the end.\This song...\It's starting...\The princess' song.\Everyone!\Let's sing a song of healing to the Star Whale, too! response:	Yeah!
context: Not yet.\No, this is the end.\This song...\It's starting...\The princess' song.\Everyone!\Let's sing a song of healing to the Star Whale, too!\Yeah! response:	Who is this wonderful person?
context: No, this is the end.\This song...\It's starting...\The princess' song.\Everyone!\Let's sing a song of healing to the Star Whale, too!\Yeah!\Who is this wonderful person? response:	Who could it be?
context: This song...\It's starting...\The princess' song.\Everyone!\Let's sing a song of healing to the Star Whale, too!\Yeah!\Who is this wonderful person?\Who could it be? response:	Call me Pegasus Mask.
context: It's starting...\The princess' song.\Everyone!\Let's sing a song of healing to the Star Whale, too!\Yeah!\Who is this wonderful person?\Who could it be?\Call me Pegasus Mask. response:	Huh? Next week's the last episode?
context: The princess' song.\Everyone!\Let's sing a song of healing to the Star Whale, too!\Yeah!\Who is this wonderful person?\Who could it be?\Call me Pegasus Mask.\Huh? Next week's the last episode? response:	Returning Home