context: We just have to pass through these, right? response:	Yay!
context: We just have to pass through these, right?\Yay! response:	Tomoe! That was Nanami!
context: We just have to pass through these, right?\Yay!\Tomoe! That was Nanami! response:	Mom!
context: We just have to pass through these, right?\Yay!\Tomoe! That was Nanami!\Mom! response:	Her mother is suffering from an illness.
context: We just have to pass through these, right?\Yay!\Tomoe! That was Nanami!\Mom!\Her mother is suffering from an illness. response:	She is not long for this world.
context: We just have to pass through these, right?\Yay!\Tomoe! That was Nanami!\Mom!\Her mother is suffering from an illness.\She is not long for this world. response:	I wonder what's happening on this world
context: We just have to pass through these, right?\Yay!\Tomoe! That was Nanami!\Mom!\Her mother is suffering from an illness.\She is not long for this world.\I wonder what's happening on this world response:	I wonder what's happening on this world
context: We just have to pass through these, right?\Yay!\Tomoe! That was Nanami!\Mom!\Her mother is suffering from an illness.\She is not long for this world.\I wonder what's happening on this world\I wonder what's happening on this world response:	I fly through the sky into space
context: Yay!\Tomoe! That was Nanami!\Mom!\Her mother is suffering from an illness.\She is not long for this world.\I wonder what's happening on this world\I wonder what's happening on this world\I fly through the sky into space response:	I fly through the sky into space
context: Tomoe! That was Nanami!\Mom!\Her mother is suffering from an illness.\She is not long for this world.\I wonder what's happening on this world\I wonder what's happening on this world\I fly through the sky into space\I fly through the sky into space response:	and circle the world
context: Mom!\Her mother is suffering from an illness.\She is not long for this world.\I wonder what's happening on this world\I wonder what's happening on this world\I fly through the sky into space\I fly through the sky into space\and circle the world response:	and circle the world
context: Her mother is suffering from an illness.\She is not long for this world.\I wonder what's happening on this world\I wonder what's happening on this world\I fly through the sky into space\I fly through the sky into space\and circle the world\and circle the world response:	Monday, Tuesday, Wednesday, Thursday, Friday, Saturday, Sunday
context: She is not long for this world.\I wonder what's happening on this world\I wonder what's happening on this world\I fly through the sky into space\I fly through the sky into space\and circle the world\and circle the world\Monday, Tuesday, Wednesday, Thursday, Friday, Saturday, Sunday response:	Monday, Tuesday, Wednesday, Thursday, Friday, Saturday, Sunday
context: I wonder what's happening on this world\I wonder what's happening on this world\I fly through the sky into space\I fly through the sky into space\and circle the world\and circle the world\Monday, Tuesday, Wednesday, Thursday, Friday, Saturday, Sunday\Monday, Tuesday, Wednesday, Thursday, Friday, Saturday, Sunday response:	With my periodic biorhythm
context: I wonder what's happening on this world\I fly through the sky into space\I fly through the sky into space\and circle the world\and circle the world\Monday, Tuesday, Wednesday, Thursday, Friday, Saturday, Sunday\Monday, Tuesday, Wednesday, Thursday, Friday, Saturday, Sunday\With my periodic biorhythm response:	With my periodic biorhythm
context: I fly through the sky into space\I fly through the sky into space\and circle the world\and circle the world\Monday, Tuesday, Wednesday, Thursday, Friday, Saturday, Sunday\Monday, Tuesday, Wednesday, Thursday, Friday, Saturday, Sunday\With my periodic biorhythm\With my periodic biorhythm response:	I'm like a washing machine
context: I fly through the sky into space\and circle the world\and circle the world\Monday, Tuesday, Wednesday, Thursday, Friday, Saturday, Sunday\Monday, Tuesday, Wednesday, Thursday, Friday, Saturday, Sunday\With my periodic biorhythm\With my periodic biorhythm\I'm like a washing machine response:	I'm like a washing machine
context: and circle the world\and circle the world\Monday, Tuesday, Wednesday, Thursday, Friday, Saturday, Sunday\Monday, Tuesday, Wednesday, Thursday, Friday, Saturday, Sunday\With my periodic biorhythm\With my periodic biorhythm\I'm like a washing machine\I'm like a washing machine response:	Just kidding
context: and circle the world\Monday, Tuesday, Wednesday, Thursday, Friday, Saturday, Sunday\Monday, Tuesday, Wednesday, Thursday, Friday, Saturday, Sunday\With my periodic biorhythm\With my periodic biorhythm\I'm like a washing machine\I'm like a washing machine\Just kidding response:	Just kidding
context: Monday, Tuesday, Wednesday, Thursday, Friday, Saturday, Sunday\Monday, Tuesday, Wednesday, Thursday, Friday, Saturday, Sunday\With my periodic biorhythm\With my periodic biorhythm\I'm like a washing machine\I'm like a washing machine\Just kidding\Just kidding response:	Yes, I'm spinning around
context: Monday, Tuesday, Wednesday, Thursday, Friday, Saturday, Sunday\With my periodic biorhythm\With my periodic biorhythm\I'm like a washing machine\I'm like a washing machine\Just kidding\Just kidding\Yes, I'm spinning around response:	Yes, I'm spinning around
context: With my periodic biorhythm\With my periodic biorhythm\I'm like a washing machine\I'm like a washing machine\Just kidding\Just kidding\Yes, I'm spinning around\Yes, I'm spinning around response:	Around, around the world
context: With my periodic biorhythm\I'm like a washing machine\I'm like a washing machine\Just kidding\Just kidding\Yes, I'm spinning around\Yes, I'm spinning around\Around, around the world response:	Around, around the world
context: I'm like a washing machine\I'm like a washing machine\Just kidding\Just kidding\Yes, I'm spinning around\Yes, I'm spinning around\Around, around the world\Around, around the world response:	Because there's no limit to my love
context: I'm like a washing machine\Just kidding\Just kidding\Yes, I'm spinning around\Yes, I'm spinning around\Around, around the world\Around, around the world\Because there's no limit to my love response:	Because there's no limit to my love
context: Just kidding\Just kidding\Yes, I'm spinning around\Yes, I'm spinning around\Around, around the world\Around, around the world\Because there's no limit to my love\Because there's no limit to my love response:	Spinning around, around, around the world
context: Just kidding\Yes, I'm spinning around\Yes, I'm spinning around\Around, around the world\Around, around the world\Because there's no limit to my love\Because there's no limit to my love\Spinning around, around, around the world response:	Spinning around, around, around the world
context: Yes, I'm spinning around\Yes, I'm spinning around\Around, around the world\Around, around the world\Because there's no limit to my love\Because there's no limit to my love\Spinning around, around, around the world\Spinning around, around, around the world response:	I want to tell you that I love you, even if it confuses me
context: Yes, I'm spinning around\Around, around the world\Around, around the world\Because there's no limit to my love\Because there's no limit to my love\Spinning around, around, around the world\Spinning around, around, around the world\I want to tell you that I love you, even if it confuses me response:	I want to tell you that I love you, even if it confuses me
context: Around, around the world\Around, around the world\Because there's no limit to my love\Because there's no limit to my love\Spinning around, around, around the world\Spinning around, around, around the world\I want to tell you that I love you, even if it confuses me\I want to tell you that I love you, even if it confuses me response:	Bam, bam, bam
context: Around, around the world\Because there's no limit to my love\Because there's no limit to my love\Spinning around, around, around the world\Spinning around, around, around the world\I want to tell you that I love you, even if it confuses me\I want to tell you that I love you, even if it confuses me\Bam, bam, bam response:	Bam, bam, bam
context: Because there's no limit to my love\Because there's no limit to my love\Spinning around, around, around the world\Spinning around, around, around the world\I want to tell you that I love you, even if it confuses me\I want to tell you that I love you, even if it confuses me\Bam, bam, bam\Bam, bam, bam response:	You're not paying attention
context: Because there's no limit to my love\Spinning around, around, around the world\Spinning around, around, around the world\I want to tell you that I love you, even if it confuses me\I want to tell you that I love you, even if it confuses me\Bam, bam, bam\Bam, bam, bam\You're not paying attention response:	You're not paying attention
context: Spinning around, around, around the world\Spinning around, around, around the world\I want to tell you that I love you, even if it confuses me\I want to tell you that I love you, even if it confuses me\Bam, bam, bam\Bam, bam, bam\You're not paying attention\You're not paying attention response:	Sometimes love keeps being one-sided
context: Spinning around, around, around the world\I want to tell you that I love you, even if it confuses me\I want to tell you that I love you, even if it confuses me\Bam, bam, bam\Bam, bam, bam\You're not paying attention\You're not paying attention\Sometimes love keeps being one-sided response:	Sometimes love keeps being one-sided
context: I want to tell you that I love you, even if it confuses me\I want to tell you that I love you, even if it confuses me\Bam, bam, bam\Bam, bam, bam\You're not paying attention\You're not paying attention\Sometimes love keeps being one-sided\Sometimes love keeps being one-sided response:	It's gotten so hopelessly complex
context: I want to tell you that I love you, even if it confuses me\Bam, bam, bam\Bam, bam, bam\You're not paying attention\You're not paying attention\Sometimes love keeps being one-sided\Sometimes love keeps being one-sided\It's gotten so hopelessly complex response:	It's gotten so hopelessly complex
context: Bam, bam, bam\Bam, bam, bam\You're not paying attention\You're not paying attention\Sometimes love keeps being one-sided\Sometimes love keeps being one-sided\It's gotten so hopelessly complex\It's gotten so hopelessly complex response:	But I'll make it all true with a miracle
context: Bam, bam, bam\You're not paying attention\You're not paying attention\Sometimes love keeps being one-sided\Sometimes love keeps being one-sided\It's gotten so hopelessly complex\It's gotten so hopelessly complex\But I'll make it all true with a miracle response:	But I'll make it all true with a miracle
context: You're not paying attention\You're not paying attention\Sometimes love keeps being one-sided\Sometimes love keeps being one-sided\It's gotten so hopelessly complex\It's gotten so hopelessly complex\But I'll make it all true with a miracle\But I'll make it all true with a miracle response:	Hey, God,
context: You're not paying attention\Sometimes love keeps being one-sided\Sometimes love keeps being one-sided\It's gotten so hopelessly complex\It's gotten so hopelessly complex\But I'll make it all true with a miracle\But I'll make it all true with a miracle\Hey, God, response:	Hey, God,
context: Sometimes love keeps being one-sided\Sometimes love keeps being one-sided\It's gotten so hopelessly complex\It's gotten so hopelessly complex\But I'll make it all true with a miracle\But I'll make it all true with a miracle\Hey, God,\Hey, God, response:	I'm your god
context: Sometimes love keeps being one-sided\It's gotten so hopelessly complex\It's gotten so hopelessly complex\But I'll make it all true with a miracle\But I'll make it all true with a miracle\Hey, God,\Hey, God,\I'm your god response:	I'm your god
context: It's gotten so hopelessly complex\It's gotten so hopelessly complex\But I'll make it all true with a miracle\But I'll make it all true with a miracle\Hey, God,\Hey, God,\I'm your god\I'm your god response:	I think
context: It's gotten so hopelessly complex\But I'll make it all true with a miracle\But I'll make it all true with a miracle\Hey, God,\Hey, God,\I'm your god\I'm your god\I think response:	I think
context: But I'll make it all true with a miracle\But I'll make it all true with a miracle\Hey, God,\Hey, God,\I'm your god\I'm your god\I think\I think response:	The Nanami from twelve years ago is someone I do not recognize.
context: But I'll make it all true with a miracle\Hey, God,\Hey, God,\I'm your god\I'm your god\I think\I think\The Nanami from twelve years ago is someone I do not recognize. response:	The God Receives a Marriage Proposal
context: Hey, God,\Hey, God,\I'm your god\I'm your god\I think\I think\The Nanami from twelve years ago is someone I do not recognize.\The God Receives a Marriage Proposal response:	This bamboo-leaf rice cake is yummy!
context: Hey, God,\I'm your god\I'm your god\I think\I think\The Nanami from twelve years ago is someone I do not recognize.\The God Receives a Marriage Proposal\This bamboo-leaf rice cake is yummy! response:	I made plenty more.
context: I'm your god\I'm your god\I think\I think\The Nanami from twelve years ago is someone I do not recognize.\The God Receives a Marriage Proposal\This bamboo-leaf rice cake is yummy!\I made plenty more. response:	I'll put the rest in the freezer.
context: I'm your god\I think\I think\The Nanami from twelve years ago is someone I do not recognize.\The God Receives a Marriage Proposal\This bamboo-leaf rice cake is yummy!\I made plenty more.\I'll put the rest in the freezer. response:	The money I hid in the freezer for this month's electric bill...
context: I think\I think\The Nanami from twelve years ago is someone I do not recognize.\The God Receives a Marriage Proposal\This bamboo-leaf rice cake is yummy!\I made plenty more.\I'll put the rest in the freezer.\The money I hid in the freezer for this month's electric bill... response:	is gone!
context: I think\The Nanami from twelve years ago is someone I do not recognize.\The God Receives a Marriage Proposal\This bamboo-leaf rice cake is yummy!\I made plenty more.\I'll put the rest in the freezer.\The money I hid in the freezer for this month's electric bill...\is gone! response:	Curse you...
context: The Nanami from twelve years ago is someone I do not recognize.\The God Receives a Marriage Proposal\This bamboo-leaf rice cake is yummy!\I made plenty more.\I'll put the rest in the freezer.\The money I hid in the freezer for this month's electric bill...\is gone!\Curse you... response:	That was the best hiding spot I could come up with.
context: The God Receives a Marriage Proposal\This bamboo-leaf rice cake is yummy!\I made plenty more.\I'll put the rest in the freezer.\The money I hid in the freezer for this month's electric bill...\is gone!\Curse you...\That was the best hiding spot I could come up with. response:	Dad
context: This bamboo-leaf rice cake is yummy!\I made plenty more.\I'll put the rest in the freezer.\The money I hid in the freezer for this month's electric bill...\is gone!\Curse you...\That was the best hiding spot I could come up with.\Dad response:	Lucky me!
context: I made plenty more.\I'll put the rest in the freezer.\The money I hid in the freezer for this month's electric bill...\is gone!\Curse you...\That was the best hiding spot I could come up with.\Dad\Lucky me! response:	Ooh! Lucky me!
context: I'll put the rest in the freezer.\The money I hid in the freezer for this month's electric bill...\is gone!\Curse you...\That was the best hiding spot I could come up with.\Dad\Lucky me!\Ooh! Lucky me! response:	Mom! Hang in there!
context: The money I hid in the freezer for this month's electric bill...\is gone!\Curse you...\That was the best hiding spot I could come up with.\Dad\Lucky me!\Ooh! Lucky me!\Mom! Hang in there! response:	I'm okay. I'm okay.
context: is gone!\Curse you...\That was the best hiding spot I could come up with.\Dad\Lucky me!\Ooh! Lucky me!\Mom! Hang in there!\I'm okay. I'm okay. response:	I'm sorry, Nanami.
context: Curse you...\That was the best hiding spot I could come up with.\Dad\Lucky me!\Ooh! Lucky me!\Mom! Hang in there!\I'm okay. I'm okay.\I'm sorry, Nanami. response:	Mommy won't be able to stay with you forever,
context: That was the best hiding spot I could come up with.\Dad\Lucky me!\Ooh! Lucky me!\Mom! Hang in there!\I'm okay. I'm okay.\I'm sorry, Nanami.\Mommy won't be able to stay with you forever, response:	so if Mommy ever goes away, you be strong all by yourself, okay?
context: Dad\Lucky me!\Ooh! Lucky me!\Mom! Hang in there!\I'm okay. I'm okay.\I'm sorry, Nanami.\Mommy won't be able to stay with you forever,\so if Mommy ever goes away, you be strong all by yourself, okay? response:	Locking up and taking care of the house... Everything.
context: Lucky me!\Ooh! Lucky me!\Mom! Hang in there!\I'm okay. I'm okay.\I'm sorry, Nanami.\Mommy won't be able to stay with you forever,\so if Mommy ever goes away, you be strong all by yourself, okay?\Locking up and taking care of the house... Everything. response:	All by myself? What about Dad?
context: Ooh! Lucky me!\Mom! Hang in there!\I'm okay. I'm okay.\I'm sorry, Nanami.\Mommy won't be able to stay with you forever,\so if Mommy ever goes away, you be strong all by yourself, okay?\Locking up and taking care of the house... Everything.\All by myself? What about Dad? response:	You mustn't count on your dad!
context: Mom! Hang in there!\I'm okay. I'm okay.\I'm sorry, Nanami.\Mommy won't be able to stay with you forever,\so if Mommy ever goes away, you be strong all by yourself, okay?\Locking up and taking care of the house... Everything.\All by myself? What about Dad?\You mustn't count on your dad! response:	And don't tell him where the money is hidden!
context: I'm okay. I'm okay.\I'm sorry, Nanami.\Mommy won't be able to stay with you forever,\so if Mommy ever goes away, you be strong all by yourself, okay?\Locking up and taking care of the house... Everything.\All by myself? What about Dad?\You mustn't count on your dad!\And don't tell him where the money is hidden! response:	Even if he begs and cries, you keep it to yourself, okay?
context: I'm sorry, Nanami.\Mommy won't be able to stay with you forever,\so if Mommy ever goes away, you be strong all by yourself, okay?\Locking up and taking care of the house... Everything.\All by myself? What about Dad?\You mustn't count on your dad!\And don't tell him where the money is hidden!\Even if he begs and cries, you keep it to yourself, okay? response:	Okay.
context: Mommy won't be able to stay with you forever,\so if Mommy ever goes away, you be strong all by yourself, okay?\Locking up and taking care of the house... Everything.\All by myself? What about Dad?\You mustn't count on your dad!\And don't tell him where the money is hidden!\Even if he begs and cries, you keep it to yourself, okay?\Okay. response:	It would've been nice if I could've given you a little brother or sister.
context: so if Mommy ever goes away, you be strong all by yourself, okay?\Locking up and taking care of the house... Everything.\All by myself? What about Dad?\You mustn't count on your dad!\And don't tell him where the money is hidden!\Even if he begs and cries, you keep it to yourself, okay?\Okay.\It would've been nice if I could've given you a little brother or sister. response:	Our family line has been entirely female, and for some reason, only one girl is born to each generation.
context: Locking up and taking care of the house... Everything.\All by myself? What about Dad?\You mustn't count on your dad!\And don't tell him where the money is hidden!\Even if he begs and cries, you keep it to yourself, okay?\Okay.\It would've been nice if I could've given you a little brother or sister.\Our family line has been entirely female, and for some reason, only one girl is born to each generation. response:	It was like that for your grandma, your great-grandma, and so on.
context: All by myself? What about Dad?\You mustn't count on your dad!\And don't tell him where the money is hidden!\Even if he begs and cries, you keep it to yourself, okay?\Okay.\It would've been nice if I could've given you a little brother or sister.\Our family line has been entirely female, and for some reason, only one girl is born to each generation.\It was like that for your grandma, your great-grandma, and so on. response:	Why? I wanted a big brother!
context: You mustn't count on your dad!\And don't tell him where the money is hidden!\Even if he begs and cries, you keep it to yourself, okay?\Okay.\It would've been nice if I could've given you a little brother or sister.\Our family line has been entirely female, and for some reason, only one girl is born to each generation.\It was like that for your grandma, your great-grandma, and so on.\Why? I wanted a big brother! response:	Boo!
context: And don't tell him where the money is hidden!\Even if he begs and cries, you keep it to yourself, okay?\Okay.\It would've been nice if I could've given you a little brother or sister.\Our family line has been entirely female, and for some reason, only one girl is born to each generation.\It was like that for your grandma, your great-grandma, and so on.\Why? I wanted a big brother!\Boo! response:	Boo!
context: Even if he begs and cries, you keep it to yourself, okay?\Okay.\It would've been nice if I could've given you a little brother or sister.\Our family line has been entirely female, and for some reason, only one girl is born to each generation.\It was like that for your grandma, your great-grandma, and so on.\Why? I wanted a big brother!\Boo!\Boo! response:	Boo!
context: Okay.\It would've been nice if I could've given you a little brother or sister.\Our family line has been entirely female, and for some reason, only one girl is born to each generation.\It was like that for your grandma, your great-grandma, and so on.\Why? I wanted a big brother!\Boo!\Boo!\Boo! response:	Boo!
context: It would've been nice if I could've given you a little brother or sister.\Our family line has been entirely female, and for some reason, only one girl is born to each generation.\It was like that for your grandma, your great-grandma, and so on.\Why? I wanted a big brother!\Boo!\Boo!\Boo!\Boo! response:	Boo!
context: Our family line has been entirely female, and for some reason, only one girl is born to each generation.\It was like that for your grandma, your great-grandma, and so on.\Why? I wanted a big brother!\Boo!\Boo!\Boo!\Boo!\Boo! response:	Boo!
context: It was like that for your grandma, your great-grandma, and so on.\Why? I wanted a big brother!\Boo!\Boo!\Boo!\Boo!\Boo!\Boo! response:	Boo!
context: Why? I wanted a big brother!\Boo!\Boo!\Boo!\Boo!\Boo!\Boo!\Boo! response:	Boo!
context: Boo!\Boo!\Boo!\Boo!\Boo!\Boo!\Boo!\Boo! response:	Boo!
context: Boo!\Boo!\Boo!\Boo!\Boo!\Boo!\Boo!\Boo! response:	Boo!
context: Boo!\Boo!\Boo!\Boo!\Boo!\Boo!\Boo!\Boo! response:	Boo!
context: Boo!\Boo!\Boo!\Boo!\Boo!\Boo!\Boo!\Boo! response:	Boo!
context: Boo!\Boo!\Boo!\Boo!\Boo!\Boo!\Boo!\Boo! response:	Boo!
context: Boo!\Boo!\Boo!\Boo!\Boo!\Boo!\Boo!\Boo! response:	Boo!
context: Boo!\Boo!\Boo!\Boo!\Boo!\Boo!\Boo!\Boo! response:	Boo!
context: Boo!\Boo!\Boo!\Boo!\Boo!\Boo!\Boo!\Boo! response:	Boo!
context: Boo!\Boo!\Boo!\Boo!\Boo!\Boo!\Boo!\Boo! response:	Boo!
context: Boo!\Boo!\Boo!\Boo!\Boo!\Boo!\Boo!\Boo! response:	Boo!
context: Boo!\Boo!\Boo!\Boo!\Boo!\Boo!\Boo!\Boo! response:	Really? But it's quite the romantic story, you know.
context: Boo!\Boo!\Boo!\Boo!\Boo!\Boo!\Boo!\Really? But it's quite the romantic story, you know. response:	They say that once upon a time,
context: Boo!\Boo!\Boo!\Boo!\Boo!\Boo!\Really? But it's quite the romantic story, you know.\They say that once upon a time, response:	our ancestor received a potion from the gods to become beautiful, and she drank it.
context: Boo!\Boo!\Boo!\Boo!\Boo!\Really? But it's quite the romantic story, you know.\They say that once upon a time,\our ancestor received a potion from the gods to become beautiful, and she drank it. response:	Ever since then, each generation of our family has been blessed with just one healthy, adorable girl.
context: Boo!\Boo!\Boo!\Boo!\Really? But it's quite the romantic story, you know.\They say that once upon a time,\our ancestor received a potion from the gods to become beautiful, and she drank it.\Ever since then, each generation of our family has been blessed with just one healthy, adorable girl. response:	That's why... Look.
context: Boo!\Boo!\Boo!\Really? But it's quite the romantic story, you know.\They say that once upon a time,\our ancestor received a potion from the gods to become beautiful, and she drank it.\Ever since then, each generation of our family has been blessed with just one healthy, adorable girl.\That's why... Look. response:	Look at how beautiful I got you to turn out.
context: Boo!\Boo!\Really? But it's quite the romantic story, you know.\They say that once upon a time,\our ancestor received a potion from the gods to become beautiful, and she drank it.\Ever since then, each generation of our family has been blessed with just one healthy, adorable girl.\That's why... Look.\Look at how beautiful I got you to turn out. response:	But unfortunately, every generation of our family...
context: Boo!\Really? But it's quite the romantic story, you know.\They say that once upon a time,\our ancestor received a potion from the gods to become beautiful, and she drank it.\Ever since then, each generation of our family has been blessed with just one healthy, adorable girl.\That's why... Look.\Look at how beautiful I got you to turn out.\But unfortunately, every generation of our family... response:	has bad luck with men for some reason!
context: Really? But it's quite the romantic story, you know.\They say that once upon a time,\our ancestor received a potion from the gods to become beautiful, and she drank it.\Ever since then, each generation of our family has been blessed with just one healthy, adorable girl.\That's why... Look.\Look at how beautiful I got you to turn out.\But unfortunately, every generation of our family...\has bad luck with men for some reason! response:	Our family has the worst trouble with men!
context: They say that once upon a time,\our ancestor received a potion from the gods to become beautiful, and she drank it.\Ever since then, each generation of our family has been blessed with just one healthy, adorable girl.\That's why... Look.\Look at how beautiful I got you to turn out.\But unfortunately, every generation of our family...\has bad luck with men for some reason!\Our family has the worst trouble with men! response:	So please listen to me, Nanami.
context: our ancestor received a potion from the gods to become beautiful, and she drank it.\Ever since then, each generation of our family has been blessed with just one healthy, adorable girl.\That's why... Look.\Look at how beautiful I got you to turn out.\But unfortunately, every generation of our family...\has bad luck with men for some reason!\Our family has the worst trouble with men!\So please listen to me, Nanami. response:	You mustn't count on men, okay?
context: Ever since then, each generation of our family has been blessed with just one healthy, adorable girl.\That's why... Look.\Look at how beautiful I got you to turn out.\But unfortunately, every generation of our family...\has bad luck with men for some reason!\Our family has the worst trouble with men!\So please listen to me, Nanami.\You mustn't count on men, okay? response:	That way, you won't ruin your health like Mommy did.
context: That's why... Look.\Look at how beautiful I got you to turn out.\But unfortunately, every generation of our family...\has bad luck with men for some reason!\Our family has the worst trouble with men!\So please listen to me, Nanami.\You mustn't count on men, okay?\That way, you won't ruin your health like Mommy did. response:	You can live big and live long, even if you have to stay single!
context: Look at how beautiful I got you to turn out.\But unfortunately, every generation of our family...\has bad luck with men for some reason!\Our family has the worst trouble with men!\So please listen to me, Nanami.\You mustn't count on men, okay?\That way, you won't ruin your health like Mommy did.\You can live big and live long, even if you have to stay single! response:	Okay!
context: But unfortunately, every generation of our family...\has bad luck with men for some reason!\Our family has the worst trouble with men!\So please listen to me, Nanami.\You mustn't count on men, okay?\That way, you won't ruin your health like Mommy did.\You can live big and live long, even if you have to stay single!\Okay! response:	I won't count on men!
context: has bad luck with men for some reason!\Our family has the worst trouble with men!\So please listen to me, Nanami.\You mustn't count on men, okay?\That way, you won't ruin your health like Mommy did.\You can live big and live long, even if you have to stay single!\Okay!\I won't count on men! response:	I'll stay single and get big!
context: Our family has the worst trouble with men!\So please listen to me, Nanami.\You mustn't count on men, okay?\That way, you won't ruin your health like Mommy did.\You can live big and live long, even if you have to stay single!\Okay!\I won't count on men!\I'll stay single and get big! response:	Good!
context: So please listen to me, Nanami.\You mustn't count on men, okay?\That way, you won't ruin your health like Mommy did.\You can live big and live long, even if you have to stay single!\Okay!\I won't count on men!\I'll stay single and get big!\Good! response:	I see.
context: You mustn't count on men, okay?\That way, you won't ruin your health like Mommy did.\You can live big and live long, even if you have to stay single!\Okay!\I won't count on men!\I'll stay single and get big!\Good!\I see. response:	So Nanami's nerves of steel come from her late mother.
context: That way, you won't ruin your health like Mommy did.\You can live big and live long, even if you have to stay single!\Okay!\I won't count on men!\I'll stay single and get big!\Good!\I see.\So Nanami's nerves of steel come from her late mother. response:	Interesting.
context: You can live big and live long, even if you have to stay single!\Okay!\I won't count on men!\I'll stay single and get big!\Good!\I see.\So Nanami's nerves of steel come from her late mother.\Interesting. response:	Human children all grow up by watching their parents.
context: Okay!\I won't count on men!\I'll stay single and get big!\Good!\I see.\So Nanami's nerves of steel come from her late mother.\Interesting.\Human children all grow up by watching their parents. response:	Nanami is no different. Her parents set the example of who she could become.
context: I won't count on men!\I'll stay single and get big!\Good!\I see.\So Nanami's nerves of steel come from her late mother.\Interesting.\Human children all grow up by watching their parents.\Nanami is no different. Her parents set the example of who she could become. response:	Why do you like look you've gotten settled in here, Tomoe?
context: I'll stay single and get big!\Good!\I see.\So Nanami's nerves of steel come from her late mother.\Interesting.\Human children all grow up by watching their parents.\Nanami is no different. Her parents set the example of who she could become.\Why do you like look you've gotten settled in here, Tomoe? response:	I can understand wanting to get your fill of the adorable Nanami, but this is the world of Nanami's memories.
context: Good!\I see.\So Nanami's nerves of steel come from her late mother.\Interesting.\Human children all grow up by watching their parents.\Nanami is no different. Her parents set the example of who she could become.\Why do you like look you've gotten settled in here, Tomoe?\I can understand wanting to get your fill of the adorable Nanami, but this is the world of Nanami's memories. response:	There's nothing we can do here.
context: I see.\So Nanami's nerves of steel come from her late mother.\Interesting.\Human children all grow up by watching their parents.\Nanami is no different. Her parents set the example of who she could become.\Why do you like look you've gotten settled in here, Tomoe?\I can understand wanting to get your fill of the adorable Nanami, but this is the world of Nanami's memories.\There's nothing we can do here. response:	Let's hurry up and lead her out of this nightmare.
context: So Nanami's nerves of steel come from her late mother.\Interesting.\Human children all grow up by watching their parents.\Nanami is no different. Her parents set the example of who she could become.\Why do you like look you've gotten settled in here, Tomoe?\I can understand wanting to get your fill of the adorable Nanami, but this is the world of Nanami's memories.\There's nothing we can do here.\Let's hurry up and lead her out of this nightmare. response:	Yes, you are right.
context: Interesting.\Human children all grow up by watching their parents.\Nanami is no different. Her parents set the example of who she could become.\Why do you like look you've gotten settled in here, Tomoe?\I can understand wanting to get your fill of the adorable Nanami, but this is the world of Nanami's memories.\There's nothing we can do here.\Let's hurry up and lead her out of this nightmare.\Yes, you are right. response:	But even so, just a little longer...
context: Human children all grow up by watching their parents.\Nanami is no different. Her parents set the example of who she could become.\Why do you like look you've gotten settled in here, Tomoe?\I can understand wanting to get your fill of the adorable Nanami, but this is the world of Nanami's memories.\There's nothing we can do here.\Let's hurry up and lead her out of this nightmare.\Yes, you are right.\But even so, just a little longer... response:	I want to see this side of her that I do not know.
context: Nanami is no different. Her parents set the example of who she could become.\Why do you like look you've gotten settled in here, Tomoe?\I can understand wanting to get your fill of the adorable Nanami, but this is the world of Nanami's memories.\There's nothing we can do here.\Let's hurry up and lead her out of this nightmare.\Yes, you are right.\But even so, just a little longer...\I want to see this side of her that I do not know. response:	A little longer...
context: Why do you like look you've gotten settled in here, Tomoe?\I can understand wanting to get your fill of the adorable Nanami, but this is the world of Nanami's memories.\There's nothing we can do here.\Let's hurry up and lead her out of this nightmare.\Yes, you are right.\But even so, just a little longer...\I want to see this side of her that I do not know.\A little longer... response:	A little longer...
context: I can understand wanting to get your fill of the adorable Nanami, but this is the world of Nanami's memories.\There's nothing we can do here.\Let's hurry up and lead her out of this nightmare.\Yes, you are right.\But even so, just a little longer...\I want to see this side of her that I do not know.\A little longer...\A little longer... response:	Hey, Emii, what did you ask Santa for this year?
context: There's nothing we can do here.\Let's hurry up and lead her out of this nightmare.\Yes, you are right.\But even so, just a little longer...\I want to see this side of her that I do not know.\A little longer...\A little longer...\Hey, Emii, what did you ask Santa for this year? response:	Last year, I got a new Barbar doll, so this year, I'm asking for a matching dream house.
context: Let's hurry up and lead her out of this nightmare.\Yes, you are right.\But even so, just a little longer...\I want to see this side of her that I do not know.\A little longer...\A little longer...\Hey, Emii, what did you ask Santa for this year?\Last year, I got a new Barbar doll, so this year, I'm asking for a matching dream house. response:	You're so lucky!
context: Yes, you are right.\But even so, just a little longer...\I want to see this side of her that I do not know.\A little longer...\A little longer...\Hey, Emii, what did you ask Santa for this year?\Last year, I got a new Barbar doll, so this year, I'm asking for a matching dream house.\You're so lucky! response:	I asked for a bicycle.
context: But even so, just a little longer...\I want to see this side of her that I do not know.\A little longer...\A little longer...\Hey, Emii, what did you ask Santa for this year?\Last year, I got a new Barbar doll, so this year, I'm asking for a matching dream house.\You're so lucky!\I asked for a bicycle. response:	What about you, Nanami?
context: I want to see this side of her that I do not know.\A little longer...\A little longer...\Hey, Emii, what did you ask Santa for this year?\Last year, I got a new Barbar doll, so this year, I'm asking for a matching dream house.\You're so lucky!\I asked for a bicycle.\What about you, Nanami? response:	I'll be okay.
context: A little longer...\A little longer...\Hey, Emii, what did you ask Santa for this year?\Last year, I got a new Barbar doll, so this year, I'm asking for a matching dream house.\You're so lucky!\I asked for a bicycle.\What about you, Nanami?\I'll be okay. response:	I lock all the doors every night at home,
context: A little longer...\Hey, Emii, what did you ask Santa for this year?\Last year, I got a new Barbar doll, so this year, I'm asking for a matching dream house.\You're so lucky!\I asked for a bicycle.\What about you, Nanami?\I'll be okay.\I lock all the doors every night at home, response:	so no strange man can just enter in the middle of the night.
context: Hey, Emii, what did you ask Santa for this year?\Last year, I got a new Barbar doll, so this year, I'm asking for a matching dream house.\You're so lucky!\I asked for a bicycle.\What about you, Nanami?\I'll be okay.\I lock all the doors every night at home,\so no strange man can just enter in the middle of the night. response:	You should all lock up before you go to sleep too.
context: Last year, I got a new Barbar doll, so this year, I'm asking for a matching dream house.\You're so lucky!\I asked for a bicycle.\What about you, Nanami?\I'll be okay.\I lock all the doors every night at home,\so no strange man can just enter in the middle of the night.\You should all lock up before you go to sleep too. response:	You're weird, Nanami!
context: You're so lucky!\I asked for a bicycle.\What about you, Nanami?\I'll be okay.\I lock all the doors every night at home,\so no strange man can just enter in the middle of the night.\You should all lock up before you go to sleep too.\You're weird, Nanami! response:	Santa comes in through the chimney!
context: I asked for a bicycle.\What about you, Nanami?\I'll be okay.\I lock all the doors every night at home,\so no strange man can just enter in the middle of the night.\You should all lock up before you go to sleep too.\You're weird, Nanami!\Santa comes in through the chimney! response:	He's not a strange man!
context: What about you, Nanami?\I'll be okay.\I lock all the doors every night at home,\so no strange man can just enter in the middle of the night.\You should all lock up before you go to sleep too.\You're weird, Nanami!\Santa comes in through the chimney!\He's not a strange man! response:	Nanami! I can't watch anymore!
context: I'll be okay.\I lock all the doors every night at home,\so no strange man can just enter in the middle of the night.\You should all lock up before you go to sleep too.\You're weird, Nanami!\Santa comes in through the chimney!\He's not a strange man!\Nanami! I can't watch anymore! response:	This is like some soap opera!
context: I lock all the doors every night at home,\so no strange man can just enter in the middle of the night.\You should all lock up before you go to sleep too.\You're weird, Nanami!\Santa comes in through the chimney!\He's not a strange man!\Nanami! I can't watch anymore!\This is like some soap opera! response:	Who is this Santa?
context: so no strange man can just enter in the middle of the night.\You should all lock up before you go to sleep too.\You're weird, Nanami!\Santa comes in through the chimney!\He's not a strange man!\Nanami! I can't watch anymore!\This is like some soap opera!\Who is this Santa? response:	Santa
context: You should all lock up before you go to sleep too.\You're weird, Nanami!\Santa comes in through the chimney!\He's not a strange man!\Nanami! I can't watch anymore!\This is like some soap opera!\Who is this Santa?\Santa response:	I can't leave this to you anymore!
context: You're weird, Nanami!\Santa comes in through the chimney!\He's not a strange man!\Nanami! I can't watch anymore!\This is like some soap opera!\Who is this Santa?\Santa\I can't leave this to you anymore! response:	I'm going!
context: Santa comes in through the chimney!\He's not a strange man!\Nanami! I can't watch anymore!\This is like some soap opera!\Who is this Santa?\Santa\I can't leave this to you anymore!\I'm going! response:	You can continue being lackadaisical if you want.
context: He's not a strange man!\Nanami! I can't watch anymore!\This is like some soap opera!\Who is this Santa?\Santa\I can't leave this to you anymore!\I'm going!\You can continue being lackadaisical if you want. response:	A powerless child with no guardian.
context: Nanami! I can't watch anymore!\This is like some soap opera!\Who is this Santa?\Santa\I can't leave this to you anymore!\I'm going!\You can continue being lackadaisical if you want.\A powerless child with no guardian. response:	No wonder she developed such spirit. It is how she survived.
context: This is like some soap opera!\Who is this Santa?\Santa\I can't leave this to you anymore!\I'm going!\You can continue being lackadaisical if you want.\A powerless child with no guardian.\No wonder she developed such spirit. It is how she survived. response:	Life would have been overwhelming otherwise.
context: Who is this Santa?\Santa\I can't leave this to you anymore!\I'm going!\You can continue being lackadaisical if you want.\A powerless child with no guardian.\No wonder she developed such spirit. It is how she survived.\Life would have been overwhelming otherwise. response:	Nanami?
context: Santa\I can't leave this to you anymore!\I'm going!\You can continue being lackadaisical if you want.\A powerless child with no guardian.\No wonder she developed such spirit. It is how she survived.\Life would have been overwhelming otherwise.\Nanami? response:	Nanami.
context: I can't leave this to you anymore!\I'm going!\You can continue being lackadaisical if you want.\A powerless child with no guardian.\No wonder she developed such spirit. It is how she survived.\Life would have been overwhelming otherwise.\Nanami?\Nanami. response:	Long time no see!
context: I'm going!\You can continue being lackadaisical if you want.\A powerless child with no guardian.\No wonder she developed such spirit. It is how she survived.\Life would have been overwhelming otherwise.\Nanami?\Nanami.\Long time no see! response:	Don't look at me like that!
context: You can continue being lackadaisical if you want.\A powerless child with no guardian.\No wonder she developed such spirit. It is how she survived.\Life would have been overwhelming otherwise.\Nanami?\Nanami.\Long time no see!\Don't look at me like that! response:	I'm here to help you!
context: A powerless child with no guardian.\No wonder she developed such spirit. It is how she survived.\Life would have been overwhelming otherwise.\Nanami?\Nanami.\Long time no see!\Don't look at me like that!\I'm here to help you! response:	It's me. Me!
context: No wonder she developed such spirit. It is how she survived.\Life would have been overwhelming otherwise.\Nanami?\Nanami.\Long time no see!\Don't look at me like that!\I'm here to help you!\It's me. Me! response:	Mizuki, your primary familiar!
context: Life would have been overwhelming otherwise.\Nanami?\Nanami.\Long time no see!\Don't look at me like that!\I'm here to help you!\It's me. Me!\Mizuki, your primary familiar! response:	But I guess there's no way you'd remember me.
context: Nanami?\Nanami.\Long time no see!\Don't look at me like that!\I'm here to help you!\It's me. Me!\Mizuki, your primary familiar!\But I guess there's no way you'd remember me. response:	I remember.
context: Nanami.\Long time no see!\Don't look at me like that!\I'm here to help you!\It's me. Me!\Mizuki, your primary familiar!\But I guess there's no way you'd remember me.\I remember. response:	What?
context: Long time no see!\Don't look at me like that!\I'm here to help you!\It's me. Me!\Mizuki, your primary familiar!\But I guess there's no way you'd remember me.\I remember.\What? response:	Stranger danger!
context: Don't look at me like that!\I'm here to help you!\It's me. Me!\Mizuki, your primary familiar!\But I guess there's no way you'd remember me.\I remember.\What?\Stranger danger! response:	I should've known.
context: I'm here to help you!\It's me. Me!\Mizuki, your primary familiar!\But I guess there's no way you'd remember me.\I remember.\What?\Stranger danger!\I should've known. response:	You've got it all wrong. I'm...
context: It's me. Me!\Mizuki, your primary familiar!\But I guess there's no way you'd remember me.\I remember.\What?\Stranger danger!\I should've known.\You've got it all wrong. I'm... response:	Oh, Tomoe!
context: Mizuki, your primary familiar!\But I guess there's no way you'd remember me.\I remember.\What?\Stranger danger!\I should've known.\You've got it all wrong. I'm...\Oh, Tomoe! response:	Quickly. Come with me.
context: But I guess there's no way you'd remember me.\I remember.\What?\Stranger danger!\I should've known.\You've got it all wrong. I'm...\Oh, Tomoe!\Quickly. Come with me. response:	We have to run.
context: I remember.\What?\Stranger danger!\I should've known.\You've got it all wrong. I'm...\Oh, Tomoe!\Quickly. Come with me.\We have to run. response:	Hm?
context: What?\Stranger danger!\I should've known.\You've got it all wrong. I'm...\Oh, Tomoe!\Quickly. Come with me.\We have to run.\Hm? response:	The stranger is closing in.
context: Stranger danger!\I should've known.\You've got it all wrong. I'm...\Oh, Tomoe!\Quickly. Come with me.\We have to run.\Hm?\The stranger is closing in. response:	Okay!
context: I should've known.\You've got it all wrong. I'm...\Oh, Tomoe!\Quickly. Come with me.\We have to run.\Hm?\The stranger is closing in.\Okay! response:	Hey!
context: You've got it all wrong. I'm...\Oh, Tomoe!\Quickly. Come with me.\We have to run.\Hm?\The stranger is closing in.\Okay!\Hey! response:	Serves you right, you lousy snake!
context: Oh, Tomoe!\Quickly. Come with me.\We have to run.\Hm?\The stranger is closing in.\Okay!\Hey!\Serves you right, you lousy snake! response:	Tomoe...
context: Quickly. Come with me.\We have to run.\Hm?\The stranger is closing in.\Okay!\Hey!\Serves you right, you lousy snake!\Tomoe... response:	When we get home, you are so dead!
context: We have to run.\Hm?\The stranger is closing in.\Okay!\Hey!\Serves you right, you lousy snake!\Tomoe...\When we get home, you are so dead! response:	I swear...
context: Hm?\The stranger is closing in.\Okay!\Hey!\Serves you right, you lousy snake!\Tomoe...\When we get home, you are so dead!\I swear... response:	Your ears!
context: The stranger is closing in.\Okay!\Hey!\Serves you right, you lousy snake!\Tomoe...\When we get home, you are so dead!\I swear...\Your ears! response:	They're so funny!
context: Okay!\Hey!\Serves you right, you lousy snake!\Tomoe...\When we get home, you are so dead!\I swear...\Your ears!\They're so funny! response:	Kinda like a cat's!
context: Hey!\Serves you right, you lousy snake!\Tomoe...\When we get home, you are so dead!\I swear...\Your ears!\They're so funny!\Kinda like a cat's! response:	Can you hear a lot?
context: Serves you right, you lousy snake!\Tomoe...\When we get home, you are so dead!\I swear...\Your ears!\They're so funny!\Kinda like a cat's!\Can you hear a lot? response:	Hey! Hey! Hey! Lemme touch your ears!
context: Tomoe...\When we get home, you are so dead!\I swear...\Your ears!\They're so funny!\Kinda like a cat's!\Can you hear a lot?\Hey! Hey! Hey! Lemme touch your ears! response:	Why did I get caught up in this mess?
context: When we get home, you are so dead!\I swear...\Your ears!\They're so funny!\Kinda like a cat's!\Can you hear a lot?\Hey! Hey! Hey! Lemme touch your ears!\Why did I get caught up in this mess? response:	Come on! I wanna touch your ears! I wanna touch your ears!
context: I swear...\Your ears!\They're so funny!\Kinda like a cat's!\Can you hear a lot?\Hey! Hey! Hey! Lemme touch your ears!\Why did I get caught up in this mess?\Come on! I wanna touch your ears! I wanna touch your ears! response:	Well, I suppose we should head for the exit.
context: Your ears!\They're so funny!\Kinda like a cat's!\Can you hear a lot?\Hey! Hey! Hey! Lemme touch your ears!\Why did I get caught up in this mess?\Come on! I wanna touch your ears! I wanna touch your ears!\Well, I suppose we should head for the exit. response:	The scenery is rather odd.
context: They're so funny!\Kinda like a cat's!\Can you hear a lot?\Hey! Hey! Hey! Lemme touch your ears!\Why did I get caught up in this mess?\Come on! I wanna touch your ears! I wanna touch your ears!\Well, I suppose we should head for the exit.\The scenery is rather odd. response:	I thought it was blurry,
context: Kinda like a cat's!\Can you hear a lot?\Hey! Hey! Hey! Lemme touch your ears!\Why did I get caught up in this mess?\Come on! I wanna touch your ears! I wanna touch your ears!\Well, I suppose we should head for the exit.\The scenery is rather odd.\I thought it was blurry, response:	but some parts are exceedingly detailed.
context: Can you hear a lot?\Hey! Hey! Hey! Lemme touch your ears!\Why did I get caught up in this mess?\Come on! I wanna touch your ears! I wanna touch your ears!\Well, I suppose we should head for the exit.\The scenery is rather odd.\I thought it was blurry,\but some parts are exceedingly detailed. response:	I see.
context: Hey! Hey! Hey! Lemme touch your ears!\Why did I get caught up in this mess?\Come on! I wanna touch your ears! I wanna touch your ears!\Well, I suppose we should head for the exit.\The scenery is rather odd.\I thought it was blurry,\but some parts are exceedingly detailed.\I see. response:	This is the world of her memories.
context: Why did I get caught up in this mess?\Come on! I wanna touch your ears! I wanna touch your ears!\Well, I suppose we should head for the exit.\The scenery is rather odd.\I thought it was blurry,\but some parts are exceedingly detailed.\I see.\This is the world of her memories. response:	The more she paid attention to something, the more clearly it is reflected here.
context: Come on! I wanna touch your ears! I wanna touch your ears!\Well, I suppose we should head for the exit.\The scenery is rather odd.\I thought it was blurry,\but some parts are exceedingly detailed.\I see.\This is the world of her memories.\The more she paid attention to something, the more clearly it is reflected here. response:	You want ice cream, do you not?
context: Well, I suppose we should head for the exit.\The scenery is rather odd.\I thought it was blurry,\but some parts are exceedingly detailed.\I see.\This is the world of her memories.\The more she paid attention to something, the more clearly it is reflected here.\You want ice cream, do you not? response:	Eep
context: The scenery is rather odd.\I thought it was blurry,\but some parts are exceedingly detailed.\I see.\This is the world of her memories.\The more she paid attention to something, the more clearly it is reflected here.\You want ice cream, do you not?\Eep response:	Eep
context: I thought it was blurry,\but some parts are exceedingly detailed.\I see.\This is the world of her memories.\The more she paid attention to something, the more clearly it is reflected here.\You want ice cream, do you not?\Eep\Eep response:	D-Do not!
context: but some parts are exceedingly detailed.\I see.\This is the world of her memories.\The more she paid attention to something, the more clearly it is reflected here.\You want ice cream, do you not?\Eep\Eep\D-Do not! response:	Here.
context: I see.\This is the world of her memories.\The more she paid attention to something, the more clearly it is reflected here.\You want ice cream, do you not?\Eep\Eep\D-Do not!\Here. response:	Wow!
context: This is the world of her memories.\The more she paid attention to something, the more clearly it is reflected here.\You want ice cream, do you not?\Eep\Eep\D-Do not!\Here.\Wow! response:	Thank you, mister!
context: The more she paid attention to something, the more clearly it is reflected here.\You want ice cream, do you not?\Eep\Eep\D-Do not!\Here.\Wow!\Thank you, mister! response:	Mister?
context: You want ice cream, do you not?\Eep\Eep\D-Do not!\Here.\Wow!\Thank you, mister!\Mister? response:	If there is anything else you desire, let me know.
context: Eep\Eep\D-Do not!\Here.\Wow!\Thank you, mister!\Mister?\If there is anything else you desire, let me know. response:	I am happy to fetch it for you.
context: Eep\D-Do not!\Here.\Wow!\Thank you, mister!\Mister?\If there is anything else you desire, let me know.\I am happy to fetch it for you. response:	In this world, the things that you long for are as plain as day.
context: D-Do not!\Here.\Wow!\Thank you, mister!\Mister?\If there is anything else you desire, let me know.\I am happy to fetch it for you.\In this world, the things that you long for are as plain as day. response:	For me, satisfying those needs is a simple matter.
context: Here.\Wow!\Thank you, mister!\Mister?\If there is anything else you desire, let me know.\I am happy to fetch it for you.\In this world, the things that you long for are as plain as day.\For me, satisfying those needs is a simple matter. response:	Wow! I can eat this?
context: Wow!\Thank you, mister!\Mister?\If there is anything else you desire, let me know.\I am happy to fetch it for you.\In this world, the things that you long for are as plain as day.\For me, satisfying those needs is a simple matter.\Wow! I can eat this? response:	Yes.
context: Thank you, mister!\Mister?\If there is anything else you desire, let me know.\I am happy to fetch it for you.\In this world, the things that you long for are as plain as day.\For me, satisfying those needs is a simple matter.\Wow! I can eat this?\Yes. response:	Really?
context: Mister?\If there is anything else you desire, let me know.\I am happy to fetch it for you.\In this world, the things that you long for are as plain as day.\For me, satisfying those needs is a simple matter.\Wow! I can eat this?\Yes.\Really? response:	So smile.
context: If there is anything else you desire, let me know.\I am happy to fetch it for you.\In this world, the things that you long for are as plain as day.\For me, satisfying those needs is a simple matter.\Wow! I can eat this?\Yes.\Really?\So smile. response:	Like you always do.
context: I am happy to fetch it for you.\In this world, the things that you long for are as plain as day.\For me, satisfying those needs is a simple matter.\Wow! I can eat this?\Yes.\Really?\So smile.\Like you always do. response:	I will...
context: In this world, the things that you long for are as plain as day.\For me, satisfying those needs is a simple matter.\Wow! I can eat this?\Yes.\Really?\So smile.\Like you always do.\I will... response:	stay by your side.
context: For me, satisfying those needs is a simple matter.\Wow! I can eat this?\Yes.\Really?\So smile.\Like you always do.\I will...\stay by your side. response:	There is no need to be sad.
context: Wow! I can eat this?\Yes.\Really?\So smile.\Like you always do.\I will...\stay by your side.\There is no need to be sad. response:	I guess the sun's going down now.
context: Yes.\Really?\So smile.\Like you always do.\I will...\stay by your side.\There is no need to be sad.\I guess the sun's going down now. response:	The sunset is massive.
context: Really?\So smile.\Like you always do.\I will...\stay by your side.\There is no need to be sad.\I guess the sun's going down now.\The sunset is massive. response:	Once the sun sets, everyone will go home.
context: So smile.\Like you always do.\I will...\stay by your side.\There is no need to be sad.\I guess the sun's going down now.\The sunset is massive.\Once the sun sets, everyone will go home. response:	I don't wanna go home.
context: Like you always do.\I will...\stay by your side.\There is no need to be sad.\I guess the sun's going down now.\The sunset is massive.\Once the sun sets, everyone will go home.\I don't wanna go home. response:	Back there, no one is waiting for me.
context: I will...\stay by your side.\There is no need to be sad.\I guess the sun's going down now.\The sunset is massive.\Once the sun sets, everyone will go home.\I don't wanna go home.\Back there, no one is waiting for me. response:	There's only me.
context: stay by your side.\There is no need to be sad.\I guess the sun's going down now.\The sunset is massive.\Once the sun sets, everyone will go home.\I don't wanna go home.\Back there, no one is waiting for me.\There's only me. response:	I see.
context: There is no need to be sad.\I guess the sun's going down now.\The sunset is massive.\Once the sun sets, everyone will go home.\I don't wanna go home.\Back there, no one is waiting for me.\There's only me.\I see. response:	What you want is...
context: I guess the sun's going down now.\The sunset is massive.\Once the sun sets, everyone will go home.\I don't wanna go home.\Back there, no one is waiting for me.\There's only me.\I see.\What you want is... response:	Only for the time being.
context: The sunset is massive.\Once the sun sets, everyone will go home.\I don't wanna go home.\Back there, no one is waiting for me.\There's only me.\I see.\What you want is...\Only for the time being. response:	In a few years, when you are older, you will become the head of a household more rowdy than you can imagine.
context: Once the sun sets, everyone will go home.\I don't wanna go home.\Back there, no one is waiting for me.\There's only me.\I see.\What you want is...\Only for the time being.\In a few years, when you are older, you will become the head of a household more rowdy than you can imagine. response:	Are you telling me that I'm gonna get married when I get bigger?
context: I don't wanna go home.\Back there, no one is waiting for me.\There's only me.\I see.\What you want is...\Only for the time being.\In a few years, when you are older, you will become the head of a household more rowdy than you can imagine.\Are you telling me that I'm gonna get married when I get bigger? response:	And that I'm gonna make a new family to replace my old one?
context: Back there, no one is waiting for me.\There's only me.\I see.\What you want is...\Only for the time being.\In a few years, when you are older, you will become the head of a household more rowdy than you can imagine.\Are you telling me that I'm gonna get married when I get bigger?\And that I'm gonna make a new family to replace my old one? response:	Oh, well, no...
context: There's only me.\I see.\What you want is...\Only for the time being.\In a few years, when you are older, you will become the head of a household more rowdy than you can imagine.\Are you telling me that I'm gonna get married when I get bigger?\And that I'm gonna make a new family to replace my old one?\Oh, well, no... response:	That's good'cause I'm not getting married!
context: I see.\What you want is...\Only for the time being.\In a few years, when you are older, you will become the head of a household more rowdy than you can imagine.\Are you telling me that I'm gonna get married when I get bigger?\And that I'm gonna make a new family to replace my old one?\Oh, well, no...\That's good'cause I'm not getting married! response:	And why is that?
context: What you want is...\Only for the time being.\In a few years, when you are older, you will become the head of a household more rowdy than you can imagine.\Are you telling me that I'm gonna get married when I get bigger?\And that I'm gonna make a new family to replace my old one?\Oh, well, no...\That's good'cause I'm not getting married!\And why is that? response:	Because my family has really bad luck with deadbeat men!
context: Only for the time being.\In a few years, when you are older, you will become the head of a household more rowdy than you can imagine.\Are you telling me that I'm gonna get married when I get bigger?\And that I'm gonna make a new family to replace my old one?\Oh, well, no...\That's good'cause I'm not getting married!\And why is that?\Because my family has really bad luck with deadbeat men! response:	I can't count on a husband!
context: In a few years, when you are older, you will become the head of a household more rowdy than you can imagine.\Are you telling me that I'm gonna get married when I get bigger?\And that I'm gonna make a new family to replace my old one?\Oh, well, no...\That's good'cause I'm not getting married!\And why is that?\Because my family has really bad luck with deadbeat men!\I can't count on a husband! response:	I'm gonna stay healthy and single!
context: Are you telling me that I'm gonna get married when I get bigger?\And that I'm gonna make a new family to replace my old one?\Oh, well, no...\That's good'cause I'm not getting married!\And why is that?\Because my family has really bad luck with deadbeat men!\I can't count on a husband!\I'm gonna stay healthy and single! response:	It is not that you have bad luck.
context: And that I'm gonna make a new family to replace my old one?\Oh, well, no...\That's good'cause I'm not getting married!\And why is that?\Because my family has really bad luck with deadbeat men!\I can't count on a husband!\I'm gonna stay healthy and single!\It is not that you have bad luck. response:	You are a poor judge of character.
context: Oh, well, no...\That's good'cause I'm not getting married!\And why is that?\Because my family has really bad luck with deadbeat men!\I can't count on a husband!\I'm gonna stay healthy and single!\It is not that you have bad luck.\You are a poor judge of character. response:	For example, I would be able to make you happy.
context: That's good'cause I'm not getting married!\And why is that?\Because my family has really bad luck with deadbeat men!\I can't count on a husband!\I'm gonna stay healthy and single!\It is not that you have bad luck.\You are a poor judge of character.\For example, I would be able to make you happy. response:	Your wish is my command.
context: And why is that?\Because my family has really bad luck with deadbeat men!\I can't count on a husband!\I'm gonna stay healthy and single!\It is not that you have bad luck.\You are a poor judge of character.\For example, I would be able to make you happy.\Your wish is my command. response:	There is surely no man more reliable than I.
context: Because my family has really bad luck with deadbeat men!\I can't count on a husband!\I'm gonna stay healthy and single!\It is not that you have bad luck.\You are a poor judge of character.\For example, I would be able to make you happy.\Your wish is my command.\There is surely no man more reliable than I. response:	You can't use yummy foods to trick me into a loveless marriage!
context: I can't count on a husband!\I'm gonna stay healthy and single!\It is not that you have bad luck.\You are a poor judge of character.\For example, I would be able to make you happy.\Your wish is my command.\There is surely no man more reliable than I.\You can't use yummy foods to trick me into a loveless marriage! response:	So do you really love me?! I need to know!
context: I'm gonna stay healthy and single!\It is not that you have bad luck.\You are a poor judge of character.\For example, I would be able to make you happy.\Your wish is my command.\There is surely no man more reliable than I.\You can't use yummy foods to trick me into a loveless marriage!\So do you really love me?! I need to know! response:	When asked in such a direct and adorable way...
context: It is not that you have bad luck.\You are a poor judge of character.\For example, I would be able to make you happy.\Your wish is my command.\There is surely no man more reliable than I.\You can't use yummy foods to trick me into a loveless marriage!\So do you really love me?! I need to know!\When asked in such a direct and adorable way... response:	Yes.
context: You are a poor judge of character.\For example, I would be able to make you happy.\Your wish is my command.\There is surely no man more reliable than I.\You can't use yummy foods to trick me into a loveless marriage!\So do you really love me?! I need to know!\When asked in such a direct and adorable way...\Yes. response:	I do love you.
context: For example, I would be able to make you happy.\Your wish is my command.\There is surely no man more reliable than I.\You can't use yummy foods to trick me into a loveless marriage!\So do you really love me?! I need to know!\When asked in such a direct and adorable way...\Yes.\I do love you. response:	Well, will you marry me, Nanami?
context: Your wish is my command.\There is surely no man more reliable than I.\You can't use yummy foods to trick me into a loveless marriage!\So do you really love me?! I need to know!\When asked in such a direct and adorable way...\Yes.\I do love you.\Well, will you marry me, Nanami? response:	Know this...
context: There is surely no man more reliable than I.\You can't use yummy foods to trick me into a loveless marriage!\So do you really love me?! I need to know!\When asked in such a direct and adorable way...\Yes.\I do love you.\Well, will you marry me, Nanami?\Know this... response:	I will ensure you always have that carefree smile on your face.
context: You can't use yummy foods to trick me into a loveless marriage!\So do you really love me?! I need to know!\When asked in such a direct and adorable way...\Yes.\I do love you.\Well, will you marry me, Nanami?\Know this...\I will ensure you always have that carefree smile on your face. response:	Okay!
context: So do you really love me?! I need to know!\When asked in such a direct and adorable way...\Yes.\I do love you.\Well, will you marry me, Nanami?\Know this...\I will ensure you always have that carefree smile on your face.\Okay! response:	I will always stay by your side.
context: When asked in such a direct and adorable way...\Yes.\I do love you.\Well, will you marry me, Nanami?\Know this...\I will ensure you always have that carefree smile on your face.\Okay!\I will always stay by your side. response:	Next part coming
context: Yes.\I do love you.\Well, will you marry me, Nanami?\Know this...\I will ensure you always have that carefree smile on your face.\Okay!\I will always stay by your side.\Next part coming response:	right up
context: I do love you.\Well, will you marry me, Nanami?\Know this...\I will ensure you always have that carefree smile on your face.\Okay!\I will always stay by your side.\Next part coming\right up response:	right up
context: Well, will you marry me, Nanami?\Know this...\I will ensure you always have that carefree smile on your face.\Okay!\I will always stay by your side.\Next part coming\right up\right up response:	right up
context: Know this...\I will ensure you always have that carefree smile on your face.\Okay!\I will always stay by your side.\Next part coming\right up\right up\right up response:	right up
context: I will ensure you always have that carefree smile on your face.\Okay!\I will always stay by your side.\Next part coming\right up\right up\right up\right up response:	right up
context: Okay!\I will always stay by your side.\Next part coming\right up\right up\right up\right up\right up response:	Next part starting
context: I will always stay by your side.\Next part coming\right up\right up\right up\right up\right up\Next part starting response:	Next part starting
context: Next part coming\right up\right up\right up\right up\right up\Next part starting\Next part starting response:	Next part starting
context: right up\right up\right up\right up\right up\Next part starting\Next part starting\Next part starting response:	Next part starting
context: right up\right up\right up\right up\Next part starting\Next part starting\Next part starting\Next part starting response:	Next part starting
context: right up\right up\right up\Next part starting\Next part starting\Next part starting\Next part starting\Next part starting response:	Oh, what in the world am I saying?!
context: right up\right up\Next part starting\Next part starting\Next part starting\Next part starting\Next part starting\Oh, what in the world am I saying?! response:	Why did I get caught up in the moment and propose to her?!
context: right up\Next part starting\Next part starting\Next part starting\Next part starting\Next part starting\Oh, what in the world am I saying?!\Why did I get caught up in the moment and propose to her?! response:	How am I going to explain this later?!
context: Next part starting\Next part starting\Next part starting\Next part starting\Next part starting\Oh, what in the world am I saying?!\Why did I get caught up in the moment and propose to her?!\How am I going to explain this later?! response:	Knowing her...
context: Next part starting\Next part starting\Next part starting\Next part starting\Oh, what in the world am I saying?!\Why did I get caught up in the moment and propose to her?!\How am I going to explain this later?!\Knowing her... response:	Tomoe, you asked me to marry you, right?
context: Next part starting\Next part starting\Next part starting\Oh, what in the world am I saying?!\Why did I get caught up in the moment and propose to her?!\How am I going to explain this later?!\Knowing her...\Tomoe, you asked me to marry you, right? response:	She is bound to press the issue!
context: Next part starting\Next part starting\Oh, what in the world am I saying?!\Why did I get caught up in the moment and propose to her?!\How am I going to explain this later?!\Knowing her...\Tomoe, you asked me to marry you, right?\She is bound to press the issue! response:	How can I possibly get out of this mess?
context: Next part starting\Oh, what in the world am I saying?!\Why did I get caught up in the moment and propose to her?!\How am I going to explain this later?!\Knowing her...\Tomoe, you asked me to marry you, right?\She is bound to press the issue!\How can I possibly get out of this mess? response:	What's wrong, Tomoe?
context: Oh, what in the world am I saying?!\Why did I get caught up in the moment and propose to her?!\How am I going to explain this later?!\Knowing her...\Tomoe, you asked me to marry you, right?\She is bound to press the issue!\How can I possibly get out of this mess?\What's wrong, Tomoe? response:	You seem awfully fidgety.
context: Why did I get caught up in the moment and propose to her?!\How am I going to explain this later?!\Knowing her...\Tomoe, you asked me to marry you, right?\She is bound to press the issue!\How can I possibly get out of this mess?\What's wrong, Tomoe?\You seem awfully fidgety. response:	Don't you worry about a thing. I can keep a secret.
context: How am I going to explain this later?!\Knowing her...\Tomoe, you asked me to marry you, right?\She is bound to press the issue!\How can I possibly get out of this mess?\What's wrong, Tomoe?\You seem awfully fidgety.\Don't you worry about a thing. I can keep a secret. response:	Nanami will never know what you did to her as a child.
context: Knowing her...\Tomoe, you asked me to marry you, right?\She is bound to press the issue!\How can I possibly get out of this mess?\What's wrong, Tomoe?\You seem awfully fidgety.\Don't you worry about a thing. I can keep a secret.\Nanami will never know what you did to her as a child. response:	Wait. Seriously?
context: Tomoe, you asked me to marry you, right?\She is bound to press the issue!\How can I possibly get out of this mess?\What's wrong, Tomoe?\You seem awfully fidgety.\Don't you worry about a thing. I can keep a secret.\Nanami will never know what you did to her as a child.\Wait. Seriously? response:	So you did do something?
context: She is bound to press the issue!\How can I possibly get out of this mess?\What's wrong, Tomoe?\You seem awfully fidgety.\Don't you worry about a thing. I can keep a secret.\Nanami will never know what you did to her as a child.\Wait. Seriously?\So you did do something? response:	Stop that!
context: How can I possibly get out of this mess?\What's wrong, Tomoe?\You seem awfully fidgety.\Don't you worry about a thing. I can keep a secret.\Nanami will never know what you did to her as a child.\Wait. Seriously?\So you did do something?\Stop that! response:	Honestly! Why do you guys fight every time I turn my back on you?
context: What's wrong, Tomoe?\You seem awfully fidgety.\Don't you worry about a thing. I can keep a secret.\Nanami will never know what you did to her as a child.\Wait. Seriously?\So you did do something?\Stop that!\Honestly! Why do you guys fight every time I turn my back on you? response:	Where are we? What about the Torii Gates of Twelve?
context: You seem awfully fidgety.\Don't you worry about a thing. I can keep a secret.\Nanami will never know what you did to her as a child.\Wait. Seriously?\So you did do something?\Stop that!\Honestly! Why do you guys fight every time I turn my back on you?\Where are we? What about the Torii Gates of Twelve? response:	We passed through them already.
context: Don't you worry about a thing. I can keep a secret.\Nanami will never know what you did to her as a child.\Wait. Seriously?\So you did do something?\Stop that!\Honestly! Why do you guys fight every time I turn my back on you?\Where are we? What about the Torii Gates of Twelve?\We passed through them already. response:	Huh? When did we go through?
context: Nanami will never know what you did to her as a child.\Wait. Seriously?\So you did do something?\Stop that!\Honestly! Why do you guys fight every time I turn my back on you?\Where are we? What about the Torii Gates of Twelve?\We passed through them already.\Huh? When did we go through? response:	I can't believe I missed that. I must've fallen asleep.
context: Wait. Seriously?\So you did do something?\Stop that!\Honestly! Why do you guys fight every time I turn my back on you?\Where are we? What about the Torii Gates of Twelve?\We passed through them already.\Huh? When did we go through?\I can't believe I missed that. I must've fallen asleep. response:	It does feel like I woke up from a really long dream.
context: So you did do something?\Stop that!\Honestly! Why do you guys fight every time I turn my back on you?\Where are we? What about the Torii Gates of Twelve?\We passed through them already.\Huh? When did we go through?\I can't believe I missed that. I must've fallen asleep.\It does feel like I woke up from a really long dream. response:	Really? What kind of dream?
context: Stop that!\Honestly! Why do you guys fight every time I turn my back on you?\Where are we? What about the Torii Gates of Twelve?\We passed through them already.\Huh? When did we go through?\I can't believe I missed that. I must've fallen asleep.\It does feel like I woke up from a really long dream.\Really? What kind of dream? response:	It would appear I was worried for nothing.
context: Honestly! Why do you guys fight every time I turn my back on you?\Where are we? What about the Torii Gates of Twelve?\We passed through them already.\Huh? When did we go through?\I can't believe I missed that. I must've fallen asleep.\It does feel like I woke up from a really long dream.\Really? What kind of dream?\It would appear I was worried for nothing. response:	Even if she did remember what happened,
context: Where are we? What about the Torii Gates of Twelve?\We passed through them already.\Huh? When did we go through?\I can't believe I missed that. I must've fallen asleep.\It does feel like I woke up from a really long dream.\Really? What kind of dream?\It would appear I was worried for nothing.\Even if she did remember what happened, response:	she would believe the proposal was merely a fantasy.
context: We passed through them already.\Huh? When did we go through?\I can't believe I missed that. I must've fallen asleep.\It does feel like I woke up from a really long dream.\Really? What kind of dream?\It would appear I was worried for nothing.\Even if she did remember what happened,\she would believe the proposal was merely a fantasy. response:	Nothing more.
context: Huh? When did we go through?\I can't believe I missed that. I must've fallen asleep.\It does feel like I woke up from a really long dream.\Really? What kind of dream?\It would appear I was worried for nothing.\Even if she did remember what happened,\she would believe the proposal was merely a fantasy.\Nothing more. response:	I don't know.
context: I can't believe I missed that. I must've fallen asleep.\It does feel like I woke up from a really long dream.\Really? What kind of dream?\It would appear I was worried for nothing.\Even if she did remember what happened,\she would believe the proposal was merely a fantasy.\Nothing more.\I don't know. response:	I can't remember anything, so it must not have been that important.
context: It does feel like I woke up from a really long dream.\Really? What kind of dream?\It would appear I was worried for nothing.\Even if she did remember what happened,\she would believe the proposal was merely a fantasy.\Nothing more.\I don't know.\I can't remember anything, so it must not have been that important. response:	Really? Are you sure?
context: Really? What kind of dream?\It would appear I was worried for nothing.\Even if she did remember what happened,\she would believe the proposal was merely a fantasy.\Nothing more.\I don't know.\I can't remember anything, so it must not have been that important.\Really? Are you sure? response:	Nothing about a sweet, handsome stranger?
context: It would appear I was worried for nothing.\Even if she did remember what happened,\she would believe the proposal was merely a fantasy.\Nothing more.\I don't know.\I can't remember anything, so it must not have been that important.\Really? Are you sure?\Nothing about a sweet, handsome stranger? response:	Did you just say a stranger?
context: Even if she did remember what happened,\she would believe the proposal was merely a fantasy.\Nothing more.\I don't know.\I can't remember anything, so it must not have been that important.\Really? Are you sure?\Nothing about a sweet, handsome stranger?\Did you just say a stranger? response:	Doesn't ring any bells.
context: she would believe the proposal was merely a fantasy.\Nothing more.\I don't know.\I can't remember anything, so it must not have been that important.\Really? Are you sure?\Nothing about a sweet, handsome stranger?\Did you just say a stranger?\Doesn't ring any bells. response:	She...
context: Nothing more.\I don't know.\I can't remember anything, so it must not have been that important.\Really? Are you sure?\Nothing about a sweet, handsome stranger?\Did you just say a stranger?\Doesn't ring any bells.\She... response:	She really does not remember?!
context: I don't know.\I can't remember anything, so it must not have been that important.\Really? Are you sure?\Nothing about a sweet, handsome stranger?\Did you just say a stranger?\Doesn't ring any bells.\She...\She really does not remember?! response:	Come on! Let's hurry to the Year God's shrine, grab the new talisman, and go home!
context: I can't remember anything, so it must not have been that important.\Really? Are you sure?\Nothing about a sweet, handsome stranger?\Did you just say a stranger?\Doesn't ring any bells.\She...\She really does not remember?!\Come on! Let's hurry to the Year God's shrine, grab the new talisman, and go home! response:	If we don't hurry, the sun's gonna set!
context: Really? Are you sure?\Nothing about a sweet, handsome stranger?\Did you just say a stranger?\Doesn't ring any bells.\She...\She really does not remember?!\Come on! Let's hurry to the Year God's shrine, grab the new talisman, and go home!\If we don't hurry, the sun's gonna set! response:	The entrance should be around here somewhere.
context: Nothing about a sweet, handsome stranger?\Did you just say a stranger?\Doesn't ring any bells.\She...\She really does not remember?!\Come on! Let's hurry to the Year God's shrine, grab the new talisman, and go home!\If we don't hurry, the sun's gonna set!\The entrance should be around here somewhere. response:	I wonder what next year's Lord Year God is like.
context: Did you just say a stranger?\Doesn't ring any bells.\She...\She really does not remember?!\Come on! Let's hurry to the Year God's shrine, grab the new talisman, and go home!\If we don't hurry, the sun's gonna set!\The entrance should be around here somewhere.\I wonder what next year's Lord Year God is like. response:	What do you think, Tomoe?
context: Doesn't ring any bells.\She...\She really does not remember?!\Come on! Let's hurry to the Year God's shrine, grab the new talisman, and go home!\If we don't hurry, the sun's gonna set!\The entrance should be around here somewhere.\I wonder what next year's Lord Year God is like.\What do you think, Tomoe? response:	Tomoe?
context: She...\She really does not remember?!\Come on! Let's hurry to the Year God's shrine, grab the new talisman, and go home!\If we don't hurry, the sun's gonna set!\The entrance should be around here somewhere.\I wonder what next year's Lord Year God is like.\What do you think, Tomoe?\Tomoe? response:	Is it true? Does she really not recall?
context: She really does not remember?!\Come on! Let's hurry to the Year God's shrine, grab the new talisman, and go home!\If we don't hurry, the sun's gonna set!\The entrance should be around here somewhere.\I wonder what next year's Lord Year God is like.\What do you think, Tomoe?\Tomoe?\Is it true? Does she really not recall? response:	Would you like some ice cream?
context: Come on! Let's hurry to the Year God's shrine, grab the new talisman, and go home!\If we don't hurry, the sun's gonna set!\The entrance should be around here somewhere.\I wonder what next year's Lord Year God is like.\What do you think, Tomoe?\Tomoe?\Is it true? Does she really not recall?\Would you like some ice cream? response:	Wow, that was amazing. What'd you make this from?
context: If we don't hurry, the sun's gonna set!\The entrance should be around here somewhere.\I wonder what next year's Lord Year God is like.\What do you think, Tomoe?\Tomoe?\Is it true? Does she really not recall?\Would you like some ice cream?\Wow, that was amazing. What'd you make this from? response:	Wow! Ice cream!
context: The entrance should be around here somewhere.\I wonder what next year's Lord Year God is like.\What do you think, Tomoe?\Tomoe?\Is it true? Does she really not recall?\Would you like some ice cream?\Wow, that was amazing. What'd you make this from?\Wow! Ice cream! response:	Mizuki, you know what ice cream is?
context: I wonder what next year's Lord Year God is like.\What do you think, Tomoe?\Tomoe?\Is it true? Does she really not recall?\Would you like some ice cream?\Wow, that was amazing. What'd you make this from?\Wow! Ice cream!\Mizuki, you know what ice cream is? response:	Yeah! I love it!
context: What do you think, Tomoe?\Tomoe?\Is it true? Does she really not recall?\Would you like some ice cream?\Wow, that was amazing. What'd you make this from?\Wow! Ice cream!\Mizuki, you know what ice cream is?\Yeah! I love it! response:	Then you have it. Here.
context: Tomoe?\Is it true? Does she really not recall?\Would you like some ice cream?\Wow, that was amazing. What'd you make this from?\Wow! Ice cream!\Mizuki, you know what ice cream is?\Yeah! I love it!\Then you have it. Here. response:	You don't mind, right, Tomoe?
context: Is it true? Does she really not recall?\Would you like some ice cream?\Wow, that was amazing. What'd you make this from?\Wow! Ice cream!\Mizuki, you know what ice cream is?\Yeah! I love it!\Then you have it. Here.\You don't mind, right, Tomoe? response:	Can I? Thank you! Yay!
context: Would you like some ice cream?\Wow, that was amazing. What'd you make this from?\Wow! Ice cream!\Mizuki, you know what ice cream is?\Yeah! I love it!\Then you have it. Here.\You don't mind, right, Tomoe?\Can I? Thank you! Yay! response:	You're just like a little kid sometimes, Mizuki.
context: Wow, that was amazing. What'd you make this from?\Wow! Ice cream!\Mizuki, you know what ice cream is?\Yeah! I love it!\Then you have it. Here.\You don't mind, right, Tomoe?\Can I? Thank you! Yay!\You're just like a little kid sometimes, Mizuki. response:	Until just earlier, you were a child too.
context: Wow! Ice cream!\Mizuki, you know what ice cream is?\Yeah! I love it!\Then you have it. Here.\You don't mind, right, Tomoe?\Can I? Thank you! Yay!\You're just like a little kid sometimes, Mizuki.\Until just earlier, you were a child too. response:	That reminds me. I never knew how much you take after your mother.
context: Mizuki, you know what ice cream is?\Yeah! I love it!\Then you have it. Here.\You don't mind, right, Tomoe?\Can I? Thank you! Yay!\You're just like a little kid sometimes, Mizuki.\Until just earlier, you were a child too.\That reminds me. I never knew how much you take after your mother. response:	You think I'm like my mom?
context: Yeah! I love it!\Then you have it. Here.\You don't mind, right, Tomoe?\Can I? Thank you! Yay!\You're just like a little kid sometimes, Mizuki.\Until just earlier, you were a child too.\That reminds me. I never knew how much you take after your mother.\You think I'm like my mom? response:	I dunno. I always thought I took after my dad.
context: Then you have it. Here.\You don't mind, right, Tomoe?\Can I? Thank you! Yay!\You're just like a little kid sometimes, Mizuki.\Until just earlier, you were a child too.\That reminds me. I never knew how much you take after your mother.\You think I'm like my mom?\I dunno. I always thought I took after my dad. response:	I was really young when she passed away, so I hardly knew her. I can barely remember what she looked like.
context: You don't mind, right, Tomoe?\Can I? Thank you! Yay!\You're just like a little kid sometimes, Mizuki.\Until just earlier, you were a child too.\That reminds me. I never knew how much you take after your mother.\You think I'm like my mom?\I dunno. I always thought I took after my dad.\I was really young when she passed away, so I hardly knew her. I can barely remember what she looked like. response:	We lost all the photos of her in the fire.
context: Can I? Thank you! Yay!\You're just like a little kid sometimes, Mizuki.\Until just earlier, you were a child too.\That reminds me. I never knew how much you take after your mother.\You think I'm like my mom?\I dunno. I always thought I took after my dad.\I was really young when she passed away, so I hardly knew her. I can barely remember what she looked like.\We lost all the photos of her in the fire. response:	It would've been nice if one had survived, but oh well...
context: You're just like a little kid sometimes, Mizuki.\Until just earlier, you were a child too.\That reminds me. I never knew how much you take after your mother.\You think I'm like my mom?\I dunno. I always thought I took after my dad.\I was really young when she passed away, so I hardly knew her. I can barely remember what she looked like.\We lost all the photos of her in the fire.\It would've been nice if one had survived, but oh well... response:	It seems twelve years is enough time for a human to change.
context: Until just earlier, you were a child too.\That reminds me. I never knew how much you take after your mother.\You think I'm like my mom?\I dunno. I always thought I took after my dad.\I was really young when she passed away, so I hardly knew her. I can barely remember what she looked like.\We lost all the photos of her in the fire.\It would've been nice if one had survived, but oh well...\It seems twelve years is enough time for a human to change. response:	Little Nanami and the present one...
context: That reminds me. I never knew how much you take after your mother.\You think I'm like my mom?\I dunno. I always thought I took after my dad.\I was really young when she passed away, so I hardly knew her. I can barely remember what she looked like.\We lost all the photos of her in the fire.\It would've been nice if one had survived, but oh well...\It seems twelve years is enough time for a human to change.\Little Nanami and the present one... response:	are the same person, and yet they are so different.
context: You think I'm like my mom?\I dunno. I always thought I took after my dad.\I was really young when she passed away, so I hardly knew her. I can barely remember what she looked like.\We lost all the photos of her in the fire.\It would've been nice if one had survived, but oh well...\It seems twelve years is enough time for a human to change.\Little Nanami and the present one...\are the same person, and yet they are so different. response:	If that is so...
context: I dunno. I always thought I took after my dad.\I was really young when she passed away, so I hardly knew her. I can barely remember what she looked like.\We lost all the photos of her in the fire.\It would've been nice if one had survived, but oh well...\It seems twelve years is enough time for a human to change.\Little Nanami and the present one...\are the same person, and yet they are so different.\If that is so... response:	where did that child disappear to?
context: I was really young when she passed away, so I hardly knew her. I can barely remember what she looked like.\We lost all the photos of her in the fire.\It would've been nice if one had survived, but oh well...\It seems twelve years is enough time for a human to change.\Little Nanami and the present one...\are the same person, and yet they are so different.\If that is so...\where did that child disappear to? response:	Tomoe!
context: We lost all the photos of her in the fire.\It would've been nice if one had survived, but oh well...\It seems twelve years is enough time for a human to change.\Little Nanami and the present one...\are the same person, and yet they are so different.\If that is so...\where did that child disappear to?\Tomoe! response:	Wh-What is this?!
context: It would've been nice if one had survived, but oh well...\It seems twelve years is enough time for a human to change.\Little Nanami and the present one...\are the same person, and yet they are so different.\If that is so...\where did that child disappear to?\Tomoe!\Wh-What is this?! response:	Flooof
context: It seems twelve years is enough time for a human to change.\Little Nanami and the present one...\are the same person, and yet they are so different.\If that is so...\where did that child disappear to?\Tomoe!\Wh-What is this?!\Flooof response:	Flooof
context: Little Nanami and the present one...\are the same person, and yet they are so different.\If that is so...\where did that child disappear to?\Tomoe!\Wh-What is this?!\Flooof\Flooof response:	Flooof
context: are the same person, and yet they are so different.\If that is so...\where did that child disappear to?\Tomoe!\Wh-What is this?!\Flooof\Flooof\Flooof response:	Flooof
context: If that is so...\where did that child disappear to?\Tomoe!\Wh-What is this?!\Flooof\Flooof\Flooof\Flooof response:	Flooof
context: where did that child disappear to?\Tomoe!\Wh-What is this?!\Flooof\Flooof\Flooof\Flooof\Flooof response:	Flooof
context: Tomoe!\Wh-What is this?!\Flooof\Flooof\Flooof\Flooof\Flooof\Flooof response:	Flooof
context: Wh-What is this?!\Flooof\Flooof\Flooof\Flooof\Flooof\Flooof\Flooof response:	Flooof
context: Flooof\Flooof\Flooof\Flooof\Flooof\Flooof\Flooof\Flooof response:	Flooof
context: Flooof\Flooof\Flooof\Flooof\Flooof\Flooof\Flooof\Flooof response:	Flooof
context: Flooof\Flooof\Flooof\Flooof\Flooof\Flooof\Flooof\Flooof response:	Flooof
context: Flooof\Flooof\Flooof\Flooof\Flooof\Flooof\Flooof\Flooof response:	Flooof
context: Flooof\Flooof\Flooof\Flooof\Flooof\Flooof\Flooof\Flooof response:	Flooof
context: Flooof\Flooof\Flooof\Flooof\Flooof\Flooof\Flooof\Flooof response:	Flooof
context: Flooof\Flooof\Flooof\Flooof\Flooof\Flooof\Flooof\Flooof response:	Flooof
context: Flooof\Flooof\Flooof\Flooof\Flooof\Flooof\Flooof\Flooof response:	Flooof
context: Flooof\Flooof\Flooof\Flooof\Flooof\Flooof\Flooof\Flooof response:	Flooof
context: Flooof\Flooof\Flooof\Flooof\Flooof\Flooof\Flooof\Flooof response:	Flooof
context: Flooof\Flooof\Flooof\Flooof\Flooof\Flooof\Flooof\Flooof response:	Flooof
context: Flooof\Flooof\Flooof\Flooof\Flooof\Flooof\Flooof\Flooof response:	Flooof
context: Flooof\Flooof\Flooof\Flooof\Flooof\Flooof\Flooof\Flooof response:	Flooof
context: Flooof\Flooof\Flooof\Flooof\Flooof\Flooof\Flooof\Flooof response:	Flooof
context: Flooof\Flooof\Flooof\Flooof\Flooof\Flooof\Flooof\Flooof response:	Flooof
context: Flooof\Flooof\Flooof\Flooof\Flooof\Flooof\Flooof\Flooof response:	Flooof
context: Flooof\Flooof\Flooof\Flooof\Flooof\Flooof\Flooof\Flooof response:	Flooof
context: Flooof\Flooof\Flooof\Flooof\Flooof\Flooof\Flooof\Flooof response:	Flooof
context: Flooof\Flooof\Flooof\Flooof\Flooof\Flooof\Flooof\Flooof response:	Flooof
context: Flooof\Flooof\Flooof\Flooof\Flooof\Flooof\Flooof\Flooof response:	Flooof
context: Flooof\Flooof\Flooof\Flooof\Flooof\Flooof\Flooof\Flooof response:	Flooof
context: Flooof\Flooof\Flooof\Flooof\Flooof\Flooof\Flooof\Flooof response:	Flooof
context: Flooof\Flooof\Flooof\Flooof\Flooof\Flooof\Flooof\Flooof response:	Flooof
context: Flooof\Flooof\Flooof\Flooof\Flooof\Flooof\Flooof\Flooof response:	Flooof
context: Flooof\Flooof\Flooof\Flooof\Flooof\Flooof\Flooof\Flooof response:	Flooof
context: Flooof\Flooof\Flooof\Flooof\Flooof\Flooof\Flooof\Flooof response:	Flooof
context: Flooof\Flooof\Flooof\Flooof\Flooof\Flooof\Flooof\Flooof response:	Flooof
context: Flooof\Flooof\Flooof\Flooof\Flooof\Flooof\Flooof\Flooof response:	Flooof
context: Flooof\Flooof\Flooof\Flooof\Flooof\Flooof\Flooof\Flooof response:	Flooof
context: Flooof\Flooof\Flooof\Flooof\Flooof\Flooof\Flooof\Flooof response:	Flooof
context: Flooof\Flooof\Flooof\Flooof\Flooof\Flooof\Flooof\Flooof response:	Flooof
context: Flooof\Flooof\Flooof\Flooof\Flooof\Flooof\Flooof\Flooof response:	Flooof
context: Flooof\Flooof\Flooof\Flooof\Flooof\Flooof\Flooof\Flooof response:	Flooof
context: Flooof\Flooof\Flooof\Flooof\Flooof\Flooof\Flooof\Flooof response:	Flooof
context: Flooof\Flooof\Flooof\Flooof\Flooof\Flooof\Flooof\Flooof response:	Flooof
context: Flooof\Flooof\Flooof\Flooof\Flooof\Flooof\Flooof\Flooof response:	Flooof
context: Flooof\Flooof\Flooof\Flooof\Flooof\Flooof\Flooof\Flooof response:	Flooof
context: Flooof\Flooof\Flooof\Flooof\Flooof\Flooof\Flooof\Flooof response:	Flooof
context: Flooof\Flooof\Flooof\Flooof\Flooof\Flooof\Flooof\Flooof response:	Flooof
context: Flooof\Flooof\Flooof\Flooof\Flooof\Flooof\Flooof\Flooof response:	Flooof
context: Flooof\Flooof\Flooof\Flooof\Flooof\Flooof\Flooof\Flooof response:	Flooof
context: Flooof\Flooof\Flooof\Flooof\Flooof\Flooof\Flooof\Flooof response:	Flooof
context: Flooof\Flooof\Flooof\Flooof\Flooof\Flooof\Flooof\Flooof response:	Flooof
context: Flooof\Flooof\Flooof\Flooof\Flooof\Flooof\Flooof\Flooof response:	Flooof
context: Flooof\Flooof\Flooof\Flooof\Flooof\Flooof\Flooof\Flooof response:	Flooof
context: Flooof\Flooof\Flooof\Flooof\Flooof\Flooof\Flooof\Flooof response:	Flooof
context: Flooof\Flooof\Flooof\Flooof\Flooof\Flooof\Flooof\Flooof response:	Flooof
context: Flooof\Flooof\Flooof\Flooof\Flooof\Flooof\Flooof\Flooof response:	Flooof
context: Flooof\Flooof\Flooof\Flooof\Flooof\Flooof\Flooof\Flooof response:	Flooof
context: Flooof\Flooof\Flooof\Flooof\Flooof\Flooof\Flooof\Flooof response:	Flooof
context: Flooof\Flooof\Flooof\Flooof\Flooof\Flooof\Flooof\Flooof response:	Flooof
context: Flooof\Flooof\Flooof\Flooof\Flooof\Flooof\Flooof\Flooof response:	Flooof
context: Flooof\Flooof\Flooof\Flooof\Flooof\Flooof\Flooof\Flooof response:	Flooof
context: Flooof\Flooof\Flooof\Flooof\Flooof\Flooof\Flooof\Flooof response:	Flooof
context: Flooof\Flooof\Flooof\Flooof\Flooof\Flooof\Flooof\Flooof response:	Flooof
context: Flooof\Flooof\Flooof\Flooof\Flooof\Flooof\Flooof\Flooof response:	Flooof
context: Flooof\Flooof\Flooof\Flooof\Flooof\Flooof\Flooof\Flooof response:	Flooof
context: Flooof\Flooof\Flooof\Flooof\Flooof\Flooof\Flooof\Flooof response:	Flooof
context: Flooof\Flooof\Flooof\Flooof\Flooof\Flooof\Flooof\Flooof response:	Hi there!
context: Flooof\Flooof\Flooof\Flooof\Flooof\Flooof\Flooof\Hi there! response:	Hey!
context: Flooof\Flooof\Flooof\Flooof\Flooof\Flooof\Hi there!\Hey! response:	Ah! Are you the human god of the Mikage Shrine?
context: Flooof\Flooof\Flooof\Flooof\Flooof\Hi there!\Hey!\Ah! Are you the human god of the Mikage Shrine? response:	Oh, Lord Year God!
context: Flooof\Flooof\Flooof\Flooof\Hi there!\Hey!\Ah! Are you the human god of the Mikage Shrine?\Oh, Lord Year God! response:	What? Him?
context: Flooof\Flooof\Flooof\Hi there!\Hey!\Ah! Are you the human god of the Mikage Shrine?\Oh, Lord Year God!\What? Him? response:	Goodness! Sorry that you had to see me like this.
context: Flooof\Flooof\Hi there!\Hey!\Ah! Are you the human god of the Mikage Shrine?\Oh, Lord Year God!\What? Him?\Goodness! Sorry that you had to see me like this. response:	I have to shear off all this wool before the new year. If I don't, we're gonna have problems.
context: Flooof\Hi there!\Hey!\Ah! Are you the human god of the Mikage Shrine?\Oh, Lord Year God!\What? Him?\Goodness! Sorry that you had to see me like this.\I have to shear off all this wool before the new year. If I don't, we're gonna have problems. response:	Wool?
context: Hi there!\Hey!\Ah! Are you the human god of the Mikage Shrine?\Oh, Lord Year God!\What? Him?\Goodness! Sorry that you had to see me like this.\I have to shear off all this wool before the new year. If I don't, we're gonna have problems.\Wool? response:	Floof.
context: Hey!\Ah! Are you the human god of the Mikage Shrine?\Oh, Lord Year God!\What? Him?\Goodness! Sorry that you had to see me like this.\I have to shear off all this wool before the new year. If I don't, we're gonna have problems.\Wool?\Floof. response:	Huh? What?
context: Ah! Are you the human god of the Mikage Shrine?\Oh, Lord Year God!\What? Him?\Goodness! Sorry that you had to see me like this.\I have to shear off all this wool before the new year. If I don't, we're gonna have problems.\Wool?\Floof.\Huh? What? response:	He is the zodiac sheep.
context: Oh, Lord Year God!\What? Him?\Goodness! Sorry that you had to see me like this.\I have to shear off all this wool before the new year. If I don't, we're gonna have problems.\Wool?\Floof.\Huh? What?\He is the zodiac sheep. response:	So this thing is a sheep.
context: What? Him?\Goodness! Sorry that you had to see me like this.\I have to shear off all this wool before the new year. If I don't, we're gonna have problems.\Wool?\Floof.\Huh? What?\He is the zodiac sheep.\So this thing is a sheep. response:	Yay! So fluffy!
context: Goodness! Sorry that you had to see me like this.\I have to shear off all this wool before the new year. If I don't, we're gonna have problems.\Wool?\Floof.\Huh? What?\He is the zodiac sheep.\So this thing is a sheep.\Yay! So fluffy! response:	Huh? I thought it'd be softer.
context: I have to shear off all this wool before the new year. If I don't, we're gonna have problems.\Wool?\Floof.\Huh? What?\He is the zodiac sheep.\So this thing is a sheep.\Yay! So fluffy!\Huh? I thought it'd be softer. response:	This guy says that floof will be in next year, so he does not want to be sheared.
context: Wool?\Floof.\Huh? What?\He is the zodiac sheep.\So this thing is a sheep.\Yay! So fluffy!\Huh? I thought it'd be softer.\This guy says that floof will be in next year, so he does not want to be sheared. response:	If I can't get him trimmed down, there's no way he'll fit in the shrine.
context: Floof.\Huh? What?\He is the zodiac sheep.\So this thing is a sheep.\Yay! So fluffy!\Huh? I thought it'd be softer.\This guy says that floof will be in next year, so he does not want to be sheared.\If I can't get him trimmed down, there's no way he'll fit in the shrine. response:	Then why did you wait until the last minute to handle this?
context: Huh? What?\He is the zodiac sheep.\So this thing is a sheep.\Yay! So fluffy!\Huh? I thought it'd be softer.\This guy says that floof will be in next year, so he does not want to be sheared.\If I can't get him trimmed down, there's no way he'll fit in the shrine.\Then why did you wait until the last minute to handle this? response:	Lord Year God, we came to receive next year's talisman.
context: He is the zodiac sheep.\So this thing is a sheep.\Yay! So fluffy!\Huh? I thought it'd be softer.\This guy says that floof will be in next year, so he does not want to be sheared.\If I can't get him trimmed down, there's no way he'll fit in the shrine.\Then why did you wait until the last minute to handle this?\Lord Year God, we came to receive next year's talisman. response:	Oh, right, the talisman.
context: So this thing is a sheep.\Yay! So fluffy!\Huh? I thought it'd be softer.\This guy says that floof will be in next year, so he does not want to be sheared.\If I can't get him trimmed down, there's no way he'll fit in the shrine.\Then why did you wait until the last minute to handle this?\Lord Year God, we came to receive next year's talisman.\Oh, right, the talisman. response:	It is in there!
context: Yay! So fluffy!\Huh? I thought it'd be softer.\This guy says that floof will be in next year, so he does not want to be sheared.\If I can't get him trimmed down, there's no way he'll fit in the shrine.\Then why did you wait until the last minute to handle this?\Lord Year God, we came to receive next year's talisman.\Oh, right, the talisman.\It is in there! response:	Floof...
context: Huh? I thought it'd be softer.\This guy says that floof will be in next year, so he does not want to be sheared.\If I can't get him trimmed down, there's no way he'll fit in the shrine.\Then why did you wait until the last minute to handle this?\Lord Year God, we came to receive next year's talisman.\Oh, right, the talisman.\It is in there!\Floof... response:	What?!
context: This guy says that floof will be in next year, so he does not want to be sheared.\If I can't get him trimmed down, there's no way he'll fit in the shrine.\Then why did you wait until the last minute to handle this?\Lord Year God, we came to receive next year's talisman.\Oh, right, the talisman.\It is in there!\Floof...\What?! response:	That's the shrine?!
context: If I can't get him trimmed down, there's no way he'll fit in the shrine.\Then why did you wait until the last minute to handle this?\Lord Year God, we came to receive next year's talisman.\Oh, right, the talisman.\It is in there!\Floof...\What?!\That's the shrine?! response:	Just a bit of the sheep's wool is inside there!
context: Then why did you wait until the last minute to handle this?\Lord Year God, we came to receive next year's talisman.\Oh, right, the talisman.\It is in there!\Floof...\What?!\That's the shrine?!\Just a bit of the sheep's wool is inside there! response:	He hasn't budged since this morning, so I told him it was time for a haircut, much to his dismay.
context: Lord Year God, we came to receive next year's talisman.\Oh, right, the talisman.\It is in there!\Floof...\What?!\That's the shrine?!\Just a bit of the sheep's wool is inside there!\He hasn't budged since this morning, so I told him it was time for a haircut, much to his dismay. response:	Floof!
context: Oh, right, the talisman.\It is in there!\Floof...\What?!\That's the shrine?!\Just a bit of the sheep's wool is inside there!\He hasn't budged since this morning, so I told him it was time for a haircut, much to his dismay.\Floof! response:	Floof!
context: It is in there!\Floof...\What?!\That's the shrine?!\Just a bit of the sheep's wool is inside there!\He hasn't budged since this morning, so I told him it was time for a haircut, much to his dismay.\Floof!\Floof! response:	No, stop! You're crushing the shrine!
context: Floof...\What?!\That's the shrine?!\Just a bit of the sheep's wool is inside there!\He hasn't budged since this morning, so I told him it was time for a haircut, much to his dismay.\Floof!\Floof!\No, stop! You're crushing the shrine! response:	Too bad it's not softer.
context: What?!\That's the shrine?!\Just a bit of the sheep's wool is inside there!\He hasn't budged since this morning, so I told him it was time for a haircut, much to his dismay.\Floof!\Floof!\No, stop! You're crushing the shrine!\Too bad it's not softer. response:	Shall I put him down?
context: That's the shrine?!\Just a bit of the sheep's wool is inside there!\He hasn't budged since this morning, so I told him it was time for a haircut, much to his dismay.\Floof!\Floof!\No, stop! You're crushing the shrine!\Too bad it's not softer.\Shall I put him down? response:	All that fluff must be really heavy.
context: Just a bit of the sheep's wool is inside there!\He hasn't budged since this morning, so I told him it was time for a haircut, much to his dismay.\Floof!\Floof!\No, stop! You're crushing the shrine!\Too bad it's not softer.\Shall I put him down?\All that fluff must be really heavy. response:	Floof...
context: He hasn't budged since this morning, so I told him it was time for a haircut, much to his dismay.\Floof!\Floof!\No, stop! You're crushing the shrine!\Too bad it's not softer.\Shall I put him down?\All that fluff must be really heavy.\Floof... response:	This coming year is gonna be all about you, so you should try to look your best for the occasion.
context: Floof!\Floof!\No, stop! You're crushing the shrine!\Too bad it's not softer.\Shall I put him down?\All that fluff must be really heavy.\Floof...\This coming year is gonna be all about you, so you should try to look your best for the occasion. response:	Floof...
context: Floof!\No, stop! You're crushing the shrine!\Too bad it's not softer.\Shall I put him down?\All that fluff must be really heavy.\Floof...\This coming year is gonna be all about you, so you should try to look your best for the occasion.\Floof... response:	You have such wonderful floof.
context: No, stop! You're crushing the shrine!\Too bad it's not softer.\Shall I put him down?\All that fluff must be really heavy.\Floof...\This coming year is gonna be all about you, so you should try to look your best for the occasion.\Floof...\You have such wonderful floof. response:	Instead of staying put here, wouldn't you rather show it off to everybody?
context: Too bad it's not softer.\Shall I put him down?\All that fluff must be really heavy.\Floof...\This coming year is gonna be all about you, so you should try to look your best for the occasion.\Floof...\You have such wonderful floof.\Instead of staying put here, wouldn't you rather show it off to everybody? response:	Floof!
context: Shall I put him down?\All that fluff must be really heavy.\Floof...\This coming year is gonna be all about you, so you should try to look your best for the occasion.\Floof...\You have such wonderful floof.\Instead of staying put here, wouldn't you rather show it off to everybody?\Floof! response:	Oh?! I can shear off your wool?!
context: All that fluff must be really heavy.\Floof...\This coming year is gonna be all about you, so you should try to look your best for the occasion.\Floof...\You have such wonderful floof.\Instead of staying put here, wouldn't you rather show it off to everybody?\Floof!\Oh?! I can shear off your wool?! response:	Nanami, you're incredible!
context: Floof...\This coming year is gonna be all about you, so you should try to look your best for the occasion.\Floof...\You have such wonderful floof.\Instead of staying put here, wouldn't you rather show it off to everybody?\Floof!\Oh?! I can shear off your wool?!\Nanami, you're incredible! response:	I know, right?
context: This coming year is gonna be all about you, so you should try to look your best for the occasion.\Floof...\You have such wonderful floof.\Instead of staying put here, wouldn't you rather show it off to everybody?\Floof!\Oh?! I can shear off your wool?!\Nanami, you're incredible!\I know, right? response:	Yep! Incredible! Incredible!
context: Floof...\You have such wonderful floof.\Instead of staying put here, wouldn't you rather show it off to everybody?\Floof!\Oh?! I can shear off your wool?!\Nanami, you're incredible!\I know, right?\Yep! Incredible! Incredible! response:	The child I saw twelve years ago has long since vanished.
context: You have such wonderful floof.\Instead of staying put here, wouldn't you rather show it off to everybody?\Floof!\Oh?! I can shear off your wool?!\Nanami, you're incredible!\I know, right?\Yep! Incredible! Incredible!\The child I saw twelve years ago has long since vanished. response:	Is this a slight sense of loss...
context: Instead of staying put here, wouldn't you rather show it off to everybody?\Floof!\Oh?! I can shear off your wool?!\Nanami, you're incredible!\I know, right?\Yep! Incredible! Incredible!\The child I saw twelve years ago has long since vanished.\Is this a slight sense of loss... response:	that I feel?
context: Floof!\Oh?! I can shear off your wool?!\Nanami, you're incredible!\I know, right?\Yep! Incredible! Incredible!\The child I saw twelve years ago has long since vanished.\Is this a slight sense of loss...\that I feel? response:	Floof!
context: Oh?! I can shear off your wool?!\Nanami, you're incredible!\I know, right?\Yep! Incredible! Incredible!\The child I saw twelve years ago has long since vanished.\Is this a slight sense of loss...\that I feel?\Floof! response:	Thank you, land god. You have my gratitude.
context: Nanami, you're incredible!\I know, right?\Yep! Incredible! Incredible!\The child I saw twelve years ago has long since vanished.\Is this a slight sense of loss...\that I feel?\Floof!\Thank you, land god. You have my gratitude. response:	How did it get so small?
context: I know, right?\Yep! Incredible! Incredible!\The child I saw twelve years ago has long since vanished.\Is this a slight sense of loss...\that I feel?\Floof!\Thank you, land god. You have my gratitude.\How did it get so small? response:	Here is next year's talisman.
context: Yep! Incredible! Incredible!\The child I saw twelve years ago has long since vanished.\Is this a slight sense of loss...\that I feel?\Floof!\Thank you, land god. You have my gratitude.\How did it get so small?\Here is next year's talisman. response:	Wakatoshikami
context: The child I saw twelve years ago has long since vanished.\Is this a slight sense of loss...\that I feel?\Floof!\Thank you, land god. You have my gratitude.\How did it get so small?\Here is next year's talisman.\Wakatoshikami response:	Otoshimioyanokami
context: Is this a slight sense of loss...\that I feel?\Floof!\Thank you, land god. You have my gratitude.\How did it get so small?\Here is next year's talisman.\Wakatoshikami\Otoshimioyanokami response:	Wakatoshikami
context: that I feel?\Floof!\Thank you, land god. You have my gratitude.\How did it get so small?\Here is next year's talisman.\Wakatoshikami\Otoshimioyanokami\Wakatoshikami response:	Mitoshinokami
context: Floof!\Thank you, land god. You have my gratitude.\How did it get so small?\Here is next year's talisman.\Wakatoshikami\Otoshimioyanokami\Wakatoshikami\Mitoshinokami response:	Otoshimioyanokami
context: Thank you, land god. You have my gratitude.\How did it get so small?\Here is next year's talisman.\Wakatoshikami\Otoshimioyanokami\Wakatoshikami\Mitoshinokami\Otoshimioyanokami response:	Wakatoshikami
context: How did it get so small?\Here is next year's talisman.\Wakatoshikami\Otoshimioyanokami\Wakatoshikami\Mitoshinokami\Otoshimioyanokami\Wakatoshikami response:	Mitoshinokami
context: Here is next year's talisman.\Wakatoshikami\Otoshimioyanokami\Wakatoshikami\Mitoshinokami\Otoshimioyanokami\Wakatoshikami\Mitoshinokami response:	Otoshimioyanokami
context: Wakatoshikami\Otoshimioyanokami\Wakatoshikami\Mitoshinokami\Otoshimioyanokami\Wakatoshikami\Mitoshinokami\Otoshimioyanokami response:	Wakatoshikami
context: Otoshimioyanokami\Wakatoshikami\Mitoshinokami\Otoshimioyanokami\Wakatoshikami\Mitoshinokami\Otoshimioyanokami\Wakatoshikami response:	Mitoshinokami
context: Wakatoshikami\Mitoshinokami\Otoshimioyanokami\Wakatoshikami\Mitoshinokami\Otoshimioyanokami\Wakatoshikami\Mitoshinokami response:	Otoshimioyanokami
context: Mitoshinokami\Otoshimioyanokami\Wakatoshikami\Mitoshinokami\Otoshimioyanokami\Wakatoshikami\Mitoshinokami\Otoshimioyanokami response:	Consecrated Gods
context: Otoshimioyanokami\Wakatoshikami\Mitoshinokami\Otoshimioyanokami\Wakatoshikami\Mitoshinokami\Otoshimioyanokami\Consecrated Gods response:	Wakatoshikami
context: Wakatoshikami\Mitoshinokami\Otoshimioyanokami\Wakatoshikami\Mitoshinokami\Otoshimioyanokami\Consecrated Gods\Wakatoshikami response:	Mitoshinokami
context: Mitoshinokami\Otoshimioyanokami\Wakatoshikami\Mitoshinokami\Otoshimioyanokami\Consecrated Gods\Wakatoshikami\Mitoshinokami response:	Otoshimioyanokami
context: Otoshimioyanokami\Wakatoshikami\Mitoshinokami\Otoshimioyanokami\Consecrated Gods\Wakatoshikami\Mitoshinokami\Otoshimioyanokami response:	Consecrated Gods
context: Wakatoshikami\Mitoshinokami\Otoshimioyanokami\Consecrated Gods\Wakatoshikami\Mitoshinokami\Otoshimioyanokami\Consecrated Gods response:	Wakatoshikami
context: Mitoshinokami\Otoshimioyanokami\Consecrated Gods\Wakatoshikami\Mitoshinokami\Otoshimioyanokami\Consecrated Gods\Wakatoshikami response:	Mitoshinokami
context: Otoshimioyanokami\Consecrated Gods\Wakatoshikami\Mitoshinokami\Otoshimioyanokami\Consecrated Gods\Wakatoshikami\Mitoshinokami response:	Otoshimioyanokami
context: Consecrated Gods\Wakatoshikami\Mitoshinokami\Otoshimioyanokami\Consecrated Gods\Wakatoshikami\Mitoshinokami\Otoshimioyanokami response:	Consecrated Gods
context: Wakatoshikami\Mitoshinokami\Otoshimioyanokami\Consecrated Gods\Wakatoshikami\Mitoshinokami\Otoshimioyanokami\Consecrated Gods response:	Wakatoshikami
context: Mitoshinokami\Otoshimioyanokami\Consecrated Gods\Wakatoshikami\Mitoshinokami\Otoshimioyanokami\Consecrated Gods\Wakatoshikami response:	Mitoshinokami
context: Otoshimioyanokami\Consecrated Gods\Wakatoshikami\Mitoshinokami\Otoshimioyanokami\Consecrated Gods\Wakatoshikami\Mitoshinokami response:	Otoshimioyanokami
context: Consecrated Gods\Wakatoshikami\Mitoshinokami\Otoshimioyanokami\Consecrated Gods\Wakatoshikami\Mitoshinokami\Otoshimioyanokami response:	Consecrated Gods
context: Wakatoshikami\Mitoshinokami\Otoshimioyanokami\Consecrated Gods\Wakatoshikami\Mitoshinokami\Otoshimioyanokami\Consecrated Gods response:	Wakatoshikami
context: Mitoshinokami\Otoshimioyanokami\Consecrated Gods\Wakatoshikami\Mitoshinokami\Otoshimioyanokami\Consecrated Gods\Wakatoshikami response:	Mitoshinokami
context: Otoshimioyanokami\Consecrated Gods\Wakatoshikami\Mitoshinokami\Otoshimioyanokami\Consecrated Gods\Wakatoshikami\Mitoshinokami response:	Otoshimioyanokami
context: Consecrated Gods\Wakatoshikami\Mitoshinokami\Otoshimioyanokami\Consecrated Gods\Wakatoshikami\Mitoshinokami\Otoshimioyanokami response:	Consecrated Gods
context: Wakatoshikami\Mitoshinokami\Otoshimioyanokami\Consecrated Gods\Wakatoshikami\Mitoshinokami\Otoshimioyanokami\Consecrated Gods response:	Wakatoshikami
context: Mitoshinokami\Otoshimioyanokami\Consecrated Gods\Wakatoshikami\Mitoshinokami\Otoshimioyanokami\Consecrated Gods\Wakatoshikami response:	Mitoshinokami
context: Otoshimioyanokami\Consecrated Gods\Wakatoshikami\Mitoshinokami\Otoshimioyanokami\Consecrated Gods\Wakatoshikami\Mitoshinokami response:	Otoshimioyanokami
context: Consecrated Gods\Wakatoshikami\Mitoshinokami\Otoshimioyanokami\Consecrated Gods\Wakatoshikami\Mitoshinokami\Otoshimioyanokami response:	Consecrated Gods
context: Wakatoshikami\Mitoshinokami\Otoshimioyanokami\Consecrated Gods\Wakatoshikami\Mitoshinokami\Otoshimioyanokami\Consecrated Gods response:	Wakatoshikami
context: Mitoshinokami\Otoshimioyanokami\Consecrated Gods\Wakatoshikami\Mitoshinokami\Otoshimioyanokami\Consecrated Gods\Wakatoshikami response:	Mitoshinokami
context: Otoshimioyanokami\Consecrated Gods\Wakatoshikami\Mitoshinokami\Otoshimioyanokami\Consecrated Gods\Wakatoshikami\Mitoshinokami response:	Otoshimioyanokami
context: Consecrated Gods\Wakatoshikami\Mitoshinokami\Otoshimioyanokami\Consecrated Gods\Wakatoshikami\Mitoshinokami\Otoshimioyanokami response:	Consecrated Gods
context: Wakatoshikami\Mitoshinokami\Otoshimioyanokami\Consecrated Gods\Wakatoshikami\Mitoshinokami\Otoshimioyanokami\Consecrated Gods response:	Wakatoshikami
context: Mitoshinokami\Otoshimioyanokami\Consecrated Gods\Wakatoshikami\Mitoshinokami\Otoshimioyanokami\Consecrated Gods\Wakatoshikami response:	Mitoshinokami
context: Otoshimioyanokami\Consecrated Gods\Wakatoshikami\Mitoshinokami\Otoshimioyanokami\Consecrated Gods\Wakatoshikami\Mitoshinokami response:	Otoshimioyanokami
context: Consecrated Gods\Wakatoshikami\Mitoshinokami\Otoshimioyanokami\Consecrated Gods\Wakatoshikami\Mitoshinokami\Otoshimioyanokami response:	Consecrated Gods
context: Wakatoshikami\Mitoshinokami\Otoshimioyanokami\Consecrated Gods\Wakatoshikami\Mitoshinokami\Otoshimioyanokami\Consecrated Gods response:	Wakatoshikami
context: Mitoshinokami\Otoshimioyanokami\Consecrated Gods\Wakatoshikami\Mitoshinokami\Otoshimioyanokami\Consecrated Gods\Wakatoshikami response:	Mitoshinokami
context: Otoshimioyanokami\Consecrated Gods\Wakatoshikami\Mitoshinokami\Otoshimioyanokami\Consecrated Gods\Wakatoshikami\Mitoshinokami response:	Otoshimioyanokami
context: Consecrated Gods\Wakatoshikami\Mitoshinokami\Otoshimioyanokami\Consecrated Gods\Wakatoshikami\Mitoshinokami\Otoshimioyanokami response:	Consecrated Gods
context: Wakatoshikami\Mitoshinokami\Otoshimioyanokami\Consecrated Gods\Wakatoshikami\Mitoshinokami\Otoshimioyanokami\Consecrated Gods response:	Wakatoshikami
context: Mitoshinokami\Otoshimioyanokami\Consecrated Gods\Wakatoshikami\Mitoshinokami\Otoshimioyanokami\Consecrated Gods\Wakatoshikami response:	Mitoshinokami
context: Otoshimioyanokami\Consecrated Gods\Wakatoshikami\Mitoshinokami\Otoshimioyanokami\Consecrated Gods\Wakatoshikami\Mitoshinokami response:	Otoshimioyanokami
context: Consecrated Gods\Wakatoshikami\Mitoshinokami\Otoshimioyanokami\Consecrated Gods\Wakatoshikami\Mitoshinokami\Otoshimioyanokami response:	Consecrated Gods
context: Wakatoshikami\Mitoshinokami\Otoshimioyanokami\Consecrated Gods\Wakatoshikami\Mitoshinokami\Otoshimioyanokami\Consecrated Gods response:	Wakatoshikami
context: Mitoshinokami\Otoshimioyanokami\Consecrated Gods\Wakatoshikami\Mitoshinokami\Otoshimioyanokami\Consecrated Gods\Wakatoshikami response:	Mitoshinokami
context: Otoshimioyanokami\Consecrated Gods\Wakatoshikami\Mitoshinokami\Otoshimioyanokami\Consecrated Gods\Wakatoshikami\Mitoshinokami response:	Otoshimioyanokami
context: Consecrated Gods\Wakatoshikami\Mitoshinokami\Otoshimioyanokami\Consecrated Gods\Wakatoshikami\Mitoshinokami\Otoshimioyanokami response:	Consecrated Gods
context: Wakatoshikami\Mitoshinokami\Otoshimioyanokami\Consecrated Gods\Wakatoshikami\Mitoshinokami\Otoshimioyanokami\Consecrated Gods response:	Wakatoshikami
context: Mitoshinokami\Otoshimioyanokami\Consecrated Gods\Wakatoshikami\Mitoshinokami\Otoshimioyanokami\Consecrated Gods\Wakatoshikami response:	Mitoshinokami
context: Otoshimioyanokami\Consecrated Gods\Wakatoshikami\Mitoshinokami\Otoshimioyanokami\Consecrated Gods\Wakatoshikami\Mitoshinokami response:	Otoshimioyanokami
context: Consecrated Gods\Wakatoshikami\Mitoshinokami\Otoshimioyanokami\Consecrated Gods\Wakatoshikami\Mitoshinokami\Otoshimioyanokami response:	Consecrated Gods
context: Wakatoshikami\Mitoshinokami\Otoshimioyanokami\Consecrated Gods\Wakatoshikami\Mitoshinokami\Otoshimioyanokami\Consecrated Gods response:	Wakatoshikami
context: Mitoshinokami\Otoshimioyanokami\Consecrated Gods\Wakatoshikami\Mitoshinokami\Otoshimioyanokami\Consecrated Gods\Wakatoshikami response:	Mitoshinokami
context: Otoshimioyanokami\Consecrated Gods\Wakatoshikami\Mitoshinokami\Otoshimioyanokami\Consecrated Gods\Wakatoshikami\Mitoshinokami response:	Otoshimioyanokami
context: Consecrated Gods\Wakatoshikami\Mitoshinokami\Otoshimioyanokami\Consecrated Gods\Wakatoshikami\Mitoshinokami\Otoshimioyanokami response:	Consecrated Gods
context: Wakatoshikami\Mitoshinokami\Otoshimioyanokami\Consecrated Gods\Wakatoshikami\Mitoshinokami\Otoshimioyanokami\Consecrated Gods response:	Wakatoshikami
context: Mitoshinokami\Otoshimioyanokami\Consecrated Gods\Wakatoshikami\Mitoshinokami\Otoshimioyanokami\Consecrated Gods\Wakatoshikami response:	Mitoshinokami
context: Otoshimioyanokami\Consecrated Gods\Wakatoshikami\Mitoshinokami\Otoshimioyanokami\Consecrated Gods\Wakatoshikami\Mitoshinokami response:	Otoshimioyanokami
context: Consecrated Gods\Wakatoshikami\Mitoshinokami\Otoshimioyanokami\Consecrated Gods\Wakatoshikami\Mitoshinokami\Otoshimioyanokami response:	Consecrated Gods
context: Wakatoshikami\Mitoshinokami\Otoshimioyanokami\Consecrated Gods\Wakatoshikami\Mitoshinokami\Otoshimioyanokami\Consecrated Gods response:	Wakatoshikami
context: Mitoshinokami\Otoshimioyanokami\Consecrated Gods\Wakatoshikami\Mitoshinokami\Otoshimioyanokami\Consecrated Gods\Wakatoshikami response:	Mitoshinokami
context: Otoshimioyanokami\Consecrated Gods\Wakatoshikami\Mitoshinokami\Otoshimioyanokami\Consecrated Gods\Wakatoshikami\Mitoshinokami response:	Otoshimioyanokami
context: Consecrated Gods\Wakatoshikami\Mitoshinokami\Otoshimioyanokami\Consecrated Gods\Wakatoshikami\Mitoshinokami\Otoshimioyanokami response:	Consecrated Gods
context: Wakatoshikami\Mitoshinokami\Otoshimioyanokami\Consecrated Gods\Wakatoshikami\Mitoshinokami\Otoshimioyanokami\Consecrated Gods response:	Wakatoshikami
context: Mitoshinokami\Otoshimioyanokami\Consecrated Gods\Wakatoshikami\Mitoshinokami\Otoshimioyanokami\Consecrated Gods\Wakatoshikami response:	Mitoshinokami
context: Otoshimioyanokami\Consecrated Gods\Wakatoshikami\Mitoshinokami\Otoshimioyanokami\Consecrated Gods\Wakatoshikami\Mitoshinokami response:	Otoshimioyanokami
context: Consecrated Gods\Wakatoshikami\Mitoshinokami\Otoshimioyanokami\Consecrated Gods\Wakatoshikami\Mitoshinokami\Otoshimioyanokami response:	Consecrated Gods
context: Wakatoshikami\Mitoshinokami\Otoshimioyanokami\Consecrated Gods\Wakatoshikami\Mitoshinokami\Otoshimioyanokami\Consecrated Gods response:	Wakatoshikami
context: Mitoshinokami\Otoshimioyanokami\Consecrated Gods\Wakatoshikami\Mitoshinokami\Otoshimioyanokami\Consecrated Gods\Wakatoshikami response:	Mitoshinokami
context: Otoshimioyanokami\Consecrated Gods\Wakatoshikami\Mitoshinokami\Otoshimioyanokami\Consecrated Gods\Wakatoshikami\Mitoshinokami response:	Otoshimioyanokami
context: Consecrated Gods\Wakatoshikami\Mitoshinokami\Otoshimioyanokami\Consecrated Gods\Wakatoshikami\Mitoshinokami\Otoshimioyanokami response:	Consecrated Gods
context: Wakatoshikami\Mitoshinokami\Otoshimioyanokami\Consecrated Gods\Wakatoshikami\Mitoshinokami\Otoshimioyanokami\Consecrated Gods response:	Wakatoshikami
context: Mitoshinokami\Otoshimioyanokami\Consecrated Gods\Wakatoshikami\Mitoshinokami\Otoshimioyanokami\Consecrated Gods\Wakatoshikami response:	Mitoshinokami
context: Otoshimioyanokami\Consecrated Gods\Wakatoshikami\Mitoshinokami\Otoshimioyanokami\Consecrated Gods\Wakatoshikami\Mitoshinokami response:	Otoshimioyanokami
context: Consecrated Gods\Wakatoshikami\Mitoshinokami\Otoshimioyanokami\Consecrated Gods\Wakatoshikami\Mitoshinokami\Otoshimioyanokami response:	Consecrated Gods
context: Wakatoshikami\Mitoshinokami\Otoshimioyanokami\Consecrated Gods\Wakatoshikami\Mitoshinokami\Otoshimioyanokami\Consecrated Gods response:	Wakatoshikami
context: Mitoshinokami\Otoshimioyanokami\Consecrated Gods\Wakatoshikami\Mitoshinokami\Otoshimioyanokami\Consecrated Gods\Wakatoshikami response:	Mitoshinokami
context: Otoshimioyanokami\Consecrated Gods\Wakatoshikami\Mitoshinokami\Otoshimioyanokami\Consecrated Gods\Wakatoshikami\Mitoshinokami response:	Otoshimioyanokami
context: Consecrated Gods\Wakatoshikami\Mitoshinokami\Otoshimioyanokami\Consecrated Gods\Wakatoshikami\Mitoshinokami\Otoshimioyanokami response:	Consecrated Gods
context: Wakatoshikami\Mitoshinokami\Otoshimioyanokami\Consecrated Gods\Wakatoshikami\Mitoshinokami\Otoshimioyanokami\Consecrated Gods response:	Wakatoshikami
context: Mitoshinokami\Otoshimioyanokami\Consecrated Gods\Wakatoshikami\Mitoshinokami\Otoshimioyanokami\Consecrated Gods\Wakatoshikami response:	Mitoshinokami
context: Otoshimioyanokami\Consecrated Gods\Wakatoshikami\Mitoshinokami\Otoshimioyanokami\Consecrated Gods\Wakatoshikami\Mitoshinokami response:	Otoshimioyanokami
context: Consecrated Gods\Wakatoshikami\Mitoshinokami\Otoshimioyanokami\Consecrated Gods\Wakatoshikami\Mitoshinokami\Otoshimioyanokami response:	Consecrated Gods
context: Wakatoshikami\Mitoshinokami\Otoshimioyanokami\Consecrated Gods\Wakatoshikami\Mitoshinokami\Otoshimioyanokami\Consecrated Gods response:	Wakatoshikami
context: Mitoshinokami\Otoshimioyanokami\Consecrated Gods\Wakatoshikami\Mitoshinokami\Otoshimioyanokami\Consecrated Gods\Wakatoshikami response:	Mitoshinokami
context: Otoshimioyanokami\Consecrated Gods\Wakatoshikami\Mitoshinokami\Otoshimioyanokami\Consecrated Gods\Wakatoshikami\Mitoshinokami response:	Otoshimioyanokami
context: Consecrated Gods\Wakatoshikami\Mitoshinokami\Otoshimioyanokami\Consecrated Gods\Wakatoshikami\Mitoshinokami\Otoshimioyanokami response:	Consecrated Gods
context: Wakatoshikami\Mitoshinokami\Otoshimioyanokami\Consecrated Gods\Wakatoshikami\Mitoshinokami\Otoshimioyanokami\Consecrated Gods response:	Wakatoshikami
context: Mitoshinokami\Otoshimioyanokami\Consecrated Gods\Wakatoshikami\Mitoshinokami\Otoshimioyanokami\Consecrated Gods\Wakatoshikami response:	Mitoshinokami
context: Otoshimioyanokami\Consecrated Gods\Wakatoshikami\Mitoshinokami\Otoshimioyanokami\Consecrated Gods\Wakatoshikami\Mitoshinokami response:	Otoshimioyanokami
context: Consecrated Gods\Wakatoshikami\Mitoshinokami\Otoshimioyanokami\Consecrated Gods\Wakatoshikami\Mitoshinokami\Otoshimioyanokami response:	Consecrated Gods
context: Wakatoshikami\Mitoshinokami\Otoshimioyanokami\Consecrated Gods\Wakatoshikami\Mitoshinokami\Otoshimioyanokami\Consecrated Gods response:	Wakatoshikami
context: Mitoshinokami\Otoshimioyanokami\Consecrated Gods\Wakatoshikami\Mitoshinokami\Otoshimioyanokami\Consecrated Gods\Wakatoshikami response:	Mitoshinokami
context: Otoshimioyanokami\Consecrated Gods\Wakatoshikami\Mitoshinokami\Otoshimioyanokami\Consecrated Gods\Wakatoshikami\Mitoshinokami response:	Otoshimioyanokami
context: Consecrated Gods\Wakatoshikami\Mitoshinokami\Otoshimioyanokami\Consecrated Gods\Wakatoshikami\Mitoshinokami\Otoshimioyanokami response:	Thank you very much, Lord Year God.
context: Wakatoshikami\Mitoshinokami\Otoshimioyanokami\Consecrated Gods\Wakatoshikami\Mitoshinokami\Otoshimioyanokami\Thank you very much, Lord Year God. response:	One more thing.
context: Mitoshinokami\Otoshimioyanokami\Consecrated Gods\Wakatoshikami\Mitoshinokami\Otoshimioyanokami\Thank you very much, Lord Year God.\One more thing. response:	A present. My way of saying thanks.
context: Otoshimioyanokami\Consecrated Gods\Wakatoshikami\Mitoshinokami\Otoshimioyanokami\Thank you very much, Lord Year God.\One more thing.\A present. My way of saying thanks. response:	I heard you say that after the fire, you didn't have any left.
context: Consecrated Gods\Wakatoshikami\Mitoshinokami\Otoshimioyanokami\Thank you very much, Lord Year God.\One more thing.\A present. My way of saying thanks.\I heard you say that after the fire, you didn't have any left. response:	With the memories I saw while you were in the Torii Gates of Twelve...
context: Wakatoshikami\Mitoshinokami\Otoshimioyanokami\Thank you very much, Lord Year God.\One more thing.\A present. My way of saying thanks.\I heard you say that after the fire, you didn't have any left.\With the memories I saw while you were in the Torii Gates of Twelve... response:	I can make you a print.
context: Mitoshinokami\Otoshimioyanokami\Thank you very much, Lord Year God.\One more thing.\A present. My way of saying thanks.\I heard you say that after the fire, you didn't have any left.\With the memories I saw while you were in the Torii Gates of Twelve...\I can make you a print. response:	What is the matter, Nanami?
context: Otoshimioyanokami\Thank you very much, Lord Year God.\One more thing.\A present. My way of saying thanks.\I heard you say that after the fire, you didn't have any left.\With the memories I saw while you were in the Torii Gates of Twelve...\I can make you a print.\What is the matter, Nanami? response:	Mom...
context: Thank you very much, Lord Year God.\One more thing.\A present. My way of saying thanks.\I heard you say that after the fire, you didn't have any left.\With the memories I saw while you were in the Torii Gates of Twelve...\I can make you a print.\What is the matter, Nanami?\Mom... response:	I see.
context: One more thing.\A present. My way of saying thanks.\I heard you say that after the fire, you didn't have any left.\With the memories I saw while you were in the Torii Gates of Twelve...\I can make you a print.\What is the matter, Nanami?\Mom...\I see. response:	They have not vanished after all.
context: A present. My way of saying thanks.\I heard you say that after the fire, you didn't have any left.\With the memories I saw while you were in the Torii Gates of Twelve...\I can make you a print.\What is the matter, Nanami?\Mom...\I see.\They have not vanished after all. response:	Neither the child nor the mother.
context: I heard you say that after the fire, you didn't have any left.\With the memories I saw while you were in the Torii Gates of Twelve...\I can make you a print.\What is the matter, Nanami?\Mom...\I see.\They have not vanished after all.\Neither the child nor the mother. response:	Even the emotions she felt back then...
context: With the memories I saw while you were in the Torii Gates of Twelve...\I can make you a print.\What is the matter, Nanami?\Mom...\I see.\They have not vanished after all.\Neither the child nor the mother.\Even the emotions she felt back then... response:	All of these things live on inside her.
context: I can make you a print.\What is the matter, Nanami?\Mom...\I see.\They have not vanished after all.\Neither the child nor the mother.\Even the emotions she felt back then...\All of these things live on inside her. response:	Even though...
context: What is the matter, Nanami?\Mom...\I see.\They have not vanished after all.\Neither the child nor the mother.\Even the emotions she felt back then...\All of these things live on inside her.\Even though... response:	she may not remember.
context: Mom...\I see.\They have not vanished after all.\Neither the child nor the mother.\Even the emotions she felt back then...\All of these things live on inside her.\Even though...\she may not remember. response:	Heave-ho!
context: I see.\They have not vanished after all.\Neither the child nor the mother.\Even the emotions she felt back then...\All of these things live on inside her.\Even though...\she may not remember.\Heave-ho! response:	Oh! Wait! Wait!
context: They have not vanished after all.\Neither the child nor the mother.\Even the emotions she felt back then...\All of these things live on inside her.\Even though...\she may not remember.\Heave-ho!\Oh! Wait! Wait! response:	Please take these ones too!
context: Neither the child nor the mother.\Even the emotions she felt back then...\All of these things live on inside her.\Even though...\she may not remember.\Heave-ho!\Oh! Wait! Wait!\Please take these ones too! response:	Sure thing.
context: Even the emotions she felt back then...\All of these things live on inside her.\Even though...\she may not remember.\Heave-ho!\Oh! Wait! Wait!\Please take these ones too!\Sure thing. response:	Whew!
context: All of these things live on inside her.\Even though...\she may not remember.\Heave-ho!\Oh! Wait! Wait!\Please take these ones too!\Sure thing.\Whew! response:	It's the first New Year since I became a god.
context: Even though...\she may not remember.\Heave-ho!\Oh! Wait! Wait!\Please take these ones too!\Sure thing.\Whew!\It's the first New Year since I became a god. response:	So much has happened. It's hard to believe.
context: she may not remember.\Heave-ho!\Oh! Wait! Wait!\Please take these ones too!\Sure thing.\Whew!\It's the first New Year since I became a god.\So much has happened. It's hard to believe. response:	Traffic Safety
context: Heave-ho!\Oh! Wait! Wait!\Please take these ones too!\Sure thing.\Whew!\It's the first New Year since I became a god.\So much has happened. It's hard to believe.\Traffic Safety response:	Marital Happiness
context: Oh! Wait! Wait!\Please take these ones too!\Sure thing.\Whew!\It's the first New Year since I became a god.\So much has happened. It's hard to believe.\Traffic Safety\Marital Happiness response:	Good Business
context: Please take these ones too!\Sure thing.\Whew!\It's the first New Year since I became a god.\So much has happened. It's hard to believe.\Traffic Safety\Marital Happiness\Good Business response:	Safety of Family
context: Sure thing.\Whew!\It's the first New Year since I became a god.\So much has happened. It's hard to believe.\Traffic Safety\Marital Happiness\Good Business\Safety of Family response:	Fruition of Love
context: Whew!\It's the first New Year since I became a god.\So much has happened. It's hard to believe.\Traffic Safety\Marital Happiness\Good Business\Safety of Family\Fruition of Love response:	Long Life
context: It's the first New Year since I became a god.\So much has happened. It's hard to believe.\Traffic Safety\Marital Happiness\Good Business\Safety of Family\Fruition of Love\Long Life response:	As a god...
context: So much has happened. It's hard to believe.\Traffic Safety\Marital Happiness\Good Business\Safety of Family\Fruition of Love\Long Life\As a god... response:	I stayed up late and made talismans for the first shrine visits of the year!
context: Traffic Safety\Marital Happiness\Good Business\Safety of Family\Fruition of Love\Long Life\As a god...\I stayed up late and made talismans for the first shrine visits of the year! response:	That's the Nanami I know! You're so thoughtful.
context: Marital Happiness\Good Business\Safety of Family\Fruition of Love\Long Life\As a god...\I stayed up late and made talismans for the first shrine visits of the year!\That's the Nanami I know! You're so thoughtful. response:	Slip
context: Good Business\Safety of Family\Fruition of Love\Long Life\As a god...\I stayed up late and made talismans for the first shrine visits of the year!\That's the Nanami I know! You're so thoughtful.\Slip response:	Slip
context: Safety of Family\Fruition of Love\Long Life\As a god...\I stayed up late and made talismans for the first shrine visits of the year!\That's the Nanami I know! You're so thoughtful.\Slip\Slip response:	Let me see.
context: Fruition of Love\Long Life\As a god...\I stayed up late and made talismans for the first shrine visits of the year!\That's the Nanami I know! You're so thoughtful.\Slip\Slip\Let me see. response:	What did you do that for?!
context: Long Life\As a god...\I stayed up late and made talismans for the first shrine visits of the year!\That's the Nanami I know! You're so thoughtful.\Slip\Slip\Let me see.\What did you do that for?! response:	Because any worshiper who is sorry enough to ask for your blessing
context: As a god...\I stayed up late and made talismans for the first shrine visits of the year!\That's the Nanami I know! You're so thoughtful.\Slip\Slip\Let me see.\What did you do that for?!\Because any worshiper who is sorry enough to ask for your blessing response:	should not be further punished by your orange-scented chicken scratches.
context: I stayed up late and made talismans for the first shrine visits of the year!\That's the Nanami I know! You're so thoughtful.\Slip\Slip\Let me see.\What did you do that for?!\Because any worshiper who is sorry enough to ask for your blessing\should not be further punished by your orange-scented chicken scratches. response:	The more I think about it, the more I realize how much we've gone through.
context: That's the Nanami I know! You're so thoughtful.\Slip\Slip\Let me see.\What did you do that for?!\Because any worshiper who is sorry enough to ask for your blessing\should not be further punished by your orange-scented chicken scratches.\The more I think about it, the more I realize how much we've gone through. response:	Yes, yes. I know, Grandmother Izanami.
context: Slip\Slip\Let me see.\What did you do that for?!\Because any worshiper who is sorry enough to ask for your blessing\should not be further punished by your orange-scented chicken scratches.\The more I think about it, the more I realize how much we've gone through.\Yes, yes. I know, Grandmother Izanami. response:	But I'm extremely busy preparing for New Year's Eve right now.
context: Slip\Let me see.\What did you do that for?!\Because any worshiper who is sorry enough to ask for your blessing\should not be further punished by your orange-scented chicken scratches.\The more I think about it, the more I realize how much we've gone through.\Yes, yes. I know, Grandmother Izanami.\But I'm extremely busy preparing for New Year's Eve right now. response:	Yes, but of course!
context: Let me see.\What did you do that for?!\Because any worshiper who is sorry enough to ask for your blessing\should not be further punished by your orange-scented chicken scratches.\The more I think about it, the more I realize how much we've gone through.\Yes, yes. I know, Grandmother Izanami.\But I'm extremely busy preparing for New Year's Eve right now.\Yes, but of course! response:	I've made the arrangements for your favorite dishes.
context: What did you do that for?!\Because any worshiper who is sorry enough to ask for your blessing\should not be further punished by your orange-scented chicken scratches.\The more I think about it, the more I realize how much we've gone through.\Yes, yes. I know, Grandmother Izanami.\But I'm extremely busy preparing for New Year's Eve right now.\Yes, but of course!\I've made the arrangements for your favorite dishes. response:	Lord Ookuninushi, please look over these as well.
context: Because any worshiper who is sorry enough to ask for your blessing\should not be further punished by your orange-scented chicken scratches.\The more I think about it, the more I realize how much we've gone through.\Yes, yes. I know, Grandmother Izanami.\But I'm extremely busy preparing for New Year's Eve right now.\Yes, but of course!\I've made the arrangements for your favorite dishes.\Lord Ookuninushi, please look over these as well. response:	Hey, Kotarou.
context: should not be further punished by your orange-scented chicken scratches.\The more I think about it, the more I realize how much we've gone through.\Yes, yes. I know, Grandmother Izanami.\But I'm extremely busy preparing for New Year's Eve right now.\Yes, but of course!\I've made the arrangements for your favorite dishes.\Lord Ookuninushi, please look over these as well.\Hey, Kotarou. response:	For our New Year's shrine visit, what dost thou say to going to Mikage Shrine?
context: The more I think about it, the more I realize how much we've gone through.\Yes, yes. I know, Grandmother Izanami.\But I'm extremely busy preparing for New Year's Eve right now.\Yes, but of course!\I've made the arrangements for your favorite dishes.\Lord Ookuninushi, please look over these as well.\Hey, Kotarou.\For our New Year's shrine visit, what dost thou say to going to Mikage Shrine? response:	Was that the shrine that Momozono works at?
context: Yes, yes. I know, Grandmother Izanami.\But I'm extremely busy preparing for New Year's Eve right now.\Yes, but of course!\I've made the arrangements for your favorite dishes.\Lord Ookuninushi, please look over these as well.\Hey, Kotarou.\For our New Year's shrine visit, what dost thou say to going to Mikage Shrine?\Was that the shrine that Momozono works at? response:	I wish to go with thee!
context: But I'm extremely busy preparing for New Year's Eve right now.\Yes, but of course!\I've made the arrangements for your favorite dishes.\Lord Ookuninushi, please look over these as well.\Hey, Kotarou.\For our New Year's shrine visit, what dost thou say to going to Mikage Shrine?\Was that the shrine that Momozono works at?\I wish to go with thee! response:	And to see where we will hold our ceremony.
context: Yes, but of course!\I've made the arrangements for your favorite dishes.\Lord Ookuninushi, please look over these as well.\Hey, Kotarou.\For our New Year's shrine visit, what dost thou say to going to Mikage Shrine?\Was that the shrine that Momozono works at?\I wish to go with thee!\And to see where we will hold our ceremony. response:	Oh!
context: I've made the arrangements for your favorite dishes.\Lord Ookuninushi, please look over these as well.\Hey, Kotarou.\For our New Year's shrine visit, what dost thou say to going to Mikage Shrine?\Was that the shrine that Momozono works at?\I wish to go with thee!\And to see where we will hold our ceremony.\Oh! response:	Look, Himemiko! I set a new personal record!
context: Lord Ookuninushi, please look over these as well.\Hey, Kotarou.\For our New Year's shrine visit, what dost thou say to going to Mikage Shrine?\Was that the shrine that Momozono works at?\I wish to go with thee!\And to see where we will hold our ceremony.\Oh!\Look, Himemiko! I set a new personal record! response:	Kota!
context: Hey, Kotarou.\For our New Year's shrine visit, what dost thou say to going to Mikage Shrine?\Was that the shrine that Momozono works at?\I wish to go with thee!\And to see where we will hold our ceremony.\Oh!\Look, Himemiko! I set a new personal record!\Kota! response:	Surely, next year... Surely, next year...
context: For our New Year's shrine visit, what dost thou say to going to Mikage Shrine?\Was that the shrine that Momozono works at?\I wish to go with thee!\And to see where we will hold our ceremony.\Oh!\Look, Himemiko! I set a new personal record!\Kota!\Surely, next year... Surely, next year... response:	Let us pledge ourselves to one another!
context: Was that the shrine that Momozono works at?\I wish to go with thee!\And to see where we will hold our ceremony.\Oh!\Look, Himemiko! I set a new personal record!\Kota!\Surely, next year... Surely, next year...\Let us pledge ourselves to one another! response:	I thought I told you...
context: I wish to go with thee!\And to see where we will hold our ceremony.\Oh!\Look, Himemiko! I set a new personal record!\Kota!\Surely, next year... Surely, next year...\Let us pledge ourselves to one another!\I thought I told you... response:	Don't book any work for me until after the 20th this month.
context: And to see where we will hold our ceremony.\Oh!\Look, Himemiko! I set a new personal record!\Kota!\Surely, next year... Surely, next year...\Let us pledge ourselves to one another!\I thought I told you...\Don't book any work for me until after the 20th this month. response:	Bam
context: Oh!\Look, Himemiko! I set a new personal record!\Kota!\Surely, next year... Surely, next year...\Let us pledge ourselves to one another!\I thought I told you...\Don't book any work for me until after the 20th this month.\Bam response:	Bam
context: Look, Himemiko! I set a new personal record!\Kota!\Surely, next year... Surely, next year...\Let us pledge ourselves to one another!\I thought I told you...\Don't book any work for me until after the 20th this month.\Bam\Bam response:	Bam
context: Kota!\Surely, next year... Surely, next year...\Let us pledge ourselves to one another!\I thought I told you...\Don't book any work for me until after the 20th this month.\Bam\Bam\Bam response:	Bam
context: Surely, next year... Surely, next year...\Let us pledge ourselves to one another!\I thought I told you...\Don't book any work for me until after the 20th this month.\Bam\Bam\Bam\Bam response:	Bam
context: Let us pledge ourselves to one another!\I thought I told you...\Don't book any work for me until after the 20th this month.\Bam\Bam\Bam\Bam\Bam response:	Bam
context: I thought I told you...\Don't book any work for me until after the 20th this month.\Bam\Bam\Bam\Bam\Bam\Bam response:	Bam
context: Don't book any work for me until after the 20th this month.\Bam\Bam\Bam\Bam\Bam\Bam\Bam response:	Bam
context: Bam\Bam\Bam\Bam\Bam\Bam\Bam\Bam response:	Bam
context: Bam\Bam\Bam\Bam\Bam\Bam\Bam\Bam response:	Bam
context: Bam\Bam\Bam\Bam\Bam\Bam\Bam\Bam response:	Bam
context: Bam\Bam\Bam\Bam\Bam\Bam\Bam\Bam response:	Bam
context: Bam\Bam\Bam\Bam\Bam\Bam\Bam\Bam response:	Bam
context: Bam\Bam\Bam\Bam\Bam\Bam\Bam\Bam response:	Bam
context: Bam\Bam\Bam\Bam\Bam\Bam\Bam\Bam response:	Bam
context: Bam\Bam\Bam\Bam\Bam\Bam\Bam\Bam response:	Bam
context: Bam\Bam\Bam\Bam\Bam\Bam\Bam\Bam response:	Bam
context: Bam\Bam\Bam\Bam\Bam\Bam\Bam\Bam response:	Bam
context: Bam\Bam\Bam\Bam\Bam\Bam\Bam\Bam response:	Bam
context: Bam\Bam\Bam\Bam\Bam\Bam\Bam\Bam response:	Bam
context: Bam\Bam\Bam\Bam\Bam\Bam\Bam\Bam response:	Bam
context: Bam\Bam\Bam\Bam\Bam\Bam\Bam\Bam response:	Bam
context: Bam\Bam\Bam\Bam\Bam\Bam\Bam\Bam response:	Bam
context: Bam\Bam\Bam\Bam\Bam\Bam\Bam\Bam response:	Bam
context: Bam\Bam\Bam\Bam\Bam\Bam\Bam\Bam response:	Bam
context: Bam\Bam\Bam\Bam\Bam\Bam\Bam\Bam response:	Bam
context: Bam\Bam\Bam\Bam\Bam\Bam\Bam\Bam response:	Bam
context: Bam\Bam\Bam\Bam\Bam\Bam\Bam\Bam response:	Bam
context: Bam\Bam\Bam\Bam\Bam\Bam\Bam\Bam response:	Bam
context: Bam\Bam\Bam\Bam\Bam\Bam\Bam\Bam response:	Bam
context: Bam\Bam\Bam\Bam\Bam\Bam\Bam\Bam response:	Bam
context: Bam\Bam\Bam\Bam\Bam\Bam\Bam\Bam response:	Bam
context: Bam\Bam\Bam\Bam\Bam\Bam\Bam\Bam response:	Bam
context: Bam\Bam\Bam\Bam\Bam\Bam\Bam\Bam response:	Bam
context: Bam\Bam\Bam\Bam\Bam\Bam\Bam\Bam response:	Bam
context: Bam\Bam\Bam\Bam\Bam\Bam\Bam\Bam response:	Bam
context: Bam\Bam\Bam\Bam\Bam\Bam\Bam\Bam response:	Bam
context: Bam\Bam\Bam\Bam\Bam\Bam\Bam\Bam response:	Bam
context: Bam\Bam\Bam\Bam\Bam\Bam\Bam\Bam response:	Bam
context: Bam\Bam\Bam\Bam\Bam\Bam\Bam\Bam response:	Bam
context: Bam\Bam\Bam\Bam\Bam\Bam\Bam\Bam response:	Good grief, what a badly-fitted door.
context: Bam\Bam\Bam\Bam\Bam\Bam\Bam\Good grief, what a badly-fitted door. response:	Master Shinjurou!
context: Bam\Bam\Bam\Bam\Bam\Bam\Good grief, what a badly-fitted door.\Master Shinjurou! response:	B-Brothers and Botanmaru! It has been so long since I've seen you!
context: Bam\Bam\Bam\Bam\Bam\Good grief, what a badly-fitted door.\Master Shinjurou!\B-Brothers and Botanmaru! It has been so long since I've seen you! response:	So how may I help you, Brother?
context: Bam\Bam\Bam\Bam\Good grief, what a badly-fitted door.\Master Shinjurou!\B-Brothers and Botanmaru! It has been so long since I've seen you!\So how may I help you, Brother? response:	We've come in the service of Soujoubou the Third.
context: Bam\Bam\Bam\Good grief, what a badly-fitted door.\Master Shinjurou!\B-Brothers and Botanmaru! It has been so long since I've seen you!\So how may I help you, Brother?\We've come in the service of Soujoubou the Third. response:	He sends a resolution.
context: Bam\Bam\Good grief, what a badly-fitted door.\Master Shinjurou!\B-Brothers and Botanmaru! It has been so long since I've seen you!\So how may I help you, Brother?\We've come in the service of Soujoubou the Third.\He sends a resolution. response:	You are to spend the New Year in training and refrain from all further immersion in the mundane world.
context: Bam\Good grief, what a badly-fitted door.\Master Shinjurou!\B-Brothers and Botanmaru! It has been so long since I've seen you!\So how may I help you, Brother?\We've come in the service of Soujoubou the Third.\He sends a resolution.\You are to spend the New Year in training and refrain from all further immersion in the mundane world. response:	As your senior, I've come to oversee your progress.
context: Good grief, what a badly-fitted door.\Master Shinjurou!\B-Brothers and Botanmaru! It has been so long since I've seen you!\So how may I help you, Brother?\We've come in the service of Soujoubou the Third.\He sends a resolution.\You are to spend the New Year in training and refrain from all further immersion in the mundane world.\As your senior, I've come to oversee your progress. response:	What?!
context: Master Shinjurou!\B-Brothers and Botanmaru! It has been so long since I've seen you!\So how may I help you, Brother?\We've come in the service of Soujoubou the Third.\He sends a resolution.\You are to spend the New Year in training and refrain from all further immersion in the mundane world.\As your senior, I've come to oversee your progress.\What?! response:	That is not our only reason for coming.
context: B-Brothers and Botanmaru! It has been so long since I've seen you!\So how may I help you, Brother?\We've come in the service of Soujoubou the Third.\He sends a resolution.\You are to spend the New Year in training and refrain from all further immersion in the mundane world.\As your senior, I've come to oversee your progress.\What?!\That is not our only reason for coming. response:	We were concerned for our brother with whom we have been reunited by fate.
context: So how may I help you, Brother?\We've come in the service of Soujoubou the Third.\He sends a resolution.\You are to spend the New Year in training and refrain from all further immersion in the mundane world.\As your senior, I've come to oversee your progress.\What?!\That is not our only reason for coming.\We were concerned for our brother with whom we have been reunited by fate. response:	So we came to check in on you as representatives of the mountain.
context: We've come in the service of Soujoubou the Third.\He sends a resolution.\You are to spend the New Year in training and refrain from all further immersion in the mundane world.\As your senior, I've come to oversee your progress.\What?!\That is not our only reason for coming.\We were concerned for our brother with whom we have been reunited by fate.\So we came to check in on you as representatives of the mountain. response:	And we thought you might take us to the shrine of the lady land god who did so much for us.
context: He sends a resolution.\You are to spend the New Year in training and refrain from all further immersion in the mundane world.\As your senior, I've come to oversee your progress.\What?!\That is not our only reason for coming.\We were concerned for our brother with whom we have been reunited by fate.\So we came to check in on you as representatives of the mountain.\And we thought you might take us to the shrine of the lady land god who did so much for us. response:	So that's why you tagged along, Brother Jirou.
context: You are to spend the New Year in training and refrain from all further immersion in the mundane world.\As your senior, I've come to oversee your progress.\What?!\That is not our only reason for coming.\We were concerned for our brother with whom we have been reunited by fate.\So we came to check in on you as representatives of the mountain.\And we thought you might take us to the shrine of the lady land god who did so much for us.\So that's why you tagged along, Brother Jirou. response:	The old year will end,
context: As your senior, I've come to oversee your progress.\What?!\That is not our only reason for coming.\We were concerned for our brother with whom we have been reunited by fate.\So we came to check in on you as representatives of the mountain.\And we thought you might take us to the shrine of the lady land god who did so much for us.\So that's why you tagged along, Brother Jirou.\The old year will end, response:	and a new year will come for each of us.
context: What?!\That is not our only reason for coming.\We were concerned for our brother with whom we have been reunited by fate.\So we came to check in on you as representatives of the mountain.\And we thought you might take us to the shrine of the lady land god who did so much for us.\So that's why you tagged along, Brother Jirou.\The old year will end,\and a new year will come for each of us. response:	All year long,
context: That is not our only reason for coming.\We were concerned for our brother with whom we have been reunited by fate.\So we came to check in on you as representatives of the mountain.\And we thought you might take us to the shrine of the lady land god who did so much for us.\So that's why you tagged along, Brother Jirou.\The old year will end,\and a new year will come for each of us.\All year long, response:	we've laughed, and we've cried.
context: We were concerned for our brother with whom we have been reunited by fate.\So we came to check in on you as representatives of the mountain.\And we thought you might take us to the shrine of the lady land god who did so much for us.\So that's why you tagged along, Brother Jirou.\The old year will end,\and a new year will come for each of us.\All year long,\we've laughed, and we've cried. response:	It's been a crazy year, but...
context: So we came to check in on you as representatives of the mountain.\And we thought you might take us to the shrine of the lady land god who did so much for us.\So that's why you tagged along, Brother Jirou.\The old year will end,\and a new year will come for each of us.\All year long,\we've laughed, and we've cried.\It's been a crazy year, but... response:	it's also been a lot of fun.
context: And we thought you might take us to the shrine of the lady land god who did so much for us.\So that's why you tagged along, Brother Jirou.\The old year will end,\and a new year will come for each of us.\All year long,\we've laughed, and we've cried.\It's been a crazy year, but...\it's also been a lot of fun. response:	Another year comes to an end.
context: So that's why you tagged along, Brother Jirou.\The old year will end,\and a new year will come for each of us.\All year long,\we've laughed, and we've cried.\It's been a crazy year, but...\it's also been a lot of fun.\Another year comes to an end. response:	It has been a long year, and yet it really flew by.
context: The old year will end,\and a new year will come for each of us.\All year long,\we've laughed, and we've cried.\It's been a crazy year, but...\it's also been a lot of fun.\Another year comes to an end.\It has been a long year, and yet it really flew by. response:	Yeah...
context: and a new year will come for each of us.\All year long,\we've laughed, and we've cried.\It's been a crazy year, but...\it's also been a lot of fun.\Another year comes to an end.\It has been a long year, and yet it really flew by.\Yeah... response:	Oh, Nanami, snow!
context: All year long,\we've laughed, and we've cried.\It's been a crazy year, but...\it's also been a lot of fun.\Another year comes to an end.\It has been a long year, and yet it really flew by.\Yeah...\Oh, Nanami, snow! response:	What?
context: we've laughed, and we've cried.\It's been a crazy year, but...\it's also been a lot of fun.\Another year comes to an end.\It has been a long year, and yet it really flew by.\Yeah...\Oh, Nanami, snow!\What? response:	You're right!
context: It's been a crazy year, but...\it's also been a lot of fun.\Another year comes to an end.\It has been a long year, and yet it really flew by.\Yeah...\Oh, Nanami, snow!\What?\You're right! response:	Wow! It's already piling up!
context: it's also been a lot of fun.\Another year comes to an end.\It has been a long year, and yet it really flew by.\Yeah...\Oh, Nanami, snow!\What?\You're right!\Wow! It's already piling up! response:	Only for the time being.
context: Another year comes to an end.\It has been a long year, and yet it really flew by.\Yeah...\Oh, Nanami, snow!\What?\You're right!\Wow! It's already piling up!\Only for the time being. response:	In a few years, when you are older, you will become the head of a household more rowdy than you can imagine.
context: It has been a long year, and yet it really flew by.\Yeah...\Oh, Nanami, snow!\What?\You're right!\Wow! It's already piling up!\Only for the time being.\In a few years, when you are older, you will become the head of a household more rowdy than you can imagine. response:	Hey, let go of me!
context: Yeah...\Oh, Nanami, snow!\What?\You're right!\Wow! It's already piling up!\Only for the time being.\In a few years, when you are older, you will become the head of a household more rowdy than you can imagine.\Hey, let go of me! response:	Knock it off!
context: Oh, Nanami, snow!\What?\You're right!\Wow! It's already piling up!\Only for the time being.\In a few years, when you are older, you will become the head of a household more rowdy than you can imagine.\Hey, let go of me!\Knock it off! response:	Strange. I can't remember who told me that.
context: What?\You're right!\Wow! It's already piling up!\Only for the time being.\In a few years, when you are older, you will become the head of a household more rowdy than you can imagine.\Hey, let go of me!\Knock it off!\Strange. I can't remember who told me that. response:	Nanami.
context: You're right!\Wow! It's already piling up!\Only for the time being.\In a few years, when you are older, you will become the head of a household more rowdy than you can imagine.\Hey, let go of me!\Knock it off!\Strange. I can't remember who told me that.\Nanami. response:	What?
context: Wow! It's already piling up!\Only for the time being.\In a few years, when you are older, you will become the head of a household more rowdy than you can imagine.\Hey, let go of me!\Knock it off!\Strange. I can't remember who told me that.\Nanami.\What? response:	Peel this mandarin for me.
context: Only for the time being.\In a few years, when you are older, you will become the head of a household more rowdy than you can imagine.\Hey, let go of me!\Knock it off!\Strange. I can't remember who told me that.\Nanami.\What?\Peel this mandarin for me. response:	I can't get it right.
context: In a few years, when you are older, you will become the head of a household more rowdy than you can imagine.\Hey, let go of me!\Knock it off!\Strange. I can't remember who told me that.\Nanami.\What?\Peel this mandarin for me.\I can't get it right. response:	Okay, sure.
context: Hey, let go of me!\Knock it off!\Strange. I can't remember who told me that.\Nanami.\What?\Peel this mandarin for me.\I can't get it right.\Okay, sure. response:	You can do that yourself, you stinking brat!
context: Knock it off!\Strange. I can't remember who told me that.\Nanami.\What?\Peel this mandarin for me.\I can't get it right.\Okay, sure.\You can do that yourself, you stinking brat! response:	That's right! Nanami isn't your mom, so stop acting like a baby!
context: Strange. I can't remember who told me that.\Nanami.\What?\Peel this mandarin for me.\I can't get it right.\Okay, sure.\You can do that yourself, you stinking brat!\That's right! Nanami isn't your mom, so stop acting like a baby! response:	Oh, I don't really mind if Mamoru thinks of me as his mom for now.
context: Nanami.\What?\Peel this mandarin for me.\I can't get it right.\Okay, sure.\You can do that yourself, you stinking brat!\That's right! Nanami isn't your mom, so stop acting like a baby!\Oh, I don't really mind if Mamoru thinks of me as his mom for now. response:	Say, Ah!
context: What?\Peel this mandarin for me.\I can't get it right.\Okay, sure.\You can do that yourself, you stinking brat!\That's right! Nanami isn't your mom, so stop acting like a baby!\Oh, I don't really mind if Mamoru thinks of me as his mom for now.\Say, Ah! response:	Ah!
context: Peel this mandarin for me.\I can't get it right.\Okay, sure.\You can do that yourself, you stinking brat!\That's right! Nanami isn't your mom, so stop acting like a baby!\Oh, I don't really mind if Mamoru thinks of me as his mom for now.\Say, Ah!\Ah! response:	What? No fair!
context: I can't get it right.\Okay, sure.\You can do that yourself, you stinking brat!\That's right! Nanami isn't your mom, so stop acting like a baby!\Oh, I don't really mind if Mamoru thinks of me as his mom for now.\Say, Ah!\Ah!\What? No fair! response:	Nanami, don't leave us to get married like a mom would, okay?
context: Okay, sure.\You can do that yourself, you stinking brat!\That's right! Nanami isn't your mom, so stop acting like a baby!\Oh, I don't really mind if Mamoru thinks of me as his mom for now.\Say, Ah!\Ah!\What? No fair!\Nanami, don't leave us to get married like a mom would, okay? response:	I want you to stay my lady and mistress forever and ever!
context: You can do that yourself, you stinking brat!\That's right! Nanami isn't your mom, so stop acting like a baby!\Oh, I don't really mind if Mamoru thinks of me as his mom for now.\Say, Ah!\Ah!\What? No fair!\Nanami, don't leave us to get married like a mom would, okay?\I want you to stay my lady and mistress forever and ever! response:	I'm not sure I like that either.
context: That's right! Nanami isn't your mom, so stop acting like a baby!\Oh, I don't really mind if Mamoru thinks of me as his mom for now.\Say, Ah!\Ah!\What? No fair!\Nanami, don't leave us to get married like a mom would, okay?\I want you to stay my lady and mistress forever and ever!\I'm not sure I like that either. response:	Don't worry. I'm not getting married.
context: Oh, I don't really mind if Mamoru thinks of me as his mom for now.\Say, Ah!\Ah!\What? No fair!\Nanami, don't leave us to get married like a mom would, okay?\I want you to stay my lady and mistress forever and ever!\I'm not sure I like that either.\Don't worry. I'm not getting married. response:	Probably.
context: Say, Ah!\Ah!\What? No fair!\Nanami, don't leave us to get married like a mom would, okay?\I want you to stay my lady and mistress forever and ever!\I'm not sure I like that either.\Don't worry. I'm not getting married.\Probably. response:	Probably?