context: Note that though we may be apart, if I am to hear response:	Can I copy your homework?
context: Note that though we may be apart, if I am to hear\Can I copy your homework? response:	No good. What was the second verse?
context: Note that though we may be apart, if I am to hear\Can I copy your homework?\No good. What was the second verse? response:	Again?
context: Note that though we may be apart, if I am to hear\Can I copy your homework?\No good. What was the second verse?\Again? response:	that you pine for me as the Inaba mountain pines, I shall return to you.
context: Note that though we may be apart, if I am to hear\Can I copy your homework?\No good. What was the second verse?\Again?\that you pine for me as the Inaba mountain pines, I shall return to you. response:	Chihaya is a good name.
context: Note that though we may be apart, if I am to hear\Can I copy your homework?\No good. What was the second verse?\Again?\that you pine for me as the Inaba mountain pines, I shall return to you.\Chihaya is a good name. response:	Look, this is your card.
context: Note that though we may be apart, if I am to hear\Can I copy your homework?\No good. What was the second verse?\Again?\that you pine for me as the Inaba mountain pines, I shall return to you.\Chihaya is a good name.\Look, this is your card. response:	the red that is the Tatsuta River
context: Note that though we may be apart, if I am to hear\Can I copy your homework?\No good. What was the second verse?\Again?\that you pine for me as the Inaba mountain pines, I shall return to you.\Chihaya is a good name.\Look, this is your card.\the red that is the Tatsuta River response:	The first verse for this card begins with Chihaya Furu.
context: Can I copy your homework?\No good. What was the second verse?\Again?\that you pine for me as the Inaba mountain pines, I shall return to you.\Chihaya is a good name.\Look, this is your card.\the red that is the Tatsuta River\The first verse for this card begins with Chihaya Furu. response:	This is the card you pick up when you hear Chihaya,
context: No good. What was the second verse?\Again?\that you pine for me as the Inaba mountain pines, I shall return to you.\Chihaya is a good name.\Look, this is your card.\the red that is the Tatsuta River\The first verse for this card begins with Chihaya Furu.\This is the card you pick up when you hear Chihaya, response:	so in my mind, it's the Chihaya card.
context: Again?\that you pine for me as the Inaba mountain pines, I shall return to you.\Chihaya is a good name.\Look, this is your card.\the red that is the Tatsuta River\The first verse for this card begins with Chihaya Furu.\This is the card you pick up when you hear Chihaya,\so in my mind, it's the Chihaya card. response:	Okay! I can do this!
context: that you pine for me as the Inaba mountain pines, I shall return to you.\Chihaya is a good name.\Look, this is your card.\the red that is the Tatsuta River\The first verse for this card begins with Chihaya Furu.\This is the card you pick up when you hear Chihaya,\so in my mind, it's the Chihaya card.\Okay! I can do this! response:	Good morning!
context: Chihaya is a good name.\Look, this is your card.\the red that is the Tatsuta River\The first verse for this card begins with Chihaya Furu.\This is the card you pick up when you hear Chihaya,\so in my mind, it's the Chihaya card.\Okay! I can do this!\Good morning! response:	Huh?
context: Look, this is your card.\the red that is the Tatsuta River\The first verse for this card begins with Chihaya Furu.\This is the card you pick up when you hear Chihaya,\so in my mind, it's the Chihaya card.\Okay! I can do this!\Good morning!\Huh? response:	Oh.
context: the red that is the Tatsuta River\The first verse for this card begins with Chihaya Furu.\This is the card you pick up when you hear Chihaya,\so in my mind, it's the Chihaya card.\Okay! I can do this!\Good morning!\Huh?\Oh. response:	Everyone's gonna start ignoring you tomorrow!
context: The first verse for this card begins with Chihaya Furu.\This is the card you pick up when you hear Chihaya,\so in my mind, it's the Chihaya card.\Okay! I can do this!\Good morning!\Huh?\Oh.\Everyone's gonna start ignoring you tomorrow! response:	I don't care!
context: This is the card you pick up when you hear Chihaya,\so in my mind, it's the Chihaya card.\Okay! I can do this!\Good morning!\Huh?\Oh.\Everyone's gonna start ignoring you tomorrow!\I don't care! response:	I'm gonna ignore you, too!
context: so in my mind, it's the Chihaya card.\Okay! I can do this!\Good morning!\Huh?\Oh.\Everyone's gonna start ignoring you tomorrow!\I don't care!\I'm gonna ignore you, too! response:	I mean it!
context: Okay! I can do this!\Good morning!\Huh?\Oh.\Everyone's gonna start ignoring you tomorrow!\I don't care!\I'm gonna ignore you, too!\I mean it! response:	I said that I don't care!
context: Good morning!\Huh?\Oh.\Everyone's gonna start ignoring you tomorrow!\I don't care!\I'm gonna ignore you, too!\I mean it!\I said that I don't care! response:	If you stop talking to the outsider,
context: Huh?\Oh.\Everyone's gonna start ignoring you tomorrow!\I don't care!\I'm gonna ignore you, too!\I mean it!\I said that I don't care!\If you stop talking to the outsider, response:	we'll stop ignoring you.
context: Oh.\Everyone's gonna start ignoring you tomorrow!\I don't care!\I'm gonna ignore you, too!\I mean it!\I said that I don't care!\If you stop talking to the outsider,\we'll stop ignoring you. response:	I don't mind.
context: Everyone's gonna start ignoring you tomorrow!\I don't care!\I'm gonna ignore you, too!\I mean it!\I said that I don't care!\If you stop talking to the outsider,\we'll stop ignoring you.\I don't mind. response:	You should stop ignoring Wataya-kun instead.
context: I don't care!\I'm gonna ignore you, too!\I mean it!\I said that I don't care!\If you stop talking to the outsider,\we'll stop ignoring you.\I don't mind.\You should stop ignoring Wataya-kun instead. response:	Why do you keep taking his side?!
context: I'm gonna ignore you, too!\I mean it!\I said that I don't care!\If you stop talking to the outsider,\we'll stop ignoring you.\I don't mind.\You should stop ignoring Wataya-kun instead.\Why do you keep taking his side?! response:	Why are you so mean?!
context: I mean it!\I said that I don't care!\If you stop talking to the outsider,\we'll stop ignoring you.\I don't mind.\You should stop ignoring Wataya-kun instead.\Why do you keep taking his side?!\Why are you so mean?! response:	There's nothing to like about this puny and poor bumpkin!
context: I said that I don't care!\If you stop talking to the outsider,\we'll stop ignoring you.\I don't mind.\You should stop ignoring Wataya-kun instead.\Why do you keep taking his side?!\Why are you so mean?!\There's nothing to like about this puny and poor bumpkin! response:	I-It's okay, Ayase-san.
context: If you stop talking to the outsider,\we'll stop ignoring you.\I don't mind.\You should stop ignoring Wataya-kun instead.\Why do you keep taking his side?!\Why are you so mean?!\There's nothing to like about this puny and poor bumpkin!\I-It's okay, Ayase-san. response:	It's okay.
context: we'll stop ignoring you.\I don't mind.\You should stop ignoring Wataya-kun instead.\Why do you keep taking his side?!\Why are you so mean?!\There's nothing to like about this puny and poor bumpkin!\I-It's okay, Ayase-san.\It's okay. response:	There is!
context: I don't mind.\You should stop ignoring Wataya-kun instead.\Why do you keep taking his side?!\Why are you so mean?!\There's nothing to like about this puny and poor bumpkin!\I-It's okay, Ayase-san.\It's okay.\There is! response:	There is!
context: You should stop ignoring Wataya-kun instead.\Why do you keep taking his side?!\Why are you so mean?!\There's nothing to like about this puny and poor bumpkin!\I-It's okay, Ayase-san.\It's okay.\There is!\There is! response:	Wataya-kun can beat everyone here at karuta!
context: Why do you keep taking his side?!\Why are you so mean?!\There's nothing to like about this puny and poor bumpkin!\I-It's okay, Ayase-san.\It's okay.\There is!\There is!\Wataya-kun can beat everyone here at karuta! response:	Right?
context: Why are you so mean?!\There's nothing to like about this puny and poor bumpkin!\I-It's okay, Ayase-san.\It's okay.\There is!\There is!\Wataya-kun can beat everyone here at karuta!\Right? response:	I-
context: There's nothing to like about this puny and poor bumpkin!\I-It's okay, Ayase-san.\It's okay.\There is!\There is!\Wataya-kun can beat everyone here at karuta!\Right?\I- response:	I won't let anyone take a single card from me.
context: I-It's okay, Ayase-san.\It's okay.\There is!\There is!\Wataya-kun can beat everyone here at karuta!\Right?\I-\I won't let anyone take a single card from me. response:	I'll make you eat those words!
context: It's okay.\There is!\There is!\Wataya-kun can beat everyone here at karuta!\Right?\I-\I won't let anyone take a single card from me.\I'll make you eat those words! response:	Let's have a showdown at the upcoming karuta tournament!
context: There is!\There is!\Wataya-kun can beat everyone here at karuta!\Right?\I-\I won't let anyone take a single card from me.\I'll make you eat those words!\Let's have a showdown at the upcoming karuta tournament! response:	If anyone takes a card from you,
context: There is!\Wataya-kun can beat everyone here at karuta!\Right?\I-\I won't let anyone take a single card from me.\I'll make you eat those words!\Let's have a showdown at the upcoming karuta tournament!\If anyone takes a card from you, response:	we're ignoring you until you graduate!
context: Wataya-kun can beat everyone here at karuta!\Right?\I-\I won't let anyone take a single card from me.\I'll make you eat those words!\Let's have a showdown at the upcoming karuta tournament!\If anyone takes a card from you,\we're ignoring you until you graduate! response:	Yeah!
context: Right?\I-\I won't let anyone take a single card from me.\I'll make you eat those words!\Let's have a showdown at the upcoming karuta tournament!\If anyone takes a card from you,\we're ignoring you until you graduate!\Yeah! response:	It was a reckless bet,
context: I-\I won't let anyone take a single card from me.\I'll make you eat those words!\Let's have a showdown at the upcoming karuta tournament!\If anyone takes a card from you,\we're ignoring you until you graduate!\Yeah!\It was a reckless bet, response:	but it felt so right.
context: I won't let anyone take a single card from me.\I'll make you eat those words!\Let's have a showdown at the upcoming karuta tournament!\If anyone takes a card from you,\we're ignoring you until you graduate!\Yeah!\It was a reckless bet,\but it felt so right. response:	Because I didn't have anything where I could claim
context: I'll make you eat those words!\Let's have a showdown at the upcoming karuta tournament!\If anyone takes a card from you,\we're ignoring you until you graduate!\Yeah!\It was a reckless bet,\but it felt so right.\Because I didn't have anything where I could claim response:	that no one else could ever beat me!
context: Let's have a showdown at the upcoming karuta tournament!\If anyone takes a card from you,\we're ignoring you until you graduate!\Yeah!\It was a reckless bet,\but it felt so right.\Because I didn't have anything where I could claim\that no one else could ever beat me! response:	Chihaya Furu
context: If anyone takes a card from you,\we're ignoring you until you graduate!\Yeah!\It was a reckless bet,\but it felt so right.\Because I didn't have anything where I could claim\that no one else could ever beat me!\Chihaya Furu response:	Verse 2
context: we're ignoring you until you graduate!\Yeah!\It was a reckless bet,\but it felt so right.\Because I didn't have anything where I could claim\that no one else could ever beat me!\Chihaya Furu\Verse 2 response:	The Red That Is
context: Yeah!\It was a reckless bet,\but it felt so right.\Because I didn't have anything where I could claim\that no one else could ever beat me!\Chihaya Furu\Verse 2\The Red That Is response:	East Osato Elementary School Karuta Tournament
context: It was a reckless bet,\but it felt so right.\Because I didn't have anything where I could claim\that no one else could ever beat me!\Chihaya Furu\Verse 2\The Red That Is\East Osato Elementary School Karuta Tournament response:	Naniwa Bay, now the flower blooms, but for winter.
context: but it felt so right.\Because I didn't have anything where I could claim\that no one else could ever beat me!\Chihaya Furu\Verse 2\The Red That Is\East Osato Elementary School Karuta Tournament\Naniwa Bay, now the flower blooms, but for winter. response:	Here comes spring, now the flower blooms.
context: Because I didn't have anything where I could claim\that no one else could ever beat me!\Chihaya Furu\Verse 2\The Red That Is\East Osato Elementary School Karuta Tournament\Naniwa Bay, now the flower blooms, but for winter.\Here comes spring, now the flower blooms. response:	Hey, why isn't anyone moving?
context: that no one else could ever beat me!\Chihaya Furu\Verse 2\The Red That Is\East Osato Elementary School Karuta Tournament\Naniwa Bay, now the flower blooms, but for winter.\Here comes spring, now the flower blooms.\Hey, why isn't anyone moving? response:	This is just the opening poem.
context: Chihaya Furu\Verse 2\The Red That Is\East Osato Elementary School Karuta Tournament\Naniwa Bay, now the flower blooms, but for winter.\Here comes spring, now the flower blooms.\Hey, why isn't anyone moving?\This is just the opening poem. response:	Opening poem?
context: Verse 2\The Red That Is\East Osato Elementary School Karuta Tournament\Naniwa Bay, now the flower blooms, but for winter.\Here comes spring, now the flower blooms.\Hey, why isn't anyone moving?\This is just the opening poem.\Opening poem? response:	The contest begins with the reading
context: The Red That Is\East Osato Elementary School Karuta Tournament\Naniwa Bay, now the flower blooms, but for winter.\Here comes spring, now the flower blooms.\Hey, why isn't anyone moving?\This is just the opening poem.\Opening poem?\The contest begins with the reading response:	of a poem that isn't one of the Hundred.
context: East Osato Elementary School Karuta Tournament\Naniwa Bay, now the flower blooms, but for winter.\Here comes spring, now the flower blooms.\Hey, why isn't anyone moving?\This is just the opening poem.\Opening poem?\The contest begins with the reading\of a poem that isn't one of the Hundred. response:	Then the match starts. That's what the handout said.
context: Naniwa Bay, now the flower blooms, but for winter.\Here comes spring, now the flower blooms.\Hey, why isn't anyone moving?\This is just the opening poem.\Opening poem?\The contest begins with the reading\of a poem that isn't one of the Hundred.\Then the match starts. That's what the handout said. response:	Oh...
context: Here comes spring, now the flower blooms.\Hey, why isn't anyone moving?\This is just the opening poem.\Opening poem?\The contest begins with the reading\of a poem that isn't one of the Hundred.\Then the match starts. That's what the handout said.\Oh... response:	Kakinomoto no Hitomaro
context: Hey, why isn't anyone moving?\This is just the opening poem.\Opening poem?\The contest begins with the reading\of a poem that isn't one of the Hundred.\Then the match starts. That's what the handout said.\Oh...\Kakinomoto no Hitomaro response:	The tail feathers of the copper pheasant are long,
context: This is just the opening poem.\Opening poem?\The contest begins with the reading\of a poem that isn't one of the Hundred.\Then the match starts. That's what the handout said.\Oh...\Kakinomoto no Hitomaro\The tail feathers of the copper pheasant are long, response:	Uh...
context: Opening poem?\The contest begins with the reading\of a poem that isn't one of the Hundred.\Then the match starts. That's what the handout said.\Oh...\Kakinomoto no Hitomaro\The tail feathers of the copper pheasant are long,\Uh... response:	There it is!
context: The contest begins with the reading\of a poem that isn't one of the Hundred.\Then the match starts. That's what the handout said.\Oh...\Kakinomoto no Hitomaro\The tail feathers of the copper pheasant are long,\Uh...\There it is! response:	Yeah!
context: of a poem that isn't one of the Hundred.\Then the match starts. That's what the handout said.\Oh...\Kakinomoto no Hitomaro\The tail feathers of the copper pheasant are long,\Uh...\There it is!\Yeah! response:	You got this, Taichi!
context: Then the match starts. That's what the handout said.\Oh...\Kakinomoto no Hitomaro\The tail feathers of the copper pheasant are long,\Uh...\There it is!\Yeah!\You got this, Taichi! response:	Nice one, Taichi!
context: Oh...\Kakinomoto no Hitomaro\The tail feathers of the copper pheasant are long,\Uh...\There it is!\Yeah!\You got this, Taichi!\Nice one, Taichi! response:	Too easy.
context: Kakinomoto no Hitomaro\The tail feathers of the copper pheasant are long,\Uh...\There it is!\Yeah!\You got this, Taichi!\Nice one, Taichi!\Too easy. response:	You can win this!
context: The tail feathers of the copper pheasant are long,\Uh...\There it is!\Yeah!\You got this, Taichi!\Nice one, Taichi!\Too easy.\You can win this! response:	Keep it up!
context: Uh...\There it is!\Yeah!\You got this, Taichi!\Nice one, Taichi!\Too easy.\You can win this!\Keep it up! response:	long as the nights I spend alone.
context: There it is!\Yeah!\You got this, Taichi!\Nice one, Taichi!\Too easy.\You can win this!\Keep it up!\long as the nights I spend alone. response:	Next will be the first round matches for the second group.
context: Yeah!\You got this, Taichi!\Nice one, Taichi!\Too easy.\You can win this!\Keep it up!\long as the nights I spend alone.\Next will be the first round matches for the second group. response:	Mashima Taichi Tanno Shouta Umehara Asuka
context: You got this, Taichi!\Nice one, Taichi!\Too easy.\You can win this!\Keep it up!\long as the nights I spend alone.\Next will be the first round matches for the second group.\Mashima Taichi Tanno Shouta Umehara Asuka response:	Will the contestants please step onto the tatami?
context: Nice one, Taichi!\Too easy.\You can win this!\Keep it up!\long as the nights I spend alone.\Next will be the first round matches for the second group.\Mashima Taichi Tanno Shouta Umehara Asuka\Will the contestants please step onto the tatami? response:	You were awesome, Taichi!
context: Too easy.\You can win this!\Keep it up!\long as the nights I spend alone.\Next will be the first round matches for the second group.\Mashima Taichi Tanno Shouta Umehara Asuka\Will the contestants please step onto the tatami?\You were awesome, Taichi! response:	Piece of cake.
context: You can win this!\Keep it up!\long as the nights I spend alone.\Next will be the first round matches for the second group.\Mashima Taichi Tanno Shouta Umehara Asuka\Will the contestants please step onto the tatami?\You were awesome, Taichi!\Piece of cake. response:	Your next match should be just as easy!
context: Keep it up!\long as the nights I spend alone.\Next will be the first round matches for the second group.\Mashima Taichi Tanno Shouta Umehara Asuka\Will the contestants please step onto the tatami?\You were awesome, Taichi!\Piece of cake.\Your next match should be just as easy! response:	I know, right?
context: long as the nights I spend alone.\Next will be the first round matches for the second group.\Mashima Taichi Tanno Shouta Umehara Asuka\Will the contestants please step onto the tatami?\You were awesome, Taichi!\Piece of cake.\Your next match should be just as easy!\I know, right? response:	Wouldn't it be lame if he lost in the first round?
context: Next will be the first round matches for the second group.\Mashima Taichi Tanno Shouta Umehara Asuka\Will the contestants please step onto the tatami?\You were awesome, Taichi!\Piece of cake.\Your next match should be just as easy!\I know, right?\Wouldn't it be lame if he lost in the first round? response:	You'll understand once you've seen him play.
context: Mashima Taichi Tanno Shouta Umehara Asuka\Will the contestants please step onto the tatami?\You were awesome, Taichi!\Piece of cake.\Your next match should be just as easy!\I know, right?\Wouldn't it be lame if he lost in the first round?\You'll understand once you've seen him play. response:	Like a boatsman...
context: Will the contestants please step onto the tatami?\You were awesome, Taichi!\Piece of cake.\Your next match should be just as easy!\I know, right?\Wouldn't it be lame if he lost in the first round?\You'll understand once you've seen him play.\Like a boatsman... response:	Wow.
context: You were awesome, Taichi!\Piece of cake.\Your next match should be just as easy!\I know, right?\Wouldn't it be lame if he lost in the first round?\You'll understand once you've seen him play.\Like a boatsman...\Wow. response:	What was that?
context: Piece of cake.\Your next match should be just as easy!\I know, right?\Wouldn't it be lame if he lost in the first round?\You'll understand once you've seen him play.\Like a boatsman...\Wow.\What was that? response:	Hey, did you see Wataya's match?!
context: Your next match should be just as easy!\I know, right?\Wouldn't it be lame if he lost in the first round?\You'll understand once you've seen him play.\Like a boatsman...\Wow.\What was that?\Hey, did you see Wataya's match?! response:	Yeah, that was crazy.
context: I know, right?\Wouldn't it be lame if he lost in the first round?\You'll understand once you've seen him play.\Like a boatsman...\Wow.\What was that?\Hey, did you see Wataya's match?!\Yeah, that was crazy. response:	Does Taichi have a chance?
context: Wouldn't it be lame if he lost in the first round?\You'll understand once you've seen him play.\Like a boatsman...\Wow.\What was that?\Hey, did you see Wataya's match?!\Yeah, that was crazy.\Does Taichi have a chance? response:	He'll be fine. He can do anything.
context: You'll understand once you've seen him play.\Like a boatsman...\Wow.\What was that?\Hey, did you see Wataya's match?!\Yeah, that was crazy.\Does Taichi have a chance?\He'll be fine. He can do anything. response:	Besides, his mom will be on his case if he loses.
context: Like a boatsman...\Wow.\What was that?\Hey, did you see Wataya's match?!\Yeah, that was crazy.\Does Taichi have a chance?\He'll be fine. He can do anything.\Besides, his mom will be on his case if he loses. response:	Mashima Taichi Wataya Arata
context: Wow.\What was that?\Hey, did you see Wataya's match?!\Yeah, that was crazy.\Does Taichi have a chance?\He'll be fine. He can do anything.\Besides, his mom will be on his case if he loses.\Mashima Taichi Wataya Arata response:	Yeah, he'll have to do whatever it takes to win
context: What was that?\Hey, did you see Wataya's match?!\Yeah, that was crazy.\Does Taichi have a chance?\He'll be fine. He can do anything.\Besides, his mom will be on his case if he loses.\Mashima Taichi Wataya Arata\Yeah, he'll have to do whatever it takes to win response:	if he doesn't want to get in trouble.
context: Hey, did you see Wataya's match?!\Yeah, that was crazy.\Does Taichi have a chance?\He'll be fine. He can do anything.\Besides, his mom will be on his case if he loses.\Mashima Taichi Wataya Arata\Yeah, he'll have to do whatever it takes to win\if he doesn't want to get in trouble. response:	You don't think he'll lose without taking a single card, do you?
context: Yeah, that was crazy.\Does Taichi have a chance?\He'll be fine. He can do anything.\Besides, his mom will be on his case if he loses.\Mashima Taichi Wataya Arata\Yeah, he'll have to do whatever it takes to win\if he doesn't want to get in trouble.\You don't think he'll lose without taking a single card, do you? response:	You're amazing, Wataya-kun!
context: Does Taichi have a chance?\He'll be fine. He can do anything.\Besides, his mom will be on his case if he loses.\Mashima Taichi Wataya Arata\Yeah, he'll have to do whatever it takes to win\if he doesn't want to get in trouble.\You don't think he'll lose without taking a single card, do you?\You're amazing, Wataya-kun! response:	At this rate, you'll have a perfect victory!
context: He'll be fine. He can do anything.\Besides, his mom will be on his case if he loses.\Mashima Taichi Wataya Arata\Yeah, he'll have to do whatever it takes to win\if he doesn't want to get in trouble.\You don't think he'll lose without taking a single card, do you?\You're amazing, Wataya-kun!\At this rate, you'll have a perfect victory! response:	But you were able to take a card from me.
context: Besides, his mom will be on his case if he loses.\Mashima Taichi Wataya Arata\Yeah, he'll have to do whatever it takes to win\if he doesn't want to get in trouble.\You don't think he'll lose without taking a single card, do you?\You're amazing, Wataya-kun!\At this rate, you'll have a perfect victory!\But you were able to take a card from me. response:	That was a fluke.
context: Mashima Taichi Wataya Arata\Yeah, he'll have to do whatever it takes to win\if he doesn't want to get in trouble.\You don't think he'll lose without taking a single card, do you?\You're amazing, Wataya-kun!\At this rate, you'll have a perfect victory!\But you were able to take a card from me.\That was a fluke. response:	You're wrong.
context: Yeah, he'll have to do whatever it takes to win\if he doesn't want to get in trouble.\You don't think he'll lose without taking a single card, do you?\You're amazing, Wataya-kun!\At this rate, you'll have a perfect victory!\But you were able to take a card from me.\That was a fluke.\You're wrong. response:	Huh?
context: if he doesn't want to get in trouble.\You don't think he'll lose without taking a single card, do you?\You're amazing, Wataya-kun!\At this rate, you'll have a perfect victory!\But you were able to take a card from me.\That was a fluke.\You're wrong.\Huh? response:	You have the instinct of a karuta player.
context: You don't think he'll lose without taking a single card, do you?\You're amazing, Wataya-kun!\At this rate, you'll have a perfect victory!\But you were able to take a card from me.\That was a fluke.\You're wrong.\Huh?\You have the instinct of a karuta player. response:	The instinct of a karuta player?
context: You're amazing, Wataya-kun!\At this rate, you'll have a perfect victory!\But you were able to take a card from me.\That was a fluke.\You're wrong.\Huh?\You have the instinct of a karuta player.\The instinct of a karuta player? response:	Hey!
context: At this rate, you'll have a perfect victory!\But you were able to take a card from me.\That was a fluke.\You're wrong.\Huh?\You have the instinct of a karuta player.\The instinct of a karuta player?\Hey! response:	It's on me!
context: But you were able to take a card from me.\That was a fluke.\You're wrong.\Huh?\You have the instinct of a karuta player.\The instinct of a karuta player?\Hey!\It's on me! response:	You should be grateful!
context: That was a fluke.\You're wrong.\Huh?\You have the instinct of a karuta player.\The instinct of a karuta player?\Hey!\It's on me!\You should be grateful! response:	Taichi?
context: You're wrong.\Huh?\You have the instinct of a karuta player.\The instinct of a karuta player?\Hey!\It's on me!\You should be grateful!\Taichi? response:	What's wrong? It's not poisoned or anything.
context: Huh?\You have the instinct of a karuta player.\The instinct of a karuta player?\Hey!\It's on me!\You should be grateful!\Taichi?\What's wrong? It's not poisoned or anything. response:	Oh, that's not it...
context: You have the instinct of a karuta player.\The instinct of a karuta player?\Hey!\It's on me!\You should be grateful!\Taichi?\What's wrong? It's not poisoned or anything.\Oh, that's not it... response:	Thank you.
context: The instinct of a karuta player?\Hey!\It's on me!\You should be grateful!\Taichi?\What's wrong? It's not poisoned or anything.\Oh, that's not it...\Thank you. response:	Hey, Taichi!
context: Hey!\It's on me!\You should be grateful!\Taichi?\What's wrong? It's not poisoned or anything.\Oh, that's not it...\Thank you.\Hey, Taichi! response:	What do you think you're doing?!
context: It's on me!\You should be grateful!\Taichi?\What's wrong? It's not poisoned or anything.\Oh, that's not it...\Thank you.\Hey, Taichi!\What do you think you're doing?! response:	That was his own fault!
context: You should be grateful!\Taichi?\What's wrong? It's not poisoned or anything.\Oh, that's not it...\Thank you.\Hey, Taichi!\What do you think you're doing?!\That was his own fault! response:	Man, what's Taichi even thinking?
context: Taichi?\What's wrong? It's not poisoned or anything.\Oh, that's not it...\Thank you.\Hey, Taichi!\What do you think you're doing?!\That was his own fault!\Man, what's Taichi even thinking? response:	Sorry, I don't have a handkerchief on me.
context: What's wrong? It's not poisoned or anything.\Oh, that's not it...\Thank you.\Hey, Taichi!\What do you think you're doing?!\That was his own fault!\Man, what's Taichi even thinking?\Sorry, I don't have a handkerchief on me. response:	You can wipe your face on here.
context: Oh, that's not it...\Thank you.\Hey, Taichi!\What do you think you're doing?!\That was his own fault!\Man, what's Taichi even thinking?\Sorry, I don't have a handkerchief on me.\You can wipe your face on here. response:	No, it's okay.
context: Thank you.\Hey, Taichi!\What do you think you're doing?!\That was his own fault!\Man, what's Taichi even thinking?\Sorry, I don't have a handkerchief on me.\You can wipe your face on here.\No, it's okay. response:	It's no big deal.
context: Hey, Taichi!\What do you think you're doing?!\That was his own fault!\Man, what's Taichi even thinking?\Sorry, I don't have a handkerchief on me.\You can wipe your face on here.\No, it's okay.\It's no big deal. response:	Uh, then...
context: What do you think you're doing?!\That was his own fault!\Man, what's Taichi even thinking?\Sorry, I don't have a handkerchief on me.\You can wipe your face on here.\No, it's okay.\It's no big deal.\Uh, then... response:	How about here?
context: That was his own fault!\Man, what's Taichi even thinking?\Sorry, I don't have a handkerchief on me.\You can wipe your face on here.\No, it's okay.\It's no big deal.\Uh, then...\How about here? response:	It's really okay.
context: Man, what's Taichi even thinking?\Sorry, I don't have a handkerchief on me.\You can wipe your face on here.\No, it's okay.\It's no big deal.\Uh, then...\How about here?\It's really okay. response:	What?
context: Sorry, I don't have a handkerchief on me.\You can wipe your face on here.\No, it's okay.\It's no big deal.\Uh, then...\How about here?\It's really okay.\What? response:	What about here?
context: You can wipe your face on here.\No, it's okay.\It's no big deal.\Uh, then...\How about here?\It's really okay.\What?\What about here? response:	I said it's okay.
context: No, it's okay.\It's no big deal.\Uh, then...\How about here?\It's really okay.\What?\What about here?\I said it's okay. response:	Over here then?
context: It's no big deal.\Uh, then...\How about here?\It's really okay.\What?\What about here?\I said it's okay.\Over here then? response:	I don't want to get your clothes wet.
context: Uh, then...\How about here?\It's really okay.\What?\What about here?\I said it's okay.\Over here then?\I don't want to get your clothes wet. response:	You don't have to worry about that!
context: How about here?\It's really okay.\What?\What about here?\I said it's okay.\Over here then?\I don't want to get your clothes wet.\You don't have to worry about that! response:	If I run really fast, they'll dry in a flash!
context: It's really okay.\What?\What about here?\I said it's okay.\Over here then?\I don't want to get your clothes wet.\You don't have to worry about that!\If I run really fast, they'll dry in a flash! response:	Huh? That's strange.
context: What?\What about here?\I said it's okay.\Over here then?\I don't want to get your clothes wet.\You don't have to worry about that!\If I run really fast, they'll dry in a flash!\Huh? That's strange. response:	What's wrong?
context: What about here?\I said it's okay.\Over here then?\I don't want to get your clothes wet.\You don't have to worry about that!\If I run really fast, they'll dry in a flash!\Huh? That's strange.\What's wrong? response:	My glasses...
context: I said it's okay.\Over here then?\I don't want to get your clothes wet.\You don't have to worry about that!\If I run really fast, they'll dry in a flash!\Huh? That's strange.\What's wrong?\My glasses... response:	Huh?
context: Over here then?\I don't want to get your clothes wet.\You don't have to worry about that!\If I run really fast, they'll dry in a flash!\Huh? That's strange.\What's wrong?\My glasses...\Huh? response:	Taichi!
context: I don't want to get your clothes wet.\You don't have to worry about that!\If I run really fast, they'll dry in a flash!\Huh? That's strange.\What's wrong?\My glasses...\Huh?\Taichi! response:	Have you seen Wataya-kun's glasses?
context: You don't have to worry about that!\If I run really fast, they'll dry in a flash!\Huh? That's strange.\What's wrong?\My glasses...\Huh?\Taichi!\Have you seen Wataya-kun's glasses? response:	Nope. Isn't that right?
context: If I run really fast, they'll dry in a flash!\Huh? That's strange.\What's wrong?\My glasses...\Huh?\Taichi!\Have you seen Wataya-kun's glasses?\Nope. Isn't that right? response:	Hmm? Yeah.
context: Huh? That's strange.\What's wrong?\My glasses...\Huh?\Taichi!\Have you seen Wataya-kun's glasses?\Nope. Isn't that right?\Hmm? Yeah. response:	Right.
context: What's wrong?\My glasses...\Huh?\Taichi!\Have you seen Wataya-kun's glasses?\Nope. Isn't that right?\Hmm? Yeah.\Right. response:	Really...
context: My glasses...\Huh?\Taichi!\Have you seen Wataya-kun's glasses?\Nope. Isn't that right?\Hmm? Yeah.\Right.\Really... response:	Eyesight without glasses 0.03
context: Huh?\Taichi!\Have you seen Wataya-kun's glasses?\Nope. Isn't that right?\Hmm? Yeah.\Right.\Really...\Eyesight without glasses 0.03 response:	Ayase-san, I'm pretty sure that Mashima
context: Taichi!\Have you seen Wataya-kun's glasses?\Nope. Isn't that right?\Hmm? Yeah.\Right.\Really...\Eyesight without glasses 0.03\Ayase-san, I'm pretty sure that Mashima response:	was the one who hid my glasses.
context: Have you seen Wataya-kun's glasses?\Nope. Isn't that right?\Hmm? Yeah.\Right.\Really...\Eyesight without glasses 0.03\Ayase-san, I'm pretty sure that Mashima\was the one who hid my glasses. response:	Huh?
context: Nope. Isn't that right?\Hmm? Yeah.\Right.\Really...\Eyesight without glasses 0.03\Ayase-san, I'm pretty sure that Mashima\was the one who hid my glasses.\Huh? response:	Taichi might be selfish, but he's not mean!
context: Hmm? Yeah.\Right.\Really...\Eyesight without glasses 0.03\Ayase-san, I'm pretty sure that Mashima\was the one who hid my glasses.\Huh?\Taichi might be selfish, but he's not mean! response:	And that's not me.
context: Right.\Really...\Eyesight without glasses 0.03\Ayase-san, I'm pretty sure that Mashima\was the one who hid my glasses.\Huh?\Taichi might be selfish, but he's not mean!\And that's not me. response:	We will now begin the final match!
context: Really...\Eyesight without glasses 0.03\Ayase-san, I'm pretty sure that Mashima\was the one who hid my glasses.\Huh?\Taichi might be selfish, but he's not mean!\And that's not me.\We will now begin the final match! response:	I'll go find your glasses!
context: Eyesight without glasses 0.03\Ayase-san, I'm pretty sure that Mashima\was the one who hid my glasses.\Huh?\Taichi might be selfish, but he's not mean!\And that's not me.\We will now begin the final match!\I'll go find your glasses! response:	Hold on!
context: Ayase-san, I'm pretty sure that Mashima\was the one who hid my glasses.\Huh?\Taichi might be selfish, but he's not mean!\And that's not me.\We will now begin the final match!\I'll go find your glasses!\Hold on! response:	Do you really have to lean that close to read them?
context: was the one who hid my glasses.\Huh?\Taichi might be selfish, but he's not mean!\And that's not me.\We will now begin the final match!\I'll go find your glasses!\Hold on!\Do you really have to lean that close to read them? response:	Are you making sure you'll have an excuse when you lose?
context: Huh?\Taichi might be selfish, but he's not mean!\And that's not me.\We will now begin the final match!\I'll go find your glasses!\Hold on!\Do you really have to lean that close to read them?\Are you making sure you'll have an excuse when you lose? response:	J-Just so we're clear...
context: Taichi might be selfish, but he's not mean!\And that's not me.\We will now begin the final match!\I'll go find your glasses!\Hold on!\Do you really have to lean that close to read them?\Are you making sure you'll have an excuse when you lose?\J-Just so we're clear... response:	If I take a card from you, you lose!
context: And that's not me.\We will now begin the final match!\I'll go find your glasses!\Hold on!\Do you really have to lean that close to read them?\Are you making sure you'll have an excuse when you lose?\J-Just so we're clear...\If I take a card from you, you lose! response:	Naniwa Bay, now the flower blooms, but for winter.
context: We will now begin the final match!\I'll go find your glasses!\Hold on!\Do you really have to lean that close to read them?\Are you making sure you'll have an excuse when you lose?\J-Just so we're clear...\If I take a card from you, you lose!\Naniwa Bay, now the flower blooms, but for winter. response:	Here comes spring, now the flower blooms.
context: I'll go find your glasses!\Hold on!\Do you really have to lean that close to read them?\Are you making sure you'll have an excuse when you lose?\J-Just so we're clear...\If I take a card from you, you lose!\Naniwa Bay, now the flower blooms, but for winter.\Here comes spring, now the flower blooms. response:	A mountain stream...
context: Hold on!\Do you really have to lean that close to read them?\Are you making sure you'll have an excuse when you lose?\J-Just so we're clear...\If I take a card from you, you lose!\Naniwa Bay, now the flower blooms, but for winter.\Here comes spring, now the flower blooms.\A mountain stream... response:	That was fast!
context: Do you really have to lean that close to read them?\Are you making sure you'll have an excuse when you lose?\J-Just so we're clear...\If I take a card from you, you lose!\Naniwa Bay, now the flower blooms, but for winter.\Here comes spring, now the flower blooms.\A mountain stream...\That was fast! response:	That scared me.
context: Are you making sure you'll have an excuse when you lose?\J-Just so we're clear...\If I take a card from you, you lose!\Naniwa Bay, now the flower blooms, but for winter.\Here comes spring, now the flower blooms.\A mountain stream...\That was fast!\That scared me. response:	What's going on?
context: J-Just so we're clear...\If I take a card from you, you lose!\Naniwa Bay, now the flower blooms, but for winter.\Here comes spring, now the flower blooms.\A mountain stream...\That was fast!\That scared me.\What's going on? response:	I thought he couldn't see.
context: If I take a card from you, you lose!\Naniwa Bay, now the flower blooms, but for winter.\Here comes spring, now the flower blooms.\A mountain stream...\That was fast!\That scared me.\What's going on?\I thought he couldn't see. response:	I wish...
context: Naniwa Bay, now the flower blooms, but for winter.\Here comes spring, now the flower blooms.\A mountain stream...\That was fast!\That scared me.\What's going on?\I thought he couldn't see.\I wish... response:	No way!
context: Here comes spring, now the flower blooms.\A mountain stream...\That was fast!\That scared me.\What's going on?\I thought he couldn't see.\I wish...\No way! response:	Waves...
context: A mountain stream...\That was fast!\That scared me.\What's going on?\I thought he couldn't see.\I wish...\No way!\Waves... response:	He memorized the initial position of every card?!
context: That was fast!\That scared me.\What's going on?\I thought he couldn't see.\I wish...\No way!\Waves...\He memorized the initial position of every card?! response:	My life means nothing after...
context: That scared me.\What's going on?\I thought he couldn't see.\I wish...\No way!\Waves...\He memorized the initial position of every card?!\My life means nothing after... response:	While some dodge...
context: What's going on?\I thought he couldn't see.\I wish...\No way!\Waves...\He memorized the initial position of every card?!\My life means nothing after...\While some dodge... response:	Oh, Wataya-kun.
context: I thought he couldn't see.\I wish...\No way!\Waves...\He memorized the initial position of every card?!\My life means nothing after...\While some dodge...\Oh, Wataya-kun. response:	That's the wrong card.
context: I wish...\No way!\Waves...\He memorized the initial position of every card?!\My life means nothing after...\While some dodge...\Oh, Wataya-kun.\That's the wrong card. response:	I have learned to both love and hate my fellow man
context: No way!\Waves...\He memorized the initial position of every card?!\My life means nothing after...\While some dodge...\Oh, Wataya-kun.\That's the wrong card.\I have learned to both love and hate my fellow man response:	I deflect your artful words to keep my sleeves dry
context: Waves...\He memorized the initial position of every card?!\My life means nothing after...\While some dodge...\Oh, Wataya-kun.\That's the wrong card.\I have learned to both love and hate my fellow man\I deflect your artful words to keep my sleeves dry response:	Got it!
context: He memorized the initial position of every card?!\My life means nothing after...\While some dodge...\Oh, Wataya-kun.\That's the wrong card.\I have learned to both love and hate my fellow man\I deflect your artful words to keep my sleeves dry\Got it! response:	Nice job, Taichi!
context: My life means nothing after...\While some dodge...\Oh, Wataya-kun.\That's the wrong card.\I have learned to both love and hate my fellow man\I deflect your artful words to keep my sleeves dry\Got it!\Nice job, Taichi! response:	Time to start your comeback!
context: While some dodge...\Oh, Wataya-kun.\That's the wrong card.\I have learned to both love and hate my fellow man\I deflect your artful words to keep my sleeves dry\Got it!\Nice job, Taichi!\Time to start your comeback! response:	The cards have been moved?
context: Oh, Wataya-kun.\That's the wrong card.\I have learned to both love and hate my fellow man\I deflect your artful words to keep my sleeves dry\Got it!\Nice job, Taichi!\Time to start your comeback!\The cards have been moved? response:	My fear is that you will forget your promise to never forget me,
context: That's the wrong card.\I have learned to both love and hate my fellow man\I deflect your artful words to keep my sleeves dry\Got it!\Nice job, Taichi!\Time to start your comeback!\The cards have been moved?\My fear is that you will forget your promise to never forget me, response:	Where is it?
context: I have learned to both love and hate my fellow man\I deflect your artful words to keep my sleeves dry\Got it!\Nice job, Taichi!\Time to start your comeback!\The cards have been moved?\My fear is that you will forget your promise to never forget me,\Where is it? response:	Found it!
context: I deflect your artful words to keep my sleeves dry\Got it!\Nice job, Taichi!\Time to start your comeback!\The cards have been moved?\My fear is that you will forget your promise to never forget me,\Where is it?\Found it! response:	Mashima got another card!
context: Got it!\Nice job, Taichi!\Time to start your comeback!\The cards have been moved?\My fear is that you will forget your promise to never forget me,\Where is it?\Found it!\Mashima got another card! response:	Way to go, Mashima!
context: Nice job, Taichi!\Time to start your comeback!\The cards have been moved?\My fear is that you will forget your promise to never forget me,\Where is it?\Found it!\Mashima got another card!\Way to go, Mashima! response:	Keep it up!
context: Time to start your comeback!\The cards have been moved?\My fear is that you will forget your promise to never forget me,\Where is it?\Found it!\Mashima got another card!\Way to go, Mashima!\Keep it up! response:	When the misty bridge of magpie feathers comes into sight,
context: The cards have been moved?\My fear is that you will forget your promise to never forget me,\Where is it?\Found it!\Mashima got another card!\Way to go, Mashima!\Keep it up!\When the misty bridge of magpie feathers comes into sight, response:	Awesome!
context: My fear is that you will forget your promise to never forget me,\Where is it?\Found it!\Mashima got another card!\Way to go, Mashima!\Keep it up!\When the misty bridge of magpie feathers comes into sight,\Awesome! response:	He got it!
context: Where is it?\Found it!\Mashima got another card!\Way to go, Mashima!\Keep it up!\When the misty bridge of magpie feathers comes into sight,\Awesome!\He got it! response:	That's it, Mashima!
context: Found it!\Mashima got another card!\Way to go, Mashima!\Keep it up!\When the misty bridge of magpie feathers comes into sight,\Awesome!\He got it!\That's it, Mashima! response:	Don't lose to the outsider!
context: Mashima got another card!\Way to go, Mashima!\Keep it up!\When the misty bridge of magpie feathers comes into sight,\Awesome!\He got it!\That's it, Mashima!\Don't lose to the outsider! response:	Wataya's lame!
context: Way to go, Mashima!\Keep it up!\When the misty bridge of magpie feathers comes into sight,\Awesome!\He got it!\That's it, Mashima!\Don't lose to the outsider!\Wataya's lame! response:	That's what you get for bragging about being good at karuta!
context: Keep it up!\When the misty bridge of magpie feathers comes into sight,\Awesome!\He got it!\That's it, Mashima!\Don't lose to the outsider!\Wataya's lame!\That's what you get for bragging about being good at karuta! response:	Take him out, Mashima!
context: When the misty bridge of magpie feathers comes into sight,\Awesome!\He got it!\That's it, Mashima!\Don't lose to the outsider!\Wataya's lame!\That's what you get for bragging about being good at karuta!\Take him out, Mashima! response:	Get him!
context: Awesome!\He got it!\That's it, Mashima!\Don't lose to the outsider!\Wataya's lame!\That's what you get for bragging about being good at karuta!\Take him out, Mashima!\Get him! response:	Do it!
context: He got it!\That's it, Mashima!\Don't lose to the outsider!\Wataya's lame!\That's what you get for bragging about being good at karuta!\Take him out, Mashima!\Get him!\Do it! response:	That's it!
context: That's it, Mashima!\Don't lose to the outsider!\Wataya's lame!\That's what you get for bragging about being good at karuta!\Take him out, Mashima!\Get him!\Do it!\That's it! response:	Sensei!
context: Don't lose to the outsider!\Wataya's lame!\That's what you get for bragging about being good at karuta!\Take him out, Mashima!\Get him!\Do it!\That's it!\Sensei! response:	Can I take Wataya-kun's place?!
context: Wataya's lame!\That's what you get for bragging about being good at karuta!\Take him out, Mashima!\Get him!\Do it!\That's it!\Sensei!\Can I take Wataya-kun's place?! response:	Huh?
context: That's what you get for bragging about being good at karuta!\Take him out, Mashima!\Get him!\Do it!\That's it!\Sensei!\Can I take Wataya-kun's place?!\Huh? response:	Huh?
context: Take him out, Mashima!\Get him!\Do it!\That's it!\Sensei!\Can I take Wataya-kun's place?!\Huh?\Huh? response:	I'll take Wataya-kun's place!
context: Get him!\Do it!\That's it!\Sensei!\Can I take Wataya-kun's place?!\Huh?\Huh?\I'll take Wataya-kun's place! response:	What are you saying?
context: Do it!\That's it!\Sensei!\Can I take Wataya-kun's place?!\Huh?\Huh?\I'll take Wataya-kun's place!\What are you saying? response:	You shouldn't interrupt a match, Ayase-san.
context: That's it!\Sensei!\Can I take Wataya-kun's place?!\Huh?\Huh?\I'll take Wataya-kun's place!\What are you saying?\You shouldn't interrupt a match, Ayase-san. response:	But Sensei! Wataya-kun lost his glasses!
context: Sensei!\Can I take Wataya-kun's place?!\Huh?\Huh?\I'll take Wataya-kun's place!\What are you saying?\You shouldn't interrupt a match, Ayase-san.\But Sensei! Wataya-kun lost his glasses! response:	And um...
context: Can I take Wataya-kun's place?!\Huh?\Huh?\I'll take Wataya-kun's place!\What are you saying?\You shouldn't interrupt a match, Ayase-san.\But Sensei! Wataya-kun lost his glasses!\And um... response:	I'm his number one pupil!
context: Huh?\Huh?\I'll take Wataya-kun's place!\What are you saying?\You shouldn't interrupt a match, Ayase-san.\But Sensei! Wataya-kun lost his glasses!\And um...\I'm his number one pupil! response:	It's true that he doesn't have his glasses.
context: Huh?\I'll take Wataya-kun's place!\What are you saying?\You shouldn't interrupt a match, Ayase-san.\But Sensei! Wataya-kun lost his glasses!\And um...\I'm his number one pupil!\It's true that he doesn't have his glasses. response:	I don't mind.
context: I'll take Wataya-kun's place!\What are you saying?\You shouldn't interrupt a match, Ayase-san.\But Sensei! Wataya-kun lost his glasses!\And um...\I'm his number one pupil!\It's true that he doesn't have his glasses.\I don't mind. response:	Chihaya is obviously weaker.
context: What are you saying?\You shouldn't interrupt a match, Ayase-san.\But Sensei! Wataya-kun lost his glasses!\And um...\I'm his number one pupil!\It's true that he doesn't have his glasses.\I don't mind.\Chihaya is obviously weaker. response:	Thank you!
context: You shouldn't interrupt a match, Ayase-san.\But Sensei! Wataya-kun lost his glasses!\And um...\I'm his number one pupil!\It's true that he doesn't have his glasses.\I don't mind.\Chihaya is obviously weaker.\Thank you! response:	But Chi-chan only has a third of the poems memorized.
context: But Sensei! Wataya-kun lost his glasses!\And um...\I'm his number one pupil!\It's true that he doesn't have his glasses.\I don't mind.\Chihaya is obviously weaker.\Thank you!\But Chi-chan only has a third of the poems memorized. response:	Is she going to be okay?
context: And um...\I'm his number one pupil!\It's true that he doesn't have his glasses.\I don't mind.\Chihaya is obviously weaker.\Thank you!\But Chi-chan only has a third of the poems memorized.\Is she going to be okay? response:	I'm going to win this match for Wataya-kun!
context: I'm his number one pupil!\It's true that he doesn't have his glasses.\I don't mind.\Chihaya is obviously weaker.\Thank you!\But Chi-chan only has a third of the poems memorized.\Is she going to be okay?\I'm going to win this match for Wataya-kun! response:	No...
context: It's true that he doesn't have his glasses.\I don't mind.\Chihaya is obviously weaker.\Thank you!\But Chi-chan only has a third of the poems memorized.\Is she going to be okay?\I'm going to win this match for Wataya-kun!\No... response:	the night is nearly past
context: I don't mind.\Chihaya is obviously weaker.\Thank you!\But Chi-chan only has a third of the poems memorized.\Is she going to be okay?\I'm going to win this match for Wataya-kun!\No...\the night is nearly past response:	I'm not doing this for him.
context: Chihaya is obviously weaker.\Thank you!\But Chi-chan only has a third of the poems memorized.\Is she going to be okay?\I'm going to win this match for Wataya-kun!\No...\the night is nearly past\I'm not doing this for him. response:	I'm...
context: Thank you!\But Chi-chan only has a third of the poems memorized.\Is she going to be okay?\I'm going to win this match for Wataya-kun!\No...\the night is nearly past\I'm not doing this for him.\I'm... response:	I'm the one who's going to defeat Taichi!
context: But Chi-chan only has a third of the poems memorized.\Is she going to be okay?\I'm going to win this match for Wataya-kun!\No...\the night is nearly past\I'm not doing this for him.\I'm...\I'm the one who's going to defeat Taichi! response:	May the scarlet kadsuras of Mount Afusaka...
context: Is she going to be okay?\I'm going to win this match for Wataya-kun!\No...\the night is nearly past\I'm not doing this for him.\I'm...\I'm the one who's going to defeat Taichi!\May the scarlet kadsuras of Mount Afusaka... response:	I know this one!
context: I'm going to win this match for Wataya-kun!\No...\the night is nearly past\I'm not doing this for him.\I'm...\I'm the one who's going to defeat Taichi!\May the scarlet kadsuras of Mount Afusaka...\I know this one! response:	Wh-What are you doing?!
context: No...\the night is nearly past\I'm not doing this for him.\I'm...\I'm the one who's going to defeat Taichi!\May the scarlet kadsuras of Mount Afusaka...\I know this one!\Wh-What are you doing?! response:	You're not supposed to use both hands.
context: the night is nearly past\I'm not doing this for him.\I'm...\I'm the one who's going to defeat Taichi!\May the scarlet kadsuras of Mount Afusaka...\I know this one!\Wh-What are you doing?!\You're not supposed to use both hands. response:	Huh? What order were these in?
context: I'm not doing this for him.\I'm...\I'm the one who's going to defeat Taichi!\May the scarlet kadsuras of Mount Afusaka...\I know this one!\Wh-What are you doing?!\You're not supposed to use both hands.\Huh? What order were these in? response:	You're out of control.
context: I'm...\I'm the one who's going to defeat Taichi!\May the scarlet kadsuras of Mount Afusaka...\I know this one!\Wh-What are you doing?!\You're not supposed to use both hands.\Huh? What order were these in?\You're out of control. response:	When I was playing against Wataya-kun,
context: I'm the one who's going to defeat Taichi!\May the scarlet kadsuras of Mount Afusaka...\I know this one!\Wh-What are you doing?!\You're not supposed to use both hands.\Huh? What order were these in?\You're out of control.\When I was playing against Wataya-kun, response:	Emperor Sutoku Swift waters parted by the jagged rocks
context: May the scarlet kadsuras of Mount Afusaka...\I know this one!\Wh-What are you doing?!\You're not supposed to use both hands.\Huh? What order were these in?\You're out of control.\When I was playing against Wataya-kun,\Emperor Sutoku Swift waters parted by the jagged rocks response:	I was focused on jumping into action
context: I know this one!\Wh-What are you doing?!\You're not supposed to use both hands.\Huh? What order were these in?\You're out of control.\When I was playing against Wataya-kun,\Emperor Sutoku Swift waters parted by the jagged rocks\I was focused on jumping into action response:	are joined at river's end
context: Wh-What are you doing?!\You're not supposed to use both hands.\Huh? What order were these in?\You're out of control.\When I was playing against Wataya-kun,\Emperor Sutoku Swift waters parted by the jagged rocks\I was focused on jumping into action\are joined at river's end response:	as soon as I heard the first word of the first verse.
context: You're not supposed to use both hands.\Huh? What order were these in?\You're out of control.\When I was playing against Wataya-kun,\Emperor Sutoku Swift waters parted by the jagged rocks\I was focused on jumping into action\are joined at river's end\as soon as I heard the first word of the first verse. response:	In other words...
context: Huh? What order were these in?\You're out of control.\When I was playing against Wataya-kun,\Emperor Sutoku Swift waters parted by the jagged rocks\I was focused on jumping into action\are joined at river's end\as soon as I heard the first word of the first verse.\In other words... response:	I just have to keep cycling through the first few words
context: You're out of control.\When I was playing against Wataya-kun,\Emperor Sutoku Swift waters parted by the jagged rocks\I was focused on jumping into action\are joined at river's end\as soon as I heard the first word of the first verse.\In other words...\I just have to keep cycling through the first few words response:	of every first verse!
context: When I was playing against Wataya-kun,\Emperor Sutoku Swift waters parted by the jagged rocks\I was focused on jumping into action\are joined at river's end\as soon as I heard the first word of the first verse.\In other words...\I just have to keep cycling through the first few words\of every first verse! response:	It doesn't matter what the poem means!
context: Emperor Sutoku Swift waters parted by the jagged rocks\I was focused on jumping into action\are joined at river's end\as soon as I heard the first word of the first verse.\In other words...\I just have to keep cycling through the first few words\of every first verse!\It doesn't matter what the poem means! response:	If she reads a card I don't recognize...
context: I was focused on jumping into action\are joined at river's end\as soon as I heard the first word of the first verse.\In other words...\I just have to keep cycling through the first few words\of every first verse!\It doesn't matter what the poem means!\If she reads a card I don't recognize... response:	Since the dew atop the blades of grass
context: are joined at river's end\as soon as I heard the first word of the first verse.\In other words...\I just have to keep cycling through the first few words\of every first verse!\It doesn't matter what the poem means!\If she reads a card I don't recognize...\Since the dew atop the blades of grass response:	I bat away the cards that are in the area Taichi is looking!
context: as soon as I heard the first word of the first verse.\In other words...\I just have to keep cycling through the first few words\of every first verse!\It doesn't matter what the poem means!\If she reads a card I don't recognize...\Since the dew atop the blades of grass\I bat away the cards that are in the area Taichi is looking! response:	That's cheap, Chihaya!
context: In other words...\I just have to keep cycling through the first few words\of every first verse!\It doesn't matter what the poem means!\If she reads a card I don't recognize...\Since the dew atop the blades of grass\I bat away the cards that are in the area Taichi is looking!\That's cheap, Chihaya! response:	Am I allowed to do that, Sensei?
context: I just have to keep cycling through the first few words\of every first verse!\It doesn't matter what the poem means!\If she reads a card I don't recognize...\Since the dew atop the blades of grass\I bat away the cards that are in the area Taichi is looking!\That's cheap, Chihaya!\Am I allowed to do that, Sensei? response:	The rules allow it.
context: of every first verse!\It doesn't matter what the poem means!\If she reads a card I don't recognize...\Since the dew atop the blades of grass\I bat away the cards that are in the area Taichi is looking!\That's cheap, Chihaya!\Am I allowed to do that, Sensei?\The rules allow it. response:	As long as the correct card is removed from the area of play.
context: It doesn't matter what the poem means!\If she reads a card I don't recognize...\Since the dew atop the blades of grass\I bat away the cards that are in the area Taichi is looking!\That's cheap, Chihaya!\Am I allowed to do that, Sensei?\The rules allow it.\As long as the correct card is removed from the area of play. response:	This girl certainly has style.
context: If she reads a card I don't recognize...\Since the dew atop the blades of grass\I bat away the cards that are in the area Taichi is looking!\That's cheap, Chihaya!\Am I allowed to do that, Sensei?\The rules allow it.\As long as the correct card is removed from the area of play.\This girl certainly has style. response:	For you, I head out to the fields to pick spring greens
context: Since the dew atop the blades of grass\I bat away the cards that are in the area Taichi is looking!\That's cheap, Chihaya!\Am I allowed to do that, Sensei?\The rules allow it.\As long as the correct card is removed from the area of play.\This girl certainly has style.\For you, I head out to the fields to pick spring greens response:	The second verse is while snow falls upon...
context: I bat away the cards that are in the area Taichi is looking!\That's cheap, Chihaya!\Am I allowed to do that, Sensei?\The rules allow it.\As long as the correct card is removed from the area of play.\This girl certainly has style.\For you, I head out to the fields to pick spring greens\The second verse is while snow falls upon... response:	I can't lose!
context: That's cheap, Chihaya!\Am I allowed to do that, Sensei?\The rules allow it.\As long as the correct card is removed from the area of play.\This girl certainly has style.\For you, I head out to the fields to pick spring greens\The second verse is while snow falls upon...\I can't lose! response:	Focus on Taichi's movements!
context: Am I allowed to do that, Sensei?\The rules allow it.\As long as the correct card is removed from the area of play.\This girl certainly has style.\For you, I head out to the fields to pick spring greens\The second verse is while snow falls upon...\I can't lose!\Focus on Taichi's movements! response:	Got it!
context: The rules allow it.\As long as the correct card is removed from the area of play.\This girl certainly has style.\For you, I head out to the fields to pick spring greens\The second verse is while snow falls upon...\I can't lose!\Focus on Taichi's movements!\Got it! response:	Why is she so serious?
context: As long as the correct card is removed from the area of play.\This girl certainly has style.\For you, I head out to the fields to pick spring greens\The second verse is while snow falls upon...\I can't lose!\Focus on Taichi's movements!\Got it!\Why is she so serious? response:	Is she...
context: This girl certainly has style.\For you, I head out to the fields to pick spring greens\The second verse is while snow falls upon...\I can't lose!\Focus on Taichi's movements!\Got it!\Why is she so serious?\Is she... response:	Is she doing it for him?
context: For you, I head out to the fields to pick spring greens\The second verse is while snow falls upon...\I can't lose!\Focus on Taichi's movements!\Got it!\Why is she so serious?\Is she...\Is she doing it for him? response:	For that loser?
context: The second verse is while snow falls upon...\I can't lose!\Focus on Taichi's movements!\Got it!\Why is she so serious?\Is she...\Is she doing it for him?\For that loser? response:	Got it!
context: I can't lose!\Focus on Taichi's movements!\Got it!\Why is she so serious?\Is she...\Is she doing it for him?\For that loser?\Got it! response:	What's wrong, Taichi?!
context: Focus on Taichi's movements!\Got it!\Why is she so serious?\Is she...\Is she doing it for him?\For that loser?\Got it!\What's wrong, Taichi?! response:	You better not lose!
context: Got it!\Why is she so serious?\Is she...\Is she doing it for him?\For that loser?\Got it!\What's wrong, Taichi?!\You better not lose! response:	Pull it together!
context: Why is she so serious?\Is she...\Is she doing it for him?\For that loser?\Got it!\What's wrong, Taichi?!\You better not lose!\Pull it together! response:	They're right!
context: Is she...\Is she doing it for him?\For that loser?\Got it!\What's wrong, Taichi?!\You better not lose!\Pull it together!\They're right! response:	Focus!
context: Is she doing it for him?\For that loser?\Got it!\What's wrong, Taichi?!\You better not lose!\Pull it together!\They're right!\Focus! response:	For the...
context: For that loser?\Got it!\What's wrong, Taichi?!\You better not lose!\Pull it together!\They're right!\Focus!\For the... response:	May I find the...
context: Got it!\What's wrong, Taichi?!\You better not lose!\Pull it together!\They're right!\Focus!\For the...\May I find the... response:	Chi-chan got the card!
context: What's wrong, Taichi?!\You better not lose!\Pull it together!\They're right!\Focus!\For the...\May I find the...\Chi-chan got the card! response:	Only one left!
context: You better not lose!\Pull it together!\They're right!\Focus!\For the...\May I find the...\Chi-chan got the card!\Only one left! response:	Only one left.
context: Pull it together!\They're right!\Focus!\For the...\May I find the...\Chi-chan got the card!\Only one left!\Only one left. response:	Only one left.
context: They're right!\Focus!\For the...\May I find the...\Chi-chan got the card!\Only one left!\Only one left.\Only one left. response:	Huh?
context: Focus!\For the...\May I find the...\Chi-chan got the card!\Only one left!\Only one left.\Only one left.\Huh? response:	No way!
context: For the...\May I find the...\Chi-chan got the card!\Only one left!\Only one left.\Only one left.\Huh?\No way! response:	I don't recognize any of the other cards!
context: May I find the...\Chi-chan got the card!\Only one left!\Only one left.\Only one left.\Huh?\No way!\I don't recognize any of the other cards! response:	What do I do?
context: Chi-chan got the card!\Only one left!\Only one left.\Only one left.\Huh?\No way!\I don't recognize any of the other cards!\What do I do? response:	Oh!
context: Only one left!\Only one left.\Only one left.\Huh?\No way!\I don't recognize any of the other cards!\What do I do?\Oh! response:	That's how I see it.
context: Only one left.\Only one left.\Huh?\No way!\I don't recognize any of the other cards!\What do I do?\Oh!\That's how I see it. response:	the red that is the Tatsuta River
context: Only one left.\Huh?\No way!\I don't recognize any of the other cards!\What do I do?\Oh!\That's how I see it.\the red that is the Tatsuta River response:	Chihaya is a good name.
context: Huh?\No way!\I don't recognize any of the other cards!\What do I do?\Oh!\That's how I see it.\the red that is the Tatsuta River\Chihaya is a good name. response:	Chihaya
context: No way!\I don't recognize any of the other cards!\What do I do?\Oh!\That's how I see it.\the red that is the Tatsuta River\Chihaya is a good name.\Chihaya response:	Th-This is...
context: I don't recognize any of the other cards!\What do I do?\Oh!\That's how I see it.\the red that is the Tatsuta River\Chihaya is a good name.\Chihaya\Th-This is... response:	Impassionate gods...
context: What do I do?\Oh!\That's how I see it.\the red that is the Tatsuta River\Chihaya is a good name.\Chihaya\Th-This is...\Impassionate gods... response:	This is how a karuta player sees the world!
context: Oh!\That's how I see it.\the red that is the Tatsuta River\Chihaya is a good name.\Chihaya\Th-This is...\Impassionate gods...\This is how a karuta player sees the world! response:	She did it!
context: That's how I see it.\the red that is the Tatsuta River\Chihaya is a good name.\Chihaya\Th-This is...\Impassionate gods...\This is how a karuta player sees the world!\She did it! response:	Our sixth grade champion is Ayase Chihaya-san from Class 1!
context: the red that is the Tatsuta River\Chihaya is a good name.\Chihaya\Th-This is...\Impassionate gods...\This is how a karuta player sees the world!\She did it!\Our sixth grade champion is Ayase Chihaya-san from Class 1! response:	Man! What's going on?!
context: Chihaya is a good name.\Chihaya\Th-This is...\Impassionate gods...\This is how a karuta player sees the world!\She did it!\Our sixth grade champion is Ayase Chihaya-san from Class 1!\Man! What's going on?! response:	Who cares if I'm not good at karuta!
context: Chihaya\Th-This is...\Impassionate gods...\This is how a karuta player sees the world!\She did it!\Our sixth grade champion is Ayase Chihaya-san from Class 1!\Man! What's going on?!\Who cares if I'm not good at karuta! response:	That was a really fun match!
context: Th-This is...\Impassionate gods...\This is how a karuta player sees the world!\She did it!\Our sixth grade champion is Ayase Chihaya-san from Class 1!\Man! What's going on?!\Who cares if I'm not good at karuta!\That was a really fun match! response:	Karuta is so much fun!
context: Impassionate gods...\This is how a karuta player sees the world!\She did it!\Our sixth grade champion is Ayase Chihaya-san from Class 1!\Man! What's going on?!\Who cares if I'm not good at karuta!\That was a really fun match!\Karuta is so much fun! response:	But it would be a different story if
context: This is how a karuta player sees the world!\She did it!\Our sixth grade champion is Ayase Chihaya-san from Class 1!\Man! What's going on?!\Who cares if I'm not good at karuta!\That was a really fun match!\Karuta is so much fun!\But it would be a different story if response:	you were playing against Wataya-kun!
context: She did it!\Our sixth grade champion is Ayase Chihaya-san from Class 1!\Man! What's going on?!\Who cares if I'm not good at karuta!\That was a really fun match!\Karuta is so much fun!\But it would be a different story if\you were playing against Wataya-kun! response:	He's going to become a master.
context: Our sixth grade champion is Ayase Chihaya-san from Class 1!\Man! What's going on?!\Who cares if I'm not good at karuta!\That was a really fun match!\Karuta is so much fun!\But it would be a different story if\you were playing against Wataya-kun!\He's going to become a master. response:	That makes you the Queen, Ayase-san.
context: Man! What's going on?!\Who cares if I'm not good at karuta!\That was a really fun match!\Karuta is so much fun!\But it would be a different story if\you were playing against Wataya-kun!\He's going to become a master.\That makes you the Queen, Ayase-san. response:	Queen?
context: Who cares if I'm not good at karuta!\That was a really fun match!\Karuta is so much fun!\But it would be a different story if\you were playing against Wataya-kun!\He's going to become a master.\That makes you the Queen, Ayase-san.\Queen? response:	It's the title given to the strongest female player.
context: That was a really fun match!\Karuta is so much fun!\But it would be a different story if\you were playing against Wataya-kun!\He's going to become a master.\That makes you the Queen, Ayase-san.\Queen?\It's the title given to the strongest female player. response:	Queen...
context: Karuta is so much fun!\But it would be a different story if\you were playing against Wataya-kun!\He's going to become a master.\That makes you the Queen, Ayase-san.\Queen?\It's the title given to the strongest female player.\Queen... response:	The best player in Japan...
context: But it would be a different story if\you were playing against Wataya-kun!\He's going to become a master.\That makes you the Queen, Ayase-san.\Queen?\It's the title given to the strongest female player.\Queen...\The best player in Japan... response:	is the best player in the world!
context: you were playing against Wataya-kun!\He's going to become a master.\That makes you the Queen, Ayase-san.\Queen?\It's the title given to the strongest female player.\Queen...\The best player in Japan...\is the best player in the world! response:	I believe that you have the talent for karuta.
context: He's going to become a master.\That makes you the Queen, Ayase-san.\Queen?\It's the title given to the strongest female player.\Queen...\The best player in Japan...\is the best player in the world!\I believe that you have the talent for karuta. response:	Ayase Chihaya This award certifies that you performed admirably in the 7th East Osato Elementary School Karuta Tournament
context: That makes you the Queen, Ayase-san.\Queen?\It's the title given to the strongest female player.\Queen...\The best player in Japan...\is the best player in the world!\I believe that you have the talent for karuta.\Ayase Chihaya This award certifies that you performed admirably in the 7th East Osato Elementary School Karuta Tournament response:	Hello! Mom?
context: Queen?\It's the title given to the strongest female player.\Queen...\The best player in Japan...\is the best player in the world!\I believe that you have the talent for karuta.\Ayase Chihaya This award certifies that you performed admirably in the 7th East Osato Elementary School Karuta Tournament\Hello! Mom? response:	There was a karuta tournament today!
context: It's the title given to the strongest female player.\Queen...\The best player in Japan...\is the best player in the world!\I believe that you have the talent for karuta.\Ayase Chihaya This award certifies that you performed admirably in the 7th East Osato Elementary School Karuta Tournament\Hello! Mom?\There was a karuta tournament today! response:	We don't have any time for that!
context: Queen...\The best player in Japan...\is the best player in the world!\I believe that you have the talent for karuta.\Ayase Chihaya This award certifies that you performed admirably in the 7th East Osato Elementary School Karuta Tournament\Hello! Mom?\There was a karuta tournament today!\We don't have any time for that! response:	There's a scout at our house
context: The best player in Japan...\is the best player in the world!\I believe that you have the talent for karuta.\Ayase Chihaya This award certifies that you performed admirably in the 7th East Osato Elementary School Karuta Tournament\Hello! Mom?\There was a karuta tournament today!\We don't have any time for that!\There's a scout at our house response:	right now who's interested in your sister.
context: is the best player in the world!\I believe that you have the talent for karuta.\Ayase Chihaya This award certifies that you performed admirably in the 7th East Osato Elementary School Karuta Tournament\Hello! Mom?\There was a karuta tournament today!\We don't have any time for that!\There's a scout at our house\right now who's interested in your sister. response:	What?! Really?!
context: I believe that you have the talent for karuta.\Ayase Chihaya This award certifies that you performed admirably in the 7th East Osato Elementary School Karuta Tournament\Hello! Mom?\There was a karuta tournament today!\We don't have any time for that!\There's a scout at our house\right now who's interested in your sister.\What?! Really?! response:	That's amazing!
context: Ayase Chihaya This award certifies that you performed admirably in the 7th East Osato Elementary School Karuta Tournament\Hello! Mom?\There was a karuta tournament today!\We don't have any time for that!\There's a scout at our house\right now who's interested in your sister.\What?! Really?!\That's amazing! response:	He must have seen her in the beauty pageant.
context: Hello! Mom?\There was a karuta tournament today!\We don't have any time for that!\There's a scout at our house\right now who's interested in your sister.\What?! Really?!\That's amazing!\He must have seen her in the beauty pageant. response:	Hurry home.
context: There was a karuta tournament today!\We don't have any time for that!\There's a scout at our house\right now who's interested in your sister.\What?! Really?!\That's amazing!\He must have seen her in the beauty pageant.\Hurry home. response:	I'll have a big dinner ready.
context: We don't have any time for that!\There's a scout at our house\right now who's interested in your sister.\What?! Really?!\That's amazing!\He must have seen her in the beauty pageant.\Hurry home.\I'll have a big dinner ready. response:	We'll throw a party for your sister.
context: There's a scout at our house\right now who's interested in your sister.\What?! Really?!\That's amazing!\He must have seen her in the beauty pageant.\Hurry home.\I'll have a big dinner ready.\We'll throw a party for your sister. response:	U-Um, there was this karuta tournament today and I...
context: right now who's interested in your sister.\What?! Really?!\That's amazing!\He must have seen her in the beauty pageant.\Hurry home.\I'll have a big dinner ready.\We'll throw a party for your sister.\U-Um, there was this karuta tournament today and I... response:	Geez... Hurry up, Mom.
context: What?! Really?!\That's amazing!\He must have seen her in the beauty pageant.\Hurry home.\I'll have a big dinner ready.\We'll throw a party for your sister.\U-Um, there was this karuta tournament today and I...\Geez... Hurry up, Mom. response:	Chihaya?
context: That's amazing!\He must have seen her in the beauty pageant.\Hurry home.\I'll have a big dinner ready.\We'll throw a party for your sister.\U-Um, there was this karuta tournament today and I...\Geez... Hurry up, Mom.\Chihaya? response:	Oh, Sis?
context: He must have seen her in the beauty pageant.\Hurry home.\I'll have a big dinner ready.\We'll throw a party for your sister.\U-Um, there was this karuta tournament today and I...\Geez... Hurry up, Mom.\Chihaya?\Oh, Sis? response:	That's great news!
context: Hurry home.\I'll have a big dinner ready.\We'll throw a party for your sister.\U-Um, there was this karuta tournament today and I...\Geez... Hurry up, Mom.\Chihaya?\Oh, Sis?\That's great news! response:	And today, I was in a karuta tournament!
context: I'll have a big dinner ready.\We'll throw a party for your sister.\U-Um, there was this karuta tournament today and I...\Geez... Hurry up, Mom.\Chihaya?\Oh, Sis?\That's great news!\And today, I was in a karuta tournament! response:	Karuta?
context: We'll throw a party for your sister.\U-Um, there was this karuta tournament today and I...\Geez... Hurry up, Mom.\Chihaya?\Oh, Sis?\That's great news!\And today, I was in a karuta tournament!\Karuta? response:	Boring. And lame.
context: U-Um, there was this karuta tournament today and I...\Geez... Hurry up, Mom.\Chihaya?\Oh, Sis?\That's great news!\And today, I was in a karuta tournament!\Karuta?\Boring. And lame. response:	I'm gonna hang up.
context: Geez... Hurry up, Mom.\Chihaya?\Oh, Sis?\That's great news!\And today, I was in a karuta tournament!\Karuta?\Boring. And lame.\I'm gonna hang up. response:	How could you lose to a girl?
context: Chihaya?\Oh, Sis?\That's great news!\And today, I was in a karuta tournament!\Karuta?\Boring. And lame.\I'm gonna hang up.\How could you lose to a girl? response:	I was recording your matches.
context: Oh, Sis?\That's great news!\And today, I was in a karuta tournament!\Karuta?\Boring. And lame.\I'm gonna hang up.\How could you lose to a girl?\I was recording your matches. response:	Now I can't show this to your father.
context: That's great news!\And today, I was in a karuta tournament!\Karuta?\Boring. And lame.\I'm gonna hang up.\How could you lose to a girl?\I was recording your matches.\Now I can't show this to your father. response:	I-I'm sorry...
context: And today, I was in a karuta tournament!\Karuta?\Boring. And lame.\I'm gonna hang up.\How could you lose to a girl?\I was recording your matches.\Now I can't show this to your father.\I-I'm sorry... response:	It doesn't matter if you can play karuta or not,
context: Karuta?\Boring. And lame.\I'm gonna hang up.\How could you lose to a girl?\I was recording your matches.\Now I can't show this to your father.\I-I'm sorry...\It doesn't matter if you can play karuta or not, response:	but if you're going to lose,
context: Boring. And lame.\I'm gonna hang up.\How could you lose to a girl?\I was recording your matches.\Now I can't show this to your father.\I-I'm sorry...\It doesn't matter if you can play karuta or not,\but if you're going to lose, response:	you're no longer allowed to play in tournaments.
context: I'm gonna hang up.\How could you lose to a girl?\I was recording your matches.\Now I can't show this to your father.\I-I'm sorry...\It doesn't matter if you can play karuta or not,\but if you're going to lose,\you're no longer allowed to play in tournaments. response:	You're a good student and a good athlete.
context: How could you lose to a girl?\I was recording your matches.\Now I can't show this to your father.\I-I'm sorry...\It doesn't matter if you can play karuta or not,\but if you're going to lose,\you're no longer allowed to play in tournaments.\You're a good student and a good athlete. response:	Focus on contests that you can win.
context: I was recording your matches.\Now I can't show this to your father.\I-I'm sorry...\It doesn't matter if you can play karuta or not,\but if you're going to lose,\you're no longer allowed to play in tournaments.\You're a good student and a good athlete.\Focus on contests that you can win. response:	What?
context: Now I can't show this to your father.\I-I'm sorry...\It doesn't matter if you can play karuta or not,\but if you're going to lose,\you're no longer allowed to play in tournaments.\You're a good student and a good athlete.\Focus on contests that you can win.\What? response:	You beat me. Why are you so upset?
context: I-I'm sorry...\It doesn't matter if you can play karuta or not,\but if you're going to lose,\you're no longer allowed to play in tournaments.\You're a good student and a good athlete.\Focus on contests that you can win.\What?\You beat me. Why are you so upset? response:	I'm not.
context: It doesn't matter if you can play karuta or not,\but if you're going to lose,\you're no longer allowed to play in tournaments.\You're a good student and a good athlete.\Focus on contests that you can win.\What?\You beat me. Why are you so upset?\I'm not. response:	What's that sound?
context: but if you're going to lose,\you're no longer allowed to play in tournaments.\You're a good student and a good athlete.\Focus on contests that you can win.\What?\You beat me. Why are you so upset?\I'm not.\What's that sound? response:	Huh?
context: you're no longer allowed to play in tournaments.\You're a good student and a good athlete.\Focus on contests that you can win.\What?\You beat me. Why are you so upset?\I'm not.\What's that sound?\Huh? response:	Didn't you hear that slam?
context: You're a good student and a good athlete.\Focus on contests that you can win.\What?\You beat me. Why are you so upset?\I'm not.\What's that sound?\Huh?\Didn't you hear that slam? response:	Oh, there it is again.
context: Focus on contests that you can win.\What?\You beat me. Why are you so upset?\I'm not.\What's that sound?\Huh?\Didn't you hear that slam?\Oh, there it is again. response:	Sound?
context: What?\You beat me. Why are you so upset?\I'm not.\What's that sound?\Huh?\Didn't you hear that slam?\Oh, there it is again.\Sound? response:	Oh, I can hear it.
context: You beat me. Why are you so upset?\I'm not.\What's that sound?\Huh?\Didn't you hear that slam?\Oh, there it is again.\Sound?\Oh, I can hear it. response:	See?
context: I'm not.\What's that sound?\Huh?\Didn't you hear that slam?\Oh, there it is again.\Sound?\Oh, I can hear it.\See? response:	How good is your hearing?
context: What's that sound?\Huh?\Didn't you hear that slam?\Oh, there it is again.\Sound?\Oh, I can hear it.\See?\How good is your hearing? response:	I wish I was born with a more useful talent.
context: Huh?\Didn't you hear that slam?\Oh, there it is again.\Sound?\Oh, I can hear it.\See?\How good is your hearing?\I wish I was born with a more useful talent. response:	So I could be a good student and athlete like you.
context: Didn't you hear that slam?\Oh, there it is again.\Sound?\Oh, I can hear it.\See?\How good is your hearing?\I wish I was born with a more useful talent.\So I could be a good student and athlete like you. response:	That's true. I was born this good.
context: Oh, there it is again.\Sound?\Oh, I can hear it.\See?\How good is your hearing?\I wish I was born with a more useful talent.\So I could be a good student and athlete like you.\That's true. I was born this good. response:	But I know that you made flashcards for learning the Hundred Poets.
context: Sound?\Oh, I can hear it.\See?\How good is your hearing?\I wish I was born with a more useful talent.\So I could be a good student and athlete like you.\That's true. I was born this good.\But I know that you made flashcards for learning the Hundred Poets. response:	Don't tell anyone.
context: Oh, I can hear it.\See?\How good is your hearing?\I wish I was born with a more useful talent.\So I could be a good student and athlete like you.\That's true. I was born this good.\But I know that you made flashcards for learning the Hundred Poets.\Don't tell anyone. response:	They'll think I'm lame.
context: See?\How good is your hearing?\I wish I was born with a more useful talent.\So I could be a good student and athlete like you.\That's true. I was born this good.\But I know that you made flashcards for learning the Hundred Poets.\Don't tell anyone.\They'll think I'm lame. response:	And then I lost to you.
context: How good is your hearing?\I wish I was born with a more useful talent.\So I could be a good student and athlete like you.\That's true. I was born this good.\But I know that you made flashcards for learning the Hundred Poets.\Don't tell anyone.\They'll think I'm lame.\And then I lost to you. response:	What's so lame about losing in a fair fight?!
context: I wish I was born with a more useful talent.\So I could be a good student and athlete like you.\That's true. I was born this good.\But I know that you made flashcards for learning the Hundred Poets.\Don't tell anyone.\They'll think I'm lame.\And then I lost to you.\What's so lame about losing in a fair fight?! response:	At least, that's what I think.
context: So I could be a good student and athlete like you.\That's true. I was born this good.\But I know that you made flashcards for learning the Hundred Poets.\Don't tell anyone.\They'll think I'm lame.\And then I lost to you.\What's so lame about losing in a fair fight?!\At least, that's what I think. response:	Though nobody's gonna praise you for doing well at karuta.
context: That's true. I was born this good.\But I know that you made flashcards for learning the Hundred Poets.\Don't tell anyone.\They'll think I'm lame.\And then I lost to you.\What's so lame about losing in a fair fight?!\At least, that's what I think.\Though nobody's gonna praise you for doing well at karuta. response:	He doesn't need his glasses...
context: But I know that you made flashcards for learning the Hundred Poets.\Don't tell anyone.\They'll think I'm lame.\And then I lost to you.\What's so lame about losing in a fair fight?!\At least, that's what I think.\Though nobody's gonna praise you for doing well at karuta.\He doesn't need his glasses... response:	Or cards...
context: Don't tell anyone.\They'll think I'm lame.\And then I lost to you.\What's so lame about losing in a fair fight?!\At least, that's what I think.\Though nobody's gonna praise you for doing well at karuta.\He doesn't need his glasses...\Or cards... response:	He can see everything!
context: They'll think I'm lame.\And then I lost to you.\What's so lame about losing in a fair fight?!\At least, that's what I think.\Though nobody's gonna praise you for doing well at karuta.\He doesn't need his glasses...\Or cards...\He can see everything! response:	What are you doing all alone here?
context: And then I lost to you.\What's so lame about losing in a fair fight?!\At least, that's what I think.\Though nobody's gonna praise you for doing well at karuta.\He doesn't need his glasses...\Or cards...\He can see everything!\What are you doing all alone here? response:	You like playing karuta that much?
context: What's so lame about losing in a fair fight?!\At least, that's what I think.\Though nobody's gonna praise you for doing well at karuta.\He doesn't need his glasses...\Or cards...\He can see everything!\What are you doing all alone here?\You like playing karuta that much? response:	I'll go look for your glasses again!
context: At least, that's what I think.\Though nobody's gonna praise you for doing well at karuta.\He doesn't need his glasses...\Or cards...\He can see everything!\What are you doing all alone here?\You like playing karuta that much?\I'll go look for your glasses again! response:	H-Hey, Chihaya!
context: Though nobody's gonna praise you for doing well at karuta.\He doesn't need his glasses...\Or cards...\He can see everything!\What are you doing all alone here?\You like playing karuta that much?\I'll go look for your glasses again!\H-Hey, Chihaya! response:	There are a lot of crows around here,
context: He doesn't need his glasses...\Or cards...\He can see everything!\What are you doing all alone here?\You like playing karuta that much?\I'll go look for your glasses again!\H-Hey, Chihaya!\There are a lot of crows around here, response:	and one of them might have taken the glasses since they're shiny!
context: Or cards...\He can see everything!\What are you doing all alone here?\You like playing karuta that much?\I'll go look for your glasses again!\H-Hey, Chihaya!\There are a lot of crows around here,\and one of them might have taken the glasses since they're shiny! response:	I'll go check the hill behind the school!
context: He can see everything!\What are you doing all alone here?\You like playing karuta that much?\I'll go look for your glasses again!\H-Hey, Chihaya!\There are a lot of crows around here,\and one of them might have taken the glasses since they're shiny!\I'll go check the hill behind the school! response:	Ayase-san!
context: What are you doing all alone here?\You like playing karuta that much?\I'll go look for your glasses again!\H-Hey, Chihaya!\There are a lot of crows around here,\and one of them might have taken the glasses since they're shiny!\I'll go check the hill behind the school!\Ayase-san! response:	Ayase-san, it's okay!
context: You like playing karuta that much?\I'll go look for your glasses again!\H-Hey, Chihaya!\There are a lot of crows around here,\and one of them might have taken the glasses since they're shiny!\I'll go check the hill behind the school!\Ayase-san!\Ayase-san, it's okay! response:	It's okay!
context: I'll go look for your glasses again!\H-Hey, Chihaya!\There are a lot of crows around here,\and one of them might have taken the glasses since they're shiny!\I'll go check the hill behind the school!\Ayase-san!\Ayase-san, it's okay!\It's okay! response:	I have to find them!
context: H-Hey, Chihaya!\There are a lot of crows around here,\and one of them might have taken the glasses since they're shiny!\I'll go check the hill behind the school!\Ayase-san!\Ayase-san, it's okay!\It's okay!\I have to find them! response:	I have to find Wataya-kun's glasses!
context: There are a lot of crows around here,\and one of them might have taken the glasses since they're shiny!\I'll go check the hill behind the school!\Ayase-san!\Ayase-san, it's okay!\It's okay!\I have to find them!\I have to find Wataya-kun's glasses! response:	I want to help Wataya-kun play karuta!
context: and one of them might have taken the glasses since they're shiny!\I'll go check the hill behind the school!\Ayase-san!\Ayase-san, it's okay!\It's okay!\I have to find them!\I have to find Wataya-kun's glasses!\I want to help Wataya-kun play karuta! response:	Ayase-san...
context: I'll go check the hill behind the school!\Ayase-san!\Ayase-san, it's okay!\It's okay!\I have to find them!\I have to find Wataya-kun's glasses!\I want to help Wataya-kun play karuta!\Ayase-san... response:	found them in the hallway.
context: Ayase-san!\Ayase-san, it's okay!\It's okay!\I have to find them!\I have to find Wataya-kun's glasses!\I want to help Wataya-kun play karuta!\Ayase-san...\found them in the hallway. response:	N-No.
context: Ayase-san, it's okay!\It's okay!\I have to find them!\I have to find Wataya-kun's glasses!\I want to help Wataya-kun play karuta!\Ayase-san...\found them in the hallway.\N-No. response:	I stole them.
context: It's okay!\I have to find them!\I have to find Wataya-kun's glasses!\I want to help Wataya-kun play karuta!\Ayase-san...\found them in the hallway.\N-No.\I stole them. response:	They're not here.
context: I have to find them!\I have to find Wataya-kun's glasses!\I want to help Wataya-kun play karuta!\Ayase-san...\found them in the hallway.\N-No.\I stole them.\They're not here. response:	Oh, sorry!
context: I have to find Wataya-kun's glasses!\I want to help Wataya-kun play karuta!\Ayase-san...\found them in the hallway.\N-No.\I stole them.\They're not here.\Oh, sorry! response:	Don't tell Chihaya.
context: I want to help Wataya-kun play karuta!\Ayase-san...\found them in the hallway.\N-No.\I stole them.\They're not here.\Oh, sorry!\Don't tell Chihaya. response:	I don't want
context: Ayase-san...\found them in the hallway.\N-No.\I stole them.\They're not here.\Oh, sorry!\Don't tell Chihaya.\I don't want response:	her to hate me.
context: found them in the hallway.\N-No.\I stole them.\They're not here.\Oh, sorry!\Don't tell Chihaya.\I don't want\her to hate me. response:	Mashima, you're...
context: N-No.\I stole them.\They're not here.\Oh, sorry!\Don't tell Chihaya.\I don't want\her to hate me.\Mashima, you're... response:	a coward.
context: I stole them.\They're not here.\Oh, sorry!\Don't tell Chihaya.\I don't want\her to hate me.\Mashima, you're...\a coward. response:	A Coward
context: They're not here.\Oh, sorry!\Don't tell Chihaya.\I don't want\her to hate me.\Mashima, you're...\a coward.\A Coward response:	A-A coward?
context: Oh, sorry!\Don't tell Chihaya.\I don't want\her to hate me.\Mashima, you're...\a coward.\A Coward\A-A coward? response:	But...
context: Don't tell Chihaya.\I don't want\her to hate me.\Mashima, you're...\a coward.\A Coward\A-A coward?\But... response:	I understand how you feel.
context: I don't want\her to hate me.\Mashima, you're...\a coward.\A Coward\A-A coward?\But...\I understand how you feel. response:	They're not here either!
context: her to hate me.\Mashima, you're...\a coward.\A Coward\A-A coward?\But...\I understand how you feel.\They're not here either! response:	How many crow nests are there anyway?
context: Mashima, you're...\a coward.\A Coward\A-A coward?\But...\I understand how you feel.\They're not here either!\How many crow nests are there anyway? response:	Chihaya!
context: a coward.\A Coward\A-A coward?\But...\I understand how you feel.\They're not here either!\How many crow nests are there anyway?\Chihaya! response:	I found my glasses!
context: A Coward\A-A coward?\But...\I understand how you feel.\They're not here either!\How many crow nests are there anyway?\Chihaya!\I found my glasses! response:	Hey! Where are you?!
context: A-A coward?\But...\I understand how you feel.\They're not here either!\How many crow nests are there anyway?\Chihaya!\I found my glasses!\Hey! Where are you?! response:	Ayase-san...
context: But...\I understand how you feel.\They're not here either!\How many crow nests are there anyway?\Chihaya!\I found my glasses!\Hey! Where are you?!\Ayase-san... response:	Chihaya!
context: I understand how you feel.\They're not here either!\How many crow nests are there anyway?\Chihaya!\I found my glasses!\Hey! Where are you?!\Ayase-san...\Chihaya! response:	Chihaya!
context: They're not here either!\How many crow nests are there anyway?\Chihaya!\I found my glasses!\Hey! Where are you?!\Ayase-san...\Chihaya!\Chihaya! response:	Chi
context: How many crow nests are there anyway?\Chihaya!\I found my glasses!\Hey! Where are you?!\Ayase-san...\Chihaya!\Chihaya!\Chi response:	Chihaya.
context: Chihaya!\I found my glasses!\Hey! Where are you?!\Ayase-san...\Chihaya!\Chihaya!\Chi\Chihaya. response:	Chihaya!
context: I found my glasses!\Hey! Where are you?!\Ayase-san...\Chihaya!\Chihaya!\Chi\Chihaya.\Chihaya! response:	Here!
context: Hey! Where are you?!\Ayase-san...\Chihaya!\Chihaya!\Chi\Chihaya.\Chihaya!\Here! response:	That was when I knew.
context: Ayase-san...\Chihaya!\Chihaya!\Chi\Chihaya.\Chihaya!\Here!\That was when I knew. response:	I would discover many lifelong treasures this winter.