context: The 88 Stars of the Heavens. response:	Shine!
context: The 88 Stars of the Heavens.\Shine! response:	Urano Meteoria!
context: The 88 Stars of the Heavens.\Shine!\Urano Meteoria! response:	If it's love and dreams and you it'll become magical.
context: The 88 Stars of the Heavens.\Shine!\Urano Meteoria!\If it's love and dreams and you it'll become magical. response:	Now, let's cast a smile spell!
context: The 88 Stars of the Heavens.\Shine!\Urano Meteoria!\If it's love and dreams and you it'll become magical.\Now, let's cast a smile spell! response:	I kind of admired this powerful world,
context: The 88 Stars of the Heavens.\Shine!\Urano Meteoria!\If it's love and dreams and you it'll become magical.\Now, let's cast a smile spell!\I kind of admired this powerful world, response:	chock-full of problems.
context: The 88 Stars of the Heavens.\Shine!\Urano Meteoria!\If it's love and dreams and you it'll become magical.\Now, let's cast a smile spell!\I kind of admired this powerful world,\chock-full of problems. response:	Frozen time has started to move again
context: The 88 Stars of the Heavens.\Shine!\Urano Meteoria!\If it's love and dreams and you it'll become magical.\Now, let's cast a smile spell!\I kind of admired this powerful world,\chock-full of problems.\Frozen time has started to move again response:	ever since I met you.
context: Shine!\Urano Meteoria!\If it's love and dreams and you it'll become magical.\Now, let's cast a smile spell!\I kind of admired this powerful world,\chock-full of problems.\Frozen time has started to move again\ever since I met you. response:	Why were we born? Why do we live?
context: Urano Meteoria!\If it's love and dreams and you it'll become magical.\Now, let's cast a smile spell!\I kind of admired this powerful world,\chock-full of problems.\Frozen time has started to move again\ever since I met you.\Why were we born? Why do we live? response:	I don't need any complicated answers.
context: If it's love and dreams and you it'll become magical.\Now, let's cast a smile spell!\I kind of admired this powerful world,\chock-full of problems.\Frozen time has started to move again\ever since I met you.\Why were we born? Why do we live?\I don't need any complicated answers. response:	Laugh! Cry! Be honest with yourself.
context: Now, let's cast a smile spell!\I kind of admired this powerful world,\chock-full of problems.\Frozen time has started to move again\ever since I met you.\Why were we born? Why do we live?\I don't need any complicated answers.\Laugh! Cry! Be honest with yourself. response:	Simple feelings are the most important.
context: I kind of admired this powerful world,\chock-full of problems.\Frozen time has started to move again\ever since I met you.\Why were we born? Why do we live?\I don't need any complicated answers.\Laugh! Cry! Be honest with yourself.\Simple feelings are the most important. response:	You can change those tears shed on sad nights into strength.
context: chock-full of problems.\Frozen time has started to move again\ever since I met you.\Why were we born? Why do we live?\I don't need any complicated answers.\Laugh! Cry! Be honest with yourself.\Simple feelings are the most important.\You can change those tears shed on sad nights into strength. response:	Now, let's cast a smile spell!
context: Frozen time has started to move again\ever since I met you.\Why were we born? Why do we live?\I don't need any complicated answers.\Laugh! Cry! Be honest with yourself.\Simple feelings are the most important.\You can change those tears shed on sad nights into strength.\Now, let's cast a smile spell! response:	Huh? What was I...
context: ever since I met you.\Why were we born? Why do we live?\I don't need any complicated answers.\Laugh! Cry! Be honest with yourself.\Simple feelings are the most important.\You can change those tears shed on sad nights into strength.\Now, let's cast a smile spell!\Huh? What was I... response:	What happened?
context: Why were we born? Why do we live?\I don't need any complicated answers.\Laugh! Cry! Be honest with yourself.\Simple feelings are the most important.\You can change those tears shed on sad nights into strength.\Now, let's cast a smile spell!\Huh? What was I...\What happened? response:	Hibiki! Happy!
context: I don't need any complicated answers.\Laugh! Cry! Be honest with yourself.\Simple feelings are the most important.\You can change those tears shed on sad nights into strength.\Now, let's cast a smile spell!\Huh? What was I...\What happened?\Hibiki! Happy! response:	Oh right, Natsu!
context: Laugh! Cry! Be honest with yourself.\Simple feelings are the most important.\You can change those tears shed on sad nights into strength.\Now, let's cast a smile spell!\Huh? What was I...\What happened?\Hibiki! Happy!\Oh right, Natsu! response:	Oracion Seis... doesn't lose...
context: Simple feelings are the most important.\You can change those tears shed on sad nights into strength.\Now, let's cast a smile spell!\Huh? What was I...\What happened?\Hibiki! Happy!\Oh right, Natsu!\Oracion Seis... doesn't lose... response:	Recollections of Jellal.
context: You can change those tears shed on sad nights into strength.\Now, let's cast a smile spell!\Huh? What was I...\What happened?\Hibiki! Happy!\Oh right, Natsu!\Oracion Seis... doesn't lose...\Recollections of Jellal. response:	What is this...
context: Now, let's cast a smile spell!\Huh? What was I...\What happened?\Hibiki! Happy!\Oh right, Natsu!\Oracion Seis... doesn't lose...\Recollections of Jellal.\What is this... response:	It's like I have no power at all...
context: Huh? What was I...\What happened?\Hibiki! Happy!\Oh right, Natsu!\Oracion Seis... doesn't lose...\Recollections of Jellal.\What is this...\It's like I have no power at all... response:	And hey... Why is she so beat up?
context: What happened?\Hibiki! Happy!\Oh right, Natsu!\Oracion Seis... doesn't lose...\Recollections of Jellal.\What is this...\It's like I have no power at all...\And hey... Why is she so beat up? response:	One woman, one kill!
context: Hibiki! Happy!\Oh right, Natsu!\Oracion Seis... doesn't lose...\Recollections of Jellal.\What is this...\It's like I have no power at all...\And hey... Why is she so beat up?\One woman, one kill! response:	Blast away to oblivion!
context: Oh right, Natsu!\Oracion Seis... doesn't lose...\Recollections of Jellal.\What is this...\It's like I have no power at all...\And hey... Why is she so beat up?\One woman, one kill!\Blast away to oblivion! response:	It missed?
context: Oracion Seis... doesn't lose...\Recollections of Jellal.\What is this...\It's like I have no power at all...\And hey... Why is she so beat up?\One woman, one kill!\Blast away to oblivion!\It missed? response:	You too?!
context: Recollections of Jellal.\What is this...\It's like I have no power at all...\And hey... Why is she so beat up?\One woman, one kill!\Blast away to oblivion!\It missed?\You too?! response:	Natsu!
context: What is this...\It's like I have no power at all...\And hey... Why is she so beat up?\One woman, one kill!\Blast away to oblivion!\It missed?\You too?!\Natsu! response:	My prayer...
context: It's like I have no power at all...\And hey... Why is she so beat up?\One woman, one kill!\Blast away to oblivion!\It missed?\You too?!\Natsu!\My prayer... response:	My prayer...
context: And hey... Why is she so beat up?\One woman, one kill!\Blast away to oblivion!\It missed?\You too?!\Natsu!\My prayer...\My prayer... response:	To disappear into the sky...
context: One woman, one kill!\Blast away to oblivion!\It missed?\You too?!\Natsu!\My prayer...\My prayer...\To disappear into the sky... response:	I said sky, not water!
context: Blast away to oblivion!\It missed?\You too?!\Natsu!\My prayer...\My prayer...\To disappear into the sky...\I said sky, not water! response:	Natsu!
context: It missed?\You too?!\Natsu!\My prayer...\My prayer...\To disappear into the sky...\I said sky, not water!\Natsu! response:	Get it together!
context: You too?!\Natsu!\My prayer...\My prayer...\To disappear into the sky...\I said sky, not water!\Natsu!\Get it together! response:	Hold out your hand, Natsu!
context: Natsu!\My prayer...\My prayer...\To disappear into the sky...\I said sky, not water!\Natsu!\Get it together!\Hold out your hand, Natsu! response:	What the... Rapids?
context: My prayer...\My prayer...\To disappear into the sky...\I said sky, not water!\Natsu!\Get it together!\Hold out your hand, Natsu!\What the... Rapids? response:	Hold it a sec... You've got to be kidding me!
context: My prayer...\To disappear into the sky...\I said sky, not water!\Natsu!\Get it together!\Hold out your hand, Natsu!\What the... Rapids?\Hold it a sec... You've got to be kidding me! response:	Natsu!
context: To disappear into the sky...\I said sky, not water!\Natsu!\Get it together!\Hold out your hand, Natsu!\What the... Rapids?\Hold it a sec... You've got to be kidding me!\Natsu! response:	I-Impossible...
context: I said sky, not water!\Natsu!\Get it together!\Hold out your hand, Natsu!\What the... Rapids?\Hold it a sec... You've got to be kidding me!\Natsu!\I-Impossible... response:	Even Angel has fallen?
context: Natsu!\Get it together!\Hold out your hand, Natsu!\What the... Rapids?\Hold it a sec... You've got to be kidding me!\Natsu!\I-Impossible...\Even Angel has fallen? response:	Your death will not be in vain!
context: Get it together!\Hold out your hand, Natsu!\What the... Rapids?\Hold it a sec... You've got to be kidding me!\Natsu!\I-Impossible...\Even Angel has fallen?\Your death will not be in vain! response:	The extinction of the light will begin soon!
context: Hold out your hand, Natsu!\What the... Rapids?\Hold it a sec... You've got to be kidding me!\Natsu!\I-Impossible...\Even Angel has fallen?\Your death will not be in vain!\The extinction of the light will begin soon! response:	I'm not dead, buddy.
context: What the... Rapids?\Hold it a sec... You've got to be kidding me!\Natsu!\I-Impossible...\Even Angel has fallen?\Your death will not be in vain!\The extinction of the light will begin soon!\I'm not dead, buddy. response:	Jellal is alive?
context: Hold it a sec... You've got to be kidding me!\Natsu!\I-Impossible...\Even Angel has fallen?\Your death will not be in vain!\The extinction of the light will begin soon!\I'm not dead, buddy.\Jellal is alive? response:	But how?
context: Natsu!\I-Impossible...\Even Angel has fallen?\Your death will not be in vain!\The extinction of the light will begin soon!\I'm not dead, buddy.\Jellal is alive?\But how? response:	And wait... Why is he here?
context: I-Impossible...\Even Angel has fallen?\Your death will not be in vain!\The extinction of the light will begin soon!\I'm not dead, buddy.\Jellal is alive?\But how?\And wait... Why is he here? response:	Erza...
context: Even Angel has fallen?\Your death will not be in vain!\The extinction of the light will begin soon!\I'm not dead, buddy.\Jellal is alive?\But how?\And wait... Why is he here?\Erza... response:	Erza, there is no such thing as freedom in this world.
context: Your death will not be in vain!\The extinction of the light will begin soon!\I'm not dead, buddy.\Jellal is alive?\But how?\And wait... Why is he here?\Erza...\Erza, there is no such thing as freedom in this world. response:	Let Erza go!
context: The extinction of the light will begin soon!\I'm not dead, buddy.\Jellal is alive?\But how?\And wait... Why is he here?\Erza...\Erza, there is no such thing as freedom in this world.\Let Erza go! response:	I don't know... I don't know how I should face him...
context: I'm not dead, buddy.\Jellal is alive?\But how?\And wait... Why is he here?\Erza...\Erza, there is no such thing as freedom in this world.\Let Erza go!\I don't know... I don't know how I should face him... response:	My heavens...
context: Jellal is alive?\But how?\And wait... Why is he here?\Erza...\Erza, there is no such thing as freedom in this world.\Let Erza go!\I don't know... I don't know how I should face him...\My heavens... response:	You say that Nirvana is a magic that can change people's personality?
context: But how?\And wait... Why is he here?\Erza...\Erza, there is no such thing as freedom in this world.\Let Erza go!\I don't know... I don't know how I should face him...\My heavens...\You say that Nirvana is a magic that can change people's personality? response:	Exactly! Yes...
context: And wait... Why is he here?\Erza...\Erza, there is no such thing as freedom in this world.\Let Erza go!\I don't know... I don't know how I should face him...\My heavens...\You say that Nirvana is a magic that can change people's personality?\Exactly! Yes... response:	The first stage is that black light,
context: Erza...\Erza, there is no such thing as freedom in this world.\Let Erza go!\I don't know... I don't know how I should face him...\My heavens...\You say that Nirvana is a magic that can change people's personality?\Exactly! Yes...\The first stage is that black light, response:	which forcibly changes anyone trapped in the boundary between good and evil.
context: Erza, there is no such thing as freedom in this world.\Let Erza go!\I don't know... I don't know how I should face him...\My heavens...\You say that Nirvana is a magic that can change people's personality?\Exactly! Yes...\The first stage is that black light,\which forcibly changes anyone trapped in the boundary between good and evil. response:	Yes...
context: Let Erza go!\I don't know... I don't know how I should face him...\My heavens...\You say that Nirvana is a magic that can change people's personality?\Exactly! Yes...\The first stage is that black light,\which forcibly changes anyone trapped in the boundary between good and evil.\Yes... response:	Which means that you were in the gap between good and evil?
context: I don't know... I don't know how I should face him...\My heavens...\You say that Nirvana is a magic that can change people's personality?\Exactly! Yes...\The first stage is that black light,\which forcibly changes anyone trapped in the boundary between good and evil.\Yes...\Which means that you were in the gap between good and evil? response:	I felt like I was doing something a bit wrong in the name of earning money.
context: My heavens...\You say that Nirvana is a magic that can change people's personality?\Exactly! Yes...\The first stage is that black light,\which forcibly changes anyone trapped in the boundary between good and evil.\Yes...\Which means that you were in the gap between good and evil?\I felt like I was doing something a bit wrong in the name of earning money. response:	Yes...
context: You say that Nirvana is a magic that can change people's personality?\Exactly! Yes...\The first stage is that black light,\which forcibly changes anyone trapped in the boundary between good and evil.\Yes...\Which means that you were in the gap between good and evil?\I felt like I was doing something a bit wrong in the name of earning money.\Yes... response:	You seemed pretty happy about it to me.
context: Exactly! Yes...\The first stage is that black light,\which forcibly changes anyone trapped in the boundary between good and evil.\Yes...\Which means that you were in the gap between good and evil?\I felt like I was doing something a bit wrong in the name of earning money.\Yes...\You seemed pretty happy about it to me. response:	It was all for my long-lost brother...
context: The first stage is that black light,\which forcibly changes anyone trapped in the boundary between good and evil.\Yes...\Which means that you were in the gap between good and evil?\I felt like I was doing something a bit wrong in the name of earning money.\Yes...\You seemed pretty happy about it to me.\It was all for my long-lost brother... response:	All to search for my brother!
context: which forcibly changes anyone trapped in the boundary between good and evil.\Yes...\Which means that you were in the gap between good and evil?\I felt like I was doing something a bit wrong in the name of earning money.\Yes...\You seemed pretty happy about it to me.\It was all for my long-lost brother...\All to search for my brother! response:	It was for that I wanted money!
context: Yes...\Which means that you were in the gap between good and evil?\I felt like I was doing something a bit wrong in the name of earning money.\Yes...\You seemed pretty happy about it to me.\It was all for my long-lost brother...\All to search for my brother!\It was for that I wanted money! response:	Yes...
context: Which means that you were in the gap between good and evil?\I felt like I was doing something a bit wrong in the name of earning money.\Yes...\You seemed pretty happy about it to me.\It was all for my long-lost brother...\All to search for my brother!\It was for that I wanted money!\Yes... response:	When I look at you, I remember the past...
context: I felt like I was doing something a bit wrong in the name of earning money.\Yes...\You seemed pretty happy about it to me.\It was all for my long-lost brother...\All to search for my brother!\It was for that I wanted money!\Yes...\When I look at you, I remember the past... response:	Could it be... Are you saying I resemble your brother, perhaps?
context: Yes...\You seemed pretty happy about it to me.\It was all for my long-lost brother...\All to search for my brother!\It was for that I wanted money!\Yes...\When I look at you, I remember the past...\Could it be... Are you saying I resemble your brother, perhaps? response:	You are the spitting image of the potatoes my brother used to eat!
context: You seemed pretty happy about it to me.\It was all for my long-lost brother...\All to search for my brother!\It was for that I wanted money!\Yes...\When I look at you, I remember the past...\Could it be... Are you saying I resemble your brother, perhaps?\You are the spitting image of the potatoes my brother used to eat! response:	Potato head?!
context: It was all for my long-lost brother...\All to search for my brother!\It was for that I wanted money!\Yes...\When I look at you, I remember the past...\Could it be... Are you saying I resemble your brother, perhaps?\You are the spitting image of the potatoes my brother used to eat!\Potato head?! response:	Now, let's stop Brain and the others for the sake of love! Yes...
context: All to search for my brother!\It was for that I wanted money!\Yes...\When I look at you, I remember the past...\Could it be... Are you saying I resemble your brother, perhaps?\You are the spitting image of the potatoes my brother used to eat!\Potato head?!\Now, let's stop Brain and the others for the sake of love! Yes... response:	R-Right...
context: It was for that I wanted money!\Yes...\When I look at you, I remember the past...\Could it be... Are you saying I resemble your brother, perhaps?\You are the spitting image of the potatoes my brother used to eat!\Potato head?!\Now, let's stop Brain and the others for the sake of love! Yes...\R-Right... response:	What's wrong?
context: Yes...\When I look at you, I remember the past...\Could it be... Are you saying I resemble your brother, perhaps?\You are the spitting image of the potatoes my brother used to eat!\Potato head?!\Now, let's stop Brain and the others for the sake of love! Yes...\R-Right...\What's wrong? response:	What the heck has been going on?
context: When I look at you, I remember the past...\Could it be... Are you saying I resemble your brother, perhaps?\You are the spitting image of the potatoes my brother used to eat!\Potato head?!\Now, let's stop Brain and the others for the sake of love! Yes...\R-Right...\What's wrong?\What the heck has been going on? response:	None of my magic has...
context: Could it be... Are you saying I resemble your brother, perhaps?\You are the spitting image of the potatoes my brother used to eat!\Potato head?!\Now, let's stop Brain and the others for the sake of love! Yes...\R-Right...\What's wrong?\What the heck has been going on?\None of my magic has... response:	Damn it!
context: You are the spitting image of the potatoes my brother used to eat!\Potato head?!\Now, let's stop Brain and the others for the sake of love! Yes...\R-Right...\What's wrong?\What the heck has been going on?\None of my magic has...\Damn it! response:	Air Magic, Aerial Shot!
context: Potato head?!\Now, let's stop Brain and the others for the sake of love! Yes...\R-Right...\What's wrong?\What the heck has been going on?\None of my magic has...\Damn it!\Air Magic, Aerial Shot! response:	I missed again?
context: Now, let's stop Brain and the others for the sake of love! Yes...\R-Right...\What's wrong?\What the heck has been going on?\None of my magic has...\Damn it!\Air Magic, Aerial Shot!\I missed again? response:	Goddamn it!
context: R-Right...\What's wrong?\What the heck has been going on?\None of my magic has...\Damn it!\Air Magic, Aerial Shot!\I missed again?\Goddamn it! response:	But... why?
context: What's wrong?\What the heck has been going on?\None of my magic has...\Damn it!\Air Magic, Aerial Shot!\I missed again?\Goddamn it!\But... why? response:	That makes two.
context: What the heck has been going on?\None of my magic has...\Damn it!\Air Magic, Aerial Shot!\I missed again?\Goddamn it!\But... why?\That makes two. response:	How boring. Isn't there anyone stronger?
context: None of my magic has...\Damn it!\Air Magic, Aerial Shot!\I missed again?\Goddamn it!\But... why?\That makes two.\How boring. Isn't there anyone stronger? response:	I wonder if I shouldn't have come?
context: Damn it!\Air Magic, Aerial Shot!\I missed again?\Goddamn it!\But... why?\That makes two.\How boring. Isn't there anyone stronger?\I wonder if I shouldn't have come? response:	Are you still saying that, Wendy?
context: Air Magic, Aerial Shot!\I missed again?\Goddamn it!\But... why?\That makes two.\How boring. Isn't there anyone stronger?\I wonder if I shouldn't have come?\Are you still saying that, Wendy? response:	Well...
context: I missed again?\Goddamn it!\But... why?\That makes two.\How boring. Isn't there anyone stronger?\I wonder if I shouldn't have come?\Are you still saying that, Wendy?\Well... response:	Those negative feelings will get your heart stolen by the darkness.
context: Goddamn it!\But... why?\That makes two.\How boring. Isn't there anyone stronger?\I wonder if I shouldn't have come?\Are you still saying that, Wendy?\Well...\Those negative feelings will get your heart stolen by the darkness. response:	But I ran away leaving Lucy-san and the others, right?
context: But... why?\That makes two.\How boring. Isn't there anyone stronger?\I wonder if I shouldn't have come?\Are you still saying that, Wendy?\Well...\Those negative feelings will get your heart stolen by the darkness.\But I ran away leaving Lucy-san and the others, right? response:	That's because you wouldn't have been any help regardless.
context: That makes two.\How boring. Isn't there anyone stronger?\I wonder if I shouldn't have come?\Are you still saying that, Wendy?\Well...\Those negative feelings will get your heart stolen by the darkness.\But I ran away leaving Lucy-san and the others, right?\That's because you wouldn't have been any help regardless. response:	I knew it, I'm just...
context: How boring. Isn't there anyone stronger?\I wonder if I shouldn't have come?\Are you still saying that, Wendy?\Well...\Those negative feelings will get your heart stolen by the darkness.\But I ran away leaving Lucy-san and the others, right?\That's because you wouldn't have been any help regardless.\I knew it, I'm just... response:	But without you here, Erza would be dead now.
context: I wonder if I shouldn't have come?\Are you still saying that, Wendy?\Well...\Those negative feelings will get your heart stolen by the darkness.\But I ran away leaving Lucy-san and the others, right?\That's because you wouldn't have been any help regardless.\I knew it, I'm just...\But without you here, Erza would be dead now. response:	Yeah...
context: Are you still saying that, Wendy?\Well...\Those negative feelings will get your heart stolen by the darkness.\But I ran away leaving Lucy-san and the others, right?\That's because you wouldn't have been any help regardless.\I knew it, I'm just...\But without you here, Erza would be dead now.\Yeah... response:	But we weren't able to find Nirvana either.
context: Well...\Those negative feelings will get your heart stolen by the darkness.\But I ran away leaving Lucy-san and the others, right?\That's because you wouldn't have been any help regardless.\I knew it, I'm just...\But without you here, Erza would be dead now.\Yeah...\But we weren't able to find Nirvana either. response:	I wonder...
context: Those negative feelings will get your heart stolen by the darkness.\But I ran away leaving Lucy-san and the others, right?\That's because you wouldn't have been any help regardless.\I knew it, I'm just...\But without you here, Erza would be dead now.\Yeah...\But we weren't able to find Nirvana either.\I wonder... response:	You were happy to be able to meet that Jellal person, right?
context: But I ran away leaving Lucy-san and the others, right?\That's because you wouldn't have been any help regardless.\I knew it, I'm just...\But without you here, Erza would be dead now.\Yeah...\But we weren't able to find Nirvana either.\I wonder...\You were happy to be able to meet that Jellal person, right? response:	But that's...
context: That's because you wouldn't have been any help regardless.\I knew it, I'm just...\But without you here, Erza would be dead now.\Yeah...\But we weren't able to find Nirvana either.\I wonder...\You were happy to be able to meet that Jellal person, right?\But that's... response:	So what is with Jellal?
context: I knew it, I'm just...\But without you here, Erza would be dead now.\Yeah...\But we weren't able to find Nirvana either.\I wonder...\You were happy to be able to meet that Jellal person, right?\But that's...\So what is with Jellal? response:	You said he saved your life,
context: But without you here, Erza would be dead now.\Yeah...\But we weren't able to find Nirvana either.\I wonder...\You were happy to be able to meet that Jellal person, right?\But that's...\So what is with Jellal?\You said he saved your life, response:	but I've never heard anything about that.
context: Yeah...\But we weren't able to find Nirvana either.\I wonder...\You were happy to be able to meet that Jellal person, right?\But that's...\So what is with Jellal?\You said he saved your life,\but I've never heard anything about that. response:	Oh, yeah... I never told you, did I?
context: But we weren't able to find Nirvana either.\I wonder...\You were happy to be able to meet that Jellal person, right?\But that's...\So what is with Jellal?\You said he saved your life,\but I've never heard anything about that.\Oh, yeah... I never told you, did I? response:	It was seven years ago...
context: I wonder...\You were happy to be able to meet that Jellal person, right?\But that's...\So what is with Jellal?\You said he saved your life,\but I've never heard anything about that.\Oh, yeah... I never told you, did I?\It was seven years ago... response:	The Sky Dragon, Grandine, vanished.
context: You were happy to be able to meet that Jellal person, right?\But that's...\So what is with Jellal?\You said he saved your life,\but I've never heard anything about that.\Oh, yeah... I never told you, did I?\It was seven years ago...\The Sky Dragon, Grandine, vanished. response:	And I was wandering along the road...
context: But that's...\So what is with Jellal?\You said he saved your life,\but I've never heard anything about that.\Oh, yeah... I never told you, did I?\It was seven years ago...\The Sky Dragon, Grandine, vanished.\And I was wandering along the road... response:	Grandine... Where are you, Grandine?
context: So what is with Jellal?\You said he saved your life,\but I've never heard anything about that.\Oh, yeah... I never told you, did I?\It was seven years ago...\The Sky Dragon, Grandine, vanished.\And I was wandering along the road...\Grandine... Where are you, Grandine? response:	What's the matter?
context: You said he saved your life,\but I've never heard anything about that.\Oh, yeah... I never told you, did I?\It was seven years ago...\The Sky Dragon, Grandine, vanished.\And I was wandering along the road...\Grandine... Where are you, Grandine?\What's the matter? response:	She's gone...
context: but I've never heard anything about that.\Oh, yeah... I never told you, did I?\It was seven years ago...\The Sky Dragon, Grandine, vanished.\And I was wandering along the road...\Grandine... Where are you, Grandine?\What's the matter?\She's gone... response:	What?
context: Oh, yeah... I never told you, did I?\It was seven years ago...\The Sky Dragon, Grandine, vanished.\And I was wandering along the road...\Grandine... Where are you, Grandine?\What's the matter?\She's gone...\What? response:	She disappeared!
context: It was seven years ago...\The Sky Dragon, Grandine, vanished.\And I was wandering along the road...\Grandine... Where are you, Grandine?\What's the matter?\She's gone...\What?\She disappeared! response:	That was how we met.
context: The Sky Dragon, Grandine, vanished.\And I was wandering along the road...\Grandine... Where are you, Grandine?\What's the matter?\She's gone...\What?\She disappeared!\That was how we met. response:	He was in the middle of traveling, and told me that he was lost as well.
context: And I was wandering along the road...\Grandine... Where are you, Grandine?\What's the matter?\She's gone...\What?\She disappeared!\That was how we met.\He was in the middle of traveling, and told me that he was lost as well. response:	So for the next month, we continued traveling together with no destination in mind...
context: Grandine... Where are you, Grandine?\What's the matter?\She's gone...\What?\She disappeared!\That was how we met.\He was in the middle of traveling, and told me that he was lost as well.\So for the next month, we continued traveling together with no destination in mind... response:	Jellal!
context: What's the matter?\She's gone...\What?\She disappeared!\That was how we met.\He was in the middle of traveling, and told me that he was lost as well.\So for the next month, we continued traveling together with no destination in mind...\Jellal! response:	Even on a nasty day like this, some good can come.
context: She's gone...\What?\She disappeared!\That was how we met.\He was in the middle of traveling, and told me that he was lost as well.\So for the next month, we continued traveling together with no destination in mind...\Jellal!\Even on a nasty day like this, some good can come. response:	See?
context: What?\She disappeared!\That was how we met.\He was in the middle of traveling, and told me that he was lost as well.\So for the next month, we continued traveling together with no destination in mind...\Jellal!\Even on a nasty day like this, some good can come.\See? response:	Where did you pick them?
context: She disappeared!\That was how we met.\He was in the middle of traveling, and told me that he was lost as well.\So for the next month, we continued traveling together with no destination in mind...\Jellal!\Even on a nasty day like this, some good can come.\See?\Where did you pick them? response:	Don't ask...
context: That was how we met.\He was in the middle of traveling, and told me that he was lost as well.\So for the next month, we continued traveling together with no destination in mind...\Jellal!\Even on a nasty day like this, some good can come.\See?\Where did you pick them?\Don't ask... response:	Now, let's eat.
context: He was in the middle of traveling, and told me that he was lost as well.\So for the next month, we continued traveling together with no destination in mind...\Jellal!\Even on a nasty day like this, some good can come.\See?\Where did you pick them?\Don't ask...\Now, let's eat. response:	Yeah!
context: So for the next month, we continued traveling together with no destination in mind...\Jellal!\Even on a nasty day like this, some good can come.\See?\Where did you pick them?\Don't ask...\Now, let's eat.\Yeah! response:	Wait here a second.
context: Jellal!\Even on a nasty day like this, some good can come.\See?\Where did you pick them?\Don't ask...\Now, let's eat.\Yeah!\Wait here a second. response:	Thank you...
context: Even on a nasty day like this, some good can come.\See?\Where did you pick them?\Don't ask...\Now, let's eat.\Yeah!\Wait here a second.\Thank you... response:	Where are we going now?
context: See?\Where did you pick them?\Don't ask...\Now, let's eat.\Yeah!\Wait here a second.\Thank you...\Where are we going now? response:	I don't know... Where would be nice?
context: Where did you pick them?\Don't ask...\Now, let's eat.\Yeah!\Wait here a second.\Thank you...\Where are we going now?\I don't know... Where would be nice? response:	Can I tag along with you forever?
context: Don't ask...\Now, let's eat.\Yeah!\Wait here a second.\Thank you...\Where are we going now?\I don't know... Where would be nice?\Can I tag along with you forever? response:	Of course.
context: Now, let's eat.\Yeah!\Wait here a second.\Thank you...\Where are we going now?\I don't know... Where would be nice?\Can I tag along with you forever?\Of course. response:	But one day, he said something weird all of a sudden...
context: Yeah!\Wait here a second.\Thank you...\Where are we going now?\I don't know... Where would be nice?\Can I tag along with you forever?\Of course.\But one day, he said something weird all of a sudden... response:	Anima!
context: Wait here a second.\Thank you...\Where are we going now?\I don't know... Where would be nice?\Can I tag along with you forever?\Of course.\But one day, he said something weird all of a sudden...\Anima! response:	Huh? What's the matter?
context: Thank you...\Where are we going now?\I don't know... Where would be nice?\Can I tag along with you forever?\Of course.\But one day, he said something weird all of a sudden...\Anima!\Huh? What's the matter? response:	No! I wanna come with you!
context: Where are we going now?\I don't know... Where would be nice?\Can I tag along with you forever?\Of course.\But one day, he said something weird all of a sudden...\Anima!\Huh? What's the matter?\No! I wanna come with you! response:	You can't. It'll be dangerous if you come.
context: I don't know... Where would be nice?\Can I tag along with you forever?\Of course.\But one day, he said something weird all of a sudden...\Anima!\Huh? What's the matter?\No! I wanna come with you!\You can't. It'll be dangerous if you come. response:	But why? I don't want to leave you, Jellal!
context: Can I tag along with you forever?\Of course.\But one day, he said something weird all of a sudden...\Anima!\Huh? What's the matter?\No! I wanna come with you!\You can't. It'll be dangerous if you come.\But why? I don't want to leave you, Jellal! response:	If you head past this forest, there's a guild.
context: Of course.\But one day, he said something weird all of a sudden...\Anima!\Huh? What's the matter?\No! I wanna come with you!\You can't. It'll be dangerous if you come.\But why? I don't want to leave you, Jellal!\If you head past this forest, there's a guild. response:	They'll take care of you there.
context: But one day, he said something weird all of a sudden...\Anima!\Huh? What's the matter?\No! I wanna come with you!\You can't. It'll be dangerous if you come.\But why? I don't want to leave you, Jellal!\If you head past this forest, there's a guild.\They'll take care of you there. response:	No!
context: Anima!\Huh? What's the matter?\No! I wanna come with you!\You can't. It'll be dangerous if you come.\But why? I don't want to leave you, Jellal!\If you head past this forest, there's a guild.\They'll take care of you there.\No! response:	Wendy...
context: Huh? What's the matter?\No! I wanna come with you!\You can't. It'll be dangerous if you come.\But why? I don't want to leave you, Jellal!\If you head past this forest, there's a guild.\They'll take care of you there.\No!\Wendy... response:	No!
context: No! I wanna come with you!\You can't. It'll be dangerous if you come.\But why? I don't want to leave you, Jellal!\If you head past this forest, there's a guild.\They'll take care of you there.\No!\Wendy...\No! response:	But in the end, I was taken in by the guild,
context: You can't. It'll be dangerous if you come.\But why? I don't want to leave you, Jellal!\If you head past this forest, there's a guild.\They'll take care of you there.\No!\Wendy...\No!\But in the end, I was taken in by the guild, response:	and that was Caitshelter...
context: But why? I don't want to leave you, Jellal!\If you head past this forest, there's a guild.\They'll take care of you there.\No!\Wendy...\No!\But in the end, I was taken in by the guild,\and that was Caitshelter... response:	Then, what happened to Jellal?
context: If you head past this forest, there's a guild.\They'll take care of you there.\No!\Wendy...\No!\But in the end, I was taken in by the guild,\and that was Caitshelter...\Then, what happened to Jellal? response:	I never met him afterwards.
context: They'll take care of you there.\No!\Wendy...\No!\But in the end, I was taken in by the guild,\and that was Caitshelter...\Then, what happened to Jellal?\I never met him afterwards. response:	But I heard rumors later...
context: No!\Wendy...\No!\But in the end, I was taken in by the guild,\and that was Caitshelter...\Then, what happened to Jellal?\I never met him afterwards.\But I heard rumors later... response:	About how a council member that looked just like Jellal
context: Wendy...\No!\But in the end, I was taken in by the guild,\and that was Caitshelter...\Then, what happened to Jellal?\I never met him afterwards.\But I heard rumors later...\About how a council member that looked just like Jellal response:	had done a bunch of really bad things recently.
context: No!\But in the end, I was taken in by the guild,\and that was Caitshelter...\Then, what happened to Jellal?\I never met him afterwards.\But I heard rumors later...\About how a council member that looked just like Jellal\had done a bunch of really bad things recently. response:	But he was really nice back then!
context: But in the end, I was taken in by the guild,\and that was Caitshelter...\Then, what happened to Jellal?\I never met him afterwards.\But I heard rumors later...\About how a council member that looked just like Jellal\had done a bunch of really bad things recently.\But he was really nice back then! response:	I wonder if Jellal remembers me?
context: and that was Caitshelter...\Then, what happened to Jellal?\I never met him afterwards.\But I heard rumors later...\About how a council member that looked just like Jellal\had done a bunch of really bad things recently.\But he was really nice back then!\I wonder if Jellal remembers me? response:	Erza? She was revived?
context: Then, what happened to Jellal?\I never met him afterwards.\But I heard rumors later...\About how a council member that looked just like Jellal\had done a bunch of really bad things recently.\But he was really nice back then!\I wonder if Jellal remembers me?\Erza? She was revived? response:	Damn it!
context: I never met him afterwards.\But I heard rumors later...\About how a council member that looked just like Jellal\had done a bunch of really bad things recently.\But he was really nice back then!\I wonder if Jellal remembers me?\Erza? She was revived?\Damn it! response:	How is it that I didn't notice she was so close?!
context: But I heard rumors later...\About how a council member that looked just like Jellal\had done a bunch of really bad things recently.\But he was really nice back then!\I wonder if Jellal remembers me?\Erza? She was revived?\Damn it!\How is it that I didn't notice she was so close?! response:	I won't let you interfere until the main body of Nirvana starts up!
context: About how a council member that looked just like Jellal\had done a bunch of really bad things recently.\But he was really nice back then!\I wonder if Jellal remembers me?\Erza? She was revived?\Damn it!\How is it that I didn't notice she was so close?!\I won't let you interfere until the main body of Nirvana starts up! response:	Jellal...
context: had done a bunch of really bad things recently.\But he was really nice back then!\I wonder if Jellal remembers me?\Erza? She was revived?\Damn it!\How is it that I didn't notice she was so close?!\I won't let you interfere until the main body of Nirvana starts up!\Jellal... response:	Erza...
context: But he was really nice back then!\I wonder if Jellal remembers me?\Erza? She was revived?\Damn it!\How is it that I didn't notice she was so close?!\I won't let you interfere until the main body of Nirvana starts up!\Jellal...\Erza... response:	Why are you here?
context: I wonder if Jellal remembers me?\Erza? She was revived?\Damn it!\How is it that I didn't notice she was so close?!\I won't let you interfere until the main body of Nirvana starts up!\Jellal...\Erza...\Why are you here? response:	I don't know.
context: Erza? She was revived?\Damn it!\How is it that I didn't notice she was so close?!\I won't let you interfere until the main body of Nirvana starts up!\Jellal...\Erza...\Why are you here?\I don't know. response:	Erza...
context: Damn it!\How is it that I didn't notice she was so close?!\I won't let you interfere until the main body of Nirvana starts up!\Jellal...\Erza...\Why are you here?\I don't know.\Erza... response:	Er...za...
context: How is it that I didn't notice she was so close?!\I won't let you interfere until the main body of Nirvana starts up!\Jellal...\Erza...\Why are you here?\I don't know.\Erza...\Er...za... response:	I don't remember anything except that word...
context: I won't let you interfere until the main body of Nirvana starts up!\Jellal...\Erza...\Why are you here?\I don't know.\Erza...\Er...za...\I don't remember anything except that word... response:	Will you tell me? Who am I?
context: Jellal...\Erza...\Why are you here?\I don't know.\Erza...\Er...za...\I don't remember anything except that word...\Will you tell me? Who am I? response:	Do you know?
context: Erza...\Why are you here?\I don't know.\Erza...\Er...za...\I don't remember anything except that word...\Will you tell me? Who am I?\Do you know? response:	Who is Erza?
context: Why are you here?\I don't know.\Erza...\Er...za...\I don't remember anything except that word...\Will you tell me? Who am I?\Do you know?\Who is Erza? response:	I can't remember anything!
context: I don't know.\Erza...\Er...za...\I don't remember anything except that word...\Will you tell me? Who am I?\Do you know?\Who is Erza?\I can't remember anything! response:	He's lost all his memories?
context: Erza...\Er...za...\I don't remember anything except that word...\Will you tell me? Who am I?\Do you know?\Who is Erza?\I can't remember anything!\He's lost all his memories? response:	Jellal...
context: Er...za...\I don't remember anything except that word...\Will you tell me? Who am I?\Do you know?\Who is Erza?\I can't remember anything!\He's lost all his memories?\Jellal... response:	What was that for, Gray?!
context: I don't remember anything except that word...\Will you tell me? Who am I?\Do you know?\Who is Erza?\I can't remember anything!\He's lost all his memories?\Jellal...\What was that for, Gray?! response:	Carla, stand back!
context: Will you tell me? Who am I?\Do you know?\Who is Erza?\I can't remember anything!\He's lost all his memories?\Jellal...\What was that for, Gray?!\Carla, stand back! response:	Leave everything to me! I'll save Natsu!
context: Do you know?\Who is Erza?\I can't remember anything!\He's lost all his memories?\Jellal...\What was that for, Gray?!\Carla, stand back!\Leave everything to me! I'll save Natsu! response:	Wait, no one's here...
context: Who is Erza?\I can't remember anything!\He's lost all his memories?\Jellal...\What was that for, Gray?!\Carla, stand back!\Leave everything to me! I'll save Natsu!\Wait, no one's here... response:	What happened?
context: I can't remember anything!\He's lost all his memories?\Jellal...\What was that for, Gray?!\Carla, stand back!\Leave everything to me! I'll save Natsu!\Wait, no one's here...\What happened? response:	I can't remember anything!
context: He's lost all his memories?\Jellal...\What was that for, Gray?!\Carla, stand back!\Leave everything to me! I'll save Natsu!\Wait, no one's here...\What happened?\I can't remember anything! response:	He's lost all his memories?
context: Jellal...\What was that for, Gray?!\Carla, stand back!\Leave everything to me! I'll save Natsu!\Wait, no one's here...\What happened?\I can't remember anything!\He's lost all his memories? response:	Jellal...
context: What was that for, Gray?!\Carla, stand back!\Leave everything to me! I'll save Natsu!\Wait, no one's here...\What happened?\I can't remember anything!\He's lost all his memories?\Jellal... response:	Stay back!
context: Carla, stand back!\Leave everything to me! I'll save Natsu!\Wait, no one's here...\What happened?\I can't remember anything!\He's lost all his memories?\Jellal...\Stay back! response:	Stay back...
context: Leave everything to me! I'll save Natsu!\Wait, no one's here...\What happened?\I can't remember anything!\He's lost all his memories?\Jellal...\Stay back!\Stay back... response:	Then you come to me!
context: Wait, no one's here...\What happened?\I can't remember anything!\He's lost all his memories?\Jellal...\Stay back!\Stay back...\Then you come to me! response:	For I am Erza!
context: What happened?\I can't remember anything!\He's lost all his memories?\Jellal...\Stay back!\Stay back...\Then you come to me!\For I am Erza! response:	Come here.
context: I can't remember anything!\He's lost all his memories?\Jellal...\Stay back!\Stay back...\Then you come to me!\For I am Erza!\Come here. response:	Your name is Jellal.
context: He's lost all his memories?\Jellal...\Stay back!\Stay back...\Then you come to me!\For I am Erza!\Come here.\Your name is Jellal. response:	You were once my friend.
context: Jellal...\Stay back!\Stay back...\Then you come to me!\For I am Erza!\Come here.\Your name is Jellal.\You were once my friend. response:	Friend?
context: Stay back!\Stay back...\Then you come to me!\For I am Erza!\Come here.\Your name is Jellal.\You were once my friend.\Friend? response:	But you went mad, desecrated the dead, hurt your friends,
context: Stay back...\Then you come to me!\For I am Erza!\Come here.\Your name is Jellal.\You were once my friend.\Friend?\But you went mad, desecrated the dead, hurt your friends, response:	and even destroyed the Magic Council.
context: Then you come to me!\For I am Erza!\Come here.\Your name is Jellal.\You were once my friend.\Friend?\But you went mad, desecrated the dead, hurt your friends,\and even destroyed the Magic Council. response:	You killed Simon.
context: For I am Erza!\Come here.\Your name is Jellal.\You were once my friend.\Friend?\But you went mad, desecrated the dead, hurt your friends,\and even destroyed the Magic Council.\You killed Simon. response:	If you...
context: Come here.\Your name is Jellal.\You were once my friend.\Friend?\But you went mad, desecrated the dead, hurt your friends,\and even destroyed the Magic Council.\You killed Simon.\If you... response:	If you are trying to say you forgot that,
context: Your name is Jellal.\You were once my friend.\Friend?\But you went mad, desecrated the dead, hurt your friends,\and even destroyed the Magic Council.\You killed Simon.\If you...\If you are trying to say you forgot that, response:	then I will thrust a blade into your chest and engrave it into your heart!
context: You were once my friend.\Friend?\But you went mad, desecrated the dead, hurt your friends,\and even destroyed the Magic Council.\You killed Simon.\If you...\If you are trying to say you forgot that,\then I will thrust a blade into your chest and engrave it into your heart! response:	Come here!
context: Friend?\But you went mad, desecrated the dead, hurt your friends,\and even destroyed the Magic Council.\You killed Simon.\If you...\If you are trying to say you forgot that,\then I will thrust a blade into your chest and engrave it into your heart!\Come here! response:	Come before me!
context: But you went mad, desecrated the dead, hurt your friends,\and even destroyed the Magic Council.\You killed Simon.\If you...\If you are trying to say you forgot that,\then I will thrust a blade into your chest and engrave it into your heart!\Come here!\Come before me! response:	To my friends...
context: and even destroyed the Magic Council.\You killed Simon.\If you...\If you are trying to say you forgot that,\then I will thrust a blade into your chest and engrave it into your heart!\Come here!\Come before me!\To my friends... response:	No...
context: You killed Simon.\If you...\If you are trying to say you forgot that,\then I will thrust a blade into your chest and engrave it into your heart!\Come here!\Come before me!\To my friends...\No... response:	What have I done?
context: If you...\If you are trying to say you forgot that,\then I will thrust a blade into your chest and engrave it into your heart!\Come here!\Come before me!\To my friends...\No...\What have I done? response:	What... What should I...
context: If you are trying to say you forgot that,\then I will thrust a blade into your chest and engrave it into your heart!\Come here!\Come before me!\To my friends...\No...\What have I done?\What... What should I... response:	Is this really that Jellal?
context: then I will thrust a blade into your chest and engrave it into your heart!\Come here!\Come before me!\To my friends...\No...\What have I done?\What... What should I...\Is this really that Jellal? response:	Ouch...
context: Come here!\Come before me!\To my friends...\No...\What have I done?\What... What should I...\Is this really that Jellal?\Ouch... response:	Huh? A bandage?
context: Come before me!\To my friends...\No...\What have I done?\What... What should I...\Is this really that Jellal?\Ouch...\Huh? A bandage? response:	And wait, what's with these clothes?
context: To my friends...\No...\What have I done?\What... What should I...\Is this really that Jellal?\Ouch...\Huh? A bandage?\And wait, what's with these clothes? response:	They are items from the Spirit World.
context: No...\What have I done?\What... What should I...\Is this really that Jellal?\Ouch...\Huh? A bandage?\And wait, what's with these clothes?\They are items from the Spirit World. response:	As yours were quite in tatters...
context: What have I done?\What... What should I...\Is this really that Jellal?\Ouch...\Huh? A bandage?\And wait, what's with these clothes?\They are items from the Spirit World.\As yours were quite in tatters... response:	Virgo!
context: What... What should I...\Is this really that Jellal?\Ouch...\Huh? A bandage?\And wait, what's with these clothes?\They are items from the Spirit World.\As yours were quite in tatters...\Virgo! response:	Where are we?
context: Is this really that Jellal?\Ouch...\Huh? A bandage?\And wait, what's with these clothes?\They are items from the Spirit World.\As yours were quite in tatters...\Virgo!\Where are we? response:	I gave Natsu-sama a matching outfit.
context: Ouch...\Huh? A bandage?\And wait, what's with these clothes?\They are items from the Spirit World.\As yours were quite in tatters...\Virgo!\Where are we?\I gave Natsu-sama a matching outfit. response:	That really isn't necessary!
context: Huh? A bandage?\And wait, what's with these clothes?\They are items from the Spirit World.\As yours were quite in tatters...\Virgo!\Where are we?\I gave Natsu-sama a matching outfit.\That really isn't necessary! response:	Jellal! Where's that light?
context: And wait, what's with these clothes?\They are items from the Spirit World.\As yours were quite in tatters...\Virgo!\Where are we?\I gave Natsu-sama a matching outfit.\That really isn't necessary!\Jellal! Where's that light? response:	It's close. And wait, hasn't the color changed?
context: They are items from the Spirit World.\As yours were quite in tatters...\Virgo!\Where are we?\I gave Natsu-sama a matching outfit.\That really isn't necessary!\Jellal! Where's that light?\It's close. And wait, hasn't the color changed? response:	Yes. While you two were unconscious, it changed from black to white.
context: As yours were quite in tatters...\Virgo!\Where are we?\I gave Natsu-sama a matching outfit.\That really isn't necessary!\Jellal! Where's that light?\It's close. And wait, hasn't the color changed?\Yes. While you two were unconscious, it changed from black to white. response:	That was a close call. Thanks.
context: Virgo!\Where are we?\I gave Natsu-sama a matching outfit.\That really isn't necessary!\Jellal! Where's that light?\It's close. And wait, hasn't the color changed?\Yes. While you two were unconscious, it changed from black to white.\That was a close call. Thanks. response:	What's with you all of a sudden...
context: Where are we?\I gave Natsu-sama a matching outfit.\That really isn't necessary!\Jellal! Where's that light?\It's close. And wait, hasn't the color changed?\Yes. While you two were unconscious, it changed from black to white.\That was a close call. Thanks.\What's with you all of a sudden... response:	He lllikes you!
context: I gave Natsu-sama a matching outfit.\That really isn't necessary!\Jellal! Where's that light?\It's close. And wait, hasn't the color changed?\Yes. While you two were unconscious, it changed from black to white.\That was a close call. Thanks.\What's with you all of a sudden...\He lllikes you! response:	Would you quit it with that?!
context: That really isn't necessary!\Jellal! Where's that light?\It's close. And wait, hasn't the color changed?\Yes. While you two were unconscious, it changed from black to white.\That was a close call. Thanks.\What's with you all of a sudden...\He lllikes you!\Would you quit it with that?! response:	Oh yeah, where's Happy?
context: Jellal! Where's that light?\It's close. And wait, hasn't the color changed?\Yes. While you two were unconscious, it changed from black to white.\That was a close call. Thanks.\What's with you all of a sudden...\He lllikes you!\Would you quit it with that?!\Oh yeah, where's Happy? response:	I have not seen him.
context: It's close. And wait, hasn't the color changed?\Yes. While you two were unconscious, it changed from black to white.\That was a close call. Thanks.\What's with you all of a sudden...\He lllikes you!\Would you quit it with that?!\Oh yeah, where's Happy?\I have not seen him. response:	Lucy, weren't you with Erza?
context: Yes. While you two were unconscious, it changed from black to white.\That was a close call. Thanks.\What's with you all of a sudden...\He lllikes you!\Would you quit it with that?!\Oh yeah, where's Happy?\I have not seen him.\Lucy, weren't you with Erza? response:	We all got separated.
context: That was a close call. Thanks.\What's with you all of a sudden...\He lllikes you!\Would you quit it with that?!\Oh yeah, where's Happy?\I have not seen him.\Lucy, weren't you with Erza?\We all got separated. response:	Oh, well... I guess the two of us should head to that light ourselves.
context: What's with you all of a sudden...\He lllikes you!\Would you quit it with that?!\Oh yeah, where's Happy?\I have not seen him.\Lucy, weren't you with Erza?\We all got separated.\Oh, well... I guess the two of us should head to that light ourselves. response:	Princess, I will now take my leave.
context: He lllikes you!\Would you quit it with that?!\Oh yeah, where's Happy?\I have not seen him.\Lucy, weren't you with Erza?\We all got separated.\Oh, well... I guess the two of us should head to that light ourselves.\Princess, I will now take my leave. response:	Virgo!
context: Would you quit it with that?!\Oh yeah, where's Happy?\I have not seen him.\Lucy, weren't you with Erza?\We all got separated.\Oh, well... I guess the two of us should head to that light ourselves.\Princess, I will now take my leave.\Virgo! response:	Virgo just passed through the gate using her own magic...
context: Oh yeah, where's Happy?\I have not seen him.\Lucy, weren't you with Erza?\We all got separated.\Oh, well... I guess the two of us should head to that light ourselves.\Princess, I will now take my leave.\Virgo!\Virgo just passed through the gate using her own magic... response:	Wait, do I have zero magic power left?
context: I have not seen him.\Lucy, weren't you with Erza?\We all got separated.\Oh, well... I guess the two of us should head to that light ourselves.\Princess, I will now take my leave.\Virgo!\Virgo just passed through the gate using her own magic...\Wait, do I have zero magic power left? response:	Sherry!
context: Lucy, weren't you with Erza?\We all got separated.\Oh, well... I guess the two of us should head to that light ourselves.\Princess, I will now take my leave.\Virgo!\Virgo just passed through the gate using her own magic...\Wait, do I have zero magic power left?\Sherry! response:	Thank goodness you're safe!
context: We all got separated.\Oh, well... I guess the two of us should head to that light ourselves.\Princess, I will now take my leave.\Virgo!\Virgo just passed through the gate using her own magic...\Wait, do I have zero magic power left?\Sherry!\Thank goodness you're safe! response:	It's you! Weren't you on Galuna Island...
context: Oh, well... I guess the two of us should head to that light ourselves.\Princess, I will now take my leave.\Virgo!\Virgo just passed through the gate using her own magic...\Wait, do I have zero magic power left?\Sherry!\Thank goodness you're safe!\It's you! Weren't you on Galuna Island... response:	Oh yeah, where's doggy and'brows?
context: Princess, I will now take my leave.\Virgo!\Virgo just passed through the gate using her own magic...\Wait, do I have zero magic power left?\Sherry!\Thank goodness you're safe!\It's you! Weren't you on Galuna Island...\Oh yeah, where's doggy and'brows? response:	Do you know how many episodes back that was?!
context: Virgo!\Virgo just passed through the gate using her own magic...\Wait, do I have zero magic power left?\Sherry!\Thank goodness you're safe!\It's you! Weren't you on Galuna Island...\Oh yeah, where's doggy and'brows?\Do you know how many episodes back that was?! response:	I found you, Fairy Tail wizards...
context: Virgo just passed through the gate using her own magic...\Wait, do I have zero magic power left?\Sherry!\Thank goodness you're safe!\It's you! Weren't you on Galuna Island...\Oh yeah, where's doggy and'brows?\Do you know how many episodes back that was?!\I found you, Fairy Tail wizards... response:	What?
context: Wait, do I have zero magic power left?\Sherry!\Thank goodness you're safe!\It's you! Weren't you on Galuna Island...\Oh yeah, where's doggy and'brows?\Do you know how many episodes back that was?!\I found you, Fairy Tail wizards...\What? response:	You idiot!
context: Sherry!\Thank goodness you're safe!\It's you! Weren't you on Galuna Island...\Oh yeah, where's doggy and'brows?\Do you know how many episodes back that was?!\I found you, Fairy Tail wizards...\What?\You idiot! response:	Gray!
context: Thank goodness you're safe!\It's you! Weren't you on Galuna Island...\Oh yeah, where's doggy and'brows?\Do you know how many episodes back that was?!\I found you, Fairy Tail wizards...\What?\You idiot!\Gray! response:	You guys safe?
context: It's you! Weren't you on Galuna Island...\Oh yeah, where's doggy and'brows?\Do you know how many episodes back that was?!\I found you, Fairy Tail wizards...\What?\You idiot!\Gray!\You guys safe? response:	Let me go! Damn you! You're still alive?
context: Oh yeah, where's doggy and'brows?\Do you know how many episodes back that was?!\I found you, Fairy Tail wizards...\What?\You idiot!\Gray!\You guys safe?\Let me go! Damn you! You're still alive? response:	I'm getting revenge for Lyon-sama!
context: Do you know how many episodes back that was?!\I found you, Fairy Tail wizards...\What?\You idiot!\Gray!\You guys safe?\Let me go! Damn you! You're still alive?\I'm getting revenge for Lyon-sama! response:	She's been acting all weird after that light appeared.
context: I found you, Fairy Tail wizards...\What?\You idiot!\Gray!\You guys safe?\Let me go! Damn you! You're still alive?\I'm getting revenge for Lyon-sama!\She's been acting all weird after that light appeared. response:	You were acting pretty weird before too!
context: What?\You idiot!\Gray!\You guys safe?\Let me go! Damn you! You're still alive?\I'm getting revenge for Lyon-sama!\She's been acting all weird after that light appeared.\You were acting pretty weird before too! response:	Huh?
context: You idiot!\Gray!\You guys safe?\Let me go! Damn you! You're still alive?\I'm getting revenge for Lyon-sama!\She's been acting all weird after that light appeared.\You were acting pretty weird before too!\Huh? response:	Natsu, that was a fake...
context: Gray!\You guys safe?\Let me go! Damn you! You're still alive?\I'm getting revenge for Lyon-sama!\She's been acting all weird after that light appeared.\You were acting pretty weird before too!\Huh?\Natsu, that was a fake... response:	I won't forgive you! Revenge for Lyon-sama!
context: You guys safe?\Let me go! Damn you! You're still alive?\I'm getting revenge for Lyon-sama!\She's been acting all weird after that light appeared.\You were acting pretty weird before too!\Huh?\Natsu, that was a fake...\I won't forgive you! Revenge for Lyon-sama! response:	Revenge for who exactly?
context: Let me go! Damn you! You're still alive?\I'm getting revenge for Lyon-sama!\She's been acting all weird after that light appeared.\You were acting pretty weird before too!\Huh?\Natsu, that was a fake...\I won't forgive you! Revenge for Lyon-sama!\Revenge for who exactly? response:	Reports of my death are greatly exaggerated.
context: I'm getting revenge for Lyon-sama!\She's been acting all weird after that light appeared.\You were acting pretty weird before too!\Huh?\Natsu, that was a fake...\I won't forgive you! Revenge for Lyon-sama!\Revenge for who exactly?\Reports of my death are greatly exaggerated. response:	Lyon-sama?
context: She's been acting all weird after that light appeared.\You were acting pretty weird before too!\Huh?\Natsu, that was a fake...\I won't forgive you! Revenge for Lyon-sama!\Revenge for who exactly?\Reports of my death are greatly exaggerated.\Lyon-sama? response:	He's a stubborn one.
context: You were acting pretty weird before too!\Huh?\Natsu, that was a fake...\I won't forgive you! Revenge for Lyon-sama!\Revenge for who exactly?\Reports of my death are greatly exaggerated.\Lyon-sama?\He's a stubborn one. response:	Well, it was pretty close...
context: Huh?\Natsu, that was a fake...\I won't forgive you! Revenge for Lyon-sama!\Revenge for who exactly?\Reports of my death are greatly exaggerated.\Lyon-sama?\He's a stubborn one.\Well, it was pretty close... response:	That guy's bomb lacrima was more powerful than I thought.
context: Natsu, that was a fake...\I won't forgive you! Revenge for Lyon-sama!\Revenge for who exactly?\Reports of my death are greatly exaggerated.\Lyon-sama?\He's a stubborn one.\Well, it was pretty close...\That guy's bomb lacrima was more powerful than I thought. response:	It took a long time before I was able to move again.
context: I won't forgive you! Revenge for Lyon-sama!\Revenge for who exactly?\Reports of my death are greatly exaggerated.\Lyon-sama?\He's a stubborn one.\Well, it was pretty close...\That guy's bomb lacrima was more powerful than I thought.\It took a long time before I was able to move again. response:	Yup, he's stubborn all right.
context: Revenge for who exactly?\Reports of my death are greatly exaggerated.\Lyon-sama?\He's a stubborn one.\Well, it was pretty close...\That guy's bomb lacrima was more powerful than I thought.\It took a long time before I was able to move again.\Yup, he's stubborn all right. response:	Well, I'm not as stubborn as this guy.
context: Reports of my death are greatly exaggerated.\Lyon-sama?\He's a stubborn one.\Well, it was pretty close...\That guy's bomb lacrima was more powerful than I thought.\It took a long time before I was able to move again.\Yup, he's stubborn all right.\Well, I'm not as stubborn as this guy. response:	Say what?!
context: Lyon-sama?\He's a stubborn one.\Well, it was pretty close...\That guy's bomb lacrima was more powerful than I thought.\It took a long time before I was able to move again.\Yup, he's stubborn all right.\Well, I'm not as stubborn as this guy.\Say what?! response:	You jump down his throat for that?
context: He's a stubborn one.\Well, it was pretty close...\That guy's bomb lacrima was more powerful than I thought.\It took a long time before I was able to move again.\Yup, he's stubborn all right.\Well, I'm not as stubborn as this guy.\Say what?!\You jump down his throat for that? response:	Thank... goodness...
context: Well, it was pretty close...\That guy's bomb lacrima was more powerful than I thought.\It took a long time before I was able to move again.\Yup, he's stubborn all right.\Well, I'm not as stubborn as this guy.\Say what?!\You jump down his throat for that?\Thank... goodness... response:	What's this?
context: That guy's bomb lacrima was more powerful than I thought.\It took a long time before I was able to move again.\Yup, he's stubborn all right.\Well, I'm not as stubborn as this guy.\Say what?!\You jump down his throat for that?\Thank... goodness...\What's this? response:	As I thought, she was taken over by something...
context: It took a long time before I was able to move again.\Yup, he's stubborn all right.\Well, I'm not as stubborn as this guy.\Say what?!\You jump down his throat for that?\Thank... goodness...\What's this?\As I thought, she was taken over by something... response:	That's Nirvana...
context: Yup, he's stubborn all right.\Well, I'm not as stubborn as this guy.\Say what?!\You jump down his throat for that?\Thank... goodness...\What's this?\As I thought, she was taken over by something...\That's Nirvana... response:	The black pillar has turned white!
context: Well, I'm not as stubborn as this guy.\Say what?!\You jump down his throat for that?\Thank... goodness...\What's this?\As I thought, she was taken over by something...\That's Nirvana...\The black pillar has turned white! response:	I wonder what's happening?
context: Say what?!\You jump down his throat for that?\Thank... goodness...\What's this?\As I thought, she was taken over by something...\That's Nirvana...\The black pillar has turned white!\I wonder what's happening? response:	Hibiki, wake up already!
context: You jump down his throat for that?\Thank... goodness...\What's this?\As I thought, she was taken over by something...\That's Nirvana...\The black pillar has turned white!\I wonder what's happening?\Hibiki, wake up already! response:	I hope everyone is okay...
context: Thank... goodness...\What's this?\As I thought, she was taken over by something...\That's Nirvana...\The black pillar has turned white!\I wonder what's happening?\Hibiki, wake up already!\I hope everyone is okay... response:	Natsu... Erza...
context: What's this?\As I thought, she was taken over by something...\That's Nirvana...\The black pillar has turned white!\I wonder what's happening?\Hibiki, wake up already!\I hope everyone is okay...\Natsu... Erza... response:	Okay, I get that you don't remember anything.
context: As I thought, she was taken over by something...\That's Nirvana...\The black pillar has turned white!\I wonder what's happening?\Hibiki, wake up already!\I hope everyone is okay...\Natsu... Erza...\Okay, I get that you don't remember anything. response:	No wonder I wasn't able to hear your thoughts at all...
context: That's Nirvana...\The black pillar has turned white!\I wonder what's happening?\Hibiki, wake up already!\I hope everyone is okay...\Natsu... Erza...\Okay, I get that you don't remember anything.\No wonder I wasn't able to hear your thoughts at all... response:	Oracion Seis!
context: The black pillar has turned white!\I wonder what's happening?\Hibiki, wake up already!\I hope everyone is okay...\Natsu... Erza...\Okay, I get that you don't remember anything.\No wonder I wasn't able to hear your thoughts at all...\Oracion Seis! response:	How'd you manage to get here?
context: I wonder what's happening?\Hibiki, wake up already!\I hope everyone is okay...\Natsu... Erza...\Okay, I get that you don't remember anything.\No wonder I wasn't able to hear your thoughts at all...\Oracion Seis!\How'd you manage to get here? response:	And why did you unlock Nirvana's seal?
context: Hibiki, wake up already!\I hope everyone is okay...\Natsu... Erza...\Okay, I get that you don't remember anything.\No wonder I wasn't able to hear your thoughts at all...\Oracion Seis!\How'd you manage to get here?\And why did you unlock Nirvana's seal? response:	I heard someone's voice while I was asleep.
context: I hope everyone is okay...\Natsu... Erza...\Okay, I get that you don't remember anything.\No wonder I wasn't able to hear your thoughts at all...\Oracion Seis!\How'd you manage to get here?\And why did you unlock Nirvana's seal?\I heard someone's voice while I was asleep. response:	It said, We are going to obtain Nirvana.
context: Natsu... Erza...\Okay, I get that you don't remember anything.\No wonder I wasn't able to hear your thoughts at all...\Oracion Seis!\How'd you manage to get here?\And why did you unlock Nirvana's seal?\I heard someone's voice while I was asleep.\It said, We are going to obtain Nirvana. response:	I dimly remembered the place where that magic was hidden.
context: Okay, I get that you don't remember anything.\No wonder I wasn't able to hear your thoughts at all...\Oracion Seis!\How'd you manage to get here?\And why did you unlock Nirvana's seal?\I heard someone's voice while I was asleep.\It said, We are going to obtain Nirvana.\I dimly remembered the place where that magic was hidden. response:	This is a dangerous magic. It can't fall into anyone's hands.
context: No wonder I wasn't able to hear your thoughts at all...\Oracion Seis!\How'd you manage to get here?\And why did you unlock Nirvana's seal?\I heard someone's voice while I was asleep.\It said, We are going to obtain Nirvana.\I dimly remembered the place where that magic was hidden.\This is a dangerous magic. It can't fall into anyone's hands. response:	And that's why I released the seal... To destroy it completely.
context: Oracion Seis!\How'd you manage to get here?\And why did you unlock Nirvana's seal?\I heard someone's voice while I was asleep.\It said, We are going to obtain Nirvana.\I dimly remembered the place where that magic was hidden.\This is a dangerous magic. It can't fall into anyone's hands.\And that's why I released the seal... To destroy it completely. response:	To destroy Nirvana?
context: How'd you manage to get here?\And why did you unlock Nirvana's seal?\I heard someone's voice while I was asleep.\It said, We are going to obtain Nirvana.\I dimly remembered the place where that magic was hidden.\This is a dangerous magic. It can't fall into anyone's hands.\And that's why I released the seal... To destroy it completely.\To destroy Nirvana? response:	I've already set up the magic circle of self-destruction.
context: And why did you unlock Nirvana's seal?\I heard someone's voice while I was asleep.\It said, We are going to obtain Nirvana.\I dimly remembered the place where that magic was hidden.\This is a dangerous magic. It can't fall into anyone's hands.\And that's why I released the seal... To destroy it completely.\To destroy Nirvana?\I've already set up the magic circle of self-destruction. response:	Nirvana will shortly destroy itself.
context: I heard someone's voice while I was asleep.\It said, We are going to obtain Nirvana.\I dimly remembered the place where that magic was hidden.\This is a dangerous magic. It can't fall into anyone's hands.\And that's why I released the seal... To destroy it completely.\To destroy Nirvana?\I've already set up the magic circle of self-destruction.\Nirvana will shortly destroy itself. response:	What the heck is this high-level magic circle?
context: It said, We are going to obtain Nirvana.\I dimly remembered the place where that magic was hidden.\This is a dangerous magic. It can't fall into anyone's hands.\And that's why I released the seal... To destroy it completely.\To destroy Nirvana?\I've already set up the magic circle of self-destruction.\Nirvana will shortly destroy itself.\What the heck is this high-level magic circle? response:	At this rate, Nirvana will be destroyed!
context: I dimly remembered the place where that magic was hidden.\This is a dangerous magic. It can't fall into anyone's hands.\And that's why I released the seal... To destroy it completely.\To destroy Nirvana?\I've already set up the magic circle of self-destruction.\Nirvana will shortly destroy itself.\What the heck is this high-level magic circle?\At this rate, Nirvana will be destroyed! response:	Jellal! Spit out the cancellation code!
context: This is a dangerous magic. It can't fall into anyone's hands.\And that's why I released the seal... To destroy it completely.\To destroy Nirvana?\I've already set up the magic circle of self-destruction.\Nirvana will shortly destroy itself.\What the heck is this high-level magic circle?\At this rate, Nirvana will be destroyed!\Jellal! Spit out the cancellation code! response:	Erza...
context: And that's why I released the seal... To destroy it completely.\To destroy Nirvana?\I've already set up the magic circle of self-destruction.\Nirvana will shortly destroy itself.\What the heck is this high-level magic circle?\At this rate, Nirvana will be destroyed!\Jellal! Spit out the cancellation code!\Erza... response:	I can feel the kindness from that name...
context: To destroy Nirvana?\I've already set up the magic circle of self-destruction.\Nirvana will shortly destroy itself.\What the heck is this high-level magic circle?\At this rate, Nirvana will be destroyed!\Jellal! Spit out the cancellation code!\Erza...\I can feel the kindness from that name... response:	I can feel kindness, cheerfulness, and warmth...
context: I've already set up the magic circle of self-destruction.\Nirvana will shortly destroy itself.\What the heck is this high-level magic circle?\At this rate, Nirvana will be destroyed!\Jellal! Spit out the cancellation code!\Erza...\I can feel the kindness from that name...\I can feel kindness, cheerfulness, and warmth... response:	I'm sure you'll continue to hate me...
context: Nirvana will shortly destroy itself.\What the heck is this high-level magic circle?\At this rate, Nirvana will be destroyed!\Jellal! Spit out the cancellation code!\Erza...\I can feel the kindness from that name...\I can feel kindness, cheerfulness, and warmth...\I'm sure you'll continue to hate me... response:	But I can't help that... It's only natural.
context: What the heck is this high-level magic circle?\At this rate, Nirvana will be destroyed!\Jellal! Spit out the cancellation code!\Erza...\I can feel the kindness from that name...\I can feel kindness, cheerfulness, and warmth...\I'm sure you'll continue to hate me...\But I can't help that... It's only natural. response:	But hatred will steal the freedom from your heart.
context: At this rate, Nirvana will be destroyed!\Jellal! Spit out the cancellation code!\Erza...\I can feel the kindness from that name...\I can feel kindness, cheerfulness, and warmth...\I'm sure you'll continue to hate me...\But I can't help that... It's only natural.\But hatred will steal the freedom from your heart. response:	It will eat away at you from within...
context: Jellal! Spit out the cancellation code!\Erza...\I can feel the kindness from that name...\I can feel kindness, cheerfulness, and warmth...\I'm sure you'll continue to hate me...\But I can't help that... It's only natural.\But hatred will steal the freedom from your heart.\It will eat away at you from within... response:	You...
context: Erza...\I can feel the kindness from that name...\I can feel kindness, cheerfulness, and warmth...\I'm sure you'll continue to hate me...\But I can't help that... It's only natural.\But hatred will steal the freedom from your heart.\It will eat away at you from within...\You... response:	I can't go that far...
context: I can feel the kindness from that name...\I can feel kindness, cheerfulness, and warmth...\I'm sure you'll continue to hate me...\But I can't help that... It's only natural.\But hatred will steal the freedom from your heart.\It will eat away at you from within...\You...\I can't go that far... response:	I can't go before you!
context: I can feel kindness, cheerfulness, and warmth...\I'm sure you'll continue to hate me...\But I can't help that... It's only natural.\But hatred will steal the freedom from your heart.\It will eat away at you from within...\You...\I can't go that far...\I can't go before you! response:	He's...
context: I'm sure you'll continue to hate me...\But I can't help that... It's only natural.\But hatred will steal the freedom from your heart.\It will eat away at you from within...\You...\I can't go that far...\I can't go before you!\He's... response:	You will be free from Jellal...
context: But I can't help that... It's only natural.\But hatred will steal the freedom from your heart.\It will eat away at you from within...\You...\I can't go that far...\I can't go before you!\He's...\You will be free from Jellal... response:	I will take your hatred and sadness... with me...
context: But hatred will steal the freedom from your heart.\It will eat away at you from within...\You...\I can't go that far...\I can't go before you!\He's...\You will be free from Jellal...\I will take your hatred and sadness... with me... response:	He's attached a magic circle of self-destruction to his own body?!
context: It will eat away at you from within...\You...\I can't go that far...\I can't go before you!\He's...\You will be free from Jellal...\I will take your hatred and sadness... with me...\He's attached a magic circle of self-destruction to his own body?! response:	You are... free!
context: You...\I can't go that far...\I can't go before you!\He's...\You will be free from Jellal...\I will take your hatred and sadness... with me...\He's attached a magic circle of self-destruction to his own body?!\You are... free! response:	Jellal!
context: I can't go that far...\I can't go before you!\He's...\You will be free from Jellal...\I will take your hatred and sadness... with me...\He's attached a magic circle of self-destruction to his own body?!\You are... free!\Jellal! response:	What'll we do? Nirvana has been resurrected!
context: I can't go before you!\He's...\You will be free from Jellal...\I will take your hatred and sadness... with me...\He's attached a magic circle of self-destruction to his own body?!\You are... free!\Jellal!\What'll we do? Nirvana has been resurrected! response:	And it's got legs!
context: He's...\You will be free from Jellal...\I will take your hatred and sadness... with me...\He's attached a magic circle of self-destruction to his own body?!\You are... free!\Jellal!\What'll we do? Nirvana has been resurrected!\And it's got legs! response:	So Nirvana was actually an octopus?
context: You will be free from Jellal...\I will take your hatred and sadness... with me...\He's attached a magic circle of self-destruction to his own body?!\You are... free!\Jellal!\What'll we do? Nirvana has been resurrected!\And it's got legs!\So Nirvana was actually an octopus? response:	It's not an octopus, duh!
context: I will take your hatred and sadness... with me...\He's attached a magic circle of self-destruction to his own body?!\You are... free!\Jellal!\What'll we do? Nirvana has been resurrected!\And it's got legs!\So Nirvana was actually an octopus?\It's not an octopus, duh! response:	Then, a squid?
context: He's attached a magic circle of self-destruction to his own body?!\You are... free!\Jellal!\What'll we do? Nirvana has been resurrected!\And it's got legs!\So Nirvana was actually an octopus?\It's not an octopus, duh!\Then, a squid? response:	Fine, squid, whatever.
context: You are... free!\Jellal!\What'll we do? Nirvana has been resurrected!\And it's got legs!\So Nirvana was actually an octopus?\It's not an octopus, duh!\Then, a squid?\Fine, squid, whatever. response:	Can we stop squidding around and go already?
context: Jellal!\What'll we do? Nirvana has been resurrected!\And it's got legs!\So Nirvana was actually an octopus?\It's not an octopus, duh!\Then, a squid?\Fine, squid, whatever.\Can we stop squidding around and go already? response:	Happy...
context: What'll we do? Nirvana has been resurrected!\And it's got legs!\So Nirvana was actually an octopus?\It's not an octopus, duh!\Then, a squid?\Fine, squid, whatever.\Can we stop squidding around and go already?\Happy... response:	I think you got the wrong show!
context: And it's got legs!\So Nirvana was actually an octopus?\It's not an octopus, duh!\Then, a squid?\Fine, squid, whatever.\Can we stop squidding around and go already?\Happy...\I think you got the wrong show! response:	Huh?
context: So Nirvana was actually an octopus?\It's not an octopus, duh!\Then, a squid?\Fine, squid, whatever.\Can we stop squidding around and go already?\Happy...\I think you got the wrong show!\Huh? response:	Next time: March of Destruction!
context: It's not an octopus, duh!\Then, a squid?\Fine, squid, whatever.\Can we stop squidding around and go already?\Happy...\I think you got the wrong show!\Huh?\Next time: March of Destruction! response:	That's not what I was trying to...
context: Then, a squid?\Fine, squid, whatever.\Can we stop squidding around and go already?\Happy...\I think you got the wrong show!\Huh?\Next time: March of Destruction!\That's not what I was trying to... response:	Don't deny it!
context: Fine, squid, whatever.\Can we stop squidding around and go already?\Happy...\I think you got the wrong show!\Huh?\Next time: March of Destruction!\That's not what I was trying to...\Don't deny it! response:	I thought it was awesome!
context: Can we stop squidding around and go already?\Happy...\I think you got the wrong show!\Huh?\Next time: March of Destruction!\That's not what I was trying to...\Don't deny it!\I thought it was awesome! response:	I think I'll leave him here and go by myself.