context: Summer is almost over. response:	Hey Sakura What?
context: Summer is almost over.\Hey Sakura What? response:	Is it really okay that we have so much free time lately?
context: Summer is almost over.\Hey Sakura What?\Is it really okay that we have so much free time lately? response:	What are you talking about?
context: Summer is almost over.\Hey Sakura What?\Is it really okay that we have so much free time lately?\What are you talking about? response:	Because of that,
context: Summer is almost over.\Hey Sakura What?\Is it really okay that we have so much free time lately?\What are you talking about?\Because of that, response:	we had lots of time to play, didn't we?
context: Summer is almost over.\Hey Sakura What?\Is it really okay that we have so much free time lately?\What are you talking about?\Because of that,\we had lots of time to play, didn't we? response:	Yeah, but'
context: Summer is almost over.\Hey Sakura What?\Is it really okay that we have so much free time lately?\What are you talking about?\Because of that,\we had lots of time to play, didn't we?\Yeah, but' response:	Huh? What are you doing?
context: Summer is almost over.\Hey Sakura What?\Is it really okay that we have so much free time lately?\What are you talking about?\Because of that,\we had lots of time to play, didn't we?\Yeah, but'\Huh? What are you doing? response:	I got a letter from Miss Mizuki,
context: Hey Sakura What?\Is it really okay that we have so much free time lately?\What are you talking about?\Because of that,\we had lots of time to play, didn't we?\Yeah, but'\Huh? What are you doing?\I got a letter from Miss Mizuki, response:	so I'm writing her back
context: Is it really okay that we have so much free time lately?\What are you talking about?\Because of that,\we had lots of time to play, didn't we?\Yeah, but'\Huh? What are you doing?\I got a letter from Miss Mizuki,\so I'm writing her back response:	That lady went somewhere
context: What are you talking about?\Because of that,\we had lots of time to play, didn't we?\Yeah, but'\Huh? What are you doing?\I got a letter from Miss Mizuki,\so I'm writing her back\That lady went somewhere response:	oversea to study, didn't she
context: Because of that,\we had lots of time to play, didn't we?\Yeah, but'\Huh? What are you doing?\I got a letter from Miss Mizuki,\so I'm writing her back\That lady went somewhere\oversea to study, didn't she response:	Is she doing fine?
context: we had lots of time to play, didn't we?\Yeah, but'\Huh? What are you doing?\I got a letter from Miss Mizuki,\so I'm writing her back\That lady went somewhere\oversea to study, didn't she\Is she doing fine? response:	Yeah, she said she's studyng hard.
context: Yeah, but'\Huh? What are you doing?\I got a letter from Miss Mizuki,\so I'm writing her back\That lady went somewhere\oversea to study, didn't she\Is she doing fine?\Yeah, she said she's studyng hard. response:	But thanks to her,
context: Huh? What are you doing?\I got a letter from Miss Mizuki,\so I'm writing her back\That lady went somewhere\oversea to study, didn't she\Is she doing fine?\Yeah, she said she's studyng hard.\But thanks to her, response:	you've officially become the Mistress of the Clow Cards
context: I got a letter from Miss Mizuki,\so I'm writing her back\That lady went somewhere\oversea to study, didn't she\Is she doing fine?\Yeah, she said she's studyng hard.\But thanks to her,\you've officially become the Mistress of the Clow Cards response:	I'm real glad for that.
context: so I'm writing her back\That lady went somewhere\oversea to study, didn't she\Is she doing fine?\Yeah, she said she's studyng hard.\But thanks to her,\you've officially become the Mistress of the Clow Cards\I'm real glad for that. response:	Why? Isn't it obvious?
context: That lady went somewhere\oversea to study, didn't she\Is she doing fine?\Yeah, she said she's studyng hard.\But thanks to her,\you've officially become the Mistress of the Clow Cards\I'm real glad for that.\Why? Isn't it obvious? response:	If that brat had become the Master,
context: oversea to study, didn't she\Is she doing fine?\Yeah, she said she's studyng hard.\But thanks to her,\you've officially become the Mistress of the Clow Cards\I'm real glad for that.\Why? Isn't it obvious?\If that brat had become the Master, response:	I'd have lost all my confidence to live.
context: Is she doing fine?\Yeah, she said she's studyng hard.\But thanks to her,\you've officially become the Mistress of the Clow Cards\I'm real glad for that.\Why? Isn't it obvious?\If that brat had become the Master,\I'd have lost all my confidence to live. response:	Don't say that!
context: Yeah, she said she's studyng hard.\But thanks to her,\you've officially become the Mistress of the Clow Cards\I'm real glad for that.\Why? Isn't it obvious?\If that brat had become the Master,\I'd have lost all my confidence to live.\Don't say that! response:	Li worked hard at it too!
context: But thanks to her,\you've officially become the Mistress of the Clow Cards\I'm real glad for that.\Why? Isn't it obvious?\If that brat had become the Master,\I'd have lost all my confidence to live.\Don't say that!\Li worked hard at it too! response:	By the way, what's he gonna do?
context: you've officially become the Mistress of the Clow Cards\I'm real glad for that.\Why? Isn't it obvious?\If that brat had become the Master,\I'd have lost all my confidence to live.\Don't say that!\Li worked hard at it too!\By the way, what's he gonna do? response:	Has he gone back to Hong Kong yet?
context: I'm real glad for that.\Why? Isn't it obvious?\If that brat had become the Master,\I'd have lost all my confidence to live.\Don't say that!\Li worked hard at it too!\By the way, what's he gonna do?\Has he gone back to Hong Kong yet? response:	Not yet,
context: Why? Isn't it obvious?\If that brat had become the Master,\I'd have lost all my confidence to live.\Don't say that!\Li worked hard at it too!\By the way, what's he gonna do?\Has he gone back to Hong Kong yet?\Not yet, response:	but he said he'd be going back soon.
context: If that brat had become the Master,\I'd have lost all my confidence to live.\Don't say that!\Li worked hard at it too!\By the way, what's he gonna do?\Has he gone back to Hong Kong yet?\Not yet,\but he said he'd be going back soon. response:	With this much free time every day,
context: I'd have lost all my confidence to live.\Don't say that!\Li worked hard at it too!\By the way, what's he gonna do?\Has he gone back to Hong Kong yet?\Not yet,\but he said he'd be going back soon.\With this much free time every day, response:	it's getting boring!
context: Don't say that!\Li worked hard at it too!\By the way, what's he gonna do?\Has he gone back to Hong Kong yet?\Not yet,\but he said he'd be going back soon.\With this much free time every day,\it's getting boring! response:	I don't have any free time
context: Li worked hard at it too!\By the way, what's he gonna do?\Has he gone back to Hong Kong yet?\Not yet,\but he said he'd be going back soon.\With this much free time every day,\it's getting boring!\I don't have any free time response:	because I have school tomorrow'
context: By the way, what's he gonna do?\Has he gone back to Hong Kong yet?\Not yet,\but he said he'd be going back soon.\With this much free time every day,\it's getting boring!\I don't have any free time\because I have school tomorrow' response:	Huh? What's wrong?
context: Has he gone back to Hong Kong yet?\Not yet,\but he said he'd be going back soon.\With this much free time every day,\it's getting boring!\I don't have any free time\because I have school tomorrow'\Huh? What's wrong? response:	The summer vacation homework were still left in the school bag!!
context: Not yet,\but he said he'd be going back soon.\With this much free time every day,\it's getting boring!\I don't have any free time\because I have school tomorrow'\Huh? What's wrong?\The summer vacation homework were still left in the school bag!! response:	What??!
context: but he said he'd be going back soon.\With this much free time every day,\it's getting boring!\I don't have any free time\because I have school tomorrow'\Huh? What's wrong?\The summer vacation homework were still left in the school bag!!\What??! response:	Gotta finish Maths exercise,
context: With this much free time every day,\it's getting boring!\I don't have any free time\because I have school tomorrow'\Huh? What's wrong?\The summer vacation homework were still left in the school bag!!\What??!\Gotta finish Maths exercise, response:	Japanese exercise,
context: it's getting boring!\I don't have any free time\because I have school tomorrow'\Huh? What's wrong?\The summer vacation homework were still left in the school bag!!\What??!\Gotta finish Maths exercise,\Japanese exercise, response:	Picture Diary.
context: I don't have any free time\because I have school tomorrow'\Huh? What's wrong?\The summer vacation homework were still left in the school bag!!\What??!\Gotta finish Maths exercise,\Japanese exercise,\Picture Diary. response:	and then there's independent research, and' and'
context: because I have school tomorrow'\Huh? What's wrong?\The summer vacation homework were still left in the school bag!!\What??!\Gotta finish Maths exercise,\Japanese exercise,\Picture Diary.\and then there's independent research, and' and' response:	Can you finish them all in one night?
context: Huh? What's wrong?\The summer vacation homework were still left in the school bag!!\What??!\Gotta finish Maths exercise,\Japanese exercise,\Picture Diary.\and then there's independent research, and' and'\Can you finish them all in one night? response:	It'll all work out!
context: The summer vacation homework were still left in the school bag!!\What??!\Gotta finish Maths exercise,\Japanese exercise,\Picture Diary.\and then there's independent research, and' and'\Can you finish them all in one night?\It'll all work out! response:	It'll be okay for sure!
context: What??!\Gotta finish Maths exercise,\Japanese exercise,\Picture Diary.\and then there's independent research, and' and'\Can you finish them all in one night?\It'll all work out!\It'll be okay for sure! response:	This is not too good.
context: Gotta finish Maths exercise,\Japanese exercise,\Picture Diary.\and then there's independent research, and' and'\Can you finish them all in one night?\It'll all work out!\It'll be okay for sure!\This is not too good. response:	Kero, help me please!!
context: Japanese exercise,\Picture Diary.\and then there's independent research, and' and'\Can you finish them all in one night?\It'll all work out!\It'll be okay for sure!\This is not too good.\Kero, help me please!! response:	I helped you last year, and you got mad at me!
context: Picture Diary.\and then there's independent research, and' and'\Can you finish them all in one night?\It'll all work out!\It'll be okay for sure!\This is not too good.\Kero, help me please!!\I helped you last year, and you got mad at me! response:	Yeah, but now'
context: and then there's independent research, and' and'\Can you finish them all in one night?\It'll all work out!\It'll be okay for sure!\This is not too good.\Kero, help me please!!\I helped you last year, and you got mad at me!\Yeah, but now' response:	Oh, by the way, I'm on duty tomorrow!
context: Can you finish them all in one night?\It'll all work out!\It'll be okay for sure!\This is not too good.\Kero, help me please!!\I helped you last year, and you got mad at me!\Yeah, but now'\Oh, by the way, I'm on duty tomorrow! response:	Oh no! I gotta get up early tomorrow!
context: It'll all work out!\It'll be okay for sure!\This is not too good.\Kero, help me please!!\I helped you last year, and you got mad at me!\Yeah, but now'\Oh, by the way, I'm on duty tomorrow!\Oh no! I gotta get up early tomorrow! response:	You'll be fine!
context: It'll be okay for sure!\This is not too good.\Kero, help me please!!\I helped you last year, and you got mad at me!\Yeah, but now'\Oh, by the way, I'm on duty tomorrow!\Oh no! I gotta get up early tomorrow!\You'll be fine! response:	I'm sure you'll get all of them done.
context: This is not too good.\Kero, help me please!!\I helped you last year, and you got mad at me!\Yeah, but now'\Oh, by the way, I'm on duty tomorrow!\Oh no! I gotta get up early tomorrow!\You'll be fine!\I'm sure you'll get all of them done. response:	Good morning!
context: Kero, help me please!!\I helped you last year, and you got mad at me!\Yeah, but now'\Oh, by the way, I'm on duty tomorrow!\Oh no! I gotta get up early tomorrow!\You'll be fine!\I'm sure you'll get all of them done.\Good morning! response:	Did you finish your homework? Yeah!
context: I helped you last year, and you got mad at me!\Yeah, but now'\Oh, by the way, I'm on duty tomorrow!\Oh no! I gotta get up early tomorrow!\You'll be fine!\I'm sure you'll get all of them done.\Good morning!\Did you finish your homework? Yeah! response:	Good morning, Mother.
context: Yeah, but now'\Oh, by the way, I'm on duty tomorrow!\Oh no! I gotta get up early tomorrow!\You'll be fine!\I'm sure you'll get all of them done.\Good morning!\Did you finish your homework? Yeah!\Good morning, Mother. response:	Are you okay, Sakura?
context: Oh, by the way, I'm on duty tomorrow!\Oh no! I gotta get up early tomorrow!\You'll be fine!\I'm sure you'll get all of them done.\Good morning!\Did you finish your homework? Yeah!\Good morning, Mother.\Are you okay, Sakura? response:	Good morning, Father
context: Oh no! I gotta get up early tomorrow!\You'll be fine!\I'm sure you'll get all of them done.\Good morning!\Did you finish your homework? Yeah!\Good morning, Mother.\Are you okay, Sakura?\Good morning, Father response:	Good morning
context: You'll be fine!\I'm sure you'll get all of them done.\Good morning!\Did you finish your homework? Yeah!\Good morning, Mother.\Are you okay, Sakura?\Good morning, Father\Good morning response:	Today's only the opening ceremony but you're up quite early.
context: I'm sure you'll get all of them done.\Good morning!\Did you finish your homework? Yeah!\Good morning, Mother.\Are you okay, Sakura?\Good morning, Father\Good morning\Today's only the opening ceremony but you're up quite early. response:	I'm on duty today.
context: Good morning!\Did you finish your homework? Yeah!\Good morning, Mother.\Are you okay, Sakura?\Good morning, Father\Good morning\Today's only the opening ceremony but you're up quite early.\I'm on duty today. response:	I see.
context: Did you finish your homework? Yeah!\Good morning, Mother.\Are you okay, Sakura?\Good morning, Father\Good morning\Today's only the opening ceremony but you're up quite early.\I'm on duty today.\I see. response:	From today on is the 2nd semester.
context: Good morning, Mother.\Are you okay, Sakura?\Good morning, Father\Good morning\Today's only the opening ceremony but you're up quite early.\I'm on duty today.\I see.\From today on is the 2nd semester. response:	Work hard, okay
context: Are you okay, Sakura?\Good morning, Father\Good morning\Today's only the opening ceremony but you're up quite early.\I'm on duty today.\I see.\From today on is the 2nd semester.\Work hard, okay response:	Thanks for the food.
context: Good morning, Father\Good morning\Today's only the opening ceremony but you're up quite early.\I'm on duty today.\I see.\From today on is the 2nd semester.\Work hard, okay\Thanks for the food. response:	Even if you go this early,
context: Good morning\Today's only the opening ceremony but you're up quite early.\I'm on duty today.\I see.\From today on is the 2nd semester.\Work hard, okay\Thanks for the food.\Even if you go this early, response:	Yuki won't be there.
context: Today's only the opening ceremony but you're up quite early.\I'm on duty today.\I see.\From today on is the 2nd semester.\Work hard, okay\Thanks for the food.\Even if you go this early,\Yuki won't be there. response:	That's not it!!
context: I'm on duty today.\I see.\From today on is the 2nd semester.\Work hard, okay\Thanks for the food.\Even if you go this early,\Yuki won't be there.\That's not it!! response:	I'm going now.
context: I see.\From today on is the 2nd semester.\Work hard, okay\Thanks for the food.\Even if you go this early,\Yuki won't be there.\That's not it!!\I'm going now. response:	Humm, I hate Maths already.
context: From today on is the 2nd semester.\Work hard, okay\Thanks for the food.\Even if you go this early,\Yuki won't be there.\That's not it!!\I'm going now.\Humm, I hate Maths already. response:	Come to think of it,
context: Work hard, okay\Thanks for the food.\Even if you go this early,\Yuki won't be there.\That's not it!!\I'm going now.\Humm, I hate Maths already.\Come to think of it, response:	who's on duty with me today?
context: Thanks for the food.\Even if you go this early,\Yuki won't be there.\That's not it!!\I'm going now.\Humm, I hate Maths already.\Come to think of it,\who's on duty with me today? response:	Yukito!
context: Even if you go this early,\Yuki won't be there.\That's not it!!\I'm going now.\Humm, I hate Maths already.\Come to think of it,\who's on duty with me today?\Yukito! response:	' Sakura!' Good morning!
context: Yuki won't be there.\That's not it!!\I'm going now.\Humm, I hate Maths already.\Come to think of it,\who's on duty with me today?\Yukito!\' Sakura!' Good morning! response:	Good morning! Oh, you're really early today.
context: That's not it!!\I'm going now.\Humm, I hate Maths already.\Come to think of it,\who's on duty with me today?\Yukito!\' Sakura!' Good morning!\Good morning! Oh, you're really early today. response:	I'm on duty and so'
context: I'm going now.\Humm, I hate Maths already.\Come to think of it,\who's on duty with me today?\Yukito!\' Sakura!' Good morning!\Good morning! Oh, you're really early today.\I'm on duty and so' response:	But you're early too.
context: Humm, I hate Maths already.\Come to think of it,\who's on duty with me today?\Yukito!\' Sakura!' Good morning!\Good morning! Oh, you're really early today.\I'm on duty and so'\But you're early too. response:	I got up early to buy breakfast.
context: Come to think of it,\who's on duty with me today?\Yukito!\' Sakura!' Good morning!\Good morning! Oh, you're really early today.\I'm on duty and so'\But you're early too.\I got up early to buy breakfast. response:	Because lately,
context: who's on duty with me today?\Yukito!\' Sakura!' Good morning!\Good morning! Oh, you're really early today.\I'm on duty and so'\But you're early too.\I got up early to buy breakfast.\Because lately, response:	no matter how much I eat, I'm still hungry'
context: Yukito!\' Sakura!' Good morning!\Good morning! Oh, you're really early today.\I'm on duty and so'\But you're early too.\I got up early to buy breakfast.\Because lately,\no matter how much I eat, I'm still hungry' response:	Maybe I bought a little too much.
context: ' Sakura!' Good morning!\Good morning! Oh, you're really early today.\I'm on duty and so'\But you're early too.\I got up early to buy breakfast.\Because lately,\no matter how much I eat, I'm still hungry'\Maybe I bought a little too much. response:	No' Not at all!
context: Good morning! Oh, you're really early today.\I'm on duty and so'\But you're early too.\I got up early to buy breakfast.\Because lately,\no matter how much I eat, I'm still hungry'\Maybe I bought a little too much.\No' Not at all! response:	To be able to eat a lot'
context: I'm on duty and so'\But you're early too.\I got up early to buy breakfast.\Because lately,\no matter how much I eat, I'm still hungry'\Maybe I bought a little too much.\No' Not at all!\To be able to eat a lot' response:	It's the proof of good health, right?
context: But you're early too.\I got up early to buy breakfast.\Because lately,\no matter how much I eat, I'm still hungry'\Maybe I bought a little too much.\No' Not at all!\To be able to eat a lot'\It's the proof of good health, right? response:	Yup!
context: I got up early to buy breakfast.\Because lately,\no matter how much I eat, I'm still hungry'\Maybe I bought a little too much.\No' Not at all!\To be able to eat a lot'\It's the proof of good health, right?\Yup! response:	Oh, I've to go now.
context: Because lately,\no matter how much I eat, I'm still hungry'\Maybe I bought a little too much.\No' Not at all!\To be able to eat a lot'\It's the proof of good health, right?\Yup!\Oh, I've to go now. response:	okay, See you later.
context: no matter how much I eat, I'm still hungry'\Maybe I bought a little too much.\No' Not at all!\To be able to eat a lot'\It's the proof of good health, right?\Yup!\Oh, I've to go now.\okay, See you later. response:	Yukito is the
context: Maybe I bought a little too much.\No' Not at all!\To be able to eat a lot'\It's the proof of good health, right?\Yup!\Oh, I've to go now.\okay, See you later.\Yukito is the response:	false form of Yue'
context: No' Not at all!\To be able to eat a lot'\It's the proof of good health, right?\Yup!\Oh, I've to go now.\okay, See you later.\Yukito is the\false form of Yue' response:	Sakura!
context: To be able to eat a lot'\It's the proof of good health, right?\Yup!\Oh, I've to go now.\okay, See you later.\Yukito is the\false form of Yue'\Sakura! response:	But, but but,
context: It's the proof of good health, right?\Yup!\Oh, I've to go now.\okay, See you later.\Yukito is the\false form of Yue'\Sakura!\But, but but, response:	Yukito is Yukito after all!!
context: Yup!\Oh, I've to go now.\okay, See you later.\Yukito is the\false form of Yue'\Sakura!\But, but but,\Yukito is Yukito after all!! response:	Good morning!
context: Oh, I've to go now.\okay, See you later.\Yukito is the\false form of Yue'\Sakura!\But, but but,\Yukito is Yukito after all!!\Good morning! response:	But, no one's here yet anyway.
context: okay, See you later.\Yukito is the\false form of Yue'\Sakura!\But, but but,\Yukito is Yukito after all!!\Good morning!\But, no one's here yet anyway. response:	On duty, on duty, on-duty.
context: Yukito is the\false form of Yue'\Sakura!\But, but but,\Yukito is Yukito after all!!\Good morning!\But, no one's here yet anyway.\On duty, on duty, on-duty. response:	I even finished the summer vacation homework somehow.
context: false form of Yue'\Sakura!\But, but but,\Yukito is Yukito after all!!\Good morning!\But, no one's here yet anyway.\On duty, on duty, on-duty.\I even finished the summer vacation homework somehow. response:	Writing the class journal,
context: Sakura!\But, but but,\Yukito is Yukito after all!!\Good morning!\But, no one's here yet anyway.\On duty, on duty, on-duty.\I even finished the summer vacation homework somehow.\Writing the class journal, response:	changing the flowers.
context: But, but but,\Yukito is Yukito after all!!\Good morning!\But, no one's here yet anyway.\On duty, on duty, on-duty.\I even finished the summer vacation homework somehow.\Writing the class journal,\changing the flowers. response:	Let's make everyone's desk clean.
context: Yukito is Yukito after all!!\Good morning!\But, no one's here yet anyway.\On duty, on duty, on-duty.\I even finished the summer vacation homework somehow.\Writing the class journal,\changing the flowers.\Let's make everyone's desk clean. response:	On duty, on duty, my'
context: Good morning!\But, no one's here yet anyway.\On duty, on duty, on-duty.\I even finished the summer vacation homework somehow.\Writing the class journal,\changing the flowers.\Let's make everyone's desk clean.\On duty, on duty, my' response:	Good morning, Li.
context: But, no one's here yet anyway.\On duty, on duty, on-duty.\I even finished the summer vacation homework somehow.\Writing the class journal,\changing the flowers.\Let's make everyone's desk clean.\On duty, on duty, my'\Good morning, Li. response:	Good morning
context: On duty, on duty, on-duty.\I even finished the summer vacation homework somehow.\Writing the class journal,\changing the flowers.\Let's make everyone's desk clean.\On duty, on duty, my'\Good morning, Li.\Good morning response:	So you heard me'
context: I even finished the summer vacation homework somehow.\Writing the class journal,\changing the flowers.\Let's make everyone's desk clean.\On duty, on duty, my'\Good morning, Li.\Good morning\So you heard me' response:	I see, I'm on duty with Li today'
context: Writing the class journal,\changing the flowers.\Let's make everyone's desk clean.\On duty, on duty, my'\Good morning, Li.\Good morning\So you heard me'\I see, I'm on duty with Li today' response:	Because all the Clow Cards were captured before summer break
context: changing the flowers.\Let's make everyone's desk clean.\On duty, on duty, my'\Good morning, Li.\Good morning\So you heard me'\I see, I'm on duty with Li today'\Because all the Clow Cards were captured before summer break response:	we haven't seen each other for a while, you know?
context: Let's make everyone's desk clean.\On duty, on duty, my'\Good morning, Li.\Good morning\So you heard me'\I see, I'm on duty with Li today'\Because all the Clow Cards were captured before summer break\we haven't seen each other for a while, you know? response:	' Yeah.' How was your summer?
context: On duty, on duty, my'\Good morning, Li.\Good morning\So you heard me'\I see, I'm on duty with Li today'\Because all the Clow Cards were captured before summer break\we haven't seen each other for a while, you know?\' Yeah.' How was your summer? response:	' Did you go anywhere?' No.
context: Good morning, Li.\Good morning\So you heard me'\I see, I'm on duty with Li today'\Because all the Clow Cards were captured before summer break\we haven't seen each other for a while, you know?\' Yeah.' How was your summer?\' Did you go anywhere?' No. response:	' What about the beach?' Didn't go.
context: Good morning\So you heard me'\I see, I'm on duty with Li today'\Because all the Clow Cards were captured before summer break\we haven't seen each other for a while, you know?\' Yeah.' How was your summer?\' Did you go anywhere?' No.\' What about the beach?' Didn't go. response:	So, are you really going back to Hong Kong?
context: So you heard me'\I see, I'm on duty with Li today'\Because all the Clow Cards were captured before summer break\we haven't seen each other for a while, you know?\' Yeah.' How was your summer?\' Did you go anywhere?' No.\' What about the beach?' Didn't go.\So, are you really going back to Hong Kong? response:	Yeah.
context: I see, I'm on duty with Li today'\Because all the Clow Cards were captured before summer break\we haven't seen each other for a while, you know?\' Yeah.' How was your summer?\' Did you go anywhere?' No.\' What about the beach?' Didn't go.\So, are you really going back to Hong Kong?\Yeah. response:	Since the Clow Cards already have a new Mistress,
context: Because all the Clow Cards were captured before summer break\we haven't seen each other for a while, you know?\' Yeah.' How was your summer?\' Did you go anywhere?' No.\' What about the beach?' Didn't go.\So, are you really going back to Hong Kong?\Yeah.\Since the Clow Cards already have a new Mistress, response:	I have to explain to Mother.
context: we haven't seen each other for a while, you know?\' Yeah.' How was your summer?\' Did you go anywhere?' No.\' What about the beach?' Didn't go.\So, are you really going back to Hong Kong?\Yeah.\Since the Clow Cards already have a new Mistress,\I have to explain to Mother. response:	I see'
context: ' Yeah.' How was your summer?\' Did you go anywhere?' No.\' What about the beach?' Didn't go.\So, are you really going back to Hong Kong?\Yeah.\Since the Clow Cards already have a new Mistress,\I have to explain to Mother.\I see' response:	It's not like we'll never see each other again.
context: ' Did you go anywhere?' No.\' What about the beach?' Didn't go.\So, are you really going back to Hong Kong?\Yeah.\Since the Clow Cards already have a new Mistress,\I have to explain to Mother.\I see'\It's not like we'll never see each other again. response:	Tha' That's right.
context: ' What about the beach?' Didn't go.\So, are you really going back to Hong Kong?\Yeah.\Since the Clow Cards already have a new Mistress,\I have to explain to Mother.\I see'\It's not like we'll never see each other again.\Tha' That's right. response:	Thank goodness
context: So, are you really going back to Hong Kong?\Yeah.\Since the Clow Cards already have a new Mistress,\I have to explain to Mother.\I see'\It's not like we'll never see each other again.\Tha' That's right.\Thank goodness response:	' Good morning.' Good morning, Tomoyo!
context: Yeah.\Since the Clow Cards already have a new Mistress,\I have to explain to Mother.\I see'\It's not like we'll never see each other again.\Tha' That's right.\Thank goodness\' Good morning.' Good morning, Tomoyo! response:	' What's wrong?' Lately,
context: Since the Clow Cards already have a new Mistress,\I have to explain to Mother.\I see'\It's not like we'll never see each other again.\Tha' That's right.\Thank goodness\' Good morning.' Good morning, Tomoyo!\' What's wrong?' Lately, response:	there has not been many occasions
context: I have to explain to Mother.\I see'\It's not like we'll never see each other again.\Tha' That's right.\Thank goodness\' Good morning.' Good morning, Tomoyo!\' What's wrong?' Lately,\there has not been many occasions response:	for you to wear my special costumes.
context: I see'\It's not like we'll never see each other again.\Tha' That's right.\Thank goodness\' Good morning.' Good morning, Tomoyo!\' What's wrong?' Lately,\there has not been many occasions\for you to wear my special costumes. response:	I still have so many, many, many costumes
context: It's not like we'll never see each other again.\Tha' That's right.\Thank goodness\' Good morning.' Good morning, Tomoyo!\' What's wrong?' Lately,\there has not been many occasions\for you to wear my special costumes.\I still have so many, many, many costumes response:	that I would like you to wear for me
context: Tha' That's right.\Thank goodness\' Good morning.' Good morning, Tomoyo!\' What's wrong?' Lately,\there has not been many occasions\for you to wear my special costumes.\I still have so many, many, many costumes\that I would like you to wear for me response:	And then, to film you in these costumes'
context: Thank goodness\' Good morning.' Good morning, Tomoyo!\' What's wrong?' Lately,\there has not been many occasions\for you to wear my special costumes.\I still have so many, many, many costumes\that I would like you to wear for me\And then, to film you in these costumes' response:	It would have been so great!
context: ' Good morning.' Good morning, Tomoyo!\' What's wrong?' Lately,\there has not been many occasions\for you to wear my special costumes.\I still have so many, many, many costumes\that I would like you to wear for me\And then, to film you in these costumes'\It would have been so great! response:	' Tomoyo'' So great!
context: ' What's wrong?' Lately,\there has not been many occasions\for you to wear my special costumes.\I still have so many, many, many costumes\that I would like you to wear for me\And then, to film you in these costumes'\It would have been so great!\' Tomoyo'' So great! response:	' Good morning!' Good morning!
context: there has not been many occasions\for you to wear my special costumes.\I still have so many, many, many costumes\that I would like you to wear for me\And then, to film you in these costumes'\It would have been so great!\' Tomoyo'' So great!\' Good morning!' Good morning! response:	Thanks for the letter.
context: for you to wear my special costumes.\I still have so many, many, many costumes\that I would like you to wear for me\And then, to film you in these costumes'\It would have been so great!\' Tomoyo'' So great!\' Good morning!' Good morning!\Thanks for the letter. response:	Did you get my reply?
context: I still have so many, many, many costumes\that I would like you to wear for me\And then, to film you in these costumes'\It would have been so great!\' Tomoyo'' So great!\' Good morning!' Good morning!\Thanks for the letter.\Did you get my reply? response:	Yeah, I got everyone's reply already.
context: that I would like you to wear for me\And then, to film you in these costumes'\It would have been so great!\' Tomoyo'' So great!\' Good morning!' Good morning!\Thanks for the letter.\Did you get my reply?\Yeah, I got everyone's reply already. response:	Oh yeah,
context: And then, to film you in these costumes'\It would have been so great!\' Tomoyo'' So great!\' Good morning!' Good morning!\Thanks for the letter.\Did you get my reply?\Yeah, I got everyone's reply already.\Oh yeah, response:	I got one from Miss Mizuki too.
context: It would have been so great!\' Tomoyo'' So great!\' Good morning!' Good morning!\Thanks for the letter.\Did you get my reply?\Yeah, I got everyone's reply already.\Oh yeah,\I got one from Miss Mizuki too. response:	She replied you too.
context: ' Tomoyo'' So great!\' Good morning!' Good morning!\Thanks for the letter.\Did you get my reply?\Yeah, I got everyone's reply already.\Oh yeah,\I got one from Miss Mizuki too.\She replied you too. response:	Is she doing well?
context: ' Good morning!' Good morning!\Thanks for the letter.\Did you get my reply?\Yeah, I got everyone's reply already.\Oh yeah,\I got one from Miss Mizuki too.\She replied you too.\Is she doing well? response:	Yeah, she said she's studying hard in England.
context: Thanks for the letter.\Did you get my reply?\Yeah, I got everyone's reply already.\Oh yeah,\I got one from Miss Mizuki too.\She replied you too.\Is she doing well?\Yeah, she said she's studying hard in England. response:	Do you know who's our class teacher
context: Did you get my reply?\Yeah, I got everyone's reply already.\Oh yeah,\I got one from Miss Mizuki too.\She replied you too.\Is she doing well?\Yeah, she said she's studying hard in England.\Do you know who's our class teacher response:	for the 2nd semester
context: Yeah, I got everyone's reply already.\Oh yeah,\I got one from Miss Mizuki too.\She replied you too.\Is she doing well?\Yeah, she said she's studying hard in England.\Do you know who's our class teacher\for the 2nd semester response:	Come to think of it, who could it be?
context: Oh yeah,\I got one from Miss Mizuki too.\She replied you too.\Is she doing well?\Yeah, she said she's studying hard in England.\Do you know who's our class teacher\for the 2nd semester\Come to think of it, who could it be? response:	Tomoyo, do you know?
context: I got one from Miss Mizuki too.\She replied you too.\Is she doing well?\Yeah, she said she's studying hard in England.\Do you know who's our class teacher\for the 2nd semester\Come to think of it, who could it be?\Tomoyo, do you know? response:	Yes, I saw our class teacher just now.
context: She replied you too.\Is she doing well?\Yeah, she said she's studying hard in England.\Do you know who's our class teacher\for the 2nd semester\Come to think of it, who could it be?\Tomoyo, do you know?\Yes, I saw our class teacher just now. response:	' Who is it? Who is it?' Teacher is here.
context: Is she doing well?\Yeah, she said she's studying hard in England.\Do you know who's our class teacher\for the 2nd semester\Come to think of it, who could it be?\Tomoyo, do you know?\Yes, I saw our class teacher just now.\' Who is it? Who is it?' Teacher is here. response:	Get to your seats!
context: Yeah, she said she's studying hard in England.\Do you know who's our class teacher\for the 2nd semester\Come to think of it, who could it be?\Tomoyo, do you know?\Yes, I saw our class teacher just now.\' Who is it? Who is it?' Teacher is here.\Get to your seats! response:	It is Mr Terada!
context: Do you know who's our class teacher\for the 2nd semester\Come to think of it, who could it be?\Tomoyo, do you know?\Yes, I saw our class teacher just now.\' Who is it? Who is it?' Teacher is here.\Get to your seats!\It is Mr Terada! response:	So,
context: for the 2nd semester\Come to think of it, who could it be?\Tomoyo, do you know?\Yes, I saw our class teacher just now.\' Who is it? Who is it?' Teacher is here.\Get to your seats!\It is Mr Terada!\So, response:	summer break ended yesterday,
context: Come to think of it, who could it be?\Tomoyo, do you know?\Yes, I saw our class teacher just now.\' Who is it? Who is it?' Teacher is here.\Get to your seats!\It is Mr Terada!\So,\summer break ended yesterday, response:	did all of you bring your homework?
context: Tomoyo, do you know?\Yes, I saw our class teacher just now.\' Who is it? Who is it?' Teacher is here.\Get to your seats!\It is Mr Terada!\So,\summer break ended yesterday,\did all of you bring your homework? response:	Yes!
context: Yes, I saw our class teacher just now.\' Who is it? Who is it?' Teacher is here.\Get to your seats!\It is Mr Terada!\So,\summer break ended yesterday,\did all of you bring your homework?\Yes! response:	Today, I'll introduce you to your new classmate
context: ' Who is it? Who is it?' Teacher is here.\Get to your seats!\It is Mr Terada!\So,\summer break ended yesterday,\did all of you bring your homework?\Yes!\Today, I'll introduce you to your new classmate response:	who'll be studying with us.
context: Get to your seats!\It is Mr Terada!\So,\summer break ended yesterday,\did all of you bring your homework?\Yes!\Today, I'll introduce you to your new classmate\who'll be studying with us. response:	Now, Come in.
context: It is Mr Terada!\So,\summer break ended yesterday,\did all of you bring your homework?\Yes!\Today, I'll introduce you to your new classmate\who'll be studying with us.\Now, Come in. response:	He seems kind.
context: So,\summer break ended yesterday,\did all of you bring your homework?\Yes!\Today, I'll introduce you to your new classmate\who'll be studying with us.\Now, Come in.\He seems kind. response:	This is Eriol Hiiragizawa
context: summer break ended yesterday,\did all of you bring your homework?\Yes!\Today, I'll introduce you to your new classmate\who'll be studying with us.\Now, Come in.\He seems kind.\This is Eriol Hiiragizawa response:	from England.
context: did all of you bring your homework?\Yes!\Today, I'll introduce you to your new classmate\who'll be studying with us.\Now, Come in.\He seems kind.\This is Eriol Hiiragizawa\from England. response:	I hope you'll all get along
context: Yes!\Today, I'll introduce you to your new classmate\who'll be studying with us.\Now, Come in.\He seems kind.\This is Eriol Hiiragizawa\from England.\I hope you'll all get along response:	I'm Eriol Hiiragizawa.
context: Today, I'll introduce you to your new classmate\who'll be studying with us.\Now, Come in.\He seems kind.\This is Eriol Hiiragizawa\from England.\I hope you'll all get along\I'm Eriol Hiiragizawa. response:	Nice to meet you.
context: who'll be studying with us.\Now, Come in.\He seems kind.\This is Eriol Hiiragizawa\from England.\I hope you'll all get along\I'm Eriol Hiiragizawa.\Nice to meet you. response:	Your sear' Let's see'
context: Now, Come in.\He seems kind.\This is Eriol Hiiragizawa\from England.\I hope you'll all get along\I'm Eriol Hiiragizawa.\Nice to meet you.\Your sear' Let's see' response:	That's it.
context: He seems kind.\This is Eriol Hiiragizawa\from England.\I hope you'll all get along\I'm Eriol Hiiragizawa.\Nice to meet you.\Your sear' Let's see'\That's it. response:	How about the one next to Li?
context: This is Eriol Hiiragizawa\from England.\I hope you'll all get along\I'm Eriol Hiiragizawa.\Nice to meet you.\Your sear' Let's see'\That's it.\How about the one next to Li? response:	Hello.
context: from England.\I hope you'll all get along\I'm Eriol Hiiragizawa.\Nice to meet you.\Your sear' Let's see'\That's it.\How about the one next to Li?\Hello. response:	What's this?
context: I hope you'll all get along\I'm Eriol Hiiragizawa.\Nice to meet you.\Your sear' Let's see'\That's it.\How about the one next to Li?\Hello.\What's this? response:	Did I meet him somewhere before?
context: I'm Eriol Hiiragizawa.\Nice to meet you.\Your sear' Let's see'\That's it.\How about the one next to Li?\Hello.\What's this?\Did I meet him somewhere before? response:	Miss Kaho,
context: Nice to meet you.\Your sear' Let's see'\That's it.\How about the one next to Li?\Hello.\What's this?\Did I meet him somewhere before?\Miss Kaho, response:	class 5-2 has a new student today
context: Your sear' Let's see'\That's it.\How about the one next to Li?\Hello.\What's this?\Did I meet him somewhere before?\Miss Kaho,\class 5-2 has a new student today response:	It's a boy named Eriol Hiiragizawa.
context: That's it.\How about the one next to Li?\Hello.\What's this?\Did I meet him somewhere before?\Miss Kaho,\class 5-2 has a new student today\It's a boy named Eriol Hiiragizawa. response:	He seems kind.
context: How about the one next to Li?\Hello.\What's this?\Did I meet him somewhere before?\Miss Kaho,\class 5-2 has a new student today\It's a boy named Eriol Hiiragizawa.\He seems kind. response:	But'
context: Hello.\What's this?\Did I meet him somewhere before?\Miss Kaho,\class 5-2 has a new student today\It's a boy named Eriol Hiiragizawa.\He seems kind.\But' response:	For some reason, I feel like this is
context: What's this?\Did I meet him somewhere before?\Miss Kaho,\class 5-2 has a new student today\It's a boy named Eriol Hiiragizawa.\He seems kind.\But'\For some reason, I feel like this is response:	not the first time we met
context: Did I meet him somewhere before?\Miss Kaho,\class 5-2 has a new student today\It's a boy named Eriol Hiiragizawa.\He seems kind.\But'\For some reason, I feel like this is\not the first time we met response:	Same here.
context: Miss Kaho,\class 5-2 has a new student today\It's a boy named Eriol Hiiragizawa.\He seems kind.\But'\For some reason, I feel like this is\not the first time we met\Same here. response:	Hi' Hiiragizawa??
context: class 5-2 has a new student today\It's a boy named Eriol Hiiragizawa.\He seems kind.\But'\For some reason, I feel like this is\not the first time we met\Same here.\Hi' Hiiragizawa?? response:	I'm so sorry that I scared you.
context: It's a boy named Eriol Hiiragizawa.\He seems kind.\But'\For some reason, I feel like this is\not the first time we met\Same here.\Hi' Hiiragizawa??\I'm so sorry that I scared you. response:	Thank goodness.
context: He seems kind.\But'\For some reason, I feel like this is\not the first time we met\Same here.\Hi' Hiiragizawa??\I'm so sorry that I scared you.\Thank goodness. response:	Is it all right if I sit next to you?
context: But'\For some reason, I feel like this is\not the first time we met\Same here.\Hi' Hiiragizawa??\I'm so sorry that I scared you.\Thank goodness.\Is it all right if I sit next to you? response:	Somehow I also feel that
context: For some reason, I feel like this is\not the first time we met\Same here.\Hi' Hiiragizawa??\I'm so sorry that I scared you.\Thank goodness.\Is it all right if I sit next to you?\Somehow I also feel that response:	today is not the first time we meet.
context: not the first time we met\Same here.\Hi' Hiiragizawa??\I'm so sorry that I scared you.\Thank goodness.\Is it all right if I sit next to you?\Somehow I also feel that\today is not the first time we meet. response:	It is strange, isn't it?
context: Same here.\Hi' Hiiragizawa??\I'm so sorry that I scared you.\Thank goodness.\Is it all right if I sit next to you?\Somehow I also feel that\today is not the first time we meet.\It is strange, isn't it? response:	We might have met before.
context: Hi' Hiiragizawa??\I'm so sorry that I scared you.\Thank goodness.\Is it all right if I sit next to you?\Somehow I also feel that\today is not the first time we meet.\It is strange, isn't it?\We might have met before. response:	We might have met before
context: I'm so sorry that I scared you.\Thank goodness.\Is it all right if I sit next to you?\Somehow I also feel that\today is not the first time we meet.\It is strange, isn't it?\We might have met before.\We might have met before response:	in our previous lives
context: Thank goodness.\Is it all right if I sit next to you?\Somehow I also feel that\today is not the first time we meet.\It is strange, isn't it?\We might have met before.\We might have met before\in our previous lives response:	Do you mind telling me your name?
context: Is it all right if I sit next to you?\Somehow I also feel that\today is not the first time we meet.\It is strange, isn't it?\We might have met before.\We might have met before\in our previous lives\Do you mind telling me your name? response:	M' My name is Sakura Kinomoto.
context: Somehow I also feel that\today is not the first time we meet.\It is strange, isn't it?\We might have met before.\We might have met before\in our previous lives\Do you mind telling me your name?\M' My name is Sakura Kinomoto. response:	What a beautiful name of the flower
context: today is not the first time we meet.\It is strange, isn't it?\We might have met before.\We might have met before\in our previous lives\Do you mind telling me your name?\M' My name is Sakura Kinomoto.\What a beautiful name of the flower response:	that blooms in spring
context: It is strange, isn't it?\We might have met before.\We might have met before\in our previous lives\Do you mind telling me your name?\M' My name is Sakura Kinomoto.\What a beautiful name of the flower\that blooms in spring response:	May I call you Sakura?
context: We might have met before.\We might have met before\in our previous lives\Do you mind telling me your name?\M' My name is Sakura Kinomoto.\What a beautiful name of the flower\that blooms in spring\May I call you Sakura? response:	Yes, Hiiragizawa.
context: We might have met before\in our previous lives\Do you mind telling me your name?\M' My name is Sakura Kinomoto.\What a beautiful name of the flower\that blooms in spring\May I call you Sakura?\Yes, Hiiragizawa. response:	Please call me Eriol,
context: in our previous lives\Do you mind telling me your name?\M' My name is Sakura Kinomoto.\What a beautiful name of the flower\that blooms in spring\May I call you Sakura?\Yes, Hiiragizawa.\Please call me Eriol, response:	Sakura.
context: Do you mind telling me your name?\M' My name is Sakura Kinomoto.\What a beautiful name of the flower\that blooms in spring\May I call you Sakura?\Yes, Hiiragizawa.\Please call me Eriol,\Sakura. response:	That's like
context: M' My name is Sakura Kinomoto.\What a beautiful name of the flower\that blooms in spring\May I call you Sakura?\Yes, Hiiragizawa.\Please call me Eriol,\Sakura.\That's like response:	a promising development
context: What a beautiful name of the flower\that blooms in spring\May I call you Sakura?\Yes, Hiiragizawa.\Please call me Eriol,\Sakura.\That's like\a promising development response:	in a girl's comic
context: that blooms in spring\May I call you Sakura?\Yes, Hiiragizawa.\Please call me Eriol,\Sakura.\That's like\a promising development\in a girl's comic response:	Keeping an eye on Sakura like that'
context: May I call you Sakura?\Yes, Hiiragizawa.\Please call me Eriol,\Sakura.\That's like\a promising development\in a girl's comic\Keeping an eye on Sakura like that' response:	Li, did something happen?
context: Yes, Hiiragizawa.\Please call me Eriol,\Sakura.\That's like\a promising development\in a girl's comic\Keeping an eye on Sakura like that'\Li, did something happen? response:	Because you've been having such a difficult face all day.
context: Please call me Eriol,\Sakura.\That's like\a promising development\in a girl's comic\Keeping an eye on Sakura like that'\Li, did something happen?\Because you've been having such a difficult face all day. response:	Li has a new thing
context: Sakura.\That's like\a promising development\in a girl's comic\Keeping an eye on Sakura like that'\Li, did something happen?\Because you've been having such a difficult face all day.\Li has a new thing response:	to worry about today, right
context: That's like\a promising development\in a girl's comic\Keeping an eye on Sakura like that'\Li, did something happen?\Because you've been having such a difficult face all day.\Li has a new thing\to worry about today, right response:	Wha' Th' Th' That's not'
context: a promising development\in a girl's comic\Keeping an eye on Sakura like that'\Li, did something happen?\Because you've been having such a difficult face all day.\Li has a new thing\to worry about today, right\Wha' Th' Th' That's not' response:	If there's anything
context: in a girl's comic\Keeping an eye on Sakura like that'\Li, did something happen?\Because you've been having such a difficult face all day.\Li has a new thing\to worry about today, right\Wha' Th' Th' That's not'\If there's anything response:	I can do
context: Keeping an eye on Sakura like that'\Li, did something happen?\Because you've been having such a difficult face all day.\Li has a new thing\to worry about today, right\Wha' Th' Th' That's not'\If there's anything\I can do response:	let me know.
context: Li, did something happen?\Because you've been having such a difficult face all day.\Li has a new thing\to worry about today, right\Wha' Th' Th' That's not'\If there's anything\I can do\let me know. response:	You helped me so much
context: Because you've been having such a difficult face all day.\Li has a new thing\to worry about today, right\Wha' Th' Th' That's not'\If there's anything\I can do\let me know.\You helped me so much response:	when we were gathering the Clow Cards.
context: Li has a new thing\to worry about today, right\Wha' Th' Th' That's not'\If there's anything\I can do\let me know.\You helped me so much\when we were gathering the Clow Cards. response:	This time I wanna be of help to you.
context: to worry about today, right\Wha' Th' Th' That's not'\If there's anything\I can do\let me know.\You helped me so much\when we were gathering the Clow Cards.\This time I wanna be of help to you. response:	But you're
context: Wha' Th' Th' That's not'\If there's anything\I can do\let me know.\You helped me so much\when we were gathering the Clow Cards.\This time I wanna be of help to you.\But you're response:	going back to Hong Kong soon.
context: If there's anything\I can do\let me know.\You helped me so much\when we were gathering the Clow Cards.\This time I wanna be of help to you.\But you're\going back to Hong Kong soon. response:	I can't go yet.
context: I can do\let me know.\You helped me so much\when we were gathering the Clow Cards.\This time I wanna be of help to you.\But you're\going back to Hong Kong soon.\I can't go yet. response:	I'm still staying here.
context: let me know.\You helped me so much\when we were gathering the Clow Cards.\This time I wanna be of help to you.\But you're\going back to Hong Kong soon.\I can't go yet.\I'm still staying here. response:	' Really?' Yes.
context: You helped me so much\when we were gathering the Clow Cards.\This time I wanna be of help to you.\But you're\going back to Hong Kong soon.\I can't go yet.\I'm still staying here.\' Really?' Yes. response:	I see now! That's great!
context: when we were gathering the Clow Cards.\This time I wanna be of help to you.\But you're\going back to Hong Kong soon.\I can't go yet.\I'm still staying here.\' Really?' Yes.\I see now! That's great! response:	Thank goodness!
context: This time I wanna be of help to you.\But you're\going back to Hong Kong soon.\I can't go yet.\I'm still staying here.\' Really?' Yes.\I see now! That's great!\Thank goodness! response:	Ice-cream bars over there are very good.
context: But you're\going back to Hong Kong soon.\I can't go yet.\I'm still staying here.\' Really?' Yes.\I see now! That's great!\Thank goodness!\Ice-cream bars over there are very good. response:	I'll go buy some.
context: going back to Hong Kong soon.\I can't go yet.\I'm still staying here.\' Really?' Yes.\I see now! That's great!\Thank goodness!\Ice-cream bars over there are very good.\I'll go buy some. response:	Because a new rival seemed to have appeared.
context: I can't go yet.\I'm still staying here.\' Really?' Yes.\I see now! That's great!\Thank goodness!\Ice-cream bars over there are very good.\I'll go buy some.\Because a new rival seemed to have appeared. response:	If you went back to Hong Kong, it would be like giving her up, right?
context: I'm still staying here.\' Really?' Yes.\I see now! That's great!\Thank goodness!\Ice-cream bars over there are very good.\I'll go buy some.\Because a new rival seemed to have appeared.\If you went back to Hong Kong, it would be like giving her up, right? response:	I said that's not it!
context: ' Really?' Yes.\I see now! That's great!\Thank goodness!\Ice-cream bars over there are very good.\I'll go buy some.\Because a new rival seemed to have appeared.\If you went back to Hong Kong, it would be like giving her up, right?\I said that's not it! response:	Thanks for waiting.
context: I see now! That's great!\Thank goodness!\Ice-cream bars over there are very good.\I'll go buy some.\Because a new rival seemed to have appeared.\If you went back to Hong Kong, it would be like giving her up, right?\I said that's not it!\Thanks for waiting. response:	Here, Tomoyo, Li.
context: Thank goodness!\Ice-cream bars over there are very good.\I'll go buy some.\Because a new rival seemed to have appeared.\If you went back to Hong Kong, it would be like giving her up, right?\I said that's not it!\Thanks for waiting.\Here, Tomoyo, Li. response:	' Thank you very much.' Thanks.
context: Ice-cream bars over there are very good.\I'll go buy some.\Because a new rival seemed to have appeared.\If you went back to Hong Kong, it would be like giving her up, right?\I said that's not it!\Thanks for waiting.\Here, Tomoyo, Li.\' Thank you very much.' Thanks. response:	Touya Big Brother!
context: I'll go buy some.\Because a new rival seemed to have appeared.\If you went back to Hong Kong, it would be like giving her up, right?\I said that's not it!\Thanks for waiting.\Here, Tomoyo, Li.\' Thank you very much.' Thanks.\Touya Big Brother! response:	Don't do that, Touya!
context: Because a new rival seemed to have appeared.\If you went back to Hong Kong, it would be like giving her up, right?\I said that's not it!\Thanks for waiting.\Here, Tomoyo, Li.\' Thank you very much.' Thanks.\Touya Big Brother!\Don't do that, Touya! response:	You want some too, Yuki?
context: If you went back to Hong Kong, it would be like giving her up, right?\I said that's not it!\Thanks for waiting.\Here, Tomoyo, Li.\' Thank you very much.' Thanks.\Touya Big Brother!\Don't do that, Touya!\You want some too, Yuki? response:	I'll buy you another one, okay?
context: I said that's not it!\Thanks for waiting.\Here, Tomoyo, Li.\' Thank you very much.' Thanks.\Touya Big Brother!\Don't do that, Touya!\You want some too, Yuki?\I'll buy you another one, okay? response:	It' It's okay. No need.
context: Thanks for waiting.\Here, Tomoyo, Li.\' Thank you very much.' Thanks.\Touya Big Brother!\Don't do that, Touya!\You want some too, Yuki?\I'll buy you another one, okay?\It' It's okay. No need. response:	What's wrong, big brother?
context: Here, Tomoyo, Li.\' Thank you very much.' Thanks.\Touya Big Brother!\Don't do that, Touya!\You want some too, Yuki?\I'll buy you another one, okay?\It' It's okay. No need.\What's wrong, big brother? response:	A new student came to our class today.
context: ' Thank you very much.' Thanks.\Touya Big Brother!\Don't do that, Touya!\You want some too, Yuki?\I'll buy you another one, okay?\It' It's okay. No need.\What's wrong, big brother?\A new student came to our class today. response:	We have one too.
context: Touya Big Brother!\Don't do that, Touya!\You want some too, Yuki?\I'll buy you another one, okay?\It' It's okay. No need.\What's wrong, big brother?\A new student came to our class today.\We have one too. response:	But what about it?
context: Don't do that, Touya!\You want some too, Yuki?\I'll buy you another one, okay?\It' It's okay. No need.\What's wrong, big brother?\A new student came to our class today.\We have one too.\But what about it? response:	Touya!! I was looking for you!!
context: You want some too, Yuki?\I'll buy you another one, okay?\It' It's okay. No need.\What's wrong, big brother?\A new student came to our class today.\We have one too.\But what about it?\Touya!! I was looking for you!! response:	Oh? You must be Touya's little sister!
context: I'll buy you another one, okay?\It' It's okay. No need.\What's wrong, big brother?\A new student came to our class today.\We have one too.\But what about it?\Touya!! I was looking for you!!\Oh? You must be Touya's little sister! response:	Yes! I'm Sakura Kinomoto.
context: It' It's okay. No need.\What's wrong, big brother?\A new student came to our class today.\We have one too.\But what about it?\Touya!! I was looking for you!!\Oh? You must be Touya's little sister!\Yes! I'm Sakura Kinomoto. response:	I'm Nakuru.
context: What's wrong, big brother?\A new student came to our class today.\We have one too.\But what about it?\Touya!! I was looking for you!!\Oh? You must be Touya's little sister!\Yes! I'm Sakura Kinomoto.\I'm Nakuru. response:	Nakuru Akizuki.
context: A new student came to our class today.\We have one too.\But what about it?\Touya!! I was looking for you!!\Oh? You must be Touya's little sister!\Yes! I'm Sakura Kinomoto.\I'm Nakuru.\Nakuru Akizuki. response:	Just as I thought, you're so cute!!
context: We have one too.\But what about it?\Touya!! I was looking for you!!\Oh? You must be Touya's little sister!\Yes! I'm Sakura Kinomoto.\I'm Nakuru.\Nakuru Akizuki.\Just as I thought, you're so cute!! response:	Hey! don't be such a'
context: But what about it?\Touya!! I was looking for you!!\Oh? You must be Touya's little sister!\Yes! I'm Sakura Kinomoto.\I'm Nakuru.\Nakuru Akizuki.\Just as I thought, you're so cute!!\Hey! don't be such a' response:	Later, Touya! See you tomorrow!
context: Touya!! I was looking for you!!\Oh? You must be Touya's little sister!\Yes! I'm Sakura Kinomoto.\I'm Nakuru.\Nakuru Akizuki.\Just as I thought, you're so cute!!\Hey! don't be such a'\Later, Touya! See you tomorrow! response:	' Ice-cream.' She took it'
context: Oh? You must be Touya's little sister!\Yes! I'm Sakura Kinomoto.\I'm Nakuru.\Nakuru Akizuki.\Just as I thought, you're so cute!!\Hey! don't be such a'\Later, Touya! See you tomorrow!\' Ice-cream.' She took it' response:	' Is something wrong?' Nothing.
context: Yes! I'm Sakura Kinomoto.\I'm Nakuru.\Nakuru Akizuki.\Just as I thought, you're so cute!!\Hey! don't be such a'\Later, Touya! See you tomorrow!\' Ice-cream.' She took it'\' Is something wrong?' Nothing. response:	Thanks for your ice-cream!
context: I'm Nakuru.\Nakuru Akizuki.\Just as I thought, you're so cute!!\Hey! don't be such a'\Later, Touya! See you tomorrow!\' Ice-cream.' She took it'\' Is something wrong?' Nothing.\Thanks for your ice-cream! response:	Oh! It is raining'
context: Nakuru Akizuki.\Just as I thought, you're so cute!!\Hey! don't be such a'\Later, Touya! See you tomorrow!\' Ice-cream.' She took it'\' Is something wrong?' Nothing.\Thanks for your ice-cream!\Oh! It is raining' response:	Oh no! The laundry!
context: Just as I thought, you're so cute!!\Hey! don't be such a'\Later, Touya! See you tomorrow!\' Ice-cream.' She took it'\' Is something wrong?' Nothing.\Thanks for your ice-cream!\Oh! It is raining'\Oh no! The laundry! response:	This is the last basket.
context: Hey! don't be such a'\Later, Touya! See you tomorrow!\' Ice-cream.' She took it'\' Is something wrong?' Nothing.\Thanks for your ice-cream!\Oh! It is raining'\Oh no! The laundry!\This is the last basket. response:	Just leave it there.
context: Later, Touya! See you tomorrow!\' Ice-cream.' She took it'\' Is something wrong?' Nothing.\Thanks for your ice-cream!\Oh! It is raining'\Oh no! The laundry!\This is the last basket.\Just leave it there. response:	I'll put them in afterwards.
context: ' Ice-cream.' She took it'\' Is something wrong?' Nothing.\Thanks for your ice-cream!\Oh! It is raining'\Oh no! The laundry!\This is the last basket.\Just leave it there.\I'll put them in afterwards. response:	Thank you.
context: ' Is something wrong?' Nothing.\Thanks for your ice-cream!\Oh! It is raining'\Oh no! The laundry!\This is the last basket.\Just leave it there.\I'll put them in afterwards.\Thank you. response:	Then I'm going to my part-time job.
context: Thanks for your ice-cream!\Oh! It is raining'\Oh no! The laundry!\This is the last basket.\Just leave it there.\I'll put them in afterwards.\Thank you.\Then I'm going to my part-time job. response:	You have part-time today?
context: Oh! It is raining'\Oh no! The laundry!\This is the last basket.\Just leave it there.\I'll put them in afterwards.\Thank you.\Then I'm going to my part-time job.\You have part-time today? response:	It's written on the board.
context: Oh no! The laundry!\This is the last basket.\Just leave it there.\I'll put them in afterwards.\Thank you.\Then I'm going to my part-time job.\You have part-time today?\It's written on the board. response:	Then, what about dinner? No, thanks.
context: This is the last basket.\Just leave it there.\I'll put them in afterwards.\Thank you.\Then I'm going to my part-time job.\You have part-time today?\It's written on the board.\Then, what about dinner? No, thanks. response:	Oh no, I bought dinner for 3 persons'
context: Just leave it there.\I'll put them in afterwards.\Thank you.\Then I'm going to my part-time job.\You have part-time today?\It's written on the board.\Then, what about dinner? No, thanks.\Oh no, I bought dinner for 3 persons' response:	Transfer student?
context: I'll put them in afterwards.\Thank you.\Then I'm going to my part-time job.\You have part-time today?\It's written on the board.\Then, what about dinner? No, thanks.\Oh no, I bought dinner for 3 persons'\Transfer student? response:	What kinda person?
context: Thank you.\Then I'm going to my part-time job.\You have part-time today?\It's written on the board.\Then, what about dinner? No, thanks.\Oh no, I bought dinner for 3 persons'\Transfer student?\What kinda person? response:	His name is Eriol Hiiragizawa.
context: Then I'm going to my part-time job.\You have part-time today?\It's written on the board.\Then, what about dinner? No, thanks.\Oh no, I bought dinner for 3 persons'\Transfer student?\What kinda person?\His name is Eriol Hiiragizawa. response:	Aerial? What kanji is that?
context: You have part-time today?\It's written on the board.\Then, what about dinner? No, thanks.\Oh no, I bought dinner for 3 persons'\Transfer student?\What kinda person?\His name is Eriol Hiiragizawa.\Aerial? What kanji is that? response:	It's not a kanji! E-RI-O-L.
context: It's written on the board.\Then, what about dinner? No, thanks.\Oh no, I bought dinner for 3 persons'\Transfer student?\What kinda person?\His name is Eriol Hiiragizawa.\Aerial? What kanji is that?\It's not a kanji! E-RI-O-L. response:	He's from England. England'
context: Then, what about dinner? No, thanks.\Oh no, I bought dinner for 3 persons'\Transfer student?\What kinda person?\His name is Eriol Hiiragizawa.\Aerial? What kanji is that?\It's not a kanji! E-RI-O-L.\He's from England. England' response:	No!!!
context: Oh no, I bought dinner for 3 persons'\Transfer student?\What kinda person?\His name is Eriol Hiiragizawa.\Aerial? What kanji is that?\It's not a kanji! E-RI-O-L.\He's from England. England'\No!!! response:	So, what kanji is that?
context: Transfer student?\What kinda person?\His name is Eriol Hiiragizawa.\Aerial? What kanji is that?\It's not a kanji! E-RI-O-L.\He's from England. England'\No!!!\So, what kanji is that? response:	Forget it!
context: What kinda person?\His name is Eriol Hiiragizawa.\Aerial? What kanji is that?\It's not a kanji! E-RI-O-L.\He's from England. England'\No!!!\So, what kanji is that?\Forget it! response:	You weren't listening at all.
context: His name is Eriol Hiiragizawa.\Aerial? What kanji is that?\It's not a kanji! E-RI-O-L.\He's from England. England'\No!!!\So, what kanji is that?\Forget it!\You weren't listening at all. response:	'and now the forecast in your local area.
context: Aerial? What kanji is that?\It's not a kanji! E-RI-O-L.\He's from England. England'\No!!!\So, what kanji is that?\Forget it!\You weren't listening at all.\'and now the forecast in your local area. response:	What incredible rain.
context: It's not a kanji! E-RI-O-L.\He's from England. England'\No!!!\So, what kanji is that?\Forget it!\You weren't listening at all.\'and now the forecast in your local area.\What incredible rain. response:	And it was so sunny in the afternoon too.
context: He's from England. England'\No!!!\So, what kanji is that?\Forget it!\You weren't listening at all.\'and now the forecast in your local area.\What incredible rain.\And it was so sunny in the afternoon too. response:	What?
context: No!!!\So, what kanji is that?\Forget it!\You weren't listening at all.\'and now the forecast in your local area.\What incredible rain.\And it was so sunny in the afternoon too.\What? response:	What's in that drawer?
context: So, what kanji is that?\Forget it!\You weren't listening at all.\'and now the forecast in your local area.\What incredible rain.\And it was so sunny in the afternoon too.\What?\What's in that drawer? response:	The book of Clow Cards!
context: Forget it!\You weren't listening at all.\'and now the forecast in your local area.\What incredible rain.\And it was so sunny in the afternoon too.\What?\What's in that drawer?\The book of Clow Cards! response:	What?!
context: You weren't listening at all.\'and now the forecast in your local area.\What incredible rain.\And it was so sunny in the afternoon too.\What?\What's in that drawer?\The book of Clow Cards!\What?! response:	Kero!!
context: 'and now the forecast in your local area.\What incredible rain.\And it was so sunny in the afternoon too.\What?\What's in that drawer?\The book of Clow Cards!\What?!\Kero!! response:	I might be troubling you
context: What incredible rain.\And it was so sunny in the afternoon too.\What?\What's in that drawer?\The book of Clow Cards!\What?!\Kero!!\I might be troubling you response:	from here on
context: And it was so sunny in the afternoon too.\What?\What's in that drawer?\The book of Clow Cards!\What?!\Kero!!\I might be troubling you\from here on response:	but if it is you,
context: What?\What's in that drawer?\The book of Clow Cards!\What?!\Kero!!\I might be troubling you\from here on\but if it is you, response:	it will be okay for sure
context: What's in that drawer?\The book of Clow Cards!\What?!\Kero!!\I might be troubling you\from here on\but if it is you,\it will be okay for sure response:	This voice'
context: The book of Clow Cards!\What?!\Kero!!\I might be troubling you\from here on\but if it is you,\it will be okay for sure\This voice' response:	This is Clow's voice'?
context: What?!\Kero!!\I might be troubling you\from here on\but if it is you,\it will be okay for sure\This voice'\This is Clow's voice'? response:	' Sakura' Kero,
context: Kero!!\I might be troubling you\from here on\but if it is you,\it will be okay for sure\This voice'\This is Clow's voice'?\' Sakura' Kero, response:	Clow's voice
context: I might be troubling you\from here on\but if it is you,\it will be okay for sure\This voice'\This is Clow's voice'?\' Sakura' Kero,\Clow's voice response:	came from the book'
context: from here on\but if it is you,\it will be okay for sure\This voice'\This is Clow's voice'?\' Sakura' Kero,\Clow's voice\came from the book' response:	Clow's voice?
context: but if it is you,\it will be okay for sure\This voice'\This is Clow's voice'?\' Sakura' Kero,\Clow's voice\came from the book'\Clow's voice? response:	What's this?
context: it will be okay for sure\This voice'\This is Clow's voice'?\' Sakura' Kero,\Clow's voice\came from the book'\Clow's voice?\What's this? response:	SA-KU-RA?
context: This voice'\This is Clow's voice'?\' Sakura' Kero,\Clow's voice\came from the book'\Clow's voice?\What's this?\SA-KU-RA? response:	My name?!
context: This is Clow's voice'?\' Sakura' Kero,\Clow's voice\came from the book'\Clow's voice?\What's this?\SA-KU-RA?\My name?! response:	what does this mean?!
context: ' Sakura' Kero,\Clow's voice\came from the book'\Clow's voice?\What's this?\SA-KU-RA?\My name?!\what does this mean?! response:	Kero, did you sense that just now?
context: Clow's voice\came from the book'\Clow's voice?\What's this?\SA-KU-RA?\My name?!\what does this mean?!\Kero, did you sense that just now? response:	Yeah, I sensed it too.
context: came from the book'\Clow's voice?\What's this?\SA-KU-RA?\My name?!\what does this mean?!\Kero, did you sense that just now?\Yeah, I sensed it too. response:	What's this aura'
context: Clow's voice?\What's this?\SA-KU-RA?\My name?!\what does this mean?!\Kero, did you sense that just now?\Yeah, I sensed it too.\What's this aura' response:	The rain in Tomoeda
context: What's this?\SA-KU-RA?\My name?!\what does this mean?!\Kero, did you sense that just now?\Yeah, I sensed it too.\What's this aura'\The rain in Tomoeda response:	will continue to fall.
context: SA-KU-RA?\My name?!\what does this mean?!\Kero, did you sense that just now?\Yeah, I sensed it too.\What's this aura'\The rain in Tomoeda\will continue to fall. response:	It's a limited area raining.
context: My name?!\what does this mean?!\Kero, did you sense that just now?\Yeah, I sensed it too.\What's this aura'\The rain in Tomoeda\will continue to fall.\It's a limited area raining. response:	It's cloudy in the surrounding area.
context: what does this mean?!\Kero, did you sense that just now?\Yeah, I sensed it too.\What's this aura'\The rain in Tomoeda\will continue to fall.\It's a limited area raining.\It's cloudy in the surrounding area. response:	where the rest of the area
context: Kero, did you sense that just now?\Yeah, I sensed it too.\What's this aura'\The rain in Tomoeda\will continue to fall.\It's a limited area raining.\It's cloudy in the surrounding area.\where the rest of the area response:	will enjoy another sunny day.
context: Yeah, I sensed it too.\What's this aura'\The rain in Tomoeda\will continue to fall.\It's a limited area raining.\It's cloudy in the surrounding area.\where the rest of the area\will enjoy another sunny day. response:	This isn't just any normal rain after all.
context: What's this aura'\The rain in Tomoeda\will continue to fall.\It's a limited area raining.\It's cloudy in the surrounding area.\where the rest of the area\will enjoy another sunny day.\This isn't just any normal rain after all. response:	So' why this?
context: The rain in Tomoeda\will continue to fall.\It's a limited area raining.\It's cloudy in the surrounding area.\where the rest of the area\will enjoy another sunny day.\This isn't just any normal rain after all.\So' why this? response:	Mysterious rain in Tomoeda!
context: will continue to fall.\It's a limited area raining.\It's cloudy in the surrounding area.\where the rest of the area\will enjoy another sunny day.\This isn't just any normal rain after all.\So' why this?\Mysterious rain in Tomoeda! response:	This's also Card Captor's call, Right?
context: It's a limited area raining.\It's cloudy in the surrounding area.\where the rest of the area\will enjoy another sunny day.\This isn't just any normal rain after all.\So' why this?\Mysterious rain in Tomoeda!\This's also Card Captor's call, Right? response:	My, it has been so long since the last filming!
context: It's cloudy in the surrounding area.\where the rest of the area\will enjoy another sunny day.\This isn't just any normal rain after all.\So' why this?\Mysterious rain in Tomoeda!\This's also Card Captor's call, Right?\My, it has been so long since the last filming! response:	Kero?
context: where the rest of the area\will enjoy another sunny day.\This isn't just any normal rain after all.\So' why this?\Mysterious rain in Tomoeda!\This's also Card Captor's call, Right?\My, it has been so long since the last filming!\Kero? response:	Be careful.
context: will enjoy another sunny day.\This isn't just any normal rain after all.\So' why this?\Mysterious rain in Tomoeda!\This's also Card Captor's call, Right?\My, it has been so long since the last filming!\Kero?\Be careful. response:	I sense very powerful aura.
context: This isn't just any normal rain after all.\So' why this?\Mysterious rain in Tomoeda!\This's also Card Captor's call, Right?\My, it has been so long since the last filming!\Kero?\Be careful.\I sense very powerful aura. response:	But all the Clow Cards have been gathered.
context: So' why this?\Mysterious rain in Tomoeda!\This's also Card Captor's call, Right?\My, it has been so long since the last filming!\Kero?\Be careful.\I sense very powerful aura.\But all the Clow Cards have been gathered. response:	What's this?
context: Mysterious rain in Tomoeda!\This's also Card Captor's call, Right?\My, it has been so long since the last filming!\Kero?\Be careful.\I sense very powerful aura.\But all the Clow Cards have been gathered.\What's this? response:	' Kero! I'll leave Tomoyo to you!' Okay!
context: This's also Card Captor's call, Right?\My, it has been so long since the last filming!\Kero?\Be careful.\I sense very powerful aura.\But all the Clow Cards have been gathered.\What's this?\' Kero! I'll leave Tomoyo to you!' Okay! response:	Sakura!
context: My, it has been so long since the last filming!\Kero?\Be careful.\I sense very powerful aura.\But all the Clow Cards have been gathered.\What's this?\' Kero! I'll leave Tomoyo to you!' Okay!\Sakura! response:	Sakura! What're you playing?
context: Kero?\Be careful.\I sense very powerful aura.\But all the Clow Cards have been gathered.\What's this?\' Kero! I'll leave Tomoyo to you!' Okay!\Sakura!\Sakura! What're you playing? response:	Use magic!
context: Be careful.\I sense very powerful aura.\But all the Clow Cards have been gathered.\What's this?\' Kero! I'll leave Tomoyo to you!' Okay!\Sakura!\Sakura! What're you playing?\Use magic! response:	O, Key which hides the forces of darkness,
context: I sense very powerful aura.\But all the Clow Cards have been gathered.\What's this?\' Kero! I'll leave Tomoyo to you!' Okay!\Sakura!\Sakura! What're you playing?\Use magic!\O, Key which hides the forces of darkness, response:	reveal thy true form before me.
context: But all the Clow Cards have been gathered.\What's this?\' Kero! I'll leave Tomoyo to you!' Okay!\Sakura!\Sakura! What're you playing?\Use magic!\O, Key which hides the forces of darkness,\reveal thy true form before me. response:	I, Sakura, command thee under contract.
context: What's this?\' Kero! I'll leave Tomoyo to you!' Okay!\Sakura!\Sakura! What're you playing?\Use magic!\O, Key which hides the forces of darkness,\reveal thy true form before me.\I, Sakura, command thee under contract. response:	Release!
context: ' Kero! I'll leave Tomoyo to you!' Okay!\Sakura!\Sakura! What're you playing?\Use magic!\O, Key which hides the forces of darkness,\reveal thy true form before me.\I, Sakura, command thee under contract.\Release! response:	Release!
context: Sakura!\Sakura! What're you playing?\Use magic!\O, Key which hides the forces of darkness,\reveal thy true form before me.\I, Sakura, command thee under contract.\Release!\Release! response:	Release!
context: Sakura! What're you playing?\Use magic!\O, Key which hides the forces of darkness,\reveal thy true form before me.\I, Sakura, command thee under contract.\Release!\Release!\Release! response:	Release!
context: Use magic!\O, Key which hides the forces of darkness,\reveal thy true form before me.\I, Sakura, command thee under contract.\Release!\Release!\Release!\Release! response:	Release!
context: O, Key which hides the forces of darkness,\reveal thy true form before me.\I, Sakura, command thee under contract.\Release!\Release!\Release!\Release!\Release! response:	Why?
context: reveal thy true form before me.\I, Sakura, command thee under contract.\Release!\Release!\Release!\Release!\Release!\Why? response:	Watch out!
context: I, Sakura, command thee under contract.\Release!\Release!\Release!\Release!\Release!\Why?\Watch out! response:	Are you okay, Sakura?
context: Release!\Release!\Release!\Release!\Release!\Why?\Watch out!\Are you okay, Sakura? response:	Kero, the key'
context: Release!\Release!\Release!\Release!\Why?\Watch out!\Are you okay, Sakura?\Kero, the key' response:	This aura'
context: Release!\Release!\Release!\Why?\Watch out!\Are you okay, Sakura?\Kero, the key'\This aura' response:	Impossible.
context: Release!\Release!\Why?\Watch out!\Are you okay, Sakura?\Kero, the key'\This aura'\Impossible. response:	It can't be' But'
context: Release!\Why?\Watch out!\Are you okay, Sakura?\Kero, the key'\This aura'\Impossible.\It can't be' But' response:	Sakura! Are you ok?
context: Why?\Watch out!\Are you okay, Sakura?\Kero, the key'\This aura'\Impossible.\It can't be' But'\Sakura! Are you ok? response:	Sakura,
context: Watch out!\Are you okay, Sakura?\Kero, the key'\This aura'\Impossible.\It can't be' But'\Sakura! Are you ok?\Sakura, response:	invite the snow-rabbit over tomorrow. (Yukito = snow-rabbit)
context: Are you okay, Sakura?\Kero, the key'\This aura'\Impossible.\It can't be' But'\Sakura! Are you ok?\Sakura,\invite the snow-rabbit over tomorrow. (Yukito = snow-rabbit) response:	Yukito?
context: Kero, the key'\This aura'\Impossible.\It can't be' But'\Sakura! Are you ok?\Sakura,\invite the snow-rabbit over tomorrow. (Yukito = snow-rabbit)\Yukito? response:	Why Tsukishiro?
context: This aura'\Impossible.\It can't be' But'\Sakura! Are you ok?\Sakura,\invite the snow-rabbit over tomorrow. (Yukito = snow-rabbit)\Yukito?\Why Tsukishiro? response:	Yue is the one I need to talk to.
context: Impossible.\It can't be' But'\Sakura! Are you ok?\Sakura,\invite the snow-rabbit over tomorrow. (Yukito = snow-rabbit)\Yukito?\Why Tsukishiro?\Yue is the one I need to talk to. response:	Yue'
context: It can't be' But'\Sakura! Are you ok?\Sakura,\invite the snow-rabbit over tomorrow. (Yukito = snow-rabbit)\Yukito?\Why Tsukishiro?\Yue is the one I need to talk to.\Yue' response:	I want to check with him on something.
context: Sakura! Are you ok?\Sakura,\invite the snow-rabbit over tomorrow. (Yukito = snow-rabbit)\Yukito?\Why Tsukishiro?\Yue is the one I need to talk to.\Yue'\I want to check with him on something. response:	Why doesn't the new Key turn into a wand?
context: Sakura,\invite the snow-rabbit over tomorrow. (Yukito = snow-rabbit)\Yukito?\Why Tsukishiro?\Yue is the one I need to talk to.\Yue'\I want to check with him on something.\Why doesn't the new Key turn into a wand? response:	And
context: invite the snow-rabbit over tomorrow. (Yukito = snow-rabbit)\Yukito?\Why Tsukishiro?\Yue is the one I need to talk to.\Yue'\I want to check with him on something.\Why doesn't the new Key turn into a wand?\And response:	this aura'