context: Sakamoto Pharmaceutical response:	Sakamoto Pharmaceutical
context: Sakamoto Pharmaceutical\Sakamoto Pharmaceutical response:	Inscribed in a circle is a quadrilateral figure ABCD AB=5 BC=4 CD=4 <B=60 Based on the figure ABCD Calculate the area S
context: Sakamoto Pharmaceutical\Sakamoto Pharmaceutical\Inscribed in a circle is a quadrilateral figure ABCD AB=5 BC=4 CD=4 <B=60 Based on the figure ABCD Calculate the area S response:	eyecatch
context: Sakamoto Pharmaceutical\Sakamoto Pharmaceutical\Inscribed in a circle is a quadrilateral figure ABCD AB=5 BC=4 CD=4 <B=60 Based on the figure ABCD Calculate the area S\eyecatch response:	H!
context: Sakamoto Pharmaceutical\Sakamoto Pharmaceutical\Inscribed in a circle is a quadrilateral figure ABCD AB=5 BC=4 CD=4 <B=60 Based on the figure ABCD Calculate the area S\eyecatch\H! response:	O?!
context: Sakamoto Pharmaceutical\Sakamoto Pharmaceutical\Inscribed in a circle is a quadrilateral figure ABCD AB=5 BC=4 CD=4 <B=60 Based on the figure ABCD Calculate the area S\eyecatch\H!\O?! response:	I do fall in love!
context: Sakamoto Pharmaceutical\Sakamoto Pharmaceutical\Inscribed in a circle is a quadrilateral figure ABCD AB=5 BC=4 CD=4 <B=60 Based on the figure ABCD Calculate the area S\eyecatch\H!\O?!\I do fall in love! response:	I just realised it for the first time
context: Sakamoto Pharmaceutical\Sakamoto Pharmaceutical\Inscribed in a circle is a quadrilateral figure ABCD AB=5 BC=4 CD=4 <B=60 Based on the figure ABCD Calculate the area S\eyecatch\H!\O?!\I do fall in love!\I just realised it for the first time response:	That I had fallen in love
context: Sakamoto Pharmaceutical\Inscribed in a circle is a quadrilateral figure ABCD AB=5 BC=4 CD=4 <B=60 Based on the figure ABCD Calculate the area S\eyecatch\H!\O?!\I do fall in love!\I just realised it for the first time\That I had fallen in love response:	Twenty-four hours a day thinking of you, you and nothing more than you!
context: Inscribed in a circle is a quadrilateral figure ABCD AB=5 BC=4 CD=4 <B=60 Based on the figure ABCD Calculate the area S\eyecatch\H!\O?!\I do fall in love!\I just realised it for the first time\That I had fallen in love\Twenty-four hours a day thinking of you, you and nothing more than you! response:	It's something I wasn't consciously aware of
context: eyecatch\H!\O?!\I do fall in love!\I just realised it for the first time\That I had fallen in love\Twenty-four hours a day thinking of you, you and nothing more than you!\It's something I wasn't consciously aware of response:	Somehow ( somehow) I'm feeling different from the usual
context: H!\O?!\I do fall in love!\I just realised it for the first time\That I had fallen in love\Twenty-four hours a day thinking of you, you and nothing more than you!\It's something I wasn't consciously aware of\Somehow ( somehow) I'm feeling different from the usual response:	With you ( the two of us) and our dull chatter
context: O?!\I do fall in love!\I just realised it for the first time\That I had fallen in love\Twenty-four hours a day thinking of you, you and nothing more than you!\It's something I wasn't consciously aware of\Somehow ( somehow) I'm feeling different from the usual\With you ( the two of us) and our dull chatter response:	Don't tell me ( mutual love?) Nope, it's a one-sided crush
context: I do fall in love!\I just realised it for the first time\That I had fallen in love\Twenty-four hours a day thinking of you, you and nothing more than you!\It's something I wasn't consciously aware of\Somehow ( somehow) I'm feeling different from the usual\With you ( the two of us) and our dull chatter\Don't tell me ( mutual love?) Nope, it's a one-sided crush response:	This is bad! Our gazes met!
context: I just realised it for the first time\That I had fallen in love\Twenty-four hours a day thinking of you, you and nothing more than you!\It's something I wasn't consciously aware of\Somehow ( somehow) I'm feeling different from the usual\With you ( the two of us) and our dull chatter\Don't tell me ( mutual love?) Nope, it's a one-sided crush\This is bad! Our gazes met! response:	What, what? Why is my heart pounding like this?
context: That I had fallen in love\Twenty-four hours a day thinking of you, you and nothing more than you!\It's something I wasn't consciously aware of\Somehow ( somehow) I'm feeling different from the usual\With you ( the two of us) and our dull chatter\Don't tell me ( mutual love?) Nope, it's a one-sided crush\This is bad! Our gazes met!\What, what? Why is my heart pounding like this? response:	Did a short circuit just make a mess out of my mind?
context: Twenty-four hours a day thinking of you, you and nothing more than you!\It's something I wasn't consciously aware of\Somehow ( somehow) I'm feeling different from the usual\With you ( the two of us) and our dull chatter\Don't tell me ( mutual love?) Nope, it's a one-sided crush\This is bad! Our gazes met!\What, what? Why is my heart pounding like this?\Did a short circuit just make a mess out of my mind? response:	This is my first time... feeling like this...
context: It's something I wasn't consciously aware of\Somehow ( somehow) I'm feeling different from the usual\With you ( the two of us) and our dull chatter\Don't tell me ( mutual love?) Nope, it's a one-sided crush\This is bad! Our gazes met!\What, what? Why is my heart pounding like this?\Did a short circuit just make a mess out of my mind?\This is my first time... feeling like this... response:	I wonder if I have a fever
context: Somehow ( somehow) I'm feeling different from the usual\With you ( the two of us) and our dull chatter\Don't tell me ( mutual love?) Nope, it's a one-sided crush\This is bad! Our gazes met!\What, what? Why is my heart pounding like this?\Did a short circuit just make a mess out of my mind?\This is my first time... feeling like this...\I wonder if I have a fever response:	Suddenly and precipitately, love has arrived.
context: With you ( the two of us) and our dull chatter\Don't tell me ( mutual love?) Nope, it's a one-sided crush\This is bad! Our gazes met!\What, what? Why is my heart pounding like this?\Did a short circuit just make a mess out of my mind?\This is my first time... feeling like this...\I wonder if I have a fever\Suddenly and precipitately, love has arrived. response:	Instantly igniting my face into a bright red
context: Don't tell me ( mutual love?) Nope, it's a one-sided crush\This is bad! Our gazes met!\What, what? Why is my heart pounding like this?\Did a short circuit just make a mess out of my mind?\This is my first time... feeling like this...\I wonder if I have a fever\Suddenly and precipitately, love has arrived.\Instantly igniting my face into a bright red response:	T-That's stupid?! My hands are shaking
context: This is bad! Our gazes met!\What, what? Why is my heart pounding like this?\Did a short circuit just make a mess out of my mind?\This is my first time... feeling like this...\I wonder if I have a fever\Suddenly and precipitately, love has arrived.\Instantly igniting my face into a bright red\T-That's stupid?! My hands are shaking response:	Is this really what they call love?
context: What, what? Why is my heart pounding like this?\Did a short circuit just make a mess out of my mind?\This is my first time... feeling like this...\I wonder if I have a fever\Suddenly and precipitately, love has arrived.\Instantly igniting my face into a bright red\T-That's stupid?! My hands are shaking\Is this really what they call love? response:	I-I did it! A conversation filled with stutters
context: Did a short circuit just make a mess out of my mind?\This is my first time... feeling like this...\I wonder if I have a fever\Suddenly and precipitately, love has arrived.\Instantly igniting my face into a bright red\T-That's stupid?! My hands are shaking\Is this really what they call love?\I-I did it! A conversation filled with stutters response:	This awkward silence... *mumble mumble*
context: This is my first time... feeling like this...\I wonder if I have a fever\Suddenly and precipitately, love has arrived.\Instantly igniting my face into a bright red\T-That's stupid?! My hands are shaking\Is this really what they call love?\I-I did it! A conversation filled with stutters\This awkward silence... *mumble mumble* response:	Your... ( Your...) I want to know your feelings.
context: I wonder if I have a fever\Suddenly and precipitately, love has arrived.\Instantly igniting my face into a bright red\T-That's stupid?! My hands are shaking\Is this really what they call love?\I-I did it! A conversation filled with stutters\This awkward silence... *mumble mumble*\Your... ( Your...) I want to know your feelings. response:	O-One-sided love
context: Suddenly and precipitately, love has arrived.\Instantly igniting my face into a bright red\T-That's stupid?! My hands are shaking\Is this really what they call love?\I-I did it! A conversation filled with stutters\This awkward silence... *mumble mumble*\Your... ( Your...) I want to know your feelings.\O-One-sided love response:	First love! The usual way to school
context: Instantly igniting my face into a bright red\T-That's stupid?! My hands are shaking\Is this really what they call love?\I-I did it! A conversation filled with stutters\This awkward silence... *mumble mumble*\Your... ( Your...) I want to know your feelings.\O-One-sided love\First love! The usual way to school response:	The shining light. I do fall in love!
context: T-That's stupid?! My hands are shaking\Is this really what they call love?\I-I did it! A conversation filled with stutters\This awkward silence... *mumble mumble*\Your... ( Your...) I want to know your feelings.\O-One-sided love\First love! The usual way to school\The shining light. I do fall in love! response:	I feel I could fly towards the sky
context: Is this really what they call love?\I-I did it! A conversation filled with stutters\This awkward silence... *mumble mumble*\Your... ( Your...) I want to know your feelings.\O-One-sided love\First love! The usual way to school\The shining light. I do fall in love!\I feel I could fly towards the sky response:	O-One-sided love
context: I-I did it! A conversation filled with stutters\This awkward silence... *mumble mumble*\Your... ( Your...) I want to know your feelings.\O-One-sided love\First love! The usual way to school\The shining light. I do fall in love!\I feel I could fly towards the sky\O-One-sided love response:	10
context: This awkward silence... *mumble mumble*\Your... ( Your...) I want to know your feelings.\O-One-sided love\First love! The usual way to school\The shining light. I do fall in love!\I feel I could fly towards the sky\O-One-sided love\10 response:	H H!
context: Your... ( Your...) I want to know your feelings.\O-One-sided love\First love! The usual way to school\The shining light. I do fall in love!\I feel I could fly towards the sky\O-One-sided love\10\H H! response:	Woke up in the morning, brushed my teeth
context: O-One-sided love\First love! The usual way to school\The shining light. I do fall in love!\I feel I could fly towards the sky\O-One-sided love\10\H H!\Woke up in the morning, brushed my teeth response:	In the blink of an eye, it's 10pm
context: First love! The usual way to school\The shining light. I do fall in love!\I feel I could fly towards the sky\O-One-sided love\10\H H!\Woke up in the morning, brushed my teeth\In the blink of an eye, it's 10pm response:	Today, we laughed a whole lot
context: The shining light. I do fall in love!\I feel I could fly towards the sky\O-One-sided love\10\H H!\Woke up in the morning, brushed my teeth\In the blink of an eye, it's 10pm\Today, we laughed a whole lot response:	We had a great time
context: I feel I could fly towards the sky\O-One-sided love\10\H H!\Woke up in the morning, brushed my teeth\In the blink of an eye, it's 10pm\Today, we laughed a whole lot\We had a great time response:	At times, with my friends, acting like fools, being noisy
context: O-One-sided love\10\H H!\Woke up in the morning, brushed my teeth\In the blink of an eye, it's 10pm\Today, we laughed a whole lot\We had a great time\At times, with my friends, acting like fools, being noisy response:	Fluttering, our eyes met.
context: 10\H H!\Woke up in the morning, brushed my teeth\In the blink of an eye, it's 10pm\Today, we laughed a whole lot\We had a great time\At times, with my friends, acting like fools, being noisy\Fluttering, our eyes met. response:	It's a coincidence, right?
context: H H!\Woke up in the morning, brushed my teeth\In the blink of an eye, it's 10pm\Today, we laughed a whole lot\We had a great time\At times, with my friends, acting like fools, being noisy\Fluttering, our eyes met.\It's a coincidence, right? response:	I wouldn't call this my first love
context: Woke up in the morning, brushed my teeth\In the blink of an eye, it's 10pm\Today, we laughed a whole lot\We had a great time\At times, with my friends, acting like fools, being noisy\Fluttering, our eyes met.\It's a coincidence, right?\I wouldn't call this my first love response:	It's not my character.
context: In the blink of an eye, it's 10pm\Today, we laughed a whole lot\We had a great time\At times, with my friends, acting like fools, being noisy\Fluttering, our eyes met.\It's a coincidence, right?\I wouldn't call this my first love\It's not my character. response:	Say, will we be able to meet again tomorrow?
context: Today, we laughed a whole lot\We had a great time\At times, with my friends, acting like fools, being noisy\Fluttering, our eyes met.\It's a coincidence, right?\I wouldn't call this my first love\It's not my character.\Say, will we be able to meet again tomorrow? response:	As my eyelids close
context: We had a great time\At times, with my friends, acting like fools, being noisy\Fluttering, our eyes met.\It's a coincidence, right?\I wouldn't call this my first love\It's not my character.\Say, will we be able to meet again tomorrow?\As my eyelids close response:	I see you sparkling all over the place
context: At times, with my friends, acting like fools, being noisy\Fluttering, our eyes met.\It's a coincidence, right?\I wouldn't call this my first love\It's not my character.\Say, will we be able to meet again tomorrow?\As my eyelids close\I see you sparkling all over the place response:	Today was fun, too, wasn't it?
context: Fluttering, our eyes met.\It's a coincidence, right?\I wouldn't call this my first love\It's not my character.\Say, will we be able to meet again tomorrow?\As my eyelids close\I see you sparkling all over the place\Today was fun, too, wasn't it? response:	I'm in love
context: It's a coincidence, right?\I wouldn't call this my first love\It's not my character.\Say, will we be able to meet again tomorrow?\As my eyelids close\I see you sparkling all over the place\Today was fun, too, wasn't it?\I'm in love response:	So happy, so happy
context: I wouldn't call this my first love\It's not my character.\Say, will we be able to meet again tomorrow?\As my eyelids close\I see you sparkling all over the place\Today was fun, too, wasn't it?\I'm in love\So happy, so happy response:	It is my pleasure to meet you, my new-found love.
context: It's not my character.\Say, will we be able to meet again tomorrow?\As my eyelids close\I see you sparkling all over the place\Today was fun, too, wasn't it?\I'm in love\So happy, so happy\It is my pleasure to meet you, my new-found love. response:	Surely, we'll meet again tomorrow
context: Say, will we be able to meet again tomorrow?\As my eyelids close\I see you sparkling all over the place\Today was fun, too, wasn't it?\I'm in love\So happy, so happy\It is my pleasure to meet you, my new-found love.\Surely, we'll meet again tomorrow response:	Have a good night
context: As my eyelids close\I see you sparkling all over the place\Today was fun, too, wasn't it?\I'm in love\So happy, so happy\It is my pleasure to meet you, my new-found love.\Surely, we'll meet again tomorrow\Have a good night response:	We'll meet immediately in our dreams
context: I see you sparkling all over the place\Today was fun, too, wasn't it?\I'm in love\So happy, so happy\It is my pleasure to meet you, my new-found love.\Surely, we'll meet again tomorrow\Have a good night\We'll meet immediately in our dreams response:	So have a good night
context: Today was fun, too, wasn't it?\I'm in love\So happy, so happy\It is my pleasure to meet you, my new-found love.\Surely, we'll meet again tomorrow\Have a good night\We'll meet immediately in our dreams\So have a good night response:	Toy Poodle Continent
context: I'm in love\So happy, so happy\It is my pleasure to meet you, my new-found love.\Surely, we'll meet again tomorrow\Have a good night\We'll meet immediately in our dreams\So have a good night\Toy Poodle Continent response:	Artificial Intelligence
context: So happy, so happy\It is my pleasure to meet you, my new-found love.\Surely, we'll meet again tomorrow\Have a good night\We'll meet immediately in our dreams\So have a good night\Toy Poodle Continent\Artificial Intelligence response:	and
context: It is my pleasure to meet you, my new-found love.\Surely, we'll meet again tomorrow\Have a good night\We'll meet immediately in our dreams\So have a good night\Toy Poodle Continent\Artificial Intelligence\and response:	Information Processing
context: Surely, we'll meet again tomorrow\Have a good night\We'll meet immediately in our dreams\So have a good night\Toy Poodle Continent\Artificial Intelligence\and\Information Processing response:	Superstring Theory
context: Have a good night\We'll meet immediately in our dreams\So have a good night\Toy Poodle Continent\Artificial Intelligence\and\Information Processing\Superstring Theory response:	And thus, I became a string.
context: We'll meet immediately in our dreams\So have a good night\Toy Poodle Continent\Artificial Intelligence\and\Information Processing\Superstring Theory\And thus, I became a string. response:	Artificial Intelligence
context: So have a good night\Toy Poodle Continent\Artificial Intelligence\and\Information Processing\Superstring Theory\And thus, I became a string.\Artificial Intelligence response:	Robotics
context: Toy Poodle Continent\Artificial Intelligence\and\Information Processing\Superstring Theory\And thus, I became a string.\Artificial Intelligence\Robotics response:	Electromagnetics
context: Artificial Intelligence\and\Information Processing\Superstring Theory\And thus, I became a string.\Artificial Intelligence\Robotics\Electromagnetics response:	Thermodynamics
context: and\Information Processing\Superstring Theory\And thus, I became a string.\Artificial Intelligence\Robotics\Electromagnetics\Thermodynamics response:	The History of Information
context: Information Processing\Superstring Theory\And thus, I became a string.\Artificial Intelligence\Robotics\Electromagnetics\Thermodynamics\The History of Information response:	Unprecedented Scientific Journals
context: Superstring Theory\And thus, I became a string.\Artificial Intelligence\Robotics\Electromagnetics\Thermodynamics\The History of Information\Unprecedented Scientific Journals response:	THE WONDERFUL SCIENCE
context: And thus, I became a string.\Artificial Intelligence\Robotics\Electromagnetics\Thermodynamics\The History of Information\Unprecedented Scientific Journals\THE WONDERFUL SCIENCE response:	Cat Life
context: Artificial Intelligence\Robotics\Electromagnetics\Thermodynamics\The History of Information\Unprecedented Scientific Journals\THE WONDERFUL SCIENCE\Cat Life response:	Robot Research
context: Robotics\Electromagnetics\Thermodynamics\The History of Information\Unprecedented Scientific Journals\THE WONDERFUL SCIENCE\Cat Life\Robot Research response:	Sakamoto Pharmaceutical
context: Electromagnetics\Thermodynamics\The History of Information\Unprecedented Scientific Journals\THE WONDERFUL SCIENCE\Cat Life\Robot Research\Sakamoto Pharmaceutical response:	Sakamoto Pharmaceutical
context: Thermodynamics\The History of Information\Unprecedented Scientific Journals\THE WONDERFUL SCIENCE\Cat Life\Robot Research\Sakamoto Pharmaceutical\Sakamoto Pharmaceutical response:	TL note: Indonesian for good morning
context: The History of Information\Unprecedented Scientific Journals\THE WONDERFUL SCIENCE\Cat Life\Robot Research\Sakamoto Pharmaceutical\Sakamoto Pharmaceutical\TL note: Indonesian for good morning response:	Nichijou 09
context: Unprecedented Scientific Journals\THE WONDERFUL SCIENCE\Cat Life\Robot Research\Sakamoto Pharmaceutical\Sakamoto Pharmaceutical\TL note: Indonesian for good morning\Nichijou 09 response:	Bargain Sale!
context: THE WONDERFUL SCIENCE\Cat Life\Robot Research\Sakamoto Pharmaceutical\Sakamoto Pharmaceutical\TL note: Indonesian for good morning\Nichijou 09\Bargain Sale! response:	Made in Australia
context: Cat Life\Robot Research\Sakamoto Pharmaceutical\Sakamoto Pharmaceutical\TL note: Indonesian for good morning\Nichijou 09\Bargain Sale!\Made in Australia response:	TL note: Maitreya = Buddha statue
context: Robot Research\Sakamoto Pharmaceutical\Sakamoto Pharmaceutical\TL note: Indonesian for good morning\Nichijou 09\Bargain Sale!\Made in Australia\TL note: Maitreya = Buddha statue response:	Mai-chan, I'm sorry
context: Sakamoto Pharmaceutical\Sakamoto Pharmaceutical\TL note: Indonesian for good morning\Nichijou 09\Bargain Sale!\Made in Australia\TL note: Maitreya = Buddha statue\Mai-chan, I'm sorry response:	Tanaka
context: Sakamoto Pharmaceutical\TL note: Indonesian for good morning\Nichijou 09\Bargain Sale!\Made in Australia\TL note: Maitreya = Buddha statue\Mai-chan, I'm sorry\Tanaka response:	Nichijou 10
context: TL note: Indonesian for good morning\Nichijou 09\Bargain Sale!\Made in Australia\TL note: Maitreya = Buddha statue\Mai-chan, I'm sorry\Tanaka\Nichijou 10 response:	The solution to these equations is 2.
context: Nichijou 09\Bargain Sale!\Made in Australia\TL note: Maitreya = Buddha statue\Mai-chan, I'm sorry\Tanaka\Nichijou 10\The solution to these equations is 2. response:	Solve the equations.
context: Bargain Sale!\Made in Australia\TL note: Maitreya = Buddha statue\Mai-chan, I'm sorry\Tanaka\Nichijou 10\The solution to these equations is 2.\Solve the equations. response:	Word of the day
context: Made in Australia\TL note: Maitreya = Buddha statue\Mai-chan, I'm sorry\Tanaka\Nichijou 10\The solution to these equations is 2.\Solve the equations.\Word of the day response:	Inscribed in a circle is quadrilateral ABCD
context: TL note: Maitreya = Buddha statue\Mai-chan, I'm sorry\Tanaka\Nichijou 10\The solution to these equations is 2.\Solve the equations.\Word of the day\Inscribed in a circle is quadrilateral ABCD response:	AB=5 BC=4 CD=4 B=60
context: Mai-chan, I'm sorry\Tanaka\Nichijou 10\The solution to these equations is 2.\Solve the equations.\Word of the day\Inscribed in a circle is quadrilateral ABCD\AB=5 BC=4 CD=4 B=60 response:	Based on quadrilateral ABCD
context: Tanaka\Nichijou 10\The solution to these equations is 2.\Solve the equations.\Word of the day\Inscribed in a circle is quadrilateral ABCD\AB=5 BC=4 CD=4 B=60\Based on quadrilateral ABCD response:	Calculate the area S
context: Nichijou 10\The solution to these equations is 2.\Solve the equations.\Word of the day\Inscribed in a circle is quadrilateral ABCD\AB=5 BC=4 CD=4 B=60\Based on quadrilateral ABCD\Calculate the area S response:	Nichijou 11
context: The solution to these equations is 2.\Solve the equations.\Word of the day\Inscribed in a circle is quadrilateral ABCD\AB=5 BC=4 CD=4 B=60\Based on quadrilateral ABCD\Calculate the area S\Nichijou 11 response:	Nichijou 12
context: Solve the equations.\Word of the day\Inscribed in a circle is quadrilateral ABCD\AB=5 BC=4 CD=4 B=60\Based on quadrilateral ABCD\Calculate the area S\Nichijou 11\Nichijou 12 response:	Osaka-ben...
context: Word of the day\Inscribed in a circle is quadrilateral ABCD\AB=5 BC=4 CD=4 B=60\Based on quadrilateral ABCD\Calculate the area S\Nichijou 11\Nichijou 12\Osaka-ben... response:	Straw
context: Inscribed in a circle is quadrilateral ABCD\AB=5 BC=4 CD=4 B=60\Based on quadrilateral ABCD\Calculate the area S\Nichijou 11\Nichijou 12\Osaka-ben...\Straw response:	Straw 2
context: AB=5 BC=4 CD=4 B=60\Based on quadrilateral ABCD\Calculate the area S\Nichijou 11\Nichijou 12\Osaka-ben...\Straw\Straw 2 response:	Nichijou 13
context: Based on quadrilateral ABCD\Calculate the area S\Nichijou 11\Nichijou 12\Osaka-ben...\Straw\Straw 2\Nichijou 13 response:	Narration: Masuoka Hiroshi
context: Calculate the area S\Nichijou 11\Nichijou 12\Osaka-ben...\Straw\Straw 2\Nichijou 13\Narration: Masuoka Hiroshi response:	Sakamoto Pharmaceutical
context: Nichijou 11\Nichijou 12\Osaka-ben...\Straw\Straw 2\Nichijou 13\Narration: Masuoka Hiroshi\Sakamoto Pharmaceutical response:	Sakamoto Pharmaceutical
context: Nichijou 12\Osaka-ben...\Straw\Straw 2\Nichijou 13\Narration: Masuoka Hiroshi\Sakamoto Pharmaceutical\Sakamoto Pharmaceutical response:	Hey, hey, Mio-chan.
context: Osaka-ben...\Straw\Straw 2\Nichijou 13\Narration: Masuoka Hiroshi\Sakamoto Pharmaceutical\Sakamoto Pharmaceutical\Hey, hey, Mio-chan. response:	What is it?
context: Straw\Straw 2\Nichijou 13\Narration: Masuoka Hiroshi\Sakamoto Pharmaceutical\Sakamoto Pharmaceutical\Hey, hey, Mio-chan.\What is it? response:	I've been wondering about this for a while now,
context: Straw 2\Nichijou 13\Narration: Masuoka Hiroshi\Sakamoto Pharmaceutical\Sakamoto Pharmaceutical\Hey, hey, Mio-chan.\What is it?\I've been wondering about this for a while now, response:	but why do you always wear that hair pin?
context: Nichijou 13\Narration: Masuoka Hiroshi\Sakamoto Pharmaceutical\Sakamoto Pharmaceutical\Hey, hey, Mio-chan.\What is it?\I've been wondering about this for a while now,\but why do you always wear that hair pin? response:	Ah, this?
context: Narration: Masuoka Hiroshi\Sakamoto Pharmaceutical\Sakamoto Pharmaceutical\Hey, hey, Mio-chan.\What is it?\I've been wondering about this for a while now,\but why do you always wear that hair pin?\Ah, this? response:	Hmm... somehow...
context: Sakamoto Pharmaceutical\Sakamoto Pharmaceutical\Hey, hey, Mio-chan.\What is it?\I've been wondering about this for a while now,\but why do you always wear that hair pin?\Ah, this?\Hmm... somehow... response:	Somehow?
context: Sakamoto Pharmaceutical\Hey, hey, Mio-chan.\What is it?\I've been wondering about this for a while now,\but why do you always wear that hair pin?\Ah, this?\Hmm... somehow...\Somehow? response:	Somehow means somehow.
context: Hey, hey, Mio-chan.\What is it?\I've been wondering about this for a while now,\but why do you always wear that hair pin?\Ah, this?\Hmm... somehow...\Somehow?\Somehow means somehow. response:	I forgot to bring my maths notebook with me.
context: What is it?\I've been wondering about this for a while now,\but why do you always wear that hair pin?\Ah, this?\Hmm... somehow...\Somehow?\Somehow means somehow.\I forgot to bring my maths notebook with me. response:	Huh?
context: I've been wondering about this for a while now,\but why do you always wear that hair pin?\Ah, this?\Hmm... somehow...\Somehow?\Somehow means somehow.\I forgot to bring my maths notebook with me.\Huh? response:	Do we have maths today?
context: but why do you always wear that hair pin?\Ah, this?\Hmm... somehow...\Somehow?\Somehow means somehow.\I forgot to bring my maths notebook with me.\Huh?\Do we have maths today? response:	We do.
context: Ah, this?\Hmm... somehow...\Somehow?\Somehow means somehow.\I forgot to bring my maths notebook with me.\Huh?\Do we have maths today?\We do. response:	We also had homework, remember?
context: Hmm... somehow...\Somehow?\Somehow means somehow.\I forgot to bring my maths notebook with me.\Huh?\Do we have maths today?\We do.\We also had homework, remember? response:	I'll go and get it.
context: Somehow?\Somehow means somehow.\I forgot to bring my maths notebook with me.\Huh?\Do we have maths today?\We do.\We also had homework, remember?\I'll go and get it. response:	Go ahead without me.
context: Somehow means somehow.\I forgot to bring my maths notebook with me.\Huh?\Do we have maths today?\We do.\We also had homework, remember?\I'll go and get it.\Go ahead without me. response:	Ah well.
context: I forgot to bring my maths notebook with me.\Huh?\Do we have maths today?\We do.\We also had homework, remember?\I'll go and get it.\Go ahead without me.\Ah well. response:	I didn't do it anyway, so it won't make any difference.
context: Huh?\Do we have maths today?\We do.\We also had homework, remember?\I'll go and get it.\Go ahead without me.\Ah well.\I didn't do it anyway, so it won't make any difference. response:	Ah, Mai-chan!
context: Do we have maths today?\We do.\We also had homework, remember?\I'll go and get it.\Go ahead without me.\Ah well.\I didn't do it anyway, so it won't make any difference.\Ah, Mai-chan! response:	Selamat pagi!
context: We do.\We also had homework, remember?\I'll go and get it.\Go ahead without me.\Ah well.\I didn't do it anyway, so it won't make any difference.\Ah, Mai-chan!\Selamat pagi! response:	Here it is!
context: We also had homework, remember?\I'll go and get it.\Go ahead without me.\Ah well.\I didn't do it anyway, so it won't make any difference.\Ah, Mai-chan!\Selamat pagi!\Here it is! response:	Here it is!
context: I'll go and get it.\Go ahead without me.\Ah well.\I didn't do it anyway, so it won't make any difference.\Ah, Mai-chan!\Selamat pagi!\Here it is!\Here it is! response:	Here it is, Mai-sensei!
context: Go ahead without me.\Ah well.\I didn't do it anyway, so it won't make any difference.\Ah, Mai-chan!\Selamat pagi!\Here it is!\Here it is!\Here it is, Mai-sensei! response:	Could it be that you're holding back on a killer greeting?
context: Ah well.\I didn't do it anyway, so it won't make any difference.\Ah, Mai-chan!\Selamat pagi!\Here it is!\Here it is!\Here it is, Mai-sensei!\Could it be that you're holding back on a killer greeting? response:	As expected, it's big.
context: I didn't do it anyway, so it won't make any difference.\Ah, Mai-chan!\Selamat pagi!\Here it is!\Here it is!\Here it is, Mai-sensei!\Could it be that you're holding back on a killer greeting?\As expected, it's big. response:	Yes. As big as a mountain... as big as a mountain!
context: Ah, Mai-chan!\Selamat pagi!\Here it is!\Here it is!\Here it is, Mai-sensei!\Could it be that you're holding back on a killer greeting?\As expected, it's big.\Yes. As big as a mountain... as big as a mountain! response:	Is it really as big as a mountain?
context: Selamat pagi!\Here it is!\Here it is!\Here it is, Mai-sensei!\Could it be that you're holding back on a killer greeting?\As expected, it's big.\Yes. As big as a mountain... as big as a mountain!\Is it really as big as a mountain? response:	Well... it's not really a mountain, is it?
context: Here it is!\Here it is!\Here it is, Mai-sensei!\Could it be that you're holding back on a killer greeting?\As expected, it's big.\Yes. As big as a mountain... as big as a mountain!\Is it really as big as a mountain?\Well... it's not really a mountain, is it? response:	I get it.
context: Here it is!\Here it is, Mai-sensei!\Could it be that you're holding back on a killer greeting?\As expected, it's big.\Yes. As big as a mountain... as big as a mountain!\Is it really as big as a mountain?\Well... it's not really a mountain, is it?\I get it. response:	I get why you're angry.
context: Here it is, Mai-sensei!\Could it be that you're holding back on a killer greeting?\As expected, it's big.\Yes. As big as a mountain... as big as a mountain!\Is it really as big as a mountain?\Well... it's not really a mountain, is it?\I get it.\I get why you're angry. response:	It's because I took that piece of broccoli from your lunch box yesterday, right?
context: Could it be that you're holding back on a killer greeting?\As expected, it's big.\Yes. As big as a mountain... as big as a mountain!\Is it really as big as a mountain?\Well... it's not really a mountain, is it?\I get it.\I get why you're angry.\It's because I took that piece of broccoli from your lunch box yesterday, right? response:	Which is why... I bought you broccoli!
context: As expected, it's big.\Yes. As big as a mountain... as big as a mountain!\Is it really as big as a mountain?\Well... it's not really a mountain, is it?\I get it.\I get why you're angry.\It's because I took that piece of broccoli from your lunch box yesterday, right?\Which is why... I bought you broccoli! response:	When I was eating your broccoli, I realised that you're fond of it.
context: Yes. As big as a mountain... as big as a mountain!\Is it really as big as a mountain?\Well... it's not really a mountain, is it?\I get it.\I get why you're angry.\It's because I took that piece of broccoli from your lunch box yesterday, right?\Which is why... I bought you broccoli!\When I was eating your broccoli, I realised that you're fond of it. response:	Since then, I've been wondering... have I done something bad?
context: Is it really as big as a mountain?\Well... it's not really a mountain, is it?\I get it.\I get why you're angry.\It's because I took that piece of broccoli from your lunch box yesterday, right?\Which is why... I bought you broccoli!\When I was eating your broccoli, I realised that you're fond of it.\Since then, I've been wondering... have I done something bad? response:	Therefore, I give this to you!
context: Well... it's not really a mountain, is it?\I get it.\I get why you're angry.\It's because I took that piece of broccoli from your lunch box yesterday, right?\Which is why... I bought you broccoli!\When I was eating your broccoli, I realised that you're fond of it.\Since then, I've been wondering... have I done something bad?\Therefore, I give this to you! response:	You know, my dad was telling me...
context: I get it.\I get why you're angry.\It's because I took that piece of broccoli from your lunch box yesterday, right?\Which is why... I bought you broccoli!\When I was eating your broccoli, I realised that you're fond of it.\Since then, I've been wondering... have I done something bad?\Therefore, I give this to you!\You know, my dad was telling me... response:	It's not the broccoli.
context: I get why you're angry.\It's because I took that piece of broccoli from your lunch box yesterday, right?\Which is why... I bought you broccoli!\When I was eating your broccoli, I realised that you're fond of it.\Since then, I've been wondering... have I done something bad?\Therefore, I give this to you!\You know, my dad was telling me...\It's not the broccoli. response:	Nor... the cauliflower.
context: It's because I took that piece of broccoli from your lunch box yesterday, right?\Which is why... I bought you broccoli!\When I was eating your broccoli, I realised that you're fond of it.\Since then, I've been wondering... have I done something bad?\Therefore, I give this to you!\You know, my dad was telling me...\It's not the broccoli.\Nor... the cauliflower. response:	I screwed up so much that I can't figure what she's angry about...
context: Which is why... I bought you broccoli!\When I was eating your broccoli, I realised that you're fond of it.\Since then, I've been wondering... have I done something bad?\Therefore, I give this to you!\You know, my dad was telling me...\It's not the broccoli.\Nor... the cauliflower.\I screwed up so much that I can't figure what she's angry about... response:	But I get the general idea.
context: When I was eating your broccoli, I realised that you're fond of it.\Since then, I've been wondering... have I done something bad?\Therefore, I give this to you!\You know, my dad was telling me...\It's not the broccoli.\Nor... the cauliflower.\I screwed up so much that I can't figure what she's angry about...\But I get the general idea. response:	I don't want her to stay angry like this...
context: Since then, I've been wondering... have I done something bad?\Therefore, I give this to you!\You know, my dad was telling me...\It's not the broccoli.\Nor... the cauliflower.\I screwed up so much that I can't figure what she's angry about...\But I get the general idea.\I don't want her to stay angry like this... response:	Now that it has come to this, all I can do is honestly apologise to her...
context: Therefore, I give this to you!\You know, my dad was telling me...\It's not the broccoli.\Nor... the cauliflower.\I screwed up so much that I can't figure what she's angry about...\But I get the general idea.\I don't want her to stay angry like this...\Now that it has come to this, all I can do is honestly apologise to her... response:	Mai-chan!
context: You know, my dad was telling me...\It's not the broccoli.\Nor... the cauliflower.\I screwed up so much that I can't figure what she's angry about...\But I get the general idea.\I don't want her to stay angry like this...\Now that it has come to this, all I can do is honestly apologise to her...\Mai-chan! response:	Sorry for taking your steak yesterday!
context: It's not the broccoli.\Nor... the cauliflower.\I screwed up so much that I can't figure what she's angry about...\But I get the general idea.\I don't want her to stay angry like this...\Now that it has come to this, all I can do is honestly apologise to her...\Mai-chan!\Sorry for taking your steak yesterday! response:	Sorry for taking your bunny!
context: Nor... the cauliflower.\I screwed up so much that I can't figure what she's angry about...\But I get the general idea.\I don't want her to stay angry like this...\Now that it has come to this, all I can do is honestly apologise to her...\Mai-chan!\Sorry for taking your steak yesterday!\Sorry for taking your bunny! response:	Sorry for eating your rice!
context: I screwed up so much that I can't figure what she's angry about...\But I get the general idea.\I don't want her to stay angry like this...\Now that it has come to this, all I can do is honestly apologise to her...\Mai-chan!\Sorry for taking your steak yesterday!\Sorry for taking your bunny!\Sorry for eating your rice! response:	Sorry for leaving the black soy beans!
context: But I get the general idea.\I don't want her to stay angry like this...\Now that it has come to this, all I can do is honestly apologise to her...\Mai-chan!\Sorry for taking your steak yesterday!\Sorry for taking your bunny!\Sorry for eating your rice!\Sorry for leaving the black soy beans! response:	What?
context: I don't want her to stay angry like this...\Now that it has come to this, all I can do is honestly apologise to her...\Mai-chan!\Sorry for taking your steak yesterday!\Sorry for taking your bunny!\Sorry for eating your rice!\Sorry for leaving the black soy beans!\What? response:	Why is she so angry?
context: Now that it has come to this, all I can do is honestly apologise to her...\Mai-chan!\Sorry for taking your steak yesterday!\Sorry for taking your bunny!\Sorry for eating your rice!\Sorry for leaving the black soy beans!\What?\Why is she so angry? response:	I don't get it any more!
context: Mai-chan!\Sorry for taking your steak yesterday!\Sorry for taking your bunny!\Sorry for eating your rice!\Sorry for leaving the black soy beans!\What?\Why is she so angry?\I don't get it any more! response:	It's not because of yesterday's lunch?
context: Sorry for taking your steak yesterday!\Sorry for taking your bunny!\Sorry for eating your rice!\Sorry for leaving the black soy beans!\What?\Why is she so angry?\I don't get it any more!\It's not because of yesterday's lunch? response:	Ah! Then could it be something from even earlier?
context: Sorry for taking your bunny!\Sorry for eating your rice!\Sorry for leaving the black soy beans!\What?\Why is she so angry?\I don't get it any more!\It's not because of yesterday's lunch?\Ah! Then could it be something from even earlier? response:	Is it because I broke the neck of the Maitreya...
context: Sorry for eating your rice!\Sorry for leaving the black soy beans!\What?\Why is she so angry?\I don't get it any more!\It's not because of yesterday's lunch?\Ah! Then could it be something from even earlier?\Is it because I broke the neck of the Maitreya... response:	Or is it because I took it away without asking?!
context: Sorry for leaving the black soy beans!\What?\Why is she so angry?\I don't get it any more!\It's not because of yesterday's lunch?\Ah! Then could it be something from even earlier?\Is it because I broke the neck of the Maitreya...\Or is it because I took it away without asking?! response:	Or is it because I secretly buried it in the ground?!
context: What?\Why is she so angry?\I don't get it any more!\It's not because of yesterday's lunch?\Ah! Then could it be something from even earlier?\Is it because I broke the neck of the Maitreya...\Or is it because I took it away without asking?!\Or is it because I secretly buried it in the ground?! response:	Or is it because I changed my mind and tried offering it on Mai-chan's desk?!
context: Why is she so angry?\I don't get it any more!\It's not because of yesterday's lunch?\Ah! Then could it be something from even earlier?\Is it because I broke the neck of the Maitreya...\Or is it because I took it away without asking?!\Or is it because I secretly buried it in the ground?!\Or is it because I changed my mind and tried offering it on Mai-chan's desk?! response:	Or is it because I changed my mind again and burned it in the incinerator?
context: I don't get it any more!\It's not because of yesterday's lunch?\Ah! Then could it be something from even earlier?\Is it because I broke the neck of the Maitreya...\Or is it because I took it away without asking?!\Or is it because I secretly buried it in the ground?!\Or is it because I changed my mind and tried offering it on Mai-chan's desk?!\Or is it because I changed my mind again and burned it in the incinerator? response:	Mai-chan!
context: It's not because of yesterday's lunch?\Ah! Then could it be something from even earlier?\Is it because I broke the neck of the Maitreya...\Or is it because I took it away without asking?!\Or is it because I secretly buried it in the ground?!\Or is it because I changed my mind and tried offering it on Mai-chan's desk?!\Or is it because I changed my mind again and burned it in the incinerator?\Mai-chan! response:	So... so you were just listening to music!
context: Ah! Then could it be something from even earlier?\Is it because I broke the neck of the Maitreya...\Or is it because I took it away without asking?!\Or is it because I secretly buried it in the ground?!\Or is it because I changed my mind and tried offering it on Mai-chan's desk?!\Or is it because I changed my mind again and burned it in the incinerator?\Mai-chan!\So... so you were just listening to music! response:	No wonder you didn't notice.
context: Is it because I broke the neck of the Maitreya...\Or is it because I took it away without asking?!\Or is it because I secretly buried it in the ground?!\Or is it because I changed my mind and tried offering it on Mai-chan's desk?!\Or is it because I changed my mind again and burned it in the incinerator?\Mai-chan!\So... so you were just listening to music!\No wonder you didn't notice. response:	I didn't know about it and kept on chatting on my own.
context: Or is it because I took it away without asking?!\Or is it because I secretly buried it in the ground?!\Or is it because I changed my mind and tried offering it on Mai-chan's desk?!\Or is it because I changed my mind again and burned it in the incinerator?\Mai-chan!\So... so you were just listening to music!\No wonder you didn't notice.\I didn't know about it and kept on chatting on my own. response:	That was dangerous!
context: Or is it because I secretly buried it in the ground?!\Or is it because I changed my mind and tried offering it on Mai-chan's desk?!\Or is it because I changed my mind again and burned it in the incinerator?\Mai-chan!\So... so you were just listening to music!\No wonder you didn't notice.\I didn't know about it and kept on chatting on my own.\That was dangerous! response:	Everything was on the verge of being exposed.
context: Or is it because I changed my mind and tried offering it on Mai-chan's desk?!\Or is it because I changed my mind again and burned it in the incinerator?\Mai-chan!\So... so you were just listening to music!\No wonder you didn't notice.\I didn't know about it and kept on chatting on my own.\That was dangerous!\Everything was on the verge of being exposed. response:	The second half.
context: Or is it because I changed my mind again and burned it in the incinerator?\Mai-chan!\So... so you were just listening to music!\No wonder you didn't notice.\I didn't know about it and kept on chatting on my own.\That was dangerous!\Everything was on the verge of being exposed.\The second half. response:	It's the first time I heard the second half...
context: Mai-chan!\So... so you were just listening to music!\No wonder you didn't notice.\I didn't know about it and kept on chatting on my own.\That was dangerous!\Everything was on the verge of being exposed.\The second half.\It's the first time I heard the second half... response:	Ah, Tanaka-kun!
context: So... so you were just listening to music!\No wonder you didn't notice.\I didn't know about it and kept on chatting on my own.\That was dangerous!\Everything was on the verge of being exposed.\The second half.\It's the first time I heard the second half...\Ah, Tanaka-kun! response:	Sorry, do you have a moment?
context: No wonder you didn't notice.\I didn't know about it and kept on chatting on my own.\That was dangerous!\Everything was on the verge of being exposed.\The second half.\It's the first time I heard the second half...\Ah, Tanaka-kun!\Sorry, do you have a moment? response:	Ah, hm, I-I was thinking...
context: I didn't know about it and kept on chatting on my own.\That was dangerous!\Everything was on the verge of being exposed.\The second half.\It's the first time I heard the second half...\Ah, Tanaka-kun!\Sorry, do you have a moment?\Ah, hm, I-I was thinking... response:	that hairstyle of yours is morally... a little...
context: That was dangerous!\Everything was on the verge of being exposed.\The second half.\It's the first time I heard the second half...\Ah, Tanaka-kun!\Sorry, do you have a moment?\Ah, hm, I-I was thinking...\that hairstyle of yours is morally... a little... response:	Sensei.
context: Everything was on the verge of being exposed.\The second half.\It's the first time I heard the second half...\Ah, Tanaka-kun!\Sorry, do you have a moment?\Ah, hm, I-I was thinking...\that hairstyle of yours is morally... a little...\Sensei. response:	Yes?!
context: The second half.\It's the first time I heard the second half...\Ah, Tanaka-kun!\Sorry, do you have a moment?\Ah, hm, I-I was thinking...\that hairstyle of yours is morally... a little...\Sensei.\Yes?! response:	Do you want to eat a dorayaki?
context: It's the first time I heard the second half...\Ah, Tanaka-kun!\Sorry, do you have a moment?\Ah, hm, I-I was thinking...\that hairstyle of yours is morally... a little...\Sensei.\Yes?!\Do you want to eat a dorayaki? response:	Oh no!
context: Ah, Tanaka-kun!\Sorry, do you have a moment?\Ah, hm, I-I was thinking...\that hairstyle of yours is morally... a little...\Sensei.\Yes?!\Do you want to eat a dorayaki?\Oh no! response:	I completely forgot about this printout!
context: Sorry, do you have a moment?\Ah, hm, I-I was thinking...\that hairstyle of yours is morally... a little...\Sensei.\Yes?!\Do you want to eat a dorayaki?\Oh no!\I completely forgot about this printout! response:	There are still five minutes left until maths.
context: Ah, hm, I-I was thinking...\that hairstyle of yours is morally... a little...\Sensei.\Yes?!\Do you want to eat a dorayaki?\Oh no!\I completely forgot about this printout!\There are still five minutes left until maths. response:	I had Mio-chan show it to me yesterday...
context: that hairstyle of yours is morally... a little...\Sensei.\Yes?!\Do you want to eat a dorayaki?\Oh no!\I completely forgot about this printout!\There are still five minutes left until maths.\I had Mio-chan show it to me yesterday... response:	This is the request of my life!
context: Sensei.\Yes?!\Do you want to eat a dorayaki?\Oh no!\I completely forgot about this printout!\There are still five minutes left until maths.\I had Mio-chan show it to me yesterday...\This is the request of my life! response:	I can't ask her!
context: Yes?!\Do you want to eat a dorayaki?\Oh no!\I completely forgot about this printout!\There are still five minutes left until maths.\I had Mio-chan show it to me yesterday...\This is the request of my life!\I can't ask her! response:	At this rate, I'll have to...
context: Do you want to eat a dorayaki?\Oh no!\I completely forgot about this printout!\There are still five minutes left until maths.\I had Mio-chan show it to me yesterday...\This is the request of my life!\I can't ask her!\At this rate, I'll have to... response:	Mai-chan.
context: Oh no!\I completely forgot about this printout!\There are still five minutes left until maths.\I had Mio-chan show it to me yesterday...\This is the request of my life!\I can't ask her!\At this rate, I'll have to...\Mai-chan. response:	This is embarrassing,
context: I completely forgot about this printout!\There are still five minutes left until maths.\I had Mio-chan show it to me yesterday...\This is the request of my life!\I can't ask her!\At this rate, I'll have to...\Mai-chan.\This is embarrassing, response:	I sorta forgot about the maths homework...
context: There are still five minutes left until maths.\I had Mio-chan show it to me yesterday...\This is the request of my life!\I can't ask her!\At this rate, I'll have to...\Mai-chan.\This is embarrassing,\I sorta forgot about the maths homework... response:	Um, if it's okay with you, I'd like to see your notes for a sec...
context: I had Mio-chan show it to me yesterday...\This is the request of my life!\I can't ask her!\At this rate, I'll have to...\Mai-chan.\This is embarrassing,\I sorta forgot about the maths homework...\Um, if it's okay with you, I'd like to see your notes for a sec... response:	Here.
context: This is the request of my life!\I can't ask her!\At this rate, I'll have to...\Mai-chan.\This is embarrassing,\I sorta forgot about the maths homework...\Um, if it's okay with you, I'd like to see your notes for a sec...\Here. response:	My, thanks!
context: I can't ask her!\At this rate, I'll have to...\Mai-chan.\This is embarrassing,\I sorta forgot about the maths homework...\Um, if it's okay with you, I'd like to see your notes for a sec...\Here.\My, thanks! response:	Thank you.
context: At this rate, I'll have to...\Mai-chan.\This is embarrassing,\I sorta forgot about the maths homework...\Um, if it's okay with you, I'd like to see your notes for a sec...\Here.\My, thanks!\Thank you. response:	Wait a sec, okay?
context: Mai-chan.\This is embarrassing,\I sorta forgot about the maths homework...\Um, if it's okay with you, I'd like to see your notes for a sec...\Here.\My, thanks!\Thank you.\Wait a sec, okay? response:	I'll copy it at Mach speed.
context: This is embarrassing,\I sorta forgot about the maths homework...\Um, if it's okay with you, I'd like to see your notes for a sec...\Here.\My, thanks!\Thank you.\Wait a sec, okay?\I'll copy it at Mach speed. response:	This is bad.
context: I sorta forgot about the maths homework...\Um, if it's okay with you, I'd like to see your notes for a sec...\Here.\My, thanks!\Thank you.\Wait a sec, okay?\I'll copy it at Mach speed.\This is bad. response:	I'm really late.
context: Um, if it's okay with you, I'd like to see your notes for a sec...\Here.\My, thanks!\Thank you.\Wait a sec, okay?\I'll copy it at Mach speed.\This is bad.\I'm really late. response:	This is bad.
context: Here.\My, thanks!\Thank you.\Wait a sec, okay?\I'll copy it at Mach speed.\This is bad.\I'm really late.\This is bad. response:	This is bad.
context: My, thanks!\Thank you.\Wait a sec, okay?\I'll copy it at Mach speed.\This is bad.\I'm really late.\This is bad.\This is bad. response:	You idiot!
context: Thank you.\Wait a sec, okay?\I'll copy it at Mach speed.\This is bad.\I'm really late.\This is bad.\This is bad.\You idiot! response:	You're so noisy in the morning, Masao!
context: Wait a sec, okay?\I'll copy it at Mach speed.\This is bad.\I'm really late.\This is bad.\This is bad.\You idiot!\You're so noisy in the morning, Masao! response:	This is really bad!
context: I'll copy it at Mach speed.\This is bad.\I'm really late.\This is bad.\This is bad.\You idiot!\You're so noisy in the morning, Masao!\This is really bad! response:	I'm really late!
context: This is bad.\I'm really late.\This is bad.\This is bad.\You idiot!\You're so noisy in the morning, Masao!\This is really bad!\I'm really late! response:	I'm restructuring here!
context: I'm really late.\This is bad.\This is bad.\You idiot!\You're so noisy in the morning, Masao!\This is really bad!\I'm really late!\I'm restructuring here! response:	This is strange.
context: This is bad.\This is bad.\You idiot!\You're so noisy in the morning, Masao!\This is really bad!\I'm really late!\I'm restructuring here!\This is strange. response:	Mai-chan, um, this doesn't really look like the maths printout...
context: This is bad.\You idiot!\You're so noisy in the morning, Masao!\This is really bad!\I'm really late!\I'm restructuring here!\This is strange.\Mai-chan, um, this doesn't really look like the maths printout... response:	I'll treat you to juice!
context: You idiot!\You're so noisy in the morning, Masao!\This is really bad!\I'm really late!\I'm restructuring here!\This is strange.\Mai-chan, um, this doesn't really look like the maths printout...\I'll treat you to juice! response:	Here.
context: You're so noisy in the morning, Masao!\This is really bad!\I'm really late!\I'm restructuring here!\This is strange.\Mai-chan, um, this doesn't really look like the maths printout...\I'll treat you to juice!\Here. response:	Thanks!
context: This is really bad!\I'm really late!\I'm restructuring here!\This is strange.\Mai-chan, um, this doesn't really look like the maths printout...\I'll treat you to juice!\Here.\Thanks! response:	I'm late for school.
context: I'm really late!\I'm restructuring here!\This is strange.\Mai-chan, um, this doesn't really look like the maths printout...\I'll treat you to juice!\Here.\Thanks!\I'm late for school. response:	And dad is restructuring.
context: I'm restructuring here!\This is strange.\Mai-chan, um, this doesn't really look like the maths printout...\I'll treat you to juice!\Here.\Thanks!\I'm late for school.\And dad is restructuring. response:	We're both in trouble.
context: This is strange.\Mai-chan, um, this doesn't really look like the maths printout...\I'll treat you to juice!\Here.\Thanks!\I'm late for school.\And dad is restructuring.\We're both in trouble. response:	Now's not the time for this!
context: Mai-chan, um, this doesn't really look like the maths printout...\I'll treat you to juice!\Here.\Thanks!\I'm late for school.\And dad is restructuring.\We're both in trouble.\Now's not the time for this! response:	Wait, isn't Masao in danger here?!
context: I'll treat you to juice!\Here.\Thanks!\I'm late for school.\And dad is restructuring.\We're both in trouble.\Now's not the time for this!\Wait, isn't Masao in danger here?! response:	What's going to happen to Masao?!
context: Here.\Thanks!\I'm late for school.\And dad is restructuring.\We're both in trouble.\Now's not the time for this!\Wait, isn't Masao in danger here?!\What's going to happen to Masao?! response:	No, wait...
context: Thanks!\I'm late for school.\And dad is restructuring.\We're both in trouble.\Now's not the time for this!\Wait, isn't Masao in danger here?!\What's going to happen to Masao?!\No, wait... response:	Now is not the time for this either!
context: I'm late for school.\And dad is restructuring.\We're both in trouble.\Now's not the time for this!\Wait, isn't Masao in danger here?!\What's going to happen to Masao?!\No, wait...\Now is not the time for this either! response:	I'm in a pinch here!
context: And dad is restructuring.\We're both in trouble.\Now's not the time for this!\Wait, isn't Masao in danger here?!\What's going to happen to Masao?!\No, wait...\Now is not the time for this either!\I'm in a pinch here! response:	The printout, Mai-chan!
context: We're both in trouble.\Now's not the time for this!\Wait, isn't Masao in danger here?!\What's going to happen to Masao?!\No, wait...\Now is not the time for this either!\I'm in a pinch here!\The printout, Mai-chan! response:	Now that it's come to this,
context: Now's not the time for this!\Wait, isn't Masao in danger here?!\What's going to happen to Masao?!\No, wait...\Now is not the time for this either!\I'm in a pinch here!\The printout, Mai-chan!\Now that it's come to this, response:	I'll also treat you to that from the store at the station!
context: Wait, isn't Masao in danger here?!\What's going to happen to Masao?!\No, wait...\Now is not the time for this either!\I'm in a pinch here!\The printout, Mai-chan!\Now that it's come to this,\I'll also treat you to that from the store at the station! response:	Here.
context: What's going to happen to Masao?!\No, wait...\Now is not the time for this either!\I'm in a pinch here!\The printout, Mai-chan!\Now that it's come to this,\I'll also treat you to that from the store at the station!\Here. response:	T-Thanks!
context: No, wait...\Now is not the time for this either!\I'm in a pinch here!\The printout, Mai-chan!\Now that it's come to this,\I'll also treat you to that from the store at the station!\Here.\T-Thanks! response:	T-This, this.
context: Now is not the time for this either!\I'm in a pinch here!\The printout, Mai-chan!\Now that it's come to this,\I'll also treat you to that from the store at the station!\Here.\T-Thanks!\T-This, this. response:	It's this.
context: I'm in a pinch here!\The printout, Mai-chan!\Now that it's come to this,\I'll also treat you to that from the store at the station!\Here.\T-Thanks!\T-This, this.\It's this. response:	See, you do have it.
context: The printout, Mai-chan!\Now that it's come to this,\I'll also treat you to that from the store at the station!\Here.\T-Thanks!\T-This, this.\It's this.\See, you do have it. response:	You should've just given it to me earlier, Mai-chan, you sneaky one.
context: Now that it's come to this,\I'll also treat you to that from the store at the station!\Here.\T-Thanks!\T-This, this.\It's this.\See, you do have it.\You should've just given it to me earlier, Mai-chan, you sneaky one. response:	Let's quickly copy this stuff then.
context: I'll also treat you to that from the store at the station!\Here.\T-Thanks!\T-This, this.\It's this.\See, you do have it.\You should've just given it to me earlier, Mai-chan, you sneaky one.\Let's quickly copy this stuff then. response:	Just how old is this printout of mine?
context: Here.\T-Thanks!\T-This, this.\It's this.\See, you do have it.\You should've just given it to me earlier, Mai-chan, you sneaky one.\Let's quickly copy this stuff then.\Just how old is this printout of mine? response:	I want to go to New Orleans.
context: T-Thanks!\T-This, this.\It's this.\See, you do have it.\You should've just given it to me earlier, Mai-chan, you sneaky one.\Let's quickly copy this stuff then.\Just how old is this printout of mine?\I want to go to New Orleans. response:	Well then, who knows how to do this question?
context: T-This, this.\It's this.\See, you do have it.\You should've just given it to me earlier, Mai-chan, you sneaky one.\Let's quickly copy this stuff then.\Just how old is this printout of mine?\I want to go to New Orleans.\Well then, who knows how to do this question? response:	No one?
context: It's this.\See, you do have it.\You should've just given it to me earlier, Mai-chan, you sneaky one.\Let's quickly copy this stuff then.\Just how old is this printout of mine?\I want to go to New Orleans.\Well then, who knows how to do this question?\No one? response:	Hakagi's class is always hard.
context: See, you do have it.\You should've just given it to me earlier, Mai-chan, you sneaky one.\Let's quickly copy this stuff then.\Just how old is this printout of mine?\I want to go to New Orleans.\Well then, who knows how to do this question?\No one?\Hakagi's class is always hard. response:	I'm confused, now that I've forgotten to do the homework.
context: You should've just given it to me earlier, Mai-chan, you sneaky one.\Let's quickly copy this stuff then.\Just how old is this printout of mine?\I want to go to New Orleans.\Well then, who knows how to do this question?\No one?\Hakagi's class is always hard.\I'm confused, now that I've forgotten to do the homework. response:	And he'll be mad if I get the question wrong.
context: Let's quickly copy this stuff then.\Just how old is this printout of mine?\I want to go to New Orleans.\Well then, who knows how to do this question?\No one?\Hakagi's class is always hard.\I'm confused, now that I've forgotten to do the homework.\And he'll be mad if I get the question wrong. response:	I'm saying this now,
context: Just how old is this printout of mine?\I want to go to New Orleans.\Well then, who knows how to do this question?\No one?\Hakagi's class is always hard.\I'm confused, now that I've forgotten to do the homework.\And he'll be mad if I get the question wrong.\I'm saying this now, response:	but anyone who's not up for it will lose their good standing.
context: I want to go to New Orleans.\Well then, who knows how to do this question?\No one?\Hakagi's class is always hard.\I'm confused, now that I've forgotten to do the homework.\And he'll be mad if I get the question wrong.\I'm saying this now,\but anyone who's not up for it will lose their good standing. response:	So it's come to this?
context: Well then, who knows how to do this question?\No one?\Hakagi's class is always hard.\I'm confused, now that I've forgotten to do the homework.\And he'll be mad if I get the question wrong.\I'm saying this now,\but anyone who's not up for it will lose their good standing.\So it's come to this? response:	Under that threat, I can't allow myself to... fail!
context: No one?\Hakagi's class is always hard.\I'm confused, now that I've forgotten to do the homework.\And he'll be mad if I get the question wrong.\I'm saying this now,\but anyone who's not up for it will lose their good standing.\So it's come to this?\Under that threat, I can't allow myself to... fail! response:	Hmm, then who should I pick?
context: Hakagi's class is always hard.\I'm confused, now that I've forgotten to do the homework.\And he'll be mad if I get the question wrong.\I'm saying this now,\but anyone who's not up for it will lose their good standing.\So it's come to this?\Under that threat, I can't allow myself to... fail!\Hmm, then who should I pick? response:	Today's the 23rd, so I'll go with attendance number 23... Nakanojou!
context: I'm confused, now that I've forgotten to do the homework.\And he'll be mad if I get the question wrong.\I'm saying this now,\but anyone who's not up for it will lose their good standing.\So it's come to this?\Under that threat, I can't allow myself to... fail!\Hmm, then who should I pick?\Today's the 23rd, so I'll go with attendance number 23... Nakanojou! response:	Now's the time!
context: And he'll be mad if I get the question wrong.\I'm saying this now,\but anyone who's not up for it will lose their good standing.\So it's come to this?\Under that threat, I can't allow myself to... fail!\Hmm, then who should I pick?\Today's the 23rd, so I'll go with attendance number 23... Nakanojou!\Now's the time! response:	Oh, he's absent?
context: I'm saying this now,\but anyone who's not up for it will lose their good standing.\So it's come to this?\Under that threat, I can't allow myself to... fail!\Hmm, then who should I pick?\Today's the 23rd, so I'll go with attendance number 23... Nakanojou!\Now's the time!\Oh, he's absent? response:	What?!
context: but anyone who's not up for it will lose their good standing.\So it's come to this?\Under that threat, I can't allow myself to... fail!\Hmm, then who should I pick?\Today's the 23rd, so I'll go with attendance number 23... Nakanojou!\Now's the time!\Oh, he's absent?\What?! response:	My hand is cramped...
context: So it's come to this?\Under that threat, I can't allow myself to... fail!\Hmm, then who should I pick?\Today's the 23rd, so I'll go with attendance number 23... Nakanojou!\Now's the time!\Oh, he's absent?\What?!\My hand is cramped... response:	Why is my hand cramped right now...
context: Under that threat, I can't allow myself to... fail!\Hmm, then who should I pick?\Today's the 23rd, so I'll go with attendance number 23... Nakanojou!\Now's the time!\Oh, he's absent?\What?!\My hand is cramped...\Why is my hand cramped right now... response:	Well, it's May, so attendance number 5 will...
context: Hmm, then who should I pick?\Today's the 23rd, so I'll go with attendance number 23... Nakanojou!\Now's the time!\Oh, he's absent?\What?!\My hand is cramped...\Why is my hand cramped right now...\Well, it's May, so attendance number 5 will... response:	This is bad... at this rate, he will see me...
context: Today's the 23rd, so I'll go with attendance number 23... Nakanojou!\Now's the time!\Oh, he's absent?\What?!\My hand is cramped...\Why is my hand cramped right now...\Well, it's May, so attendance number 5 will...\This is bad... at this rate, he will see me... response:	I just called on him...
context: Now's the time!\Oh, he's absent?\What?!\My hand is cramped...\Why is my hand cramped right now...\Well, it's May, so attendance number 5 will...\This is bad... at this rate, he will see me...\I just called on him... response:	For the time being, I'll get into his blind spot... blind spot...
context: Oh, he's absent?\What?!\My hand is cramped...\Why is my hand cramped right now...\Well, it's May, so attendance number 5 will...\This is bad... at this rate, he will see me...\I just called on him...\For the time being, I'll get into his blind spot... blind spot... response:	I'll call on someone new...
context: What?!\My hand is cramped...\Why is my hand cramped right now...\Well, it's May, so attendance number 5 will...\This is bad... at this rate, he will see me...\I just called on him...\For the time being, I'll get into his blind spot... blind spot...\I'll call on someone new... response:	Blind -
context: My hand is cramped...\Why is my hand cramped right now...\Well, it's May, so attendance number 5 will...\This is bad... at this rate, he will see me...\I just called on him...\For the time being, I'll get into his blind spot... blind spot...\I'll call on someone new...\Blind - response:	The chair... the sound of the chair will...!
context: Why is my hand cramped right now...\Well, it's May, so attendance number 5 will...\This is bad... at this rate, he will see me...\I just called on him...\For the time being, I'll get into his blind spot... blind spot...\I'll call on someone new...\Blind -\The chair... the sound of the chair will...! response:	What is that sound? What the -
context: Well, it's May, so attendance number 5 will...\This is bad... at this rate, he will see me...\I just called on him...\For the time being, I'll get into his blind spot... blind spot...\I'll call on someone new...\Blind -\The chair... the sound of the chair will...!\What is that sound? What the - response:	Hey, someone's mobile phone is ringing!
context: This is bad... at this rate, he will see me...\I just called on him...\For the time being, I'll get into his blind spot... blind spot...\I'll call on someone new...\Blind -\The chair... the sound of the chair will...!\What is that sound? What the -\Hey, someone's mobile phone is ringing! response:	It's a ghost ringtone!
context: I just called on him...\For the time being, I'll get into his blind spot... blind spot...\I'll call on someone new...\Blind -\The chair... the sound of the chair will...!\What is that sound? What the -\Hey, someone's mobile phone is ringing!\It's a ghost ringtone! response:	It's the final act.
context: For the time being, I'll get into his blind spot... blind spot...\I'll call on someone new...\Blind -\The chair... the sound of the chair will...!\What is that sound? What the -\Hey, someone's mobile phone is ringing!\It's a ghost ringtone!\It's the final act. response:	You saw it.
context: I'll call on someone new...\Blind -\The chair... the sound of the chair will...!\What is that sound? What the -\Hey, someone's mobile phone is ringing!\It's a ghost ringtone!\It's the final act.\You saw it. response:	And so the smiles of everyone in the class bloomed!
context: Blind -\The chair... the sound of the chair will...!\What is that sound? What the -\Hey, someone's mobile phone is ringing!\It's a ghost ringtone!\It's the final act.\You saw it.\And so the smiles of everyone in the class bloomed! response:	Right?
context: The chair... the sound of the chair will...!\What is that sound? What the -\Hey, someone's mobile phone is ringing!\It's a ghost ringtone!\It's the final act.\You saw it.\And so the smiles of everyone in the class bloomed!\Right? response:	Well then, this question...
context: What is that sound? What the -\Hey, someone's mobile phone is ringing!\It's a ghost ringtone!\It's the final act.\You saw it.\And so the smiles of everyone in the class bloomed!\Right?\Well then, this question... response:	Aioi.
context: Hey, someone's mobile phone is ringing!\It's a ghost ringtone!\It's the final act.\You saw it.\And so the smiles of everyone in the class bloomed!\Right?\Well then, this question...\Aioi. response:	First comes rock, next comes paper, rockscispaper doesn't count,
context: It's a ghost ringtone!\It's the final act.\You saw it.\And so the smiles of everyone in the class bloomed!\Right?\Well then, this question...\Aioi.\First comes rock, next comes paper, rockscispaper doesn't count, response:	rock paper scissors!
context: It's the final act.\You saw it.\And so the smiles of everyone in the class bloomed!\Right?\Well then, this question...\Aioi.\First comes rock, next comes paper, rockscispaper doesn't count,\rock paper scissors! response:	Come forth!
context: You saw it.\And so the smiles of everyone in the class bloomed!\Right?\Well then, this question...\Aioi.\First comes rock, next comes paper, rockscispaper doesn't count,\rock paper scissors!\Come forth! response:	Chubabababa... bang!
context: And so the smiles of everyone in the class bloomed!\Right?\Well then, this question...\Aioi.\First comes rock, next comes paper, rockscispaper doesn't count,\rock paper scissors!\Come forth!\Chubabababa... bang! response:	Hmm... I bought both the sugar and the milk...
context: Right?\Well then, this question...\Aioi.\First comes rock, next comes paper, rockscispaper doesn't count,\rock paper scissors!\Come forth!\Chubabababa... bang!\Hmm... I bought both the sugar and the milk... response:	The eggs were really cheap, right?
context: Well then, this question...\Aioi.\First comes rock, next comes paper, rockscispaper doesn't count,\rock paper scissors!\Come forth!\Chubabababa... bang!\Hmm... I bought both the sugar and the milk...\The eggs were really cheap, right? response:	Yeah, I stocked up on some as well.
context: Aioi.\First comes rock, next comes paper, rockscispaper doesn't count,\rock paper scissors!\Come forth!\Chubabababa... bang!\Hmm... I bought both the sugar and the milk...\The eggs were really cheap, right?\Yeah, I stocked up on some as well. response:	Oh no!
context: First comes rock, next comes paper, rockscispaper doesn't count,\rock paper scissors!\Come forth!\Chubabababa... bang!\Hmm... I bought both the sugar and the milk...\The eggs were really cheap, right?\Yeah, I stocked up on some as well.\Oh no! response:	The eggs are on sale today!
context: rock paper scissors!\Come forth!\Chubabababa... bang!\Hmm... I bought both the sugar and the milk...\The eggs were really cheap, right?\Yeah, I stocked up on some as well.\Oh no!\The eggs are on sale today! response:	What should I do?
context: Come forth!\Chubabababa... bang!\Hmm... I bought both the sugar and the milk...\The eggs were really cheap, right?\Yeah, I stocked up on some as well.\Oh no!\The eggs are on sale today!\What should I do? response:	I can still make it.
context: Chubabababa... bang!\Hmm... I bought both the sugar and the milk...\The eggs were really cheap, right?\Yeah, I stocked up on some as well.\Oh no!\The eggs are on sale today!\What should I do?\I can still make it. response:	I really should go back to the store.
context: Hmm... I bought both the sugar and the milk...\The eggs were really cheap, right?\Yeah, I stocked up on some as well.\Oh no!\The eggs are on sale today!\What should I do?\I can still make it.\I really should go back to the store. response:	It's a black cat!
context: The eggs were really cheap, right?\Yeah, I stocked up on some as well.\Oh no!\The eggs are on sale today!\What should I do?\I can still make it.\I really should go back to the store.\It's a black cat! response:	So... so cute!
context: Yeah, I stocked up on some as well.\Oh no!\The eggs are on sale today!\What should I do?\I can still make it.\I really should go back to the store.\It's a black cat!\So... so cute! response:	Oh... I can't bring you home; the Professor's there.
context: Oh no!\The eggs are on sale today!\What should I do?\I can still make it.\I really should go back to the store.\It's a black cat!\So... so cute!\Oh... I can't bring you home; the Professor's there. response:	I'm sorry.
context: The eggs are on sale today!\What should I do?\I can still make it.\I really should go back to the store.\It's a black cat!\So... so cute!\Oh... I can't bring you home; the Professor's there.\I'm sorry. response:	I have returned.
context: What should I do?\I can still make it.\I really should go back to the store.\It's a black cat!\So... so cute!\Oh... I can't bring you home; the Professor's there.\I'm sorry.\I have returned. response:	That cat!
context: I can still make it.\I really should go back to the store.\It's a black cat!\So... so cute!\Oh... I can't bring you home; the Professor's there.\I'm sorry.\I have returned.\That cat! response:	I caught him!
context: I really should go back to the store.\It's a black cat!\So... so cute!\Oh... I can't bring you home; the Professor's there.\I'm sorry.\I have returned.\That cat!\I caught him! response:	You can't just bring him back like that.
context: It's a black cat!\So... so cute!\Oh... I can't bring you home; the Professor's there.\I'm sorry.\I have returned.\That cat!\I caught him!\You can't just bring him back like that. response:	But he's cute.
context: So... so cute!\Oh... I can't bring you home; the Professor's there.\I'm sorry.\I have returned.\That cat!\I caught him!\You can't just bring him back like that.\But he's cute. response:	Well, that's true...
context: Oh... I can't bring you home; the Professor's there.\I'm sorry.\I have returned.\That cat!\I caught him!\You can't just bring him back like that.\But he's cute.\Well, that's true... response:	I mean, no, that's not the point!
context: I'm sorry.\I have returned.\That cat!\I caught him!\You can't just bring him back like that.\But he's cute.\Well, that's true...\I mean, no, that's not the point! response:	He's not cute?
context: I have returned.\That cat!\I caught him!\You can't just bring him back like that.\But he's cute.\Well, that's true...\I mean, no, that's not the point!\He's not cute? response:	No, he is cute.
context: That cat!\I caught him!\You can't just bring him back like that.\But he's cute.\Well, that's true...\I mean, no, that's not the point!\He's not cute?\No, he is cute. response:	He's cute, but...
context: I caught him!\You can't just bring him back like that.\But he's cute.\Well, that's true...\I mean, no, that's not the point!\He's not cute?\No, he is cute.\He's cute, but... response:	Hmm... If you get an animal, you have to take care of it.
context: You can't just bring him back like that.\But he's cute.\Well, that's true...\I mean, no, that's not the point!\He's not cute?\No, he is cute.\He's cute, but...\Hmm... If you get an animal, you have to take care of it. response:	Can you do that, Professor?
context: But he's cute.\Well, that's true...\I mean, no, that's not the point!\He's not cute?\No, he is cute.\He's cute, but...\Hmm... If you get an animal, you have to take care of it.\Can you do that, Professor? response:	I can!
context: Well, that's true...\I mean, no, that's not the point!\He's not cute?\No, he is cute.\He's cute, but...\Hmm... If you get an animal, you have to take care of it.\Can you do that, Professor?\I can! response:	I won't do anything, okay?
context: I mean, no, that's not the point!\He's not cute?\No, he is cute.\He's cute, but...\Hmm... If you get an animal, you have to take care of it.\Can you do that, Professor?\I can!\I won't do anything, okay? response:	Since you also have to clean the toilet...
context: He's not cute?\No, he is cute.\He's cute, but...\Hmm... If you get an animal, you have to take care of it.\Can you do that, Professor?\I can!\I won't do anything, okay?\Since you also have to clean the toilet... response:	Nano's not going to do anything?
context: No, he is cute.\He's cute, but...\Hmm... If you get an animal, you have to take care of it.\Can you do that, Professor?\I can!\I won't do anything, okay?\Since you also have to clean the toilet...\Nano's not going to do anything? response:	Well, then I won't let you pet him any more.
context: He's cute, but...\Hmm... If you get an animal, you have to take care of it.\Can you do that, Professor?\I can!\I won't do anything, okay?\Since you also have to clean the toilet...\Nano's not going to do anything?\Well, then I won't let you pet him any more. response:	N-Not that!
context: Hmm... If you get an animal, you have to take care of it.\Can you do that, Professor?\I can!\I won't do anything, okay?\Since you also have to clean the toilet...\Nano's not going to do anything?\Well, then I won't let you pet him any more.\N-Not that! response:	You've got it all wrong, it's not like that...
context: Can you do that, Professor?\I can!\I won't do anything, okay?\Since you also have to clean the toilet...\Nano's not going to do anything?\Well, then I won't let you pet him any more.\N-Not that!\You've got it all wrong, it's not like that... response:	Professor, Professor! I saw him, this ca -
context: I can!\I won't do anything, okay?\Since you also have to clean the toilet...\Nano's not going to do anything?\Well, then I won't let you pet him any more.\N-Not that!\You've got it all wrong, it's not like that...\Professor, Professor! I saw him, this ca - response:	I want to touch him!
context: I won't do anything, okay?\Since you also have to clean the toilet...\Nano's not going to do anything?\Well, then I won't let you pet him any more.\N-Not that!\You've got it all wrong, it's not like that...\Professor, Professor! I saw him, this ca -\I want to touch him! response:	It feels so fluffy!
context: Since you also have to clean the toilet...\Nano's not going to do anything?\Well, then I won't let you pet him any more.\N-Not that!\You've got it all wrong, it's not like that...\Professor, Professor! I saw him, this ca -\I want to touch him!\It feels so fluffy! response:	Professor, that's not fair... me too, me too!
context: Nano's not going to do anything?\Well, then I won't let you pet him any more.\N-Not that!\You've got it all wrong, it's not like that...\Professor, Professor! I saw him, this ca -\I want to touch him!\It feels so fluffy!\Professor, that's not fair... me too, me too! response:	His belly is also very fluffy!
context: Well, then I won't let you pet him any more.\N-Not that!\You've got it all wrong, it's not like that...\Professor, Professor! I saw him, this ca -\I want to touch him!\It feels so fluffy!\Professor, that's not fair... me too, me too!\His belly is also very fluffy! response:	His flank is fluffy too!
context: N-Not that!\You've got it all wrong, it's not like that...\Professor, Professor! I saw him, this ca -\I want to touch him!\It feels so fluffy!\Professor, that's not fair... me too, me too!\His belly is also very fluffy!\His flank is fluffy too! response:	His right paw is fluffy too!
context: You've got it all wrong, it's not like that...\Professor, Professor! I saw him, this ca -\I want to touch him!\It feels so fluffy!\Professor, that's not fair... me too, me too!\His belly is also very fluffy!\His flank is fluffy too!\His right paw is fluffy too! response:	His left paw is fluffy too!
context: Professor, Professor! I saw him, this ca -\I want to touch him!\It feels so fluffy!\Professor, that's not fair... me too, me too!\His belly is also very fluffy!\His flank is fluffy too!\His right paw is fluffy too!\His left paw is fluffy too! response:	His tail is fluffier.
context: I want to touch him!\It feels so fluffy!\Professor, that's not fair... me too, me too!\His belly is also very fluffy!\His flank is fluffy too!\His right paw is fluffy too!\His left paw is fluffy too!\His tail is fluffier. response:	The back of his ears is even fluffier than his tail.
context: It feels so fluffy!\Professor, that's not fair... me too, me too!\His belly is also very fluffy!\His flank is fluffy too!\His right paw is fluffy too!\His left paw is fluffy too!\His tail is fluffier.\The back of his ears is even fluffier than his tail. response:	But doesn't it feel better to touch his tail?
context: Professor, that's not fair... me too, me too!\His belly is also very fluffy!\His flank is fluffy too!\His right paw is fluffy too!\His left paw is fluffy too!\His tail is fluffier.\The back of his ears is even fluffier than his tail.\But doesn't it feel better to touch his tail? response:	His tail isn't fluffy!
context: His belly is also very fluffy!\His flank is fluffy too!\His right paw is fluffy too!\His left paw is fluffy too!\His tail is fluffier.\The back of his ears is even fluffier than his tail.\But doesn't it feel better to touch his tail?\His tail isn't fluffy! response:	I wonder what's up with him?
context: His flank is fluffy too!\His right paw is fluffy too!\His left paw is fluffy too!\His tail is fluffier.\The back of his ears is even fluffier than his tail.\But doesn't it feel better to touch his tail?\His tail isn't fluffy!\I wonder what's up with him? response:	I wonder if he's hurt somewhere?
context: His right paw is fluffy too!\His left paw is fluffy too!\His tail is fluffier.\The back of his ears is even fluffier than his tail.\But doesn't it feel better to touch his tail?\His tail isn't fluffy!\I wonder what's up with him?\I wonder if he's hurt somewhere? response:	*Shine!*
context: His left paw is fluffy too!\His tail is fluffier.\The back of his ears is even fluffier than his tail.\But doesn't it feel better to touch his tail?\His tail isn't fluffy!\I wonder what's up with him?\I wonder if he's hurt somewhere?\*Shine!* response:	Hold on a moment.
context: His tail is fluffier.\The back of his ears is even fluffier than his tail.\But doesn't it feel better to touch his tail?\His tail isn't fluffy!\I wonder what's up with him?\I wonder if he's hurt somewhere?\*Shine!*\Hold on a moment. response:	Professor?
context: The back of his ears is even fluffier than his tail.\But doesn't it feel better to touch his tail?\His tail isn't fluffy!\I wonder what's up with him?\I wonder if he's hurt somewhere?\*Shine!*\Hold on a moment.\Professor? response:	Nano, Nano, Nano!
context: But doesn't it feel better to touch his tail?\His tail isn't fluffy!\I wonder what's up with him?\I wonder if he's hurt somewhere?\*Shine!*\Hold on a moment.\Professor?\Nano, Nano, Nano! response:	I made a speech-giving scarf!
context: His tail isn't fluffy!\I wonder what's up with him?\I wonder if he's hurt somewhere?\*Shine!*\Hold on a moment.\Professor?\Nano, Nano, Nano!\I made a speech-giving scarf! response:	Professor, that's amazing! And fast!
context: I wonder what's up with him?\I wonder if he's hurt somewhere?\*Shine!*\Hold on a moment.\Professor?\Nano, Nano, Nano!\I made a speech-giving scarf!\Professor, that's amazing! And fast! response:	Let's quickly try it on, Sakamoto.
context: I wonder if he's hurt somewhere?\*Shine!*\Hold on a moment.\Professor?\Nano, Nano, Nano!\I made a speech-giving scarf!\Professor, that's amazing! And fast!\Let's quickly try it on, Sakamoto. response:	Sakamoto?
context: *Shine!*\Hold on a moment.\Professor?\Nano, Nano, Nano!\I made a speech-giving scarf!\Professor, that's amazing! And fast!\Let's quickly try it on, Sakamoto.\Sakamoto? response:	That cat's name is Sakamoto?
context: Hold on a moment.\Professor?\Nano, Nano, Nano!\I made a speech-giving scarf!\Professor, that's amazing! And fast!\Let's quickly try it on, Sakamoto.\Sakamoto?\That cat's name is Sakamoto? response:	Yep, it's also written on the box.
context: Professor?\Nano, Nano, Nano!\I made a speech-giving scarf!\Professor, that's amazing! And fast!\Let's quickly try it on, Sakamoto.\Sakamoto?\That cat's name is Sakamoto?\Yep, it's also written on the box. response:	That's too simple.
context: Nano, Nano, Nano!\I made a speech-giving scarf!\Professor, that's amazing! And fast!\Let's quickly try it on, Sakamoto.\Sakamoto?\That cat's name is Sakamoto?\Yep, it's also written on the box.\That's too simple. response:	All right, it's done!
context: I made a speech-giving scarf!\Professor, that's amazing! And fast!\Let's quickly try it on, Sakamoto.\Sakamoto?\That cat's name is Sakamoto?\Yep, it's also written on the box.\That's too simple.\All right, it's done! response:	I wonder if he'll talk?
context: Professor, that's amazing! And fast!\Let's quickly try it on, Sakamoto.\Sakamoto?\That cat's name is Sakamoto?\Yep, it's also written on the box.\That's too simple.\All right, it's done!\I wonder if he'll talk? response:	He will.
context: Let's quickly try it on, Sakamoto.\Sakamoto?\That cat's name is Sakamoto?\Yep, it's also written on the box.\That's too simple.\All right, it's done!\I wonder if he'll talk?\He will. response:	I want to hear him!
context: Sakamoto?\That cat's name is Sakamoto?\Yep, it's also written on the box.\That's too simple.\All right, it's done!\I wonder if he'll talk?\He will.\I want to hear him! response:	I want to hear him!
context: That cat's name is Sakamoto?\Yep, it's also written on the box.\That's too simple.\All right, it's done!\I wonder if he'll talk?\He will.\I want to hear him!\I want to hear him! response:	No matter how you think about it,
context: Yep, it's also written on the box.\That's too simple.\All right, it's done!\I wonder if he'll talk?\He will.\I want to hear him!\I want to hear him!\No matter how you think about it, response:	you were petting me way too much before.
context: That's too simple.\All right, it's done!\I wonder if he'll talk?\He will.\I want to hear him!\I want to hear him!\No matter how you think about it,\you were petting me way too much before. response:	In general, when a cat meows, isn't it obvious that they're hungry?
context: All right, it's done!\I wonder if he'll talk?\He will.\I want to hear him!\I want to hear him!\No matter how you think about it,\you were petting me way too much before.\In general, when a cat meows, isn't it obvious that they're hungry? response:	Sorry, we didn't really know...
context: I wonder if he'll talk?\He will.\I want to hear him!\I want to hear him!\No matter how you think about it,\you were petting me way too much before.\In general, when a cat meows, isn't it obvious that they're hungry?\Sorry, we didn't really know... response:	Also, the name.
context: He will.\I want to hear him!\I want to hear him!\No matter how you think about it,\you were petting me way too much before.\In general, when a cat meows, isn't it obvious that they're hungry?\Sorry, we didn't really know...\Also, the name. response:	Calling me Sakamoto just because it's written on the box is too feeble-minded!
context: I want to hear him!\I want to hear him!\No matter how you think about it,\you were petting me way too much before.\In general, when a cat meows, isn't it obvious that they're hungry?\Sorry, we didn't really know...\Also, the name.\Calling me Sakamoto just because it's written on the box is too feeble-minded! response:	Sorry...
context: I want to hear him!\No matter how you think about it,\you were petting me way too much before.\In general, when a cat meows, isn't it obvious that they're hungry?\Sorry, we didn't really know...\Also, the name.\Calling me Sakamoto just because it's written on the box is too feeble-minded!\Sorry... response:	See, I told you so.
context: No matter how you think about it,\you were petting me way too much before.\In general, when a cat meows, isn't it obvious that they're hungry?\Sorry, we didn't really know...\Also, the name.\Calling me Sakamoto just because it's written on the box is too feeble-minded!\Sorry...\See, I told you so. response:	But...
context: you were petting me way too much before.\In general, when a cat meows, isn't it obvious that they're hungry?\Sorry, we didn't really know...\Also, the name.\Calling me Sakamoto just because it's written on the box is too feeble-minded!\Sorry...\See, I told you so.\But... response:	How old are you two?
context: In general, when a cat meows, isn't it obvious that they're hungry?\Sorry, we didn't really know...\Also, the name.\Calling me Sakamoto just because it's written on the box is too feeble-minded!\Sorry...\See, I told you so.\But...\How old are you two? response:	Eight years old.
context: Sorry, we didn't really know...\Also, the name.\Calling me Sakamoto just because it's written on the box is too feeble-minded!\Sorry...\See, I told you so.\But...\How old are you two?\Eight years old. response:	One year old.
context: Also, the name.\Calling me Sakamoto just because it's written on the box is too feeble-minded!\Sorry...\See, I told you so.\But...\How old are you two?\Eight years old.\One year old. response:	I am, in human terms, 20 years old.
context: Calling me Sakamoto just because it's written on the box is too feeble-minded!\Sorry...\See, I told you so.\But...\How old are you two?\Eight years old.\One year old.\I am, in human terms, 20 years old. response:	Sakamoto-san... I guess?
context: Sorry...\See, I told you so.\But...\How old are you two?\Eight years old.\One year old.\I am, in human terms, 20 years old.\Sakamoto-san... I guess? response:	I guess...
context: See, I told you so.\But...\How old are you two?\Eight years old.\One year old.\I am, in human terms, 20 years old.\Sakamoto-san... I guess?\I guess... response:	Well, if I get free food from now on, then I'll be very grateful.
context: But...\How old are you two?\Eight years old.\One year old.\I am, in human terms, 20 years old.\Sakamoto-san... I guess?\I guess...\Well, if I get free food from now on, then I'll be very grateful. response:	Don't ever forget to respect your elders.
context: How old are you two?\Eight years old.\One year old.\I am, in human terms, 20 years old.\Sakamoto-san... I guess?\I guess...\Well, if I get free food from now on, then I'll be very grateful.\Don't ever forget to respect your elders. response:	And while I'm at it, let me also tell you this.
context: Eight years old.\One year old.\I am, in human terms, 20 years old.\Sakamoto-san... I guess?\I guess...\Well, if I get free food from now on, then I'll be very grateful.\Don't ever forget to respect your elders.\And while I'm at it, let me also tell you this. response:	Just because I'm a cat,
context: One year old.\I am, in human terms, 20 years old.\Sakamoto-san... I guess?\I guess...\Well, if I get free food from now on, then I'll be very grateful.\Don't ever forget to respect your elders.\And while I'm at it, let me also tell you this.\Just because I'm a cat, response:	it doesn't mean you guys can just pet me like that.
context: I am, in human terms, 20 years old.\Sakamoto-san... I guess?\I guess...\Well, if I get free food from now on, then I'll be very grateful.\Don't ever forget to respect your elders.\And while I'm at it, let me also tell you this.\Just because I'm a cat,\it doesn't mean you guys can just pet me like that. response:	To put it clearly, I don't hate being petted.
context: Sakamoto-san... I guess?\I guess...\Well, if I get free food from now on, then I'll be very grateful.\Don't ever forget to respect your elders.\And while I'm at it, let me also tell you this.\Just because I'm a cat,\it doesn't mean you guys can just pet me like that.\To put it clearly, I don't hate being petted. response:	But you know, cats have a...
context: I guess...\Well, if I get free food from now on, then I'll be very grateful.\Don't ever forget to respect your elders.\And while I'm at it, let me also tell you this.\Just because I'm a cat,\it doesn't mean you guys can just pet me like that.\To put it clearly, I don't hate being petted.\But you know, cats have a... response:	I'll put him back where we found him.
context: Well, if I get free food from now on, then I'll be very grateful.\Don't ever forget to respect your elders.\And while I'm at it, let me also tell you this.\Just because I'm a cat,\it doesn't mean you guys can just pet me like that.\To put it clearly, I don't hate being petted.\But you know, cats have a...\I'll put him back where we found him. response:	Eh?!
context: Don't ever forget to respect your elders.\And while I'm at it, let me also tell you this.\Just because I'm a cat,\it doesn't mean you guys can just pet me like that.\To put it clearly, I don't hate being petted.\But you know, cats have a...\I'll put him back where we found him.\Eh?! response:	W-Wha...
context: And while I'm at it, let me also tell you this.\Just because I'm a cat,\it doesn't mean you guys can just pet me like that.\To put it clearly, I don't hate being petted.\But you know, cats have a...\I'll put him back where we found him.\Eh?!\W-Wha... response:	Sorry about that.
context: Just because I'm a cat,\it doesn't mean you guys can just pet me like that.\To put it clearly, I don't hate being petted.\But you know, cats have a...\I'll put him back where we found him.\Eh?!\W-Wha...\Sorry about that. response:	Here you go.
context: it doesn't mean you guys can just pet me like that.\To put it clearly, I don't hate being petted.\But you know, cats have a...\I'll put him back where we found him.\Eh?!\W-Wha...\Sorry about that.\Here you go. response:	Are you sure about this?
context: To put it clearly, I don't hate being petted.\But you know, cats have a...\I'll put him back where we found him.\Eh?!\W-Wha...\Sorry about that.\Here you go.\Are you sure about this? response:	I haven't even paid the rent,
context: But you know, cats have a...\I'll put him back where we found him.\Eh?!\W-Wha...\Sorry about that.\Here you go.\Are you sure about this?\I haven't even paid the rent, response:	but you're giving me food.
context: I'll put him back where we found him.\Eh?!\W-Wha...\Sorry about that.\Here you go.\Are you sure about this?\I haven't even paid the rent,\but you're giving me food. response:	It's fine, really.
context: Eh?!\W-Wha...\Sorry about that.\Here you go.\Are you sure about this?\I haven't even paid the rent,\but you're giving me food.\It's fine, really. response:	We should help each other out in tough times.
context: W-Wha...\Sorry about that.\Here you go.\Are you sure about this?\I haven't even paid the rent,\but you're giving me food.\It's fine, really.\We should help each other out in tough times. response:	If there's anything else you need, please tell me.
context: Sorry about that.\Here you go.\Are you sure about this?\I haven't even paid the rent,\but you're giving me food.\It's fine, really.\We should help each other out in tough times.\If there's anything else you need, please tell me. response:	Really?!
context: Here you go.\Are you sure about this?\I haven't even paid the rent,\but you're giving me food.\It's fine, really.\We should help each other out in tough times.\If there's anything else you need, please tell me.\Really?! response:	Well then, could you lend me some money?
context: Are you sure about this?\I haven't even paid the rent,\but you're giving me food.\It's fine, really.\We should help each other out in tough times.\If there's anything else you need, please tell me.\Really?!\Well then, could you lend me some money? response:	Hey, you.
context: I haven't even paid the rent,\but you're giving me food.\It's fine, really.\We should help each other out in tough times.\If there's anything else you need, please tell me.\Really?!\Well then, could you lend me some money?\Hey, you. response:	Just because I've been a little nice to you doesn't mean you can be a Tengu.
context: but you're giving me food.\It's fine, really.\We should help each other out in tough times.\If there's anything else you need, please tell me.\Really?!\Well then, could you lend me some money?\Hey, you.\Just because I've been a little nice to you doesn't mean you can be a Tengu. response:	Sorry.
context: It's fine, really.\We should help each other out in tough times.\If there's anything else you need, please tell me.\Really?!\Well then, could you lend me some money?\Hey, you.\Just because I've been a little nice to you doesn't mean you can be a Tengu.\Sorry. response:	V-Vice Principal!
context: We should help each other out in tough times.\If there's anything else you need, please tell me.\Really?!\Well then, could you lend me some money?\Hey, you.\Just because I've been a little nice to you doesn't mean you can be a Tengu.\Sorry.\V-Vice Principal! response:	This is...
context: If there's anything else you need, please tell me.\Really?!\Well then, could you lend me some money?\Hey, you.\Just because I've been a little nice to you doesn't mean you can be a Tengu.\Sorry.\V-Vice Principal!\This is... response:	What's the misunderstanding, Principal?
context: Really?!\Well then, could you lend me some money?\Hey, you.\Just because I've been a little nice to you doesn't mean you can be a Tengu.\Sorry.\V-Vice Principal!\This is...\What's the misunderstanding, Principal? response:	Open and behold the contents of the torso.
context: Well then, could you lend me some money?\Hey, you.\Just because I've been a little nice to you doesn't mean you can be a Tengu.\Sorry.\V-Vice Principal!\This is...\What's the misunderstanding, Principal?\Open and behold the contents of the torso. response:	If I win, you'll forget about the that from the store in front of the station, okay?
context: Hey, you.\Just because I've been a little nice to you doesn't mean you can be a Tengu.\Sorry.\V-Vice Principal!\This is...\What's the misunderstanding, Principal?\Open and behold the contents of the torso.\If I win, you'll forget about the that from the store in front of the station, okay? response:	Okay?
context: Just because I've been a little nice to you doesn't mean you can be a Tengu.\Sorry.\V-Vice Principal!\This is...\What's the misunderstanding, Principal?\Open and behold the contents of the torso.\If I win, you'll forget about the that from the store in front of the station, okay?\Okay? response:	Okay.
context: Sorry.\V-Vice Principal!\This is...\What's the misunderstanding, Principal?\Open and behold the contents of the torso.\If I win, you'll forget about the that from the store in front of the station, okay?\Okay?\Okay. response:	Yay, she's mine!
context: V-Vice Principal!\This is...\What's the misunderstanding, Principal?\Open and behold the contents of the torso.\If I win, you'll forget about the that from the store in front of the station, okay?\Okay?\Okay.\Yay, she's mine! response:	Match for one juice, ready...
context: This is...\What's the misunderstanding, Principal?\Open and behold the contents of the torso.\If I win, you'll forget about the that from the store in front of the station, okay?\Okay?\Okay.\Yay, she's mine!\Match for one juice, ready... response:	Go!
context: What's the misunderstanding, Principal?\Open and behold the contents of the torso.\If I win, you'll forget about the that from the store in front of the station, okay?\Okay?\Okay.\Yay, she's mine!\Match for one juice, ready...\Go! response:	Mai-chan, that was a little bit of a false start just now.
context: Open and behold the contents of the torso.\If I win, you'll forget about the that from the store in front of the station, okay?\Okay?\Okay.\Yay, she's mine!\Match for one juice, ready...\Go!\Mai-chan, that was a little bit of a false start just now. response:	Right, Mio-chan?
context: If I win, you'll forget about the that from the store in front of the station, okay?\Okay?\Okay.\Yay, she's mine!\Match for one juice, ready...\Go!\Mai-chan, that was a little bit of a false start just now.\Right, Mio-chan? response:	I suppose she did start a little early.
context: Okay?\Okay.\Yay, she's mine!\Match for one juice, ready...\Go!\Mai-chan, that was a little bit of a false start just now.\Right, Mio-chan?\I suppose she did start a little early. response:	Just by a bit.
context: Okay.\Yay, she's mine!\Match for one juice, ready...\Go!\Mai-chan, that was a little bit of a false start just now.\Right, Mio-chan?\I suppose she did start a little early.\Just by a bit. response:	Right, right?
context: Yay, she's mine!\Match for one juice, ready...\Go!\Mai-chan, that was a little bit of a false start just now.\Right, Mio-chan?\I suppose she did start a little early.\Just by a bit.\Right, right? response:	Let's start again.
context: Match for one juice, ready...\Go!\Mai-chan, that was a little bit of a false start just now.\Right, Mio-chan?\I suppose she did start a little early.\Just by a bit.\Right, right?\Let's start again. response:	Okay, let's try this again.
context: Go!\Mai-chan, that was a little bit of a false start just now.\Right, Mio-chan?\I suppose she did start a little early.\Just by a bit.\Right, right?\Let's start again.\Okay, let's try this again. response:	Ready... go!
context: Mai-chan, that was a little bit of a false start just now.\Right, Mio-chan?\I suppose she did start a little early.\Just by a bit.\Right, right?\Let's start again.\Okay, let's try this again.\Ready... go! response:	Mai-chan wins!
context: Right, Mio-chan?\I suppose she did start a little early.\Just by a bit.\Right, right?\Let's start again.\Okay, let's try this again.\Ready... go!\Mai-chan wins! response:	I guess I wasn't prepared.
context: I suppose she did start a little early.\Just by a bit.\Right, right?\Let's start again.\Okay, let's try this again.\Ready... go!\Mai-chan wins!\I guess I wasn't prepared. response:	I underestimated my opponent's strength.
context: Just by a bit.\Right, right?\Let's start again.\Okay, let's try this again.\Ready... go!\Mai-chan wins!\I guess I wasn't prepared.\I underestimated my opponent's strength. response:	With this, I'm warmed up.
context: Right, right?\Let's start again.\Okay, let's try this again.\Ready... go!\Mai-chan wins!\I guess I wasn't prepared.\I underestimated my opponent's strength.\With this, I'm warmed up. response:	All right, one more time!
context: Let's start again.\Okay, let's try this again.\Ready... go!\Mai-chan wins!\I guess I wasn't prepared.\I underestimated my opponent's strength.\With this, I'm warmed up.\All right, one more time! response:	Oh my, my hand sure is weak today.
context: Okay, let's try this again.\Ready... go!\Mai-chan wins!\I guess I wasn't prepared.\I underestimated my opponent's strength.\With this, I'm warmed up.\All right, one more time!\Oh my, my hand sure is weak today. response:	Must be that all-nighter I pulled last night.
context: Ready... go!\Mai-chan wins!\I guess I wasn't prepared.\I underestimated my opponent's strength.\With this, I'm warmed up.\All right, one more time!\Oh my, my hand sure is weak today.\Must be that all-nighter I pulled last night. response:	Anyway, both my body and soul are ready.
context: Mai-chan wins!\I guess I wasn't prepared.\I underestimated my opponent's strength.\With this, I'm warmed up.\All right, one more time!\Oh my, my hand sure is weak today.\Must be that all-nighter I pulled last night.\Anyway, both my body and soul are ready. response:	It's about time for the real show!
context: I guess I wasn't prepared.\I underestimated my opponent's strength.\With this, I'm warmed up.\All right, one more time!\Oh my, my hand sure is weak today.\Must be that all-nighter I pulled last night.\Anyway, both my body and soul are ready.\It's about time for the real show! response:	You ready for it?
context: I underestimated my opponent's strength.\With this, I'm warmed up.\All right, one more time!\Oh my, my hand sure is weak today.\Must be that all-nighter I pulled last night.\Anyway, both my body and soul are ready.\It's about time for the real show!\You ready for it? response:	Oh crap!
context: With this, I'm warmed up.\All right, one more time!\Oh my, my hand sure is weak today.\Must be that all-nighter I pulled last night.\Anyway, both my body and soul are ready.\It's about time for the real show!\You ready for it?\Oh crap! response:	I wasn't paying attention!
context: All right, one more time!\Oh my, my hand sure is weak today.\Must be that all-nighter I pulled last night.\Anyway, both my body and soul are ready.\It's about time for the real show!\You ready for it?\Oh crap!\I wasn't paying attention! response:	However, I was caught unprepared three times in a row.
context: Oh my, my hand sure is weak today.\Must be that all-nighter I pulled last night.\Anyway, both my body and soul are ready.\It's about time for the real show!\You ready for it?\Oh crap!\I wasn't paying attention!\However, I was caught unprepared three times in a row. response:	This is surprising. Surprising.
context: Must be that all-nighter I pulled last night.\Anyway, both my body and soul are ready.\It's about time for the real show!\You ready for it?\Oh crap!\I wasn't paying attention!\However, I was caught unprepared three times in a row.\This is surprising. Surprising. response:	Yukko, isn't it about time -
context: Anyway, both my body and soul are ready.\It's about time for the real show!\You ready for it?\Oh crap!\I wasn't paying attention!\However, I was caught unprepared three times in a row.\This is surprising. Surprising.\Yukko, isn't it about time - response:	Wait.
context: It's about time for the real show!\You ready for it?\Oh crap!\I wasn't paying attention!\However, I was caught unprepared three times in a row.\This is surprising. Surprising.\Yukko, isn't it about time -\Wait. response:	Just wait a second.
context: You ready for it?\Oh crap!\I wasn't paying attention!\However, I was caught unprepared three times in a row.\This is surprising. Surprising.\Yukko, isn't it about time -\Wait.\Just wait a second. response:	Huh, huh.
context: Oh crap!\I wasn't paying attention!\However, I was caught unprepared three times in a row.\This is surprising. Surprising.\Yukko, isn't it about time -\Wait.\Just wait a second.\Huh, huh. response:	Yes, yes.
context: I wasn't paying attention!\However, I was caught unprepared three times in a row.\This is surprising. Surprising.\Yukko, isn't it about time -\Wait.\Just wait a second.\Huh, huh.\Yes, yes. response:	I see, I see.
context: However, I was caught unprepared three times in a row.\This is surprising. Surprising.\Yukko, isn't it about time -\Wait.\Just wait a second.\Huh, huh.\Yes, yes.\I see, I see. response:	Ah.
context: This is surprising. Surprising.\Yukko, isn't it about time -\Wait.\Just wait a second.\Huh, huh.\Yes, yes.\I see, I see.\Ah. response:	I can see it.
context: Yukko, isn't it about time -\Wait.\Just wait a second.\Huh, huh.\Yes, yes.\I see, I see.\Ah.\I can see it. response:	Beginner's luck can only take you so far, Mai-chan.
context: Wait.\Just wait a second.\Huh, huh.\Yes, yes.\I see, I see.\Ah.\I can see it.\Beginner's luck can only take you so far, Mai-chan. response:	And here I come.
context: Just wait a second.\Huh, huh.\Yes, yes.\I see, I see.\Ah.\I can see it.\Beginner's luck can only take you so far, Mai-chan.\And here I come. response:	Ready...
context: Huh, huh.\Yes, yes.\I see, I see.\Ah.\I can see it.\Beginner's luck can only take you so far, Mai-chan.\And here I come.\Ready... response:	Chest!
context: Yes, yes.\I see, I see.\Ah.\I can see it.\Beginner's luck can only take you so far, Mai-chan.\And here I come.\Ready...\Chest! response:	However, isn't this quite fun?
context: I see, I see.\Ah.\I can see it.\Beginner's luck can only take you so far, Mai-chan.\And here I come.\Ready...\Chest!\However, isn't this quite fun? response:	This... what is it again...
context: Ah.\I can see it.\Beginner's luck can only take you so far, Mai-chan.\And here I come.\Ready...\Chest!\However, isn't this quite fun?\This... what is it again... response:	Yukko...
context: I can see it.\Beginner's luck can only take you so far, Mai-chan.\And here I come.\Ready...\Chest!\However, isn't this quite fun?\This... what is it again...\Yukko... response:	You called it arm wrestling?
context: Beginner's luck can only take you so far, Mai-chan.\And here I come.\Ready...\Chest!\However, isn't this quite fun?\This... what is it again...\Yukko...\You called it arm wrestling? response:	Mio-chan, here.
context: And here I come.\Ready...\Chest!\However, isn't this quite fun?\This... what is it again...\Yukko...\You called it arm wrestling?\Mio-chan, here. response:	Can you hold onto this for the time being?
context: Ready...\Chest!\However, isn't this quite fun?\This... what is it again...\Yukko...\You called it arm wrestling?\Mio-chan, here.\Can you hold onto this for the time being? response:	It's been a while since I've been able to get serious.
context: Chest!\However, isn't this quite fun?\This... what is it again...\Yukko...\You called it arm wrestling?\Mio-chan, here.\Can you hold onto this for the time being?\It's been a while since I've been able to get serious. response:	Give me a break!
context: However, isn't this quite fun?\This... what is it again...\Yukko...\You called it arm wrestling?\Mio-chan, here.\Can you hold onto this for the time being?\It's been a while since I've been able to get serious.\Give me a break! response:	If you don't do it seriously, I can't either, okay?
context: This... what is it again...\Yukko...\You called it arm wrestling?\Mio-chan, here.\Can you hold onto this for the time being?\It's been a while since I've been able to get serious.\Give me a break!\If you don't do it seriously, I can't either, okay? response:	Listen, next time we do it for real!
context: Yukko...\You called it arm wrestling?\Mio-chan, here.\Can you hold onto this for the time being?\It's been a while since I've been able to get serious.\Give me a break!\If you don't do it seriously, I can't either, okay?\Listen, next time we do it for real! response:	I'll bring out my killer move too!
context: You called it arm wrestling?\Mio-chan, here.\Can you hold onto this for the time being?\It's been a while since I've been able to get serious.\Give me a break!\If you don't do it seriously, I can't either, okay?\Listen, next time we do it for real!\I'll bring out my killer move too! response:	Earth Dangerous!
context: Mio-chan, here.\Can you hold onto this for the time being?\It's been a while since I've been able to get serious.\Give me a break!\If you don't do it seriously, I can't either, okay?\Listen, next time we do it for real!\I'll bring out my killer move too!\Earth Dangerous! response:	Shooting Snake!
context: Can you hold onto this for the time being?\It's been a while since I've been able to get serious.\Give me a break!\If you don't do it seriously, I can't either, okay?\Listen, next time we do it for real!\I'll bring out my killer move too!\Earth Dangerous!\Shooting Snake! response:	Death...!
context: It's been a while since I've been able to get serious.\Give me a break!\If you don't do it seriously, I can't either, okay?\Listen, next time we do it for real!\I'll bring out my killer move too!\Earth Dangerous!\Shooting Snake!\Death...! response:	Death...!
context: Give me a break!\If you don't do it seriously, I can't either, okay?\Listen, next time we do it for real!\I'll bring out my killer move too!\Earth Dangerous!\Shooting Snake!\Death...!\Death...! response:	Dea -
context: If you don't do it seriously, I can't either, okay?\Listen, next time we do it for real!\I'll bring out my killer move too!\Earth Dangerous!\Shooting Snake!\Death...!\Death...!\Dea - response:	What?
context: Listen, next time we do it for real!\I'll bring out my killer move too!\Earth Dangerous!\Shooting Snake!\Death...!\Death...!\Dea -\What? response:	What is this?
context: I'll bring out my killer move too!\Earth Dangerous!\Shooting Snake!\Death...!\Death...!\Dea -\What?\What is this? response:	I don't get it at all!
context: Earth Dangerous!\Shooting Snake!\Death...!\Death...!\Dea -\What?\What is this?\I don't get it at all! response:	It's only arm wrestling... Why were you so passionate about it?
context: Shooting Snake!\Death...!\Death...!\Dea -\What?\What is this?\I don't get it at all!\It's only arm wrestling... Why were you so passionate about it? response:	Or rather, I forgot that I needed to use the toilet.
context: Death...!\Death...!\Dea -\What?\What is this?\I don't get it at all!\It's only arm wrestling... Why were you so passionate about it?\Or rather, I forgot that I needed to use the toilet. response:	I'm going there for a bit.
context: Death...!\Dea -\What?\What is this?\I don't get it at all!\It's only arm wrestling... Why were you so passionate about it?\Or rather, I forgot that I needed to use the toilet.\I'm going there for a bit. response:	I thought the outcome was a bit weird...
context: Dea -\What?\What is this?\I don't get it at all!\It's only arm wrestling... Why were you so passionate about it?\Or rather, I forgot that I needed to use the toilet.\I'm going there for a bit.\I thought the outcome was a bit weird... response:	Yukko.
context: What?\What is this?\I don't get it at all!\It's only arm wrestling... Why were you so passionate about it?\Or rather, I forgot that I needed to use the toilet.\I'm going there for a bit.\I thought the outcome was a bit weird...\Yukko. response:	That from the store in front of the station...
context: What is this?\I don't get it at all!\It's only arm wrestling... Why were you so passionate about it?\Or rather, I forgot that I needed to use the toilet.\I'm going there for a bit.\I thought the outcome was a bit weird...\Yukko.\That from the store in front of the station... response:	Aw man...
context: I don't get it at all!\It's only arm wrestling... Why were you so passionate about it?\Or rather, I forgot that I needed to use the toilet.\I'm going there for a bit.\I thought the outcome was a bit weird...\Yukko.\That from the store in front of the station...\Aw man... response:	My arm was sore, so I didn't do my homework and got told off.
context: It's only arm wrestling... Why were you so passionate about it?\Or rather, I forgot that I needed to use the toilet.\I'm going there for a bit.\I thought the outcome was a bit weird...\Yukko.\That from the store in front of the station...\Aw man...\My arm was sore, so I didn't do my homework and got told off. response:	This is the worst.
context: Or rather, I forgot that I needed to use the toilet.\I'm going there for a bit.\I thought the outcome was a bit weird...\Yukko.\That from the store in front of the station...\Aw man...\My arm was sore, so I didn't do my homework and got told off.\This is the worst. response:	Even so, Mai-chan... what happened to Masao in the end?!
context: I'm going there for a bit.\I thought the outcome was a bit weird...\Yukko.\That from the store in front of the station...\Aw man...\My arm was sore, so I didn't do my homework and got told off.\This is the worst.\Even so, Mai-chan... what happened to Masao in the end?! response:	What happened?
context: I thought the outcome was a bit weird...\Yukko.\That from the store in front of the station...\Aw man...\My arm was sore, so I didn't do my homework and got told off.\This is the worst.\Even so, Mai-chan... what happened to Masao in the end?!\What happened? response:	Okay, I get it.
context: Yukko.\That from the store in front of the station...\Aw man...\My arm was sore, so I didn't do my homework and got told off.\This is the worst.\Even so, Mai-chan... what happened to Masao in the end?!\What happened?\Okay, I get it. response:	I'll treat you to one more juice.
context: That from the store in front of the station...\Aw man...\My arm was sore, so I didn't do my homework and got told off.\This is the worst.\Even so, Mai-chan... what happened to Masao in the end?!\What happened?\Okay, I get it.\I'll treat you to one more juice. response:	Here.
context: Aw man...\My arm was sore, so I didn't do my homework and got told off.\This is the worst.\Even so, Mai-chan... what happened to Masao in the end?!\What happened?\Okay, I get it.\I'll treat you to one more juice.\Here. response:	I don't get it.
context: My arm was sore, so I didn't do my homework and got told off.\This is the worst.\Even so, Mai-chan... what happened to Masao in the end?!\What happened?\Okay, I get it.\I'll treat you to one more juice.\Here.\I don't get it. response:	Don't you just want to make some kind of joke?
context: This is the worst.\Even so, Mai-chan... what happened to Masao in the end?!\What happened?\Okay, I get it.\I'll treat you to one more juice.\Here.\I don't get it.\Don't you just want to make some kind of joke? response:	What the hell is with the Kinase?!
context: Even so, Mai-chan... what happened to Masao in the end?!\What happened?\Okay, I get it.\I'll treat you to one more juice.\Here.\I don't get it.\Don't you just want to make some kind of joke?\What the hell is with the Kinase?! response:	Some kind of serenade?
context: What happened?\Okay, I get it.\I'll treat you to one more juice.\Here.\I don't get it.\Don't you just want to make some kind of joke?\What the hell is with the Kinase?!\Some kind of serenade? response:	Well then, the next Nichijou is the fourth one.
context: Okay, I get it.\I'll treat you to one more juice.\Here.\I don't get it.\Don't you just want to make some kind of joke?\What the hell is with the Kinase?!\Some kind of serenade?\Well then, the next Nichijou is the fourth one. response:	Look forward to it!