context: Who was it? response:	Who shot him?
context: Who was it?\Who shot him? response:	Stop Kikuhara...
context: Who was it?\Who shot him?\Stop Kikuhara... response:	Stop...
context: Who was it?\Who shot him?\Stop Kikuhara...\Stop... response:	It was a silent night
context: Who was it?\Who shot him?\Stop Kikuhara...\Stop...\It was a silent night response:	Eclipse was beginnin'
context: Who was it?\Who shot him?\Stop Kikuhara...\Stop...\It was a silent night\Eclipse was beginnin' response:	Kasaneau setsuna o
context: Who was it?\Who shot him?\Stop Kikuhara...\Stop...\It was a silent night\Eclipse was beginnin'\Kasaneau setsuna o response:	Kitto eien to shinjikomu
context: Who was it?\Who shot him?\Stop Kikuhara...\Stop...\It was a silent night\Eclipse was beginnin'\Kasaneau setsuna o\Kitto eien to shinjikomu response:	In darkness...
context: Who shot him?\Stop Kikuhara...\Stop...\It was a silent night\Eclipse was beginnin'\Kasaneau setsuna o\Kitto eien to shinjikomu\In darkness... response:	It's darker than black
context: Stop Kikuhara...\Stop...\It was a silent night\Eclipse was beginnin'\Kasaneau setsuna o\Kitto eien to shinjikomu\In darkness...\It's darker than black response:	Meikyuu no sora
context: Stop...\It was a silent night\Eclipse was beginnin'\Kasaneau setsuna o\Kitto eien to shinjikomu\In darkness...\It's darker than black\Meikyuu no sora response:	Hikari o kou
context: It was a silent night\Eclipse was beginnin'\Kasaneau setsuna o\Kitto eien to shinjikomu\In darkness...\It's darker than black\Meikyuu no sora\Hikari o kou response:	If bite your soul
context: Eclipse was beginnin'\Kasaneau setsuna o\Kitto eien to shinjikomu\In darkness...\It's darker than black\Meikyuu no sora\Hikari o kou\If bite your soul response:	Shoudou ga mushibande yuku
context: Kasaneau setsuna o\Kitto eien to shinjikomu\In darkness...\It's darker than black\Meikyuu no sora\Hikari o kou\If bite your soul\Shoudou ga mushibande yuku response:	Can I... Can I... Can I... Who am I...?
context: Kitto eien to shinjikomu\In darkness...\It's darker than black\Meikyuu no sora\Hikari o kou\If bite your soul\Shoudou ga mushibande yuku\Can I... Can I... Can I... Who am I...? response:	Risei o kakikesu libido
context: In darkness...\It's darker than black\Meikyuu no sora\Hikari o kou\If bite your soul\Shoudou ga mushibande yuku\Can I... Can I... Can I... Who am I...?\Risei o kakikesu libido response:	(Where is my heart?)
context: It's darker than black\Meikyuu no sora\Hikari o kou\If bite your soul\Shoudou ga mushibande yuku\Can I... Can I... Can I... Who am I...?\Risei o kakikesu libido\(Where is my heart?) response:	Kurayami ni
context: Meikyuu no sora\Hikari o kou\If bite your soul\Shoudou ga mushibande yuku\Can I... Can I... Can I... Who am I...?\Risei o kakikesu libido\(Where is my heart?)\Kurayami ni response:	(Where is my heart?)
context: Hikari o kou\If bite your soul\Shoudou ga mushibande yuku\Can I... Can I... Can I... Who am I...?\Risei o kakikesu libido\(Where is my heart?)\Kurayami ni\(Where is my heart?) response:	Ochikitta
context: If bite your soul\Shoudou ga mushibande yuku\Can I... Can I... Can I... Who am I...?\Risei o kakikesu libido\(Where is my heart?)\Kurayami ni\(Where is my heart?)\Ochikitta response:	(Where is my heart?)
context: Shoudou ga mushibande yuku\Can I... Can I... Can I... Who am I...?\Risei o kakikesu libido\(Where is my heart?)\Kurayami ni\(Where is my heart?)\Ochikitta\(Where is my heart?) response:	Minikui sugata ni natte
context: Can I... Can I... Can I... Who am I...?\Risei o kakikesu libido\(Where is my heart?)\Kurayami ni\(Where is my heart?)\Ochikitta\(Where is my heart?)\Minikui sugata ni natte response:	Hito no namida kareta nara
context: Risei o kakikesu libido\(Where is my heart?)\Kurayami ni\(Where is my heart?)\Ochikitta\(Where is my heart?)\Minikui sugata ni natte\Hito no namida kareta nara response:	Kimi wa boku o dou omou no ka?
context: (Where is my heart?)\Kurayami ni\(Where is my heart?)\Ochikitta\(Where is my heart?)\Minikui sugata ni natte\Hito no namida kareta nara\Kimi wa boku o dou omou no ka? response:	Kotae o oshiete
context: Kurayami ni\(Where is my heart?)\Ochikitta\(Where is my heart?)\Minikui sugata ni natte\Hito no namida kareta nara\Kimi wa boku o dou omou no ka?\Kotae o oshiete response:	Makka na chi ga
context: (Where is my heart?)\Ochikitta\(Where is my heart?)\Minikui sugata ni natte\Hito no namida kareta nara\Kimi wa boku o dou omou no ka?\Kotae o oshiete\Makka na chi ga response:	(Bloody bonds) Makka na chi ga
context: Ochikitta\(Where is my heart?)\Minikui sugata ni natte\Hito no namida kareta nara\Kimi wa boku o dou omou no ka?\Kotae o oshiete\Makka na chi ga\(Bloody bonds) Makka na chi ga response:	Kizuna o nurashiai
context: (Where is my heart?)\Minikui sugata ni natte\Hito no namida kareta nara\Kimi wa boku o dou omou no ka?\Kotae o oshiete\Makka na chi ga\(Bloody bonds) Makka na chi ga\Kizuna o nurashiai response:	Yowasa o wakeatte
context: Minikui sugata ni natte\Hito no namida kareta nara\Kimi wa boku o dou omou no ka?\Kotae o oshiete\Makka na chi ga\(Bloody bonds) Makka na chi ga\Kizuna o nurashiai\Yowasa o wakeatte response:	(Bloody bonds) Yowasa o wakeatte
context: Hito no namida kareta nara\Kimi wa boku o dou omou no ka?\Kotae o oshiete\Makka na chi ga\(Bloody bonds) Makka na chi ga\Kizuna o nurashiai\Yowasa o wakeatte\(Bloody bonds) Yowasa o wakeatte response:	Futari wa ikite yuku no ka?
context: Kimi wa boku o dou omou no ka?\Kotae o oshiete\Makka na chi ga\(Bloody bonds) Makka na chi ga\Kizuna o nurashiai\Yowasa o wakeatte\(Bloody bonds) Yowasa o wakeatte\Futari wa ikite yuku no ka? response:	Kizu o nameatte
context: Kotae o oshiete\Makka na chi ga\(Bloody bonds) Makka na chi ga\Kizuna o nurashiai\Yowasa o wakeatte\(Bloody bonds) Yowasa o wakeatte\Futari wa ikite yuku no ka?\Kizu o nameatte response:	Sei o teigi shiatte
context: Makka na chi ga\(Bloody bonds) Makka na chi ga\Kizuna o nurashiai\Yowasa o wakeatte\(Bloody bonds) Yowasa o wakeatte\Futari wa ikite yuku no ka?\Kizu o nameatte\Sei o teigi shiatte response:	Ai o musabotte
context: (Bloody bonds) Makka na chi ga\Kizuna o nurashiai\Yowasa o wakeatte\(Bloody bonds) Yowasa o wakeatte\Futari wa ikite yuku no ka?\Kizu o nameatte\Sei o teigi shiatte\Ai o musabotte response:	DEVILS' LINE
context: Kizuna o nurashiai\Yowasa o wakeatte\(Bloody bonds) Yowasa o wakeatte\Futari wa ikite yuku no ka?\Kizu o nameatte\Sei o teigi shiatte\Ai o musabotte\DEVILS' LINE response:	Stop Kikuhara...
context: Yowasa o wakeatte\(Bloody bonds) Yowasa o wakeatte\Futari wa ikite yuku no ka?\Kizu o nameatte\Sei o teigi shiatte\Ai o musabotte\DEVILS' LINE\Stop Kikuhara... response:	You can't shoot me.
context: (Bloody bonds) Yowasa o wakeatte\Futari wa ikite yuku no ka?\Kizu o nameatte\Sei o teigi shiatte\Ai o musabotte\DEVILS' LINE\Stop Kikuhara...\You can't shoot me. response:	Can you get to the roof?
context: Futari wa ikite yuku no ka?\Kizu o nameatte\Sei o teigi shiatte\Ai o musabotte\DEVILS' LINE\Stop Kikuhara...\You can't shoot me.\Can you get to the roof? response:	I'll have to do it in one jump!
context: Kizu o nameatte\Sei o teigi shiatte\Ai o musabotte\DEVILS' LINE\Stop Kikuhara...\You can't shoot me.\Can you get to the roof?\I'll have to do it in one jump! response:	People are gonna see us, so they might shoot.
context: Sei o teigi shiatte\Ai o musabotte\DEVILS' LINE\Stop Kikuhara...\You can't shoot me.\Can you get to the roof?\I'll have to do it in one jump!\People are gonna see us, so they might shoot. response:	Hang on tight!
context: Ai o musabotte\DEVILS' LINE\Stop Kikuhara...\You can't shoot me.\Can you get to the roof?\I'll have to do it in one jump!\People are gonna see us, so they might shoot.\Hang on tight! response:	Something's coming from the north! Up on the roof!
context: DEVILS' LINE\Stop Kikuhara...\You can't shoot me.\Can you get to the roof?\I'll have to do it in one jump!\People are gonna see us, so they might shoot.\Hang on tight!\Something's coming from the north! Up on the roof! response:	You idiot! What are you doing...
context: Stop Kikuhara...\You can't shoot me.\Can you get to the roof?\I'll have to do it in one jump!\People are gonna see us, so they might shoot.\Hang on tight!\Something's coming from the north! Up on the roof!\You idiot! What are you doing... response:	Sorry!
context: You can't shoot me.\Can you get to the roof?\I'll have to do it in one jump!\People are gonna see us, so they might shoot.\Hang on tight!\Something's coming from the north! Up on the roof!\You idiot! What are you doing...\Sorry! response:	I'm fine.
context: Can you get to the roof?\I'll have to do it in one jump!\People are gonna see us, so they might shoot.\Hang on tight!\Something's coming from the north! Up on the roof!\You idiot! What are you doing...\Sorry!\I'm fine. response:	Don't try to resist.
context: I'll have to do it in one jump!\People are gonna see us, so they might shoot.\Hang on tight!\Something's coming from the north! Up on the roof!\You idiot! What are you doing...\Sorry!\I'm fine.\Don't try to resist. response:	Throw down your weapons and surrender!
context: People are gonna see us, so they might shoot.\Hang on tight!\Something's coming from the north! Up on the roof!\You idiot! What are you doing...\Sorry!\I'm fine.\Don't try to resist.\Throw down your weapons and surrender! response:	Can you hear me?
context: Hang on tight!\Something's coming from the north! Up on the roof!\You idiot! What are you doing...\Sorry!\I'm fine.\Don't try to resist.\Throw down your weapons and surrender!\Can you hear me? response:	What are you doing? Hurry and throw down...
context: Something's coming from the north! Up on the roof!\You idiot! What are you doing...\Sorry!\I'm fine.\Don't try to resist.\Throw down your weapons and surrender!\Can you hear me?\What are you doing? Hurry and throw down... response:	Taira and Lee are on the roof? What are you doing? Hurry and throw down...
context: You idiot! What are you doing...\Sorry!\I'm fine.\Don't try to resist.\Throw down your weapons and surrender!\Can you hear me?\What are you doing? Hurry and throw down...\Taira and Lee are on the roof? What are you doing? Hurry and throw down... response:	Taira and Lee are on the roof?
context: Sorry!\I'm fine.\Don't try to resist.\Throw down your weapons and surrender!\Can you hear me?\What are you doing? Hurry and throw down...\Taira and Lee are on the roof? What are you doing? Hurry and throw down...\Taira and Lee are on the roof? response:	What? What are they doing there?
context: I'm fine.\Don't try to resist.\Throw down your weapons and surrender!\Can you hear me?\What are you doing? Hurry and throw down...\Taira and Lee are on the roof? What are you doing? Hurry and throw down...\Taira and Lee are on the roof?\What? What are they doing there? response:	She wouldn't...!
context: Don't try to resist.\Throw down your weapons and surrender!\Can you hear me?\What are you doing? Hurry and throw down...\Taira and Lee are on the roof? What are you doing? Hurry and throw down...\Taira and Lee are on the roof?\What? What are they doing there?\She wouldn't...! response:	Don't move! I'll shoot!
context: Throw down your weapons and surrender!\Can you hear me?\What are you doing? Hurry and throw down...\Taira and Lee are on the roof? What are you doing? Hurry and throw down...\Taira and Lee are on the roof?\What? What are they doing there?\She wouldn't...!\Don't move! I'll shoot! response:	To the roof!
context: Can you hear me?\What are you doing? Hurry and throw down...\Taira and Lee are on the roof? What are you doing? Hurry and throw down...\Taira and Lee are on the roof?\What? What are they doing there?\She wouldn't...!\Don't move! I'll shoot!\To the roof! response:	Stay off the roof.
context: What are you doing? Hurry and throw down...\Taira and Lee are on the roof? What are you doing? Hurry and throw down...\Taira and Lee are on the roof?\What? What are they doing there?\She wouldn't...!\Don't move! I'll shoot!\To the roof!\Stay off the roof. response:	You'll get in the way.
context: Taira and Lee are on the roof? What are you doing? Hurry and throw down...\Taira and Lee are on the roof?\What? What are they doing there?\She wouldn't...!\Don't move! I'll shoot!\To the roof!\Stay off the roof.\You'll get in the way. response:	Tsukasa? Why...
context: Taira and Lee are on the roof?\What? What are they doing there?\She wouldn't...!\Don't move! I'll shoot!\To the roof!\Stay off the roof.\You'll get in the way.\Tsukasa? Why... response:	Stay away.
context: What? What are they doing there?\She wouldn't...!\Don't move! I'll shoot!\To the roof!\Stay off the roof.\You'll get in the way.\Tsukasa? Why...\Stay away. response:	Too... dangerous.
context: She wouldn't...!\Don't move! I'll shoot!\To the roof!\Stay off the roof.\You'll get in the way.\Tsukasa? Why...\Stay away.\Too... dangerous. response:	Stay... away...
context: Don't move! I'll shoot!\To the roof!\Stay off the roof.\You'll get in the way.\Tsukasa? Why...\Stay away.\Too... dangerous.\Stay... away... response:	Anzai!
context: To the roof!\Stay off the roof.\You'll get in the way.\Tsukasa? Why...\Stay away.\Too... dangerous.\Stay... away...\Anzai! response:	Can you hear me? Anzai!
context: Stay off the roof.\You'll get in the way.\Tsukasa? Why...\Stay away.\Too... dangerous.\Stay... away...\Anzai!\Can you hear me? Anzai! response:	A sedative?
context: You'll get in the way.\Tsukasa? Why...\Stay away.\Too... dangerous.\Stay... away...\Anzai!\Can you hear me? Anzai!\A sedative? response:	Lee!
context: Tsukasa? Why...\Stay away.\Too... dangerous.\Stay... away...\Anzai!\Can you hear me? Anzai!\A sedative?\Lee! response:	How many cc's of blood will it take to heal him?
context: Stay away.\Too... dangerous.\Stay... away...\Anzai!\Can you hear me? Anzai!\A sedative?\Lee!\How many cc's of blood will it take to heal him? response:	For just the wound and blood loss, 200cc.
context: Too... dangerous.\Stay... away...\Anzai!\Can you hear me? Anzai!\A sedative?\Lee!\How many cc's of blood will it take to heal him?\For just the wound and blood loss, 200cc. response:	But right now, he's gonna need 400cc.
context: Stay... away...\Anzai!\Can you hear me? Anzai!\A sedative?\Lee!\How many cc's of blood will it take to heal him?\For just the wound and blood loss, 200cc.\But right now, he's gonna need 400cc. response:	Four hundred?
context: Anzai!\Can you hear me? Anzai!\A sedative?\Lee!\How many cc's of blood will it take to heal him?\For just the wound and blood loss, 200cc.\But right now, he's gonna need 400cc.\Four hundred? response:	If he used that sedative before he got shot, he'll have a hard time transforming.
context: Can you hear me? Anzai!\A sedative?\Lee!\How many cc's of blood will it take to heal him?\For just the wound and blood loss, 200cc.\But right now, he's gonna need 400cc.\Four hundred?\If he used that sedative before he got shot, he'll have a hard time transforming. response:	It'll take twice as much blood as normal.
context: A sedative?\Lee!\How many cc's of blood will it take to heal him?\For just the wound and blood loss, 200cc.\But right now, he's gonna need 400cc.\Four hundred?\If he used that sedative before he got shot, he'll have a hard time transforming.\It'll take twice as much blood as normal. response:	But in the event that a devil ignores the deployment ban,
context: Lee!\How many cc's of blood will it take to heal him?\For just the wound and blood loss, 200cc.\But right now, he's gonna need 400cc.\Four hundred?\If he used that sedative before he got shot, he'll have a hard time transforming.\It'll take twice as much blood as normal.\But in the event that a devil ignores the deployment ban, response:	if they transform and engage in violence, cause injury, or drink blood,
context: How many cc's of blood will it take to heal him?\For just the wound and blood loss, 200cc.\But right now, he's gonna need 400cc.\Four hundred?\If he used that sedative before he got shot, he'll have a hard time transforming.\It'll take twice as much blood as normal.\But in the event that a devil ignores the deployment ban,\if they transform and engage in violence, cause injury, or drink blood, response:	they will be immediately relieved of duty, regardless of their reasons.
context: For just the wound and blood loss, 200cc.\But right now, he's gonna need 400cc.\Four hundred?\If he used that sedative before he got shot, he'll have a hard time transforming.\It'll take twice as much blood as normal.\But in the event that a devil ignores the deployment ban,\if they transform and engage in violence, cause injury, or drink blood,\they will be immediately relieved of duty, regardless of their reasons. response:	They will thenceforth be placed under strict surveillance
context: But right now, he's gonna need 400cc.\Four hundred?\If he used that sedative before he got shot, he'll have a hard time transforming.\It'll take twice as much blood as normal.\But in the event that a devil ignores the deployment ban,\if they transform and engage in violence, cause injury, or drink blood,\they will be immediately relieved of duty, regardless of their reasons.\They will thenceforth be placed under strict surveillance response:	and forbidden to make contact with humans for the foreseeable future.
context: Four hundred?\If he used that sedative before he got shot, he'll have a hard time transforming.\It'll take twice as much blood as normal.\But in the event that a devil ignores the deployment ban,\if they transform and engage in violence, cause injury, or drink blood,\they will be immediately relieved of duty, regardless of their reasons.\They will thenceforth be placed under strict surveillance\and forbidden to make contact with humans for the foreseeable future. response:	Thank you.
context: If he used that sedative before he got shot, he'll have a hard time transforming.\It'll take twice as much blood as normal.\But in the event that a devil ignores the deployment ban,\if they transform and engage in violence, cause injury, or drink blood,\they will be immediately relieved of duty, regardless of their reasons.\They will thenceforth be placed under strict surveillance\and forbidden to make contact with humans for the foreseeable future.\Thank you. response:	400cc is too much for someone your size, Taira.
context: It'll take twice as much blood as normal.\But in the event that a devil ignores the deployment ban,\if they transform and engage in violence, cause injury, or drink blood,\they will be immediately relieved of duty, regardless of their reasons.\They will thenceforth be placed under strict surveillance\and forbidden to make contact with humans for the foreseeable future.\Thank you.\400cc is too much for someone your size, Taira. response:	I'll give him blood, too.
context: But in the event that a devil ignores the deployment ban,\if they transform and engage in violence, cause injury, or drink blood,\they will be immediately relieved of duty, regardless of their reasons.\They will thenceforth be placed under strict surveillance\and forbidden to make contact with humans for the foreseeable future.\Thank you.\400cc is too much for someone your size, Taira.\I'll give him blood, too. response:	Who are you talking to? Drop your weapon right now!
context: if they transform and engage in violence, cause injury, or drink blood,\they will be immediately relieved of duty, regardless of their reasons.\They will thenceforth be placed under strict surveillance\and forbidden to make contact with humans for the foreseeable future.\Thank you.\400cc is too much for someone your size, Taira.\I'll give him blood, too.\Who are you talking to? Drop your weapon right now! response:	You keep the riot police busy.
context: they will be immediately relieved of duty, regardless of their reasons.\They will thenceforth be placed under strict surveillance\and forbidden to make contact with humans for the foreseeable future.\Thank you.\400cc is too much for someone your size, Taira.\I'll give him blood, too.\Who are you talking to? Drop your weapon right now!\You keep the riot police busy. response:	I'm going to close Anzai's wound.
context: They will thenceforth be placed under strict surveillance\and forbidden to make contact with humans for the foreseeable future.\Thank you.\400cc is too much for someone your size, Taira.\I'll give him blood, too.\Who are you talking to? Drop your weapon right now!\You keep the riot police busy.\I'm going to close Anzai's wound. response:	The truth is... I want to let you drink my blood, too.
context: and forbidden to make contact with humans for the foreseeable future.\Thank you.\400cc is too much for someone your size, Taira.\I'll give him blood, too.\Who are you talking to? Drop your weapon right now!\You keep the riot police busy.\I'm going to close Anzai's wound.\The truth is... I want to let you drink my blood, too. response:	I want to do anything I can to help you.
context: Thank you.\400cc is too much for someone your size, Taira.\I'll give him blood, too.\Who are you talking to? Drop your weapon right now!\You keep the riot police busy.\I'm going to close Anzai's wound.\The truth is... I want to let you drink my blood, too.\I want to do anything I can to help you. response:	Don't worry.
context: 400cc is too much for someone your size, Taira.\I'll give him blood, too.\Who are you talking to? Drop your weapon right now!\You keep the riot police busy.\I'm going to close Anzai's wound.\The truth is... I want to let you drink my blood, too.\I want to do anything I can to help you.\Don't worry. response:	I promise... I'll never give you my blood.
context: I'll give him blood, too.\Who are you talking to? Drop your weapon right now!\You keep the riot police busy.\I'm going to close Anzai's wound.\The truth is... I want to let you drink my blood, too.\I want to do anything I can to help you.\Don't worry.\I promise... I'll never give you my blood. response:	I'm sorry.
context: Who are you talking to? Drop your weapon right now!\You keep the riot police busy.\I'm going to close Anzai's wound.\The truth is... I want to let you drink my blood, too.\I want to do anything I can to help you.\Don't worry.\I promise... I'll never give you my blood.\I'm sorry. response:	It's not sharp enough.
context: You keep the riot police busy.\I'm going to close Anzai's wound.\The truth is... I want to let you drink my blood, too.\I want to do anything I can to help you.\Don't worry.\I promise... I'll never give you my blood.\I'm sorry.\It's not sharp enough. response:	Don't push yourself. You might-
context: I'm going to close Anzai's wound.\The truth is... I want to let you drink my blood, too.\I want to do anything I can to help you.\Don't worry.\I promise... I'll never give you my blood.\I'm sorry.\It's not sharp enough.\Don't push yourself. You might- response:	Bite down, Anzai!
context: The truth is... I want to let you drink my blood, too.\I want to do anything I can to help you.\Don't worry.\I promise... I'll never give you my blood.\I'm sorry.\It's not sharp enough.\Don't push yourself. You might-\Bite down, Anzai! response:	Wake up! Bite my arm!
context: I want to do anything I can to help you.\Don't worry.\I promise... I'll never give you my blood.\I'm sorry.\It's not sharp enough.\Don't push yourself. You might-\Bite down, Anzai!\Wake up! Bite my arm! response:	Anzai!
context: Don't worry.\I promise... I'll never give you my blood.\I'm sorry.\It's not sharp enough.\Don't push yourself. You might-\Bite down, Anzai!\Wake up! Bite my arm!\Anzai! response:	Anzai!
context: I promise... I'll never give you my blood.\I'm sorry.\It's not sharp enough.\Don't push yourself. You might-\Bite down, Anzai!\Wake up! Bite my arm!\Anzai!\Anzai! response:	Taira, they broke through! Hurry!
context: I'm sorry.\It's not sharp enough.\Don't push yourself. You might-\Bite down, Anzai!\Wake up! Bite my arm!\Anzai!\Anzai!\Taira, they broke through! Hurry! response:	Tsukasa?
context: It's not sharp enough.\Don't push yourself. You might-\Bite down, Anzai!\Wake up! Bite my arm!\Anzai!\Anzai!\Taira, they broke through! Hurry!\Tsukasa? response:	Anzai-
context: Don't push yourself. You might-\Bite down, Anzai!\Wake up! Bite my arm!\Anzai!\Anzai!\Taira, they broke through! Hurry!\Tsukasa?\Anzai- response:	Push your arm down...
context: Bite down, Anzai!\Wake up! Bite my arm!\Anzai!\Anzai!\Taira, they broke through! Hurry!\Tsukasa?\Anzai-\Push your arm down... response:	or he'll bite it off!
context: Wake up! Bite my arm!\Anzai!\Anzai!\Taira, they broke through! Hurry!\Tsukasa?\Anzai-\Push your arm down...\or he'll bite it off! response:	Don't move! All of you stay where you-
context: Anzai!\Anzai!\Taira, they broke through! Hurry!\Tsukasa?\Anzai-\Push your arm down...\or he'll bite it off!\Don't move! All of you stay where you- response:	Hold on! We're almost done!
context: Anzai!\Taira, they broke through! Hurry!\Tsukasa?\Anzai-\Push your arm down...\or he'll bite it off!\Don't move! All of you stay where you-\Hold on! We're almost done! response:	There's a devil on the roof.
context: Taira, they broke through! Hurry!\Tsukasa?\Anzai-\Push your arm down...\or he'll bite it off!\Don't move! All of you stay where you-\Hold on! We're almost done!\There's a devil on the roof. response:	Anzai. Don't worry about me!
context: Tsukasa?\Anzai-\Push your arm down...\or he'll bite it off!\Don't move! All of you stay where you-\Hold on! We're almost done!\There's a devil on the roof.\Anzai. Don't worry about me! response:	I'm going to be fine.
context: Anzai-\Push your arm down...\or he'll bite it off!\Don't move! All of you stay where you-\Hold on! We're almost done!\There's a devil on the roof.\Anzai. Don't worry about me!\I'm going to be fine. response:	So no dying, okay?
context: Push your arm down...\or he'll bite it off!\Don't move! All of you stay where you-\Hold on! We're almost done!\There's a devil on the roof.\Anzai. Don't worry about me!\I'm going to be fine.\So no dying, okay? response:	The wound is starting to close up.
context: or he'll bite it off!\Don't move! All of you stay where you-\Hold on! We're almost done!\There's a devil on the roof.\Anzai. Don't worry about me!\I'm going to be fine.\So no dying, okay?\The wound is starting to close up. response:	Hey, you over there! A little help?
context: Don't move! All of you stay where you-\Hold on! We're almost done!\There's a devil on the roof.\Anzai. Don't worry about me!\I'm going to be fine.\So no dying, okay?\The wound is starting to close up.\Hey, you over there! A little help? response:	Look in his pouch and find a tranq.
context: Hold on! We're almost done!\There's a devil on the roof.\Anzai. Don't worry about me!\I'm going to be fine.\So no dying, okay?\The wound is starting to close up.\Hey, you over there! A little help?\Look in his pouch and find a tranq. response:	Inject him when I give the signal.
context: There's a devil on the roof.\Anzai. Don't worry about me!\I'm going to be fine.\So no dying, okay?\The wound is starting to close up.\Hey, you over there! A little help?\Look in his pouch and find a tranq.\Inject him when I give the signal. response:	What?
context: Anzai. Don't worry about me!\I'm going to be fine.\So no dying, okay?\The wound is starting to close up.\Hey, you over there! A little help?\Look in his pouch and find a tranq.\Inject him when I give the signal.\What? response:	I'm trying to save the lives of everybody here!
context: I'm going to be fine.\So no dying, okay?\The wound is starting to close up.\Hey, you over there! A little help?\Look in his pouch and find a tranq.\Inject him when I give the signal.\What?\I'm trying to save the lives of everybody here! response:	Please!
context: So no dying, okay?\The wound is starting to close up.\Hey, you over there! A little help?\Look in his pouch and find a tranq.\Inject him when I give the signal.\What?\I'm trying to save the lives of everybody here!\Please! response:	Ogata?
context: The wound is starting to close up.\Hey, you over there! A little help?\Look in his pouch and find a tranq.\Inject him when I give the signal.\What?\I'm trying to save the lives of everybody here!\Please!\Ogata? response:	Be alert! If anything happens, shoot all of us!
context: Hey, you over there! A little help?\Look in his pouch and find a tranq.\Inject him when I give the signal.\What?\I'm trying to save the lives of everybody here!\Please!\Ogata?\Be alert! If anything happens, shoot all of us! response:	There's two different kinds! Which do I use?
context: Look in his pouch and find a tranq.\Inject him when I give the signal.\What?\I'm trying to save the lives of everybody here!\Please!\Ogata?\Be alert! If anything happens, shoot all of us!\There's two different kinds! Which do I use? response:	Uh, the thicker one!
context: Inject him when I give the signal.\What?\I'm trying to save the lives of everybody here!\Please!\Ogata?\Be alert! If anything happens, shoot all of us!\There's two different kinds! Which do I use?\Uh, the thicker one! response:	It's closed!
context: What?\I'm trying to save the lives of everybody here!\Please!\Ogata?\Be alert! If anything happens, shoot all of us!\There's two different kinds! Which do I use?\Uh, the thicker one!\It's closed! response:	Tranq him!
context: I'm trying to save the lives of everybody here!\Please!\Ogata?\Be alert! If anything happens, shoot all of us!\There's two different kinds! Which do I use?\Uh, the thicker one!\It's closed!\Tranq him! response:	Is there an ambulance here?
context: Please!\Ogata?\Be alert! If anything happens, shoot all of us!\There's two different kinds! Which do I use?\Uh, the thicker one!\It's closed!\Tranq him!\Is there an ambulance here? response:	Uh, I think one should be getting here soon.
context: Ogata?\Be alert! If anything happens, shoot all of us!\There's two different kinds! Which do I use?\Uh, the thicker one!\It's closed!\Tranq him!\Is there an ambulance here?\Uh, I think one should be getting here soon. response:	Don't kill him, okay?
context: Be alert! If anything happens, shoot all of us!\There's two different kinds! Which do I use?\Uh, the thicker one!\It's closed!\Tranq him!\Is there an ambulance here?\Uh, I think one should be getting here soon.\Don't kill him, okay? response:	He won't give you any more trouble.
context: There's two different kinds! Which do I use?\Uh, the thicker one!\It's closed!\Tranq him!\Is there an ambulance here?\Uh, I think one should be getting here soon.\Don't kill him, okay?\He won't give you any more trouble. response:	Wait, where are you-
context: Uh, the thicker one!\It's closed!\Tranq him!\Is there an ambulance here?\Uh, I think one should be getting here soon.\Don't kill him, okay?\He won't give you any more trouble.\Wait, where are you- response:	Hey!
context: It's closed!\Tranq him!\Is there an ambulance here?\Uh, I think one should be getting here soon.\Don't kill him, okay?\He won't give you any more trouble.\Wait, where are you-\Hey! response:	What's that?
context: Tranq him!\Is there an ambulance here?\Uh, I think one should be getting here soon.\Don't kill him, okay?\He won't give you any more trouble.\Wait, where are you-\Hey!\What's that? response:	I'm carrying an injured person!
context: Is there an ambulance here?\Uh, I think one should be getting here soon.\Don't kill him, okay?\He won't give you any more trouble.\Wait, where are you-\Hey!\What's that?\I'm carrying an injured person! response:	Don't shoot, okay?
context: Uh, I think one should be getting here soon.\Don't kill him, okay?\He won't give you any more trouble.\Wait, where are you-\Hey!\What's that?\I'm carrying an injured person!\Don't shoot, okay? response:	She was bitten by a devil and lost a lot of blood. Take care of her.
context: Don't kill him, okay?\He won't give you any more trouble.\Wait, where are you-\Hey!\What's that?\I'm carrying an injured person!\Don't shoot, okay?\She was bitten by a devil and lost a lot of blood. Take care of her. response:	Uh, yes, sir!
context: He won't give you any more trouble.\Wait, where are you-\Hey!\What's that?\I'm carrying an injured person!\Don't shoot, okay?\She was bitten by a devil and lost a lot of blood. Take care of her.\Uh, yes, sir! response:	Are you alright? Can you hear me?
context: Wait, where are you-\Hey!\What's that?\I'm carrying an injured person!\Don't shoot, okay?\She was bitten by a devil and lost a lot of blood. Take care of her.\Uh, yes, sir!\Are you alright? Can you hear me? response:	Get the stretcher!
context: Hey!\What's that?\I'm carrying an injured person!\Don't shoot, okay?\She was bitten by a devil and lost a lot of blood. Take care of her.\Uh, yes, sir!\Are you alright? Can you hear me?\Get the stretcher! response:	Armed Officers Instigate Devil Hunting Incident
context: What's that?\I'm carrying an injured person!\Don't shoot, okay?\She was bitten by a devil and lost a lot of blood. Take care of her.\Uh, yes, sir!\Are you alright? Can you hear me?\Get the stretcher!\Armed Officers Instigate Devil Hunting Incident response:	Tsukasa?
context: I'm carrying an injured person!\Don't shoot, okay?\She was bitten by a devil and lost a lot of blood. Take care of her.\Uh, yes, sir!\Are you alright? Can you hear me?\Get the stretcher!\Armed Officers Instigate Devil Hunting Incident\Tsukasa? response:	Freeze!
context: Don't shoot, okay?\She was bitten by a devil and lost a lot of blood. Take care of her.\Uh, yes, sir!\Are you alright? Can you hear me?\Get the stretcher!\Armed Officers Instigate Devil Hunting Incident\Tsukasa?\Freeze! response:	Down on your knees, slowly!
context: She was bitten by a devil and lost a lot of blood. Take care of her.\Uh, yes, sir!\Are you alright? Can you hear me?\Get the stretcher!\Armed Officers Instigate Devil Hunting Incident\Tsukasa?\Freeze!\Down on your knees, slowly! response:	Don't try to resist!
context: Uh, yes, sir!\Are you alright? Can you hear me?\Get the stretcher!\Armed Officers Instigate Devil Hunting Incident\Tsukasa?\Freeze!\Down on your knees, slowly!\Don't try to resist! response:	His eyes are red!
context: Are you alright? Can you hear me?\Get the stretcher!\Armed Officers Instigate Devil Hunting Incident\Tsukasa?\Freeze!\Down on your knees, slowly!\Don't try to resist!\His eyes are red! response:	Be careful!
context: Get the stretcher!\Armed Officers Instigate Devil Hunting Incident\Tsukasa?\Freeze!\Down on your knees, slowly!\Don't try to resist!\His eyes are red!\Be careful! response:	What are you going to do with me?
context: Armed Officers Instigate Devil Hunting Incident\Tsukasa?\Freeze!\Down on your knees, slowly!\Don't try to resist!\His eyes are red!\Be careful!\What are you going to do with me? response:	Arrest you for everyone's safety!
context: Tsukasa?\Freeze!\Down on your knees, slowly!\Don't try to resist!\His eyes are red!\Be careful!\What are you going to do with me?\Arrest you for everyone's safety! response:	I think you're pointing your guns at the wrong guy.
context: Freeze!\Down on your knees, slowly!\Don't try to resist!\His eyes are red!\Be careful!\What are you going to do with me?\Arrest you for everyone's safety!\I think you're pointing your guns at the wrong guy. response:	We need a stretcher on the roof.
context: Down on your knees, slowly!\Don't try to resist!\His eyes are red!\Be careful!\What are you going to do with me?\Arrest you for everyone's safety!\I think you're pointing your guns at the wrong guy.\We need a stretcher on the roof. response:	We have one devil, male. He's been tranquilized.
context: Don't try to resist!\His eyes are red!\Be careful!\What are you going to do with me?\Arrest you for everyone's safety!\I think you're pointing your guns at the wrong guy.\We need a stretcher on the roof.\We have one devil, male. He's been tranquilized. response:	He has...
context: His eyes are red!\Be careful!\What are you going to do with me?\Arrest you for everyone's safety!\I think you're pointing your guns at the wrong guy.\We need a stretcher on the roof.\We have one devil, male. He's been tranquilized.\He has... response:	I'm here in a quiet residential neighborhood where there seems to be an incident involving devils.
context: Be careful!\What are you going to do with me?\Arrest you for everyone's safety!\I think you're pointing your guns at the wrong guy.\We need a stretcher on the roof.\We have one devil, male. He's been tranquilized.\He has...\I'm here in a quiet residential neighborhood where there seems to be an incident involving devils. response:	We don't have any details yet, but they've called in the riot police,
context: What are you going to do with me?\Arrest you for everyone's safety!\I think you're pointing your guns at the wrong guy.\We need a stretcher on the roof.\We have one devil, male. He's been tranquilized.\He has...\I'm here in a quiet residential neighborhood where there seems to be an incident involving devils.\We don't have any details yet, but they've called in the riot police, response:	Kill the devils! and I understand they've found multiple bodies.
context: Arrest you for everyone's safety!\I think you're pointing your guns at the wrong guy.\We need a stretcher on the roof.\We have one devil, male. He's been tranquilized.\He has...\I'm here in a quiet residential neighborhood where there seems to be an incident involving devils.\We don't have any details yet, but they've called in the riot police,\Kill the devils! and I understand they've found multiple bodies. response:	Exterminate the pests! and I understand they've found multiple bodies.
context: I think you're pointing your guns at the wrong guy.\We need a stretcher on the roof.\We have one devil, male. He's been tranquilized.\He has...\I'm here in a quiet residential neighborhood where there seems to be an incident involving devils.\We don't have any details yet, but they've called in the riot police,\Kill the devils! and I understand they've found multiple bodies.\Exterminate the pests! and I understand they've found multiple bodies. response:	I'm calling on the F Squad private channel.
context: We need a stretcher on the roof.\We have one devil, male. He's been tranquilized.\He has...\I'm here in a quiet residential neighborhood where there seems to be an incident involving devils.\We don't have any details yet, but they've called in the riot police,\Kill the devils! and I understand they've found multiple bodies.\Exterminate the pests! and I understand they've found multiple bodies.\I'm calling on the F Squad private channel. response:	Section 11 wants to hear from your leader, Ishimaru.
context: We have one devil, male. He's been tranquilized.\He has...\I'm here in a quiet residential neighborhood where there seems to be an incident involving devils.\We don't have any details yet, but they've called in the riot police,\Kill the devils! and I understand they've found multiple bodies.\Exterminate the pests! and I understand they've found multiple bodies.\I'm calling on the F Squad private channel.\Section 11 wants to hear from your leader, Ishimaru. response:	That voice!
context: He has...\I'm here in a quiet residential neighborhood where there seems to be an incident involving devils.\We don't have any details yet, but they've called in the riot police,\Kill the devils! and I understand they've found multiple bodies.\Exterminate the pests! and I understand they've found multiple bodies.\I'm calling on the F Squad private channel.\Section 11 wants to hear from your leader, Ishimaru.\That voice! response:	It's Makimura.
context: I'm here in a quiet residential neighborhood where there seems to be an incident involving devils.\We don't have any details yet, but they've called in the riot police,\Kill the devils! and I understand they've found multiple bodies.\Exterminate the pests! and I understand they've found multiple bodies.\I'm calling on the F Squad private channel.\Section 11 wants to hear from your leader, Ishimaru.\That voice!\It's Makimura. response:	It's possible that central government offices,
context: We don't have any details yet, but they've called in the riot police,\Kill the devils! and I understand they've found multiple bodies.\Exterminate the pests! and I understand they've found multiple bodies.\I'm calling on the F Squad private channel.\Section 11 wants to hear from your leader, Ishimaru.\That voice!\It's Makimura.\It's possible that central government offices, response:	starting with the Ministry of Health, Labor, and Welfare,
context: Kill the devils! and I understand they've found multiple bodies.\Exterminate the pests! and I understand they've found multiple bodies.\I'm calling on the F Squad private channel.\Section 11 wants to hear from your leader, Ishimaru.\That voice!\It's Makimura.\It's possible that central government offices,\starting with the Ministry of Health, Labor, and Welfare, response:	were involved with the formation of the CCC.
context: Exterminate the pests! and I understand they've found multiple bodies.\I'm calling on the F Squad private channel.\Section 11 wants to hear from your leader, Ishimaru.\That voice!\It's Makimura.\It's possible that central government offices,\starting with the Ministry of Health, Labor, and Welfare,\were involved with the formation of the CCC. response:	You need to redirect the focus of your investigation.
context: I'm calling on the F Squad private channel.\Section 11 wants to hear from your leader, Ishimaru.\That voice!\It's Makimura.\It's possible that central government offices,\starting with the Ministry of Health, Labor, and Welfare,\were involved with the formation of the CCC.\You need to redirect the focus of your investigation. response:	One more thing.
context: Section 11 wants to hear from your leader, Ishimaru.\That voice!\It's Makimura.\It's possible that central government offices,\starting with the Ministry of Health, Labor, and Welfare,\were involved with the formation of the CCC.\You need to redirect the focus of your investigation.\One more thing. response:	There are signs that Kikuhara was attempting to trade out members before this incident.
context: That voice!\It's Makimura.\It's possible that central government offices,\starting with the Ministry of Health, Labor, and Welfare,\were involved with the formation of the CCC.\You need to redirect the focus of your investigation.\One more thing.\There are signs that Kikuhara was attempting to trade out members before this incident. response:	The old members may be pushed out of the organization.
context: It's Makimura.\It's possible that central government offices,\starting with the Ministry of Health, Labor, and Welfare,\were involved with the formation of the CCC.\You need to redirect the focus of your investigation.\One more thing.\There are signs that Kikuhara was attempting to trade out members before this incident.\The old members may be pushed out of the organization. response:	They are vital witnesses in this case.
context: It's possible that central government offices,\starting with the Ministry of Health, Labor, and Welfare,\were involved with the formation of the CCC.\You need to redirect the focus of your investigation.\One more thing.\There are signs that Kikuhara was attempting to trade out members before this incident.\The old members may be pushed out of the organization.\They are vital witnesses in this case. response:	Do not let them get killed.
context: starting with the Ministry of Health, Labor, and Welfare,\were involved with the formation of the CCC.\You need to redirect the focus of your investigation.\One more thing.\There are signs that Kikuhara was attempting to trade out members before this incident.\The old members may be pushed out of the organization.\They are vital witnesses in this case.\Do not let them get killed. response:	Can't get down?
context: were involved with the formation of the CCC.\You need to redirect the focus of your investigation.\One more thing.\There are signs that Kikuhara was attempting to trade out members before this incident.\The old members may be pushed out of the organization.\They are vital witnesses in this case.\Do not let them get killed.\Can't get down? response:	Jump.
context: You need to redirect the focus of your investigation.\One more thing.\There are signs that Kikuhara was attempting to trade out members before this incident.\The old members may be pushed out of the organization.\They are vital witnesses in this case.\Do not let them get killed.\Can't get down?\Jump. response:	I'll catch you.
context: One more thing.\There are signs that Kikuhara was attempting to trade out members before this incident.\The old members may be pushed out of the organization.\They are vital witnesses in this case.\Do not let them get killed.\Can't get down?\Jump.\I'll catch you. response:	I'm looking for a mass murderer named Tamaki Anzai.
context: There are signs that Kikuhara was attempting to trade out members before this incident.\The old members may be pushed out of the organization.\They are vital witnesses in this case.\Do not let them get killed.\Can't get down?\Jump.\I'll catch you.\I'm looking for a mass murderer named Tamaki Anzai. response:	He killed a lot of people.
context: The old members may be pushed out of the organization.\They are vital witnesses in this case.\Do not let them get killed.\Can't get down?\Jump.\I'll catch you.\I'm looking for a mass murderer named Tamaki Anzai.\He killed a lot of people. response:	He's your...
context: They are vital witnesses in this case.\Do not let them get killed.\Can't get down?\Jump.\I'll catch you.\I'm looking for a mass murderer named Tamaki Anzai.\He killed a lot of people.\He's your... response:	your genitor.
context: Do not let them get killed.\Can't get down?\Jump.\I'll catch you.\I'm looking for a mass murderer named Tamaki Anzai.\He killed a lot of people.\He's your...\your genitor. response:	Geni...tor?
context: Can't get down?\Jump.\I'll catch you.\I'm looking for a mass murderer named Tamaki Anzai.\He killed a lot of people.\He's your...\your genitor.\Geni...tor? response:	He was sentenced to death,
context: Jump.\I'll catch you.\I'm looking for a mass murderer named Tamaki Anzai.\He killed a lot of people.\He's your...\your genitor.\Geni...tor?\He was sentenced to death, response:	but for some reason, he was secretly released from jail,
context: I'll catch you.\I'm looking for a mass murderer named Tamaki Anzai.\He killed a lot of people.\He's your...\your genitor.\Geni...tor?\He was sentenced to death,\but for some reason, he was secretly released from jail, response:	and brought here instead.
context: I'm looking for a mass murderer named Tamaki Anzai.\He killed a lot of people.\He's your...\your genitor.\Geni...tor?\He was sentenced to death,\but for some reason, he was secretly released from jail,\and brought here instead. response:	I don't like it here. Let's go back.
context: He killed a lot of people.\He's your...\your genitor.\Geni...tor?\He was sentenced to death,\but for some reason, he was secretly released from jail,\and brought here instead.\I don't like it here. Let's go back. response:	In a sense...
context: He's your...\your genitor.\Geni...tor?\He was sentenced to death,\but for some reason, he was secretly released from jail,\and brought here instead.\I don't like it here. Let's go back.\In a sense... response:	these are a type of the darkness that lurks inside all human beings.
context: your genitor.\Geni...tor?\He was sentenced to death,\but for some reason, he was secretly released from jail,\and brought here instead.\I don't like it here. Let's go back.\In a sense...\these are a type of the darkness that lurks inside all human beings. response:	Everyone here is a devil.
context: Geni...tor?\He was sentenced to death,\but for some reason, he was secretly released from jail,\and brought here instead.\I don't like it here. Let's go back.\In a sense...\these are a type of the darkness that lurks inside all human beings.\Everyone here is a devil. response:	Just like you and me.
context: He was sentenced to death,\but for some reason, he was secretly released from jail,\and brought here instead.\I don't like it here. Let's go back.\In a sense...\these are a type of the darkness that lurks inside all human beings.\Everyone here is a devil.\Just like you and me. response:	This monster killed 15 people... a devil in the truest sense of the word.
context: but for some reason, he was secretly released from jail,\and brought here instead.\I don't like it here. Let's go back.\In a sense...\these are a type of the darkness that lurks inside all human beings.\Everyone here is a devil.\Just like you and me.\This monster killed 15 people... a devil in the truest sense of the word. response:	Tamaki Anzai.
context: and brought here instead.\I don't like it here. Let's go back.\In a sense...\these are a type of the darkness that lurks inside all human beings.\Everyone here is a devil.\Just like you and me.\This monster killed 15 people... a devil in the truest sense of the word.\Tamaki Anzai. response:	Your father.
context: I don't like it here. Let's go back.\In a sense...\these are a type of the darkness that lurks inside all human beings.\Everyone here is a devil.\Just like you and me.\This monster killed 15 people... a devil in the truest sense of the word.\Tamaki Anzai.\Your father. response:	Devil...
context: In a sense...\these are a type of the darkness that lurks inside all human beings.\Everyone here is a devil.\Just like you and me.\This monster killed 15 people... a devil in the truest sense of the word.\Tamaki Anzai.\Your father.\Devil... response:	Father...
context: these are a type of the darkness that lurks inside all human beings.\Everyone here is a devil.\Just like you and me.\This monster killed 15 people... a devil in the truest sense of the word.\Tamaki Anzai.\Your father.\Devil...\Father... response:	Murderer...
context: Everyone here is a devil.\Just like you and me.\This monster killed 15 people... a devil in the truest sense of the word.\Tamaki Anzai.\Your father.\Devil...\Father...\Murderer... response:	Hey, none of that! You have to lie down.
context: Just like you and me.\This monster killed 15 people... a devil in the truest sense of the word.\Tamaki Anzai.\Your father.\Devil...\Father...\Murderer...\Hey, none of that! You have to lie down. response:	I'm your attending physician, Feng.
context: This monster killed 15 people... a devil in the truest sense of the word.\Tamaki Anzai.\Your father.\Devil...\Father...\Murderer...\Hey, none of that! You have to lie down.\I'm your attending physician, Feng. response:	How are you feeling?
context: Tamaki Anzai.\Your father.\Devil...\Father...\Murderer...\Hey, none of that! You have to lie down.\I'm your attending physician, Feng.\How are you feeling? response:	The hospital?
context: Your father.\Devil...\Father...\Murderer...\Hey, none of that! You have to lie down.\I'm your attending physician, Feng.\How are you feeling?\The hospital? response:	That's right. Shirase Hospital Basement 2.
context: Devil...\Father...\Murderer...\Hey, none of that! You have to lie down.\I'm your attending physician, Feng.\How are you feeling?\The hospital?\That's right. Shirase Hospital Basement 2. response:	The special wing for treating devils.
context: Father...\Murderer...\Hey, none of that! You have to lie down.\I'm your attending physician, Feng.\How are you feeling?\The hospital?\That's right. Shirase Hospital Basement 2.\The special wing for treating devils. response:	Your wounds have closed up, but you lost a lot of blood, so you still need to...
context: Murderer...\Hey, none of that! You have to lie down.\I'm your attending physician, Feng.\How are you feeling?\The hospital?\That's right. Shirase Hospital Basement 2.\The special wing for treating devils.\Your wounds have closed up, but you lost a lot of blood, so you still need to... response:	Th-they didn't bring her with me?
context: Hey, none of that! You have to lie down.\I'm your attending physician, Feng.\How are you feeling?\The hospital?\That's right. Shirase Hospital Basement 2.\The special wing for treating devils.\Your wounds have closed up, but you lost a lot of blood, so you still need to...\Th-they didn't bring her with me? response:	A woman with short hair...
context: I'm your attending physician, Feng.\How are you feeling?\The hospital?\That's right. Shirase Hospital Basement 2.\The special wing for treating devils.\Your wounds have closed up, but you lost a lot of blood, so you still need to...\Th-they didn't bring her with me?\A woman with short hair... response:	You mean Tsukasa Taira?
context: How are you feeling?\The hospital?\That's right. Shirase Hospital Basement 2.\The special wing for treating devils.\Your wounds have closed up, but you lost a lot of blood, so you still need to...\Th-they didn't bring her with me?\A woman with short hair...\You mean Tsukasa Taira? response:	She's here. They admitted her to the third floor.
context: The hospital?\That's right. Shirase Hospital Basement 2.\The special wing for treating devils.\Your wounds have closed up, but you lost a lot of blood, so you still need to...\Th-they didn't bring her with me?\A woman with short hair...\You mean Tsukasa Taira?\She's here. They admitted her to the third floor. response:	Don't worry; her injuries weren't fatal.
context: That's right. Shirase Hospital Basement 2.\The special wing for treating devils.\Your wounds have closed up, but you lost a lot of blood, so you still need to...\Th-they didn't bring her with me?\A woman with short hair...\You mean Tsukasa Taira?\She's here. They admitted her to the third floor.\Don't worry; her injuries weren't fatal. response:	Really?
context: The special wing for treating devils.\Your wounds have closed up, but you lost a lot of blood, so you still need to...\Th-they didn't bring her with me?\A woman with short hair...\You mean Tsukasa Taira?\She's here. They admitted her to the third floor.\Don't worry; her injuries weren't fatal.\Really? response:	Well...
context: Your wounds have closed up, but you lost a lot of blood, so you still need to...\Th-they didn't bring her with me?\A woman with short hair...\You mean Tsukasa Taira?\She's here. They admitted her to the third floor.\Don't worry; her injuries weren't fatal.\Really?\Well... response:	Her left arm was broken, with lacerations and deep bite marks, but it's been treated.
context: Th-they didn't bring her with me?\A woman with short hair...\You mean Tsukasa Taira?\She's here. They admitted her to the third floor.\Don't worry; her injuries weren't fatal.\Really?\Well...\Her left arm was broken, with lacerations and deep bite marks, but it's been treated. response:	She lost consciousness, but she's in stable condition now.
context: A woman with short hair...\You mean Tsukasa Taira?\She's here. They admitted her to the third floor.\Don't worry; her injuries weren't fatal.\Really?\Well...\Her left arm was broken, with lacerations and deep bite marks, but it's been treated.\She lost consciousness, but she's in stable condition now. response:	I understand she forced you to bite her own arm.
context: You mean Tsukasa Taira?\She's here. They admitted her to the third floor.\Don't worry; her injuries weren't fatal.\Really?\Well...\Her left arm was broken, with lacerations and deep bite marks, but it's been treated.\She lost consciousness, but she's in stable condition now.\I understand she forced you to bite her own arm. response:	I was finally...
context: She's here. They admitted her to the third floor.\Don't worry; her injuries weren't fatal.\Really?\Well...\Her left arm was broken, with lacerations and deep bite marks, but it's been treated.\She lost consciousness, but she's in stable condition now.\I understand she forced you to bite her own arm.\I was finally... response:	starting to control myself.
context: Don't worry; her injuries weren't fatal.\Really?\Well...\Her left arm was broken, with lacerations and deep bite marks, but it's been treated.\She lost consciousness, but she's in stable condition now.\I understand she forced you to bite her own arm.\I was finally...\starting to control myself. response:	I thought... there was a light at the end of the tunnel...
context: Really?\Well...\Her left arm was broken, with lacerations and deep bite marks, but it's been treated.\She lost consciousness, but she's in stable condition now.\I understand she forced you to bite her own arm.\I was finally...\starting to control myself.\I thought... there was a light at the end of the tunnel... response:	Just remember this.
context: Well...\Her left arm was broken, with lacerations and deep bite marks, but it's been treated.\She lost consciousness, but she's in stable condition now.\I understand she forced you to bite her own arm.\I was finally...\starting to control myself.\I thought... there was a light at the end of the tunnel...\Just remember this. response:	There was no time to wait for medical help.
context: Her left arm was broken, with lacerations and deep bite marks, but it's been treated.\She lost consciousness, but she's in stable condition now.\I understand she forced you to bite her own arm.\I was finally...\starting to control myself.\I thought... there was a light at the end of the tunnel...\Just remember this.\There was no time to wait for medical help. response:	If she hadn't closed up that wound then and there...
context: She lost consciousness, but she's in stable condition now.\I understand she forced you to bite her own arm.\I was finally...\starting to control myself.\I thought... there was a light at the end of the tunnel...\Just remember this.\There was no time to wait for medical help.\If she hadn't closed up that wound then and there... response:	If she hadn't been there for you, you would be dead. Period.
context: I understand she forced you to bite her own arm.\I was finally...\starting to control myself.\I thought... there was a light at the end of the tunnel...\Just remember this.\There was no time to wait for medical help.\If she hadn't closed up that wound then and there...\If she hadn't been there for you, you would be dead. Period. response:	She made a call.
context: I was finally...\starting to control myself.\I thought... there was a light at the end of the tunnel...\Just remember this.\There was no time to wait for medical help.\If she hadn't closed up that wound then and there...\If she hadn't been there for you, you would be dead. Period.\She made a call. response:	And it was the right one.
context: starting to control myself.\I thought... there was a light at the end of the tunnel...\Just remember this.\There was no time to wait for medical help.\If she hadn't closed up that wound then and there...\If she hadn't been there for you, you would be dead. Period.\She made a call.\And it was the right one. response:	Yesterday, someone attacked Naoya Ushio.
context: I thought... there was a light at the end of the tunnel...\Just remember this.\There was no time to wait for medical help.\If she hadn't closed up that wound then and there...\If she hadn't been there for you, you would be dead. Period.\She made a call.\And it was the right one.\Yesterday, someone attacked Naoya Ushio. response:	But he escaped with no serious injuries.
context: Just remember this.\There was no time to wait for medical help.\If she hadn't closed up that wound then and there...\If she hadn't been there for you, you would be dead. Period.\She made a call.\And it was the right one.\Yesterday, someone attacked Naoya Ushio.\But he escaped with no serious injuries. response:	And this morning in the detention center, Kohei Nakamura,
context: There was no time to wait for medical help.\If she hadn't closed up that wound then and there...\If she hadn't been there for you, you would be dead. Period.\She made a call.\And it was the right one.\Yesterday, someone attacked Naoya Ushio.\But he escaped with no serious injuries.\And this morning in the detention center, Kohei Nakamura, response:	also known as Zero Four, stole a gun from a guard.
context: If she hadn't closed up that wound then and there...\If she hadn't been there for you, you would be dead. Period.\She made a call.\And it was the right one.\Yesterday, someone attacked Naoya Ushio.\But he escaped with no serious injuries.\And this morning in the detention center, Kohei Nakamura,\also known as Zero Four, stole a gun from a guard. response:	He was killed in the ensuing gunfight.
context: If she hadn't been there for you, you would be dead. Period.\She made a call.\And it was the right one.\Yesterday, someone attacked Naoya Ushio.\But he escaped with no serious injuries.\And this morning in the detention center, Kohei Nakamura,\also known as Zero Four, stole a gun from a guard.\He was killed in the ensuing gunfight. response:	I understand Kikuhara visited him yesterday.
context: She made a call.\And it was the right one.\Yesterday, someone attacked Naoya Ushio.\But he escaped with no serious injuries.\And this morning in the detention center, Kohei Nakamura,\also known as Zero Four, stole a gun from a guard.\He was killed in the ensuing gunfight.\I understand Kikuhara visited him yesterday. response:	Kikuhara?
context: And it was the right one.\Yesterday, someone attacked Naoya Ushio.\But he escaped with no serious injuries.\And this morning in the detention center, Kohei Nakamura,\also known as Zero Four, stole a gun from a guard.\He was killed in the ensuing gunfight.\I understand Kikuhara visited him yesterday.\Kikuhara? response:	At the very least, we need to immobilize Kikuhara.
context: Yesterday, someone attacked Naoya Ushio.\But he escaped with no serious injuries.\And this morning in the detention center, Kohei Nakamura,\also known as Zero Four, stole a gun from a guard.\He was killed in the ensuing gunfight.\I understand Kikuhara visited him yesterday.\Kikuhara?\At the very least, we need to immobilize Kikuhara. response:	I'll put a guard on him.
context: But he escaped with no serious injuries.\And this morning in the detention center, Kohei Nakamura,\also known as Zero Four, stole a gun from a guard.\He was killed in the ensuing gunfight.\I understand Kikuhara visited him yesterday.\Kikuhara?\At the very least, we need to immobilize Kikuhara.\I'll put a guard on him. response:	But if Makimura is right, and there are multiple government agencies pulling the strings,
context: And this morning in the detention center, Kohei Nakamura,\also known as Zero Four, stole a gun from a guard.\He was killed in the ensuing gunfight.\I understand Kikuhara visited him yesterday.\Kikuhara?\At the very least, we need to immobilize Kikuhara.\I'll put a guard on him.\But if Makimura is right, and there are multiple government agencies pulling the strings, response:	then restraining Kikuhara won't stop the murders.
context: also known as Zero Four, stole a gun from a guard.\He was killed in the ensuing gunfight.\I understand Kikuhara visited him yesterday.\Kikuhara?\At the very least, we need to immobilize Kikuhara.\I'll put a guard on him.\But if Makimura is right, and there are multiple government agencies pulling the strings,\then restraining Kikuhara won't stop the murders. response:	Don't worry about the rest.
context: He was killed in the ensuing gunfight.\I understand Kikuhara visited him yesterday.\Kikuhara?\At the very least, we need to immobilize Kikuhara.\I'll put a guard on him.\But if Makimura is right, and there are multiple government agencies pulling the strings,\then restraining Kikuhara won't stop the murders.\Don't worry about the rest. response:	As of today, F Squad is dissolved.
context: I understand Kikuhara visited him yesterday.\Kikuhara?\At the very least, we need to immobilize Kikuhara.\I'll put a guard on him.\But if Makimura is right, and there are multiple government agencies pulling the strings,\then restraining Kikuhara won't stop the murders.\Don't worry about the rest.\As of today, F Squad is dissolved. response:	Would you please reconsider Anzai's punishment?
context: Kikuhara?\At the very least, we need to immobilize Kikuhara.\I'll put a guard on him.\But if Makimura is right, and there are multiple government agencies pulling the strings,\then restraining Kikuhara won't stop the murders.\Don't worry about the rest.\As of today, F Squad is dissolved.\Would you please reconsider Anzai's punishment? response:	Officer Anzai saved my life and Ishimaru's.
context: At the very least, we need to immobilize Kikuhara.\I'll put a guard on him.\But if Makimura is right, and there are multiple government agencies pulling the strings,\then restraining Kikuhara won't stop the murders.\Don't worry about the rest.\As of today, F Squad is dissolved.\Would you please reconsider Anzai's punishment?\Officer Anzai saved my life and Ishimaru's. response:	We did take that into account.
context: I'll put a guard on him.\But if Makimura is right, and there are multiple government agencies pulling the strings,\then restraining Kikuhara won't stop the murders.\Don't worry about the rest.\As of today, F Squad is dissolved.\Would you please reconsider Anzai's punishment?\Officer Anzai saved my life and Ishimaru's.\We did take that into account. response:	I'm guessing F Squad is done?
context: But if Makimura is right, and there are multiple government agencies pulling the strings,\then restraining Kikuhara won't stop the murders.\Don't worry about the rest.\As of today, F Squad is dissolved.\Would you please reconsider Anzai's punishment?\Officer Anzai saved my life and Ishimaru's.\We did take that into account.\I'm guessing F Squad is done? response:	That's a good guess.
context: then restraining Kikuhara won't stop the murders.\Don't worry about the rest.\As of today, F Squad is dissolved.\Would you please reconsider Anzai's punishment?\Officer Anzai saved my life and Ishimaru's.\We did take that into account.\I'm guessing F Squad is done?\That's a good guess. response:	I could tell from the look on Sawazaki's face.
context: Don't worry about the rest.\As of today, F Squad is dissolved.\Would you please reconsider Anzai's punishment?\Officer Anzai saved my life and Ishimaru's.\We did take that into account.\I'm guessing F Squad is done?\That's a good guess.\I could tell from the look on Sawazaki's face. response:	What? I'm impressed.
context: As of today, F Squad is dissolved.\Would you please reconsider Anzai's punishment?\Officer Anzai saved my life and Ishimaru's.\We did take that into account.\I'm guessing F Squad is done?\That's a good guess.\I could tell from the look on Sawazaki's face.\What? I'm impressed. response:	Sawazaki's face has always looks exactly the same to me.
context: Would you please reconsider Anzai's punishment?\Officer Anzai saved my life and Ishimaru's.\We did take that into account.\I'm guessing F Squad is done?\That's a good guess.\I could tell from the look on Sawazaki's face.\What? I'm impressed.\Sawazaki's face has always looks exactly the same to me. response:	I've known him a lot longer.
context: Officer Anzai saved my life and Ishimaru's.\We did take that into account.\I'm guessing F Squad is done?\That's a good guess.\I could tell from the look on Sawazaki's face.\What? I'm impressed.\Sawazaki's face has always looks exactly the same to me.\I've known him a lot longer. response:	Anyway, we've all been suspended for 20 days.
context: We did take that into account.\I'm guessing F Squad is done?\That's a good guess.\I could tell from the look on Sawazaki's face.\What? I'm impressed.\Sawazaki's face has always looks exactly the same to me.\I've known him a lot longer.\Anyway, we've all been suspended for 20 days. response:	And Ishimaru and I are taking pay cuts.
context: I'm guessing F Squad is done?\That's a good guess.\I could tell from the look on Sawazaki's face.\What? I'm impressed.\Sawazaki's face has always looks exactly the same to me.\I've known him a lot longer.\Anyway, we've all been suspended for 20 days.\And Ishimaru and I are taking pay cuts. response:	F Squad will be dissolved,
context: That's a good guess.\I could tell from the look on Sawazaki's face.\What? I'm impressed.\Sawazaki's face has always looks exactly the same to me.\I've known him a lot longer.\Anyway, we've all been suspended for 20 days.\And Ishimaru and I are taking pay cuts.\F Squad will be dissolved, response:	and the remaining squads will divide its jurisdiction.
context: I could tell from the look on Sawazaki's face.\What? I'm impressed.\Sawazaki's face has always looks exactly the same to me.\I've known him a lot longer.\Anyway, we've all been suspended for 20 days.\And Ishimaru and I are taking pay cuts.\F Squad will be dissolved,\and the remaining squads will divide its jurisdiction. response:	I'm going back to Public Security General Affairs.
context: What? I'm impressed.\Sawazaki's face has always looks exactly the same to me.\I've known him a lot longer.\Anyway, we've all been suspended for 20 days.\And Ishimaru and I are taking pay cuts.\F Squad will be dissolved,\and the remaining squads will divide its jurisdiction.\I'm going back to Public Security General Affairs. response:	You, Asami, will be returning to Division 1.
context: Sawazaki's face has always looks exactly the same to me.\I've known him a lot longer.\Anyway, we've all been suspended for 20 days.\And Ishimaru and I are taking pay cuts.\F Squad will be dissolved,\and the remaining squads will divide its jurisdiction.\I'm going back to Public Security General Affairs.\You, Asami, will be returning to Division 1. response:	And Sawazaki will be transferred to Division 5, Section 1.
context: I've known him a lot longer.\Anyway, we've all been suspended for 20 days.\And Ishimaru and I are taking pay cuts.\F Squad will be dissolved,\and the remaining squads will divide its jurisdiction.\I'm going back to Public Security General Affairs.\You, Asami, will be returning to Division 1.\And Sawazaki will be transferred to Division 5, Section 1. response:	Tied to a desk...
context: Anyway, we've all been suspended for 20 days.\And Ishimaru and I are taking pay cuts.\F Squad will be dissolved,\and the remaining squads will divide its jurisdiction.\I'm going back to Public Security General Affairs.\You, Asami, will be returning to Division 1.\And Sawazaki will be transferred to Division 5, Section 1.\Tied to a desk... response:	Miss Lloyd will be transferred to Y Squad.
context: And Ishimaru and I are taking pay cuts.\F Squad will be dissolved,\and the remaining squads will divide its jurisdiction.\I'm going back to Public Security General Affairs.\You, Asami, will be returning to Division 1.\And Sawazaki will be transferred to Division 5, Section 1.\Tied to a desk...\Miss Lloyd will be transferred to Y Squad. response:	And Dr. Yanagi will go back to the hospital we got him from.
context: F Squad will be dissolved,\and the remaining squads will divide its jurisdiction.\I'm going back to Public Security General Affairs.\You, Asami, will be returning to Division 1.\And Sawazaki will be transferred to Division 5, Section 1.\Tied to a desk...\Miss Lloyd will be transferred to Y Squad.\And Dr. Yanagi will go back to the hospital we got him from. response:	I'll miss you all, but this is goodbye.
context: and the remaining squads will divide its jurisdiction.\I'm going back to Public Security General Affairs.\You, Asami, will be returning to Division 1.\And Sawazaki will be transferred to Division 5, Section 1.\Tied to a desk...\Miss Lloyd will be transferred to Y Squad.\And Dr. Yanagi will go back to the hospital we got him from.\I'll miss you all, but this is goodbye. response:	Anzai!
context: I'm going back to Public Security General Affairs.\You, Asami, will be returning to Division 1.\And Sawazaki will be transferred to Division 5, Section 1.\Tied to a desk...\Miss Lloyd will be transferred to Y Squad.\And Dr. Yanagi will go back to the hospital we got him from.\I'll miss you all, but this is goodbye.\Anzai! response:	Miwako?
context: You, Asami, will be returning to Division 1.\And Sawazaki will be transferred to Division 5, Section 1.\Tied to a desk...\Miss Lloyd will be transferred to Y Squad.\And Dr. Yanagi will go back to the hospital we got him from.\I'll miss you all, but this is goodbye.\Anzai!\Miwako? response:	Tsukasa! I'm so glad you're okay!
context: And Sawazaki will be transferred to Division 5, Section 1.\Tied to a desk...\Miss Lloyd will be transferred to Y Squad.\And Dr. Yanagi will go back to the hospital we got him from.\I'll miss you all, but this is goodbye.\Anzai!\Miwako?\Tsukasa! I'm so glad you're okay! response:	Ms. Tsukasa Taira
context: Tied to a desk...\Miss Lloyd will be transferred to Y Squad.\And Dr. Yanagi will go back to the hospital we got him from.\I'll miss you all, but this is goodbye.\Anzai!\Miwako?\Tsukasa! I'm so glad you're okay!\Ms. Tsukasa Taira response:	The man who saved you...
context: Miss Lloyd will be transferred to Y Squad.\And Dr. Yanagi will go back to the hospital we got him from.\I'll miss you all, but this is goodbye.\Anzai!\Miwako?\Tsukasa! I'm so glad you're okay!\Ms. Tsukasa Taira\The man who saved you... response:	he was a devil, wasn't he?
context: And Dr. Yanagi will go back to the hospital we got him from.\I'll miss you all, but this is goodbye.\Anzai!\Miwako?\Tsukasa! I'm so glad you're okay!\Ms. Tsukasa Taira\The man who saved you...\he was a devil, wasn't he? response:	What?
context: I'll miss you all, but this is goodbye.\Anzai!\Miwako?\Tsukasa! I'm so glad you're okay!\Ms. Tsukasa Taira\The man who saved you...\he was a devil, wasn't he?\What? response:	He had long hair...
context: Anzai!\Miwako?\Tsukasa! I'm so glad you're okay!\Ms. Tsukasa Taira\The man who saved you...\he was a devil, wasn't he?\What?\He had long hair... response:	Oh, that's Lee.
context: Miwako?\Tsukasa! I'm so glad you're okay!\Ms. Tsukasa Taira\The man who saved you...\he was a devil, wasn't he?\What?\He had long hair...\Oh, that's Lee. response:	Everyone's afraid of devils, and they have a really bad reputation.
context: Tsukasa! I'm so glad you're okay!\Ms. Tsukasa Taira\The man who saved you...\he was a devil, wasn't he?\What?\He had long hair...\Oh, that's Lee.\Everyone's afraid of devils, and they have a really bad reputation. response:	But I guess they're not all bad.
context: Ms. Tsukasa Taira\The man who saved you...\he was a devil, wasn't he?\What?\He had long hair...\Oh, that's Lee.\Everyone's afraid of devils, and they have a really bad reputation.\But I guess they're not all bad. response:	Miwako.
context: The man who saved you...\he was a devil, wasn't he?\What?\He had long hair...\Oh, that's Lee.\Everyone's afraid of devils, and they have a really bad reputation.\But I guess they're not all bad.\Miwako. response:	I kind of think I'm starting to get it.
context: he was a devil, wasn't he?\What?\He had long hair...\Oh, that's Lee.\Everyone's afraid of devils, and they have a really bad reputation.\But I guess they're not all bad.\Miwako.\I kind of think I'm starting to get it. response:	That there are devils who can be trusted.
context: What?\He had long hair...\Oh, that's Lee.\Everyone's afraid of devils, and they have a really bad reputation.\But I guess they're not all bad.\Miwako.\I kind of think I'm starting to get it.\That there are devils who can be trusted. response:	I don't think I'm the only one... lots of people are getting it.
context: He had long hair...\Oh, that's Lee.\Everyone's afraid of devils, and they have a really bad reputation.\But I guess they're not all bad.\Miwako.\I kind of think I'm starting to get it.\That there are devils who can be trusted.\I don't think I'm the only one... lots of people are getting it. response:	They've decided on our punishments.
context: Oh, that's Lee.\Everyone's afraid of devils, and they have a really bad reputation.\But I guess they're not all bad.\Miwako.\I kind of think I'm starting to get it.\That there are devils who can be trusted.\I don't think I'm the only one... lots of people are getting it.\They've decided on our punishments. response:	Anzai will most likely be allowed to resign.
context: Everyone's afraid of devils, and they have a really bad reputation.\But I guess they're not all bad.\Miwako.\I kind of think I'm starting to get it.\That there are devils who can be trusted.\I don't think I'm the only one... lots of people are getting it.\They've decided on our punishments.\Anzai will most likely be allowed to resign. response:	After that...
context: But I guess they're not all bad.\Miwako.\I kind of think I'm starting to get it.\That there are devils who can be trusted.\I don't think I'm the only one... lots of people are getting it.\They've decided on our punishments.\Anzai will most likely be allowed to resign.\After that... response:	he'll be placed under strict surveillance,
context: Miwako.\I kind of think I'm starting to get it.\That there are devils who can be trusted.\I don't think I'm the only one... lots of people are getting it.\They've decided on our punishments.\Anzai will most likely be allowed to resign.\After that...\he'll be placed under strict surveillance, response:	and prohibited from seeing his human victim for the foreseeable future.
context: I kind of think I'm starting to get it.\That there are devils who can be trusted.\I don't think I'm the only one... lots of people are getting it.\They've decided on our punishments.\Anzai will most likely be allowed to resign.\After that...\he'll be placed under strict surveillance,\and prohibited from seeing his human victim for the foreseeable future. response:	After the Ikebukuro Incident and this one,
context: That there are devils who can be trusted.\I don't think I'm the only one... lots of people are getting it.\They've decided on our punishments.\Anzai will most likely be allowed to resign.\After that...\he'll be placed under strict surveillance,\and prohibited from seeing his human victim for the foreseeable future.\After the Ikebukuro Incident and this one, response:	public opinion is leaning in a harsher direction.
context: I don't think I'm the only one... lots of people are getting it.\They've decided on our punishments.\Anzai will most likely be allowed to resign.\After that...\he'll be placed under strict surveillance,\and prohibited from seeing his human victim for the foreseeable future.\After the Ikebukuro Incident and this one,\public opinion is leaning in a harsher direction. response:	Protests Intensify After Introduction of Red-Eye Protection Bill
context: They've decided on our punishments.\Anzai will most likely be allowed to resign.\After that...\he'll be placed under strict surveillance,\and prohibited from seeing his human victim for the foreseeable future.\After the Ikebukuro Incident and this one,\public opinion is leaning in a harsher direction.\Protests Intensify After Introduction of Red-Eye Protection Bill response:	The Red-eye Protection Bill was submitted to the Diet,
context: Anzai will most likely be allowed to resign.\After that...\he'll be placed under strict surveillance,\and prohibited from seeing his human victim for the foreseeable future.\After the Ikebukuro Incident and this one,\public opinion is leaning in a harsher direction.\Protests Intensify After Introduction of Red-Eye Protection Bill\The Red-eye Protection Bill was submitted to the Diet, response:	Vampires Really Do Exist!! Segregate Now!
context: After that...\he'll be placed under strict surveillance,\and prohibited from seeing his human victim for the foreseeable future.\After the Ikebukuro Incident and this one,\public opinion is leaning in a harsher direction.\Protests Intensify After Introduction of Red-Eye Protection Bill\The Red-eye Protection Bill was submitted to the Diet,\Vampires Really Do Exist!! Segregate Now! response:	but all it will do is place more restrictions on devils.
context: he'll be placed under strict surveillance,\and prohibited from seeing his human victim for the foreseeable future.\After the Ikebukuro Incident and this one,\public opinion is leaning in a harsher direction.\Protests Intensify After Introduction of Red-Eye Protection Bill\The Red-eye Protection Bill was submitted to the Diet,\Vampires Really Do Exist!! Segregate Now!\but all it will do is place more restrictions on devils. response:	Segregate Now!
context: and prohibited from seeing his human victim for the foreseeable future.\After the Ikebukuro Incident and this one,\public opinion is leaning in a harsher direction.\Protests Intensify After Introduction of Red-Eye Protection Bill\The Red-eye Protection Bill was submitted to the Diet,\Vampires Really Do Exist!! Segregate Now!\but all it will do is place more restrictions on devils.\Segregate Now! response:	In the current political climate, the police had no choice but to deal with it the way they did.
context: After the Ikebukuro Incident and this one,\public opinion is leaning in a harsher direction.\Protests Intensify After Introduction of Red-Eye Protection Bill\The Red-eye Protection Bill was submitted to the Diet,\Vampires Really Do Exist!! Segregate Now!\but all it will do is place more restrictions on devils.\Segregate Now!\In the current political climate, the police had no choice but to deal with it the way they did. response:	But...
context: public opinion is leaning in a harsher direction.\Protests Intensify After Introduction of Red-Eye Protection Bill\The Red-eye Protection Bill was submitted to the Diet,\Vampires Really Do Exist!! Segregate Now!\but all it will do is place more restrictions on devils.\Segregate Now!\In the current political climate, the police had no choice but to deal with it the way they did.\But... response:	if I had my way, I want you and Anzai to be together.
context: Protests Intensify After Introduction of Red-Eye Protection Bill\The Red-eye Protection Bill was submitted to the Diet,\Vampires Really Do Exist!! Segregate Now!\but all it will do is place more restrictions on devils.\Segregate Now!\In the current political climate, the police had no choice but to deal with it the way they did.\But...\if I had my way, I want you and Anzai to be together. response:	A human-devil couple like you two
context: The Red-eye Protection Bill was submitted to the Diet,\Vampires Really Do Exist!! Segregate Now!\but all it will do is place more restrictions on devils.\Segregate Now!\In the current political climate, the police had no choice but to deal with it the way they did.\But...\if I had my way, I want you and Anzai to be together.\A human-devil couple like you two response:	would be a symbol of hope for those of us who want to coexist.
context: Vampires Really Do Exist!! Segregate Now!\but all it will do is place more restrictions on devils.\Segregate Now!\In the current political climate, the police had no choice but to deal with it the way they did.\But...\if I had my way, I want you and Anzai to be together.\A human-devil couple like you two\would be a symbol of hope for those of us who want to coexist. response:	I see. So F Squad is...
context: but all it will do is place more restrictions on devils.\Segregate Now!\In the current political climate, the police had no choice but to deal with it the way they did.\But...\if I had my way, I want you and Anzai to be together.\A human-devil couple like you two\would be a symbol of hope for those of us who want to coexist.\I see. So F Squad is... response:	I asked them to come up with a way to lighten your punishment, but...
context: Segregate Now!\In the current political climate, the police had no choice but to deal with it the way they did.\But...\if I had my way, I want you and Anzai to be together.\A human-devil couple like you two\would be a symbol of hope for those of us who want to coexist.\I see. So F Squad is...\I asked them to come up with a way to lighten your punishment, but... response:	No, it's okay.
context: In the current political climate, the police had no choice but to deal with it the way they did.\But...\if I had my way, I want you and Anzai to be together.\A human-devil couple like you two\would be a symbol of hope for those of us who want to coexist.\I see. So F Squad is...\I asked them to come up with a way to lighten your punishment, but...\No, it's okay. response:	If something like this were to happen again...
context: But...\if I had my way, I want you and Anzai to be together.\A human-devil couple like you two\would be a symbol of hope for those of us who want to coexist.\I see. So F Squad is...\I asked them to come up with a way to lighten your punishment, but...\No, it's okay.\If something like this were to happen again... response:	I think I would...
context: if I had my way, I want you and Anzai to be together.\A human-devil couple like you two\would be a symbol of hope for those of us who want to coexist.\I see. So F Squad is...\I asked them to come up with a way to lighten your punishment, but...\No, it's okay.\If something like this were to happen again...\I think I would... response:	I'd kill Tsukasa.
context: A human-devil couple like you two\would be a symbol of hope for those of us who want to coexist.\I see. So F Squad is...\I asked them to come up with a way to lighten your punishment, but...\No, it's okay.\If something like this were to happen again...\I think I would...\I'd kill Tsukasa. response:	Devils just don't...
context: would be a symbol of hope for those of us who want to coexist.\I see. So F Squad is...\I asked them to come up with a way to lighten your punishment, but...\No, it's okay.\If something like this were to happen again...\I think I would...\I'd kill Tsukasa.\Devils just don't... response:	deserve to live with humans.
context: I see. So F Squad is...\I asked them to come up with a way to lighten your punishment, but...\No, it's okay.\If something like this were to happen again...\I think I would...\I'd kill Tsukasa.\Devils just don't...\deserve to live with humans. response:	I always knew... devils were just...
context: I asked them to come up with a way to lighten your punishment, but...\No, it's okay.\If something like this were to happen again...\I think I would...\I'd kill Tsukasa.\Devils just don't...\deserve to live with humans.\I always knew... devils were just... response:	I'm not going to comment on your relationship with Taira.
context: No, it's okay.\If something like this were to happen again...\I think I would...\I'd kill Tsukasa.\Devils just don't...\deserve to live with humans.\I always knew... devils were just...\I'm not going to comment on your relationship with Taira. response:	And I don't have an answer to whether or not we can coexist.
context: If something like this were to happen again...\I think I would...\I'd kill Tsukasa.\Devils just don't...\deserve to live with humans.\I always knew... devils were just...\I'm not going to comment on your relationship with Taira.\And I don't have an answer to whether or not we can coexist. response:	But...
context: I think I would...\I'd kill Tsukasa.\Devils just don't...\deserve to live with humans.\I always knew... devils were just...\I'm not going to comment on your relationship with Taira.\And I don't have an answer to whether or not we can coexist.\But... response:	No matter what happens...
context: I'd kill Tsukasa.\Devils just don't...\deserve to live with humans.\I always knew... devils were just...\I'm not going to comment on your relationship with Taira.\And I don't have an answer to whether or not we can coexist.\But...\No matter what happens... response:	I want us all to be able to live our lives together.
context: Devils just don't...\deserve to live with humans.\I always knew... devils were just...\I'm not going to comment on your relationship with Taira.\And I don't have an answer to whether or not we can coexist.\But...\No matter what happens...\I want us all to be able to live our lives together. response:	Isn't that what you want?
context: deserve to live with humans.\I always knew... devils were just...\I'm not going to comment on your relationship with Taira.\And I don't have an answer to whether or not we can coexist.\But...\No matter what happens...\I want us all to be able to live our lives together.\Isn't that what you want? response:	It is what I want!
context: I always knew... devils were just...\I'm not going to comment on your relationship with Taira.\And I don't have an answer to whether or not we can coexist.\But...\No matter what happens...\I want us all to be able to live our lives together.\Isn't that what you want?\It is what I want! response:	But...
context: I'm not going to comment on your relationship with Taira.\And I don't have an answer to whether or not we can coexist.\But...\No matter what happens...\I want us all to be able to live our lives together.\Isn't that what you want?\It is what I want!\But... response:	Are you going to talk to Taira?
context: And I don't have an answer to whether or not we can coexist.\But...\No matter what happens...\I want us all to be able to live our lives together.\Isn't that what you want?\It is what I want!\But...\Are you going to talk to Taira? response:	Starting tomorrow afternoon,
context: But...\No matter what happens...\I want us all to be able to live our lives together.\Isn't that what you want?\It is what I want!\But...\Are you going to talk to Taira?\Starting tomorrow afternoon, response:	you and Anzai will be banned from making any contact with each other whatsoever.
context: No matter what happens...\I want us all to be able to live our lives together.\Isn't that what you want?\It is what I want!\But...\Are you going to talk to Taira?\Starting tomorrow afternoon,\you and Anzai will be banned from making any contact with each other whatsoever. response:	If there's anything you want to tell him, you have until then to see him.
context: I want us all to be able to live our lives together.\Isn't that what you want?\It is what I want!\But...\Are you going to talk to Taira?\Starting tomorrow afternoon,\you and Anzai will be banned from making any contact with each other whatsoever.\If there's anything you want to tell him, you have until then to see him. response:	Talk to her? What would I say?
context: Isn't that what you want?\It is what I want!\But...\Are you going to talk to Taira?\Starting tomorrow afternoon,\you and Anzai will be banned from making any contact with each other whatsoever.\If there's anything you want to tell him, you have until then to see him.\Talk to her? What would I say? response:	I still...
context: It is what I want!\But...\Are you going to talk to Taira?\Starting tomorrow afternoon,\you and Anzai will be banned from making any contact with each other whatsoever.\If there's anything you want to tell him, you have until then to see him.\Talk to her? What would I say?\I still... response:	Anzai, have you had any more flashbacks since we last talked?
context: But...\Are you going to talk to Taira?\Starting tomorrow afternoon,\you and Anzai will be banned from making any contact with each other whatsoever.\If there's anything you want to tell him, you have until then to see him.\Talk to her? What would I say?\I still...\Anzai, have you had any more flashbacks since we last talked? response:	Yeah, I was a kid.
context: Are you going to talk to Taira?\Starting tomorrow afternoon,\you and Anzai will be banned from making any contact with each other whatsoever.\If there's anything you want to tell him, you have until then to see him.\Talk to her? What would I say?\I still...\Anzai, have you had any more flashbacks since we last talked?\Yeah, I was a kid. response:	I met Kikuhara at ONLO.
context: Starting tomorrow afternoon,\you and Anzai will be banned from making any contact with each other whatsoever.\If there's anything you want to tell him, you have until then to see him.\Talk to her? What would I say?\I still...\Anzai, have you had any more flashbacks since we last talked?\Yeah, I was a kid.\I met Kikuhara at ONLO. response:	He took me to the basement...
context: you and Anzai will be banned from making any contact with each other whatsoever.\If there's anything you want to tell him, you have until then to see him.\Talk to her? What would I say?\I still...\Anzai, have you had any more flashbacks since we last talked?\Yeah, I was a kid.\I met Kikuhara at ONLO.\He took me to the basement... response:	and showed me my father...
context: If there's anything you want to tell him, you have until then to see him.\Talk to her? What would I say?\I still...\Anzai, have you had any more flashbacks since we last talked?\Yeah, I was a kid.\I met Kikuhara at ONLO.\He took me to the basement...\and showed me my father... response:	Tamaki Anzai.
context: Talk to her? What would I say?\I still...\Anzai, have you had any more flashbacks since we last talked?\Yeah, I was a kid.\I met Kikuhara at ONLO.\He took me to the basement...\and showed me my father...\Tamaki Anzai. response:	He said he was a devil and a mass-murderer.
context: I still...\Anzai, have you had any more flashbacks since we last talked?\Yeah, I was a kid.\I met Kikuhara at ONLO.\He took me to the basement...\and showed me my father...\Tamaki Anzai.\He said he was a devil and a mass-murderer. response:	Your father, Tamaki Anzai...
context: Anzai, have you had any more flashbacks since we last talked?\Yeah, I was a kid.\I met Kikuhara at ONLO.\He took me to the basement...\and showed me my father...\Tamaki Anzai.\He said he was a devil and a mass-murderer.\Your father, Tamaki Anzai... response:	had a human girlfriend before he met your mother.
context: Yeah, I was a kid.\I met Kikuhara at ONLO.\He took me to the basement...\and showed me my father...\Tamaki Anzai.\He said he was a devil and a mass-murderer.\Your father, Tamaki Anzai...\had a human girlfriend before he met your mother. response:	But she was killed by a bunch of humans.
context: I met Kikuhara at ONLO.\He took me to the basement...\and showed me my father...\Tamaki Anzai.\He said he was a devil and a mass-murderer.\Your father, Tamaki Anzai...\had a human girlfriend before he met your mother.\But she was killed by a bunch of humans. response:	Tamaki took revenge on the men who killed her.
context: He took me to the basement...\and showed me my father...\Tamaki Anzai.\He said he was a devil and a mass-murderer.\Your father, Tamaki Anzai...\had a human girlfriend before he met your mother.\But she was killed by a bunch of humans.\Tamaki took revenge on the men who killed her. response:	But after he drank the blood of his victims, he lost control.
context: and showed me my father...\Tamaki Anzai.\He said he was a devil and a mass-murderer.\Your father, Tamaki Anzai...\had a human girlfriend before he met your mother.\But she was killed by a bunch of humans.\Tamaki took revenge on the men who killed her.\But after he drank the blood of his victims, he lost control. response:	He killed 10 more innocent people, passersby and the like.
context: Tamaki Anzai.\He said he was a devil and a mass-murderer.\Your father, Tamaki Anzai...\had a human girlfriend before he met your mother.\But she was killed by a bunch of humans.\Tamaki took revenge on the men who killed her.\But after he drank the blood of his victims, he lost control.\He killed 10 more innocent people, passersby and the like. response:	He'd lost his love, murdered 15 people...
context: He said he was a devil and a mass-murderer.\Your father, Tamaki Anzai...\had a human girlfriend before he met your mother.\But she was killed by a bunch of humans.\Tamaki took revenge on the men who killed her.\But after he drank the blood of his victims, he lost control.\He killed 10 more innocent people, passersby and the like.\He'd lost his love, murdered 15 people... response:	By the time they brought him to ONLO, he was a living corpse,
context: Your father, Tamaki Anzai...\had a human girlfriend before he met your mother.\But she was killed by a bunch of humans.\Tamaki took revenge on the men who killed her.\But after he drank the blood of his victims, he lost control.\He killed 10 more innocent people, passersby and the like.\He'd lost his love, murdered 15 people...\By the time they brought him to ONLO, he was a living corpse, response:	ruled by his addiction to blood.
context: had a human girlfriend before he met your mother.\But she was killed by a bunch of humans.\Tamaki took revenge on the men who killed her.\But after he drank the blood of his victims, he lost control.\He killed 10 more innocent people, passersby and the like.\He'd lost his love, murdered 15 people...\By the time they brought him to ONLO, he was a living corpse,\ruled by his addiction to blood. response:	Your mother knew that's the kind of man he was.
context: But she was killed by a bunch of humans.\Tamaki took revenge on the men who killed her.\But after he drank the blood of his victims, he lost control.\He killed 10 more innocent people, passersby and the like.\He'd lost his love, murdered 15 people...\By the time they brought him to ONLO, he was a living corpse,\ruled by his addiction to blood.\Your mother knew that's the kind of man he was. response:	I don't know what she ever saw in him.
context: Tamaki took revenge on the men who killed her.\But after he drank the blood of his victims, he lost control.\He killed 10 more innocent people, passersby and the like.\He'd lost his love, murdered 15 people...\By the time they brought him to ONLO, he was a living corpse,\ruled by his addiction to blood.\Your mother knew that's the kind of man he was.\I don't know what she ever saw in him. response:	She told me she can't explain it herself.
context: But after he drank the blood of his victims, he lost control.\He killed 10 more innocent people, passersby and the like.\He'd lost his love, murdered 15 people...\By the time they brought him to ONLO, he was a living corpse,\ruled by his addiction to blood.\Your mother knew that's the kind of man he was.\I don't know what she ever saw in him.\She told me she can't explain it herself. response:	But from the first time they met...
context: He killed 10 more innocent people, passersby and the like.\He'd lost his love, murdered 15 people...\By the time they brought him to ONLO, he was a living corpse,\ruled by his addiction to blood.\Your mother knew that's the kind of man he was.\I don't know what she ever saw in him.\She told me she can't explain it herself.\But from the first time they met... response:	And by the time I saw him again, I had fallen in love.
context: He'd lost his love, murdered 15 people...\By the time they brought him to ONLO, he was a living corpse,\ruled by his addiction to blood.\Your mother knew that's the kind of man he was.\I don't know what she ever saw in him.\She told me she can't explain it herself.\But from the first time they met...\And by the time I saw him again, I had fallen in love. response:	You may be a devil, but that's not all you are.
context: By the time they brought him to ONLO, he was a living corpse,\ruled by his addiction to blood.\Your mother knew that's the kind of man he was.\I don't know what she ever saw in him.\She told me she can't explain it herself.\But from the first time they met...\And by the time I saw him again, I had fallen in love.\You may be a devil, but that's not all you are. response:	If you fixate on just one part of yourself, your thoughts skew too far in one direction.
context: ruled by his addiction to blood.\Your mother knew that's the kind of man he was.\I don't know what she ever saw in him.\She told me she can't explain it herself.\But from the first time they met...\And by the time I saw him again, I had fallen in love.\You may be a devil, but that's not all you are.\If you fixate on just one part of yourself, your thoughts skew too far in one direction. response:	Be brave and face the woman you love.
context: Your mother knew that's the kind of man he was.\I don't know what she ever saw in him.\She told me she can't explain it herself.\But from the first time they met...\And by the time I saw him again, I had fallen in love.\You may be a devil, but that's not all you are.\If you fixate on just one part of yourself, your thoughts skew too far in one direction.\Be brave and face the woman you love. response:	Did you hear about my punishment?
context: I don't know what she ever saw in him.\She told me she can't explain it herself.\But from the first time they met...\And by the time I saw him again, I had fallen in love.\You may be a devil, but that's not all you are.\If you fixate on just one part of yourself, your thoughts skew too far in one direction.\Be brave and face the woman you love.\Did you hear about my punishment? response:	Yeah.
context: She told me she can't explain it herself.\But from the first time they met...\And by the time I saw him again, I had fallen in love.\You may be a devil, but that's not all you are.\If you fixate on just one part of yourself, your thoughts skew too far in one direction.\Be brave and face the woman you love.\Did you hear about my punishment?\Yeah. response:	I'm glad you called me out here.
context: But from the first time they met...\And by the time I saw him again, I had fallen in love.\You may be a devil, but that's not all you are.\If you fixate on just one part of yourself, your thoughts skew too far in one direction.\Be brave and face the woman you love.\Did you hear about my punishment?\Yeah.\I'm glad you called me out here. response:	There's something I really had to say to you.
context: And by the time I saw him again, I had fallen in love.\You may be a devil, but that's not all you are.\If you fixate on just one part of yourself, your thoughts skew too far in one direction.\Be brave and face the woman you love.\Did you hear about my punishment?\Yeah.\I'm glad you called me out here.\There's something I really had to say to you. response:	I'm glad you're alive.
context: You may be a devil, but that's not all you are.\If you fixate on just one part of yourself, your thoughts skew too far in one direction.\Be brave and face the woman you love.\Did you hear about my punishment?\Yeah.\I'm glad you called me out here.\There's something I really had to say to you.\I'm glad you're alive. response:	Thank you for saving me.
context: If you fixate on just one part of yourself, your thoughts skew too far in one direction.\Be brave and face the woman you love.\Did you hear about my punishment?\Yeah.\I'm glad you called me out here.\There's something I really had to say to you.\I'm glad you're alive.\Thank you for saving me. response:	I was so close to finding the key to confronting the devil inside me.
context: Be brave and face the woman you love.\Did you hear about my punishment?\Yeah.\I'm glad you called me out here.\There's something I really had to say to you.\I'm glad you're alive.\Thank you for saving me.\I was so close to finding the key to confronting the devil inside me. response:	If I'd had a little more time...
context: Did you hear about my punishment?\Yeah.\I'm glad you called me out here.\There's something I really had to say to you.\I'm glad you're alive.\Thank you for saving me.\I was so close to finding the key to confronting the devil inside me.\If I'd had a little more time... response:	I might have... found it.
context: Yeah.\I'm glad you called me out here.\There's something I really had to say to you.\I'm glad you're alive.\Thank you for saving me.\I was so close to finding the key to confronting the devil inside me.\If I'd had a little more time...\I might have... found it. response:	I might have found hope... found a future.
context: I'm glad you called me out here.\There's something I really had to say to you.\I'm glad you're alive.\Thank you for saving me.\I was so close to finding the key to confronting the devil inside me.\If I'd had a little more time...\I might have... found it.\I might have found hope... found a future. response:	I'm sorry!
context: There's something I really had to say to you.\I'm glad you're alive.\Thank you for saving me.\I was so close to finding the key to confronting the devil inside me.\If I'd had a little more time...\I might have... found it.\I might have found hope... found a future.\I'm sorry! response:	Oh, no!
context: I'm glad you're alive.\Thank you for saving me.\I was so close to finding the key to confronting the devil inside me.\If I'd had a little more time...\I might have... found it.\I might have found hope... found a future.\I'm sorry!\Oh, no! response:	If you hadn't given me your blood, I would have died!
context: Thank you for saving me.\I was so close to finding the key to confronting the devil inside me.\If I'd had a little more time...\I might have... found it.\I might have found hope... found a future.\I'm sorry!\Oh, no!\If you hadn't given me your blood, I would have died! response:	That wasn't what I meant.
context: I was so close to finding the key to confronting the devil inside me.\If I'd had a little more time...\I might have... found it.\I might have found hope... found a future.\I'm sorry!\Oh, no!\If you hadn't given me your blood, I would have died!\That wasn't what I meant. response:	I wouldn't have made it this far without you.
context: If I'd had a little more time...\I might have... found it.\I might have found hope... found a future.\I'm sorry!\Oh, no!\If you hadn't given me your blood, I would have died!\That wasn't what I meant.\I wouldn't have made it this far without you. response:	If I lost you now...
context: I might have... found it.\I might have found hope... found a future.\I'm sorry!\Oh, no!\If you hadn't given me your blood, I would have died!\That wasn't what I meant.\I wouldn't have made it this far without you.\If I lost you now... response:	I feel like everything I've gained will slip through my fingers.
context: I might have found hope... found a future.\I'm sorry!\Oh, no!\If you hadn't given me your blood, I would have died!\That wasn't what I meant.\I wouldn't have made it this far without you.\If I lost you now...\I feel like everything I've gained will slip through my fingers. response:	I'm scared.
context: I'm sorry!\Oh, no!\If you hadn't given me your blood, I would have died!\That wasn't what I meant.\I wouldn't have made it this far without you.\If I lost you now...\I feel like everything I've gained will slip through my fingers.\I'm scared. response:	Don't worry.
context: Oh, no!\If you hadn't given me your blood, I would have died!\That wasn't what I meant.\I wouldn't have made it this far without you.\If I lost you now...\I feel like everything I've gained will slip through my fingers.\I'm scared.\Don't worry. response:	You'll be alright.
context: If you hadn't given me your blood, I would have died!\That wasn't what I meant.\I wouldn't have made it this far without you.\If I lost you now...\I feel like everything I've gained will slip through my fingers.\I'm scared.\Don't worry.\You'll be alright. response:	I always hated the devil inside me.
context: That wasn't what I meant.\I wouldn't have made it this far without you.\If I lost you now...\I feel like everything I've gained will slip through my fingers.\I'm scared.\Don't worry.\You'll be alright.\I always hated the devil inside me. response:	I always hated myself.
context: I wouldn't have made it this far without you.\If I lost you now...\I feel like everything I've gained will slip through my fingers.\I'm scared.\Don't worry.\You'll be alright.\I always hated the devil inside me.\I always hated myself. response:	That's why, when you said you liked me...
context: If I lost you now...\I feel like everything I've gained will slip through my fingers.\I'm scared.\Don't worry.\You'll be alright.\I always hated the devil inside me.\I always hated myself.\That's why, when you said you liked me... response:	Your smile was so blindingly bright,
context: I feel like everything I've gained will slip through my fingers.\I'm scared.\Don't worry.\You'll be alright.\I always hated the devil inside me.\I always hated myself.\That's why, when you said you liked me...\Your smile was so blindingly bright, response:	I couldn't quite accept it.
context: I'm scared.\Don't worry.\You'll be alright.\I always hated the devil inside me.\I always hated myself.\That's why, when you said you liked me...\Your smile was so blindingly bright,\I couldn't quite accept it. response:	Would you let me hear it, just one more time?
context: Don't worry.\You'll be alright.\I always hated the devil inside me.\I always hated myself.\That's why, when you said you liked me...\Your smile was so blindingly bright,\I couldn't quite accept it.\Would you let me hear it, just one more time? response:	How you feel about me?
context: You'll be alright.\I always hated the devil inside me.\I always hated myself.\That's why, when you said you liked me...\Your smile was so blindingly bright,\I couldn't quite accept it.\Would you let me hear it, just one more time?\How you feel about me? response:	I love you, Anzai.
context: I always hated the devil inside me.\I always hated myself.\That's why, when you said you liked me...\Your smile was so blindingly bright,\I couldn't quite accept it.\Would you let me hear it, just one more time?\How you feel about me?\I love you, Anzai. response:	I love you, too.
context: I always hated myself.\That's why, when you said you liked me...\Your smile was so blindingly bright,\I couldn't quite accept it.\Would you let me hear it, just one more time?\How you feel about me?\I love you, Anzai.\I love you, too. response:	Look me in the eye and say it again.
context: That's why, when you said you liked me...\Your smile was so blindingly bright,\I couldn't quite accept it.\Would you let me hear it, just one more time?\How you feel about me?\I love you, Anzai.\I love you, too.\Look me in the eye and say it again. response:	I love you.
context: Your smile was so blindingly bright,\I couldn't quite accept it.\Would you let me hear it, just one more time?\How you feel about me?\I love you, Anzai.\I love you, too.\Look me in the eye and say it again.\I love you. response:	Yeah.
context: I couldn't quite accept it.\Would you let me hear it, just one more time?\How you feel about me?\I love you, Anzai.\I love you, too.\Look me in the eye and say it again.\I love you.\Yeah. response:	Don't worry.
context: Would you let me hear it, just one more time?\How you feel about me?\I love you, Anzai.\I love you, too.\Look me in the eye and say it again.\I love you.\Yeah.\Don't worry. response:	I'll wait for you.
context: How you feel about me?\I love you, Anzai.\I love you, too.\Look me in the eye and say it again.\I love you.\Yeah.\Don't worry.\I'll wait for you. response:	We have to move forward.
context: I love you, Anzai.\I love you, too.\Look me in the eye and say it again.\I love you.\Yeah.\Don't worry.\I'll wait for you.\We have to move forward. response:	If Anzai is moving forward...
context: I love you, too.\Look me in the eye and say it again.\I love you.\Yeah.\Don't worry.\I'll wait for you.\We have to move forward.\If Anzai is moving forward... response:	I'll move forward, too.
context: Look me in the eye and say it again.\I love you.\Yeah.\Don't worry.\I'll wait for you.\We have to move forward.\If Anzai is moving forward...\I'll move forward, too. response:	Sotto tokete yuku you ni
context: I love you.\Yeah.\Don't worry.\I'll wait for you.\We have to move forward.\If Anzai is moving forward...\I'll move forward, too.\Sotto tokete yuku you ni response:	Motto ai shiaetara
context: Yeah.\Don't worry.\I'll wait for you.\We have to move forward.\If Anzai is moving forward...\I'll move forward, too.\Sotto tokete yuku you ni\Motto ai shiaetara response:	Nani o tsutaerareta no
context: Don't worry.\I'll wait for you.\We have to move forward.\If Anzai is moving forward...\I'll move forward, too.\Sotto tokete yuku you ni\Motto ai shiaetara\Nani o tsutaerareta no response:	Ai o tsumugenai meguriawase
context: I'll wait for you.\We have to move forward.\If Anzai is moving forward...\I'll move forward, too.\Sotto tokete yuku you ni\Motto ai shiaetara\Nani o tsutaerareta no\Ai o tsumugenai meguriawase response:	Dare ka yurushite
context: We have to move forward.\If Anzai is moving forward...\I'll move forward, too.\Sotto tokete yuku you ni\Motto ai shiaetara\Nani o tsutaerareta no\Ai o tsumugenai meguriawase\Dare ka yurushite response:	Kegareta sugata ga boku de aru koto o
context: If Anzai is moving forward...\I'll move forward, too.\Sotto tokete yuku you ni\Motto ai shiaetara\Nani o tsutaerareta no\Ai o tsumugenai meguriawase\Dare ka yurushite\Kegareta sugata ga boku de aru koto o response:	Aa doushite
context: I'll move forward, too.\Sotto tokete yuku you ni\Motto ai shiaetara\Nani o tsutaerareta no\Ai o tsumugenai meguriawase\Dare ka yurushite\Kegareta sugata ga boku de aru koto o\Aa doushite response:	Fureru yubi ga furueteiru
context: Sotto tokete yuku you ni\Motto ai shiaetara\Nani o tsutaerareta no\Ai o tsumugenai meguriawase\Dare ka yurushite\Kegareta sugata ga boku de aru koto o\Aa doushite\Fureru yubi ga furueteiru response:	It's story of fight together
context: Motto ai shiaetara\Nani o tsutaerareta no\Ai o tsumugenai meguriawase\Dare ka yurushite\Kegareta sugata ga boku de aru koto o\Aa doushite\Fureru yubi ga furueteiru\It's story of fight together response:	Dakishimetai yo
context: Nani o tsutaerareta no\Ai o tsumugenai meguriawase\Dare ka yurushite\Kegareta sugata ga boku de aru koto o\Aa doushite\Fureru yubi ga furueteiru\It's story of fight together\Dakishimetai yo response:	Kizu tsukezu ni mamoritai yo
context: Ai o tsumugenai meguriawase\Dare ka yurushite\Kegareta sugata ga boku de aru koto o\Aa doushite\Fureru yubi ga furueteiru\It's story of fight together\Dakishimetai yo\Kizu tsukezu ni mamoritai yo response:	Anata dake o
context: Dare ka yurushite\Kegareta sugata ga boku de aru koto o\Aa doushite\Fureru yubi ga furueteiru\It's story of fight together\Dakishimetai yo\Kizu tsukezu ni mamoritai yo\Anata dake o response:	It's story of desire forever
context: Kegareta sugata ga boku de aru koto o\Aa doushite\Fureru yubi ga furueteiru\It's story of fight together\Dakishimetai yo\Kizu tsukezu ni mamoritai yo\Anata dake o\It's story of desire forever response:	Aragai tsuzukeru
context: Aa doushite\Fureru yubi ga furueteiru\It's story of fight together\Dakishimetai yo\Kizu tsukezu ni mamoritai yo\Anata dake o\It's story of desire forever\Aragai tsuzukeru response:	Wakiagaru shoudou ni
context: Fureru yubi ga furueteiru\It's story of fight together\Dakishimetai yo\Kizu tsukezu ni mamoritai yo\Anata dake o\It's story of desire forever\Aragai tsuzukeru\Wakiagaru shoudou ni response:	Aa, mata boku wa...
context: It's story of fight together\Dakishimetai yo\Kizu tsukezu ni mamoritai yo\Anata dake o\It's story of desire forever\Aragai tsuzukeru\Wakiagaru shoudou ni\Aa, mata boku wa... response:	Deep red dawn
context: Dakishimetai yo\Kizu tsukezu ni mamoritai yo\Anata dake o\It's story of desire forever\Aragai tsuzukeru\Wakiagaru shoudou ni\Aa, mata boku wa...\Deep red dawn response:	Sotto futari tokete yuku you ni...
context: Kizu tsukezu ni mamoritai yo\Anata dake o\It's story of desire forever\Aragai tsuzukeru\Wakiagaru shoudou ni\Aa, mata boku wa...\Deep red dawn\Sotto futari tokete yuku you ni... response:	I like your hair.
context: Anata dake o\It's story of desire forever\Aragai tsuzukeru\Wakiagaru shoudou ni\Aa, mata boku wa...\Deep red dawn\Sotto futari tokete yuku you ni...\I like your hair. response:	Very cool.
context: It's story of desire forever\Aragai tsuzukeru\Wakiagaru shoudou ni\Aa, mata boku wa...\Deep red dawn\Sotto futari tokete yuku you ni...\I like your hair.\Very cool. response:	You're...
context: Aragai tsuzukeru\Wakiagaru shoudou ni\Aa, mata boku wa...\Deep red dawn\Sotto futari tokete yuku you ni...\I like your hair.\Very cool.\You're... response:	more beautiful.
context: Wakiagaru shoudou ni\Aa, mata boku wa...\Deep red dawn\Sotto futari tokete yuku you ni...\I like your hair.\Very cool.\You're...\more beautiful. response:	The Potential for Human and Red-Eye Coexistence
context: Aa, mata boku wa...\Deep red dawn\Sotto futari tokete yuku you ni...\I like your hair.\Very cool.\You're...\more beautiful.\The Potential for Human and Red-Eye Coexistence response:	Tsukasa Taira