context: Mongolia response:	Pub
context: Mongolia\Pub response:	But, wow... To think we played over sixty sets and only won three...
context: Mongolia\Pub\But, wow... To think we played over sixty sets and only won three... response:	Manabu! Come on, drink up.
context: Mongolia\Pub\But, wow... To think we played over sixty sets and only won three...\Manabu! Come on, drink up. response:	We've definitely gone down a thorny path.
context: Mongolia\Pub\But, wow... To think we played over sixty sets and only won three...\Manabu! Come on, drink up.\We've definitely gone down a thorny path. response:	No, thanks. If I drink any more, I'll definitely feel it tomorrow.
context: Mongolia\Pub\But, wow... To think we played over sixty sets and only won three...\Manabu! Come on, drink up.\We've definitely gone down a thorny path.\No, thanks. If I drink any more, I'll definitely feel it tomorrow. response:	That's for sure.
context: Mongolia\Pub\But, wow... To think we played over sixty sets and only won three...\Manabu! Come on, drink up.\We've definitely gone down a thorny path.\No, thanks. If I drink any more, I'll definitely feel it tomorrow.\That's for sure. response:	Well, if they were like they were during the Seijoh match,
context: Mongolia\Pub\But, wow... To think we played over sixty sets and only won three...\Manabu! Come on, drink up.\We've definitely gone down a thorny path.\No, thanks. If I drink any more, I'll definitely feel it tomorrow.\That's for sure.\Well, if they were like they were during the Seijoh match, response:	they could have probably won a few more.
context: Pub\But, wow... To think we played over sixty sets and only won three...\Manabu! Come on, drink up.\We've definitely gone down a thorny path.\No, thanks. If I drink any more, I'll definitely feel it tomorrow.\That's for sure.\Well, if they were like they were during the Seijoh match,\they could have probably won a few more. response:	Manabu, are you saying you're too good for my liquor?
context: But, wow... To think we played over sixty sets and only won three...\Manabu! Come on, drink up.\We've definitely gone down a thorny path.\No, thanks. If I drink any more, I'll definitely feel it tomorrow.\That's for sure.\Well, if they were like they were during the Seijoh match,\they could have probably won a few more.\Manabu, are you saying you're too good for my liquor? response:	The team's offense was styled around Hinata and Kageyama's
context: Manabu! Come on, drink up.\We've definitely gone down a thorny path.\No, thanks. If I drink any more, I'll definitely feel it tomorrow.\That's for sure.\Well, if they were like they were during the Seijoh match,\they could have probably won a few more.\Manabu, are you saying you're too good for my liquor?\The team's offense was styled around Hinata and Kageyama's response:	weirdo quick and their bait routine, and they executed them well.
context: We've definitely gone down a thorny path.\No, thanks. If I drink any more, I'll definitely feel it tomorrow.\That's for sure.\Well, if they were like they were during the Seijoh match,\they could have probably won a few more.\Manabu, are you saying you're too good for my liquor?\The team's offense was styled around Hinata and Kageyama's\weirdo quick and their bait routine, and they executed them well. response:	No, um...
context: No, thanks. If I drink any more, I'll definitely feel it tomorrow.\That's for sure.\Well, if they were like they were during the Seijoh match,\they could have probably won a few more.\Manabu, are you saying you're too good for my liquor?\The team's offense was styled around Hinata and Kageyama's\weirdo quick and their bait routine, and they executed them well.\No, um... response:	I'm just kidding!
context: That's for sure.\Well, if they were like they were during the Seijoh match,\they could have probably won a few more.\Manabu, are you saying you're too good for my liquor?\The team's offense was styled around Hinata and Kageyama's\weirdo quick and their bait routine, and they executed them well.\No, um...\I'm just kidding! response:	But we could see the limits of that strategy.
context: Well, if they were like they were during the Seijoh match,\they could have probably won a few more.\Manabu, are you saying you're too good for my liquor?\The team's offense was styled around Hinata and Kageyama's\weirdo quick and their bait routine, and they executed them well.\No, um...\I'm just kidding!\But we could see the limits of that strategy. response:	The truth is that they lost to Seijoh,
context: they could have probably won a few more.\Manabu, are you saying you're too good for my liquor?\The team's offense was styled around Hinata and Kageyama's\weirdo quick and their bait routine, and they executed them well.\No, um...\I'm just kidding!\But we could see the limits of that strategy.\The truth is that they lost to Seijoh, response:	and that's why they started changing things up.
context: Manabu, are you saying you're too good for my liquor?\The team's offense was styled around Hinata and Kageyama's\weirdo quick and their bait routine, and they executed them well.\No, um...\I'm just kidding!\But we could see the limits of that strategy.\The truth is that they lost to Seijoh,\and that's why they started changing things up. response:	I know.
context: The team's offense was styled around Hinata and Kageyama's\weirdo quick and their bait routine, and they executed them well.\No, um...\I'm just kidding!\But we could see the limits of that strategy.\The truth is that they lost to Seijoh,\and that's why they started changing things up.\I know. response:	They're all developing their own cogs.
context: weirdo quick and their bait routine, and they executed them well.\No, um...\I'm just kidding!\But we could see the limits of that strategy.\The truth is that they lost to Seijoh,\and that's why they started changing things up.\I know.\They're all developing their own cogs. response:	There's no way they could beat
context: No, um...\I'm just kidding!\But we could see the limits of that strategy.\The truth is that they lost to Seijoh,\and that's why they started changing things up.\I know.\They're all developing their own cogs.\There's no way they could beat response:	the powerhouse schools of Kanto while they're still incomplete.
context: I'm just kidding!\But we could see the limits of that strategy.\The truth is that they lost to Seijoh,\and that's why they started changing things up.\I know.\They're all developing their own cogs.\There's no way they could beat\the powerhouse schools of Kanto while they're still incomplete. response:	But... Once all the cogs fit together...
context: But we could see the limits of that strategy.\The truth is that they lost to Seijoh,\and that's why they started changing things up.\I know.\They're all developing their own cogs.\There's no way they could beat\the powerhouse schools of Kanto while they're still incomplete.\But... Once all the cogs fit together... response:	Hey! Don't think that you can beat Nekoma that easily.
context: The truth is that they lost to Seijoh,\and that's why they started changing things up.\I know.\They're all developing their own cogs.\There's no way they could beat\the powerhouse schools of Kanto while they're still incomplete.\But... Once all the cogs fit together...\Hey! Don't think that you can beat Nekoma that easily. response:	I certainly didn't mean to say that it would be easy!
context: and that's why they started changing things up.\I know.\They're all developing their own cogs.\There's no way they could beat\the powerhouse schools of Kanto while they're still incomplete.\But... Once all the cogs fit together...\Hey! Don't think that you can beat Nekoma that easily.\I certainly didn't mean to say that it would be easy! response:	But we'll still do our absolute and win.
context: I know.\They're all developing their own cogs.\There's no way they could beat\the powerhouse schools of Kanto while they're still incomplete.\But... Once all the cogs fit together...\Hey! Don't think that you can beat Nekoma that easily.\I certainly didn't mean to say that it would be easy!\But we'll still do our absolute and win. response:	You sure talk big now, Sensei.
context: They're all developing their own cogs.\There's no way they could beat\the powerhouse schools of Kanto while they're still incomplete.\But... Once all the cogs fit together...\Hey! Don't think that you can beat Nekoma that easily.\I certainly didn't mean to say that it would be easy!\But we'll still do our absolute and win.\You sure talk big now, Sensei. response:	You, too, Ukai-chan.
context: There's no way they could beat\the powerhouse schools of Kanto while they're still incomplete.\But... Once all the cogs fit together...\Hey! Don't think that you can beat Nekoma that easily.\I certainly didn't mean to say that it would be easy!\But we'll still do our absolute and win.\You sure talk big now, Sensei.\You, too, Ukai-chan. response:	Karasuno Fukurodani
context: the powerhouse schools of Kanto while they're still incomplete.\But... Once all the cogs fit together...\Hey! Don't think that you can beat Nekoma that easily.\I certainly didn't mean to say that it would be easy!\But we'll still do our absolute and win.\You sure talk big now, Sensei.\You, too, Ukai-chan.\Karasuno Fukurodani response:	This is the final set...
context: But... Once all the cogs fit together...\Hey! Don't think that you can beat Nekoma that easily.\I certainly didn't mean to say that it would be easy!\But we'll still do our absolute and win.\You sure talk big now, Sensei.\You, too, Ukai-chan.\Karasuno Fukurodani\This is the final set... response:	of our losing streak at these away games.
context: Hey! Don't think that you can beat Nekoma that easily.\I certainly didn't mean to say that it would be easy!\But we'll still do our absolute and win.\You sure talk big now, Sensei.\You, too, Ukai-chan.\Karasuno Fukurodani\This is the final set...\of our losing streak at these away games. response:	Let's at least try to win this one set against
context: I certainly didn't mean to say that it would be easy!\But we'll still do our absolute and win.\You sure talk big now, Sensei.\You, too, Ukai-chan.\Karasuno Fukurodani\This is the final set...\of our losing streak at these away games.\Let's at least try to win this one set against response:	the strongest school at the training camp, Fukurodani,
context: But we'll still do our absolute and win.\You sure talk big now, Sensei.\You, too, Ukai-chan.\Karasuno Fukurodani\This is the final set...\of our losing streak at these away games.\Let's at least try to win this one set against\the strongest school at the training camp, Fukurodani, response:	before we go home.
context: You sure talk big now, Sensei.\You, too, Ukai-chan.\Karasuno Fukurodani\This is the final set...\of our losing streak at these away games.\Let's at least try to win this one set against\the strongest school at the training camp, Fukurodani,\before we go home. response:	Yeah!
context: You, too, Ukai-chan.\Karasuno Fukurodani\This is the final set...\of our losing streak at these away games.\Let's at least try to win this one set against\the strongest school at the training camp, Fukurodani,\before we go home.\Yeah! response:	I'll show you my progress
context: Karasuno Fukurodani\This is the final set...\of our losing streak at these away games.\Let's at least try to win this one set against\the strongest school at the training camp, Fukurodani,\before we go home.\Yeah!\I'll show you my progress response:	from the training camp!
context: This is the final set...\of our losing streak at these away games.\Let's at least try to win this one set against\the strongest school at the training camp, Fukurodani,\before we go home.\Yeah!\I'll show you my progress\from the training camp! response:	Haikyu!!
context: of our losing streak at these away games.\Let's at least try to win this one set against\the strongest school at the training camp, Fukurodani,\before we go home.\Yeah!\I'll show you my progress\from the training camp!\Haikyu!! response:	Episode 10: Cogs
context: Let's at least try to win this one set against\the strongest school at the training camp, Fukurodani,\before we go home.\Yeah!\I'll show you my progress\from the training camp!\Haikyu!!\Episode 10: Cogs response:	Karasuno Fukurodani
context: the strongest school at the training camp, Fukurodani,\before we go home.\Yeah!\I'll show you my progress\from the training camp!\Haikyu!!\Episode 10: Cogs\Karasuno Fukurodani response:	Let's play!
context: before we go home.\Yeah!\I'll show you my progress\from the training camp!\Haikyu!!\Episode 10: Cogs\Karasuno Fukurodani\Let's play! response:	We're gonna get this one!
context: Yeah!\I'll show you my progress\from the training camp!\Haikyu!!\Episode 10: Cogs\Karasuno Fukurodani\Let's play!\We're gonna get this one! response:	Yeah!
context: I'll show you my progress\from the training camp!\Haikyu!!\Episode 10: Cogs\Karasuno Fukurodani\Let's play!\We're gonna get this one!\Yeah! response:	All right! Bring it, Karasuno!
context: from the training camp!\Haikyu!!\Episode 10: Cogs\Karasuno Fukurodani\Let's play!\We're gonna get this one!\Yeah!\All right! Bring it, Karasuno! response:	Asahi-san, nice serve!
context: Haikyu!!\Episode 10: Cogs\Karasuno Fukurodani\Let's play!\We're gonna get this one!\Yeah!\All right! Bring it, Karasuno!\Asahi-san, nice serve! response:	It's a bit off!
context: Episode 10: Cogs\Karasuno Fukurodani\Let's play!\We're gonna get this one!\Yeah!\All right! Bring it, Karasuno!\Asahi-san, nice serve!\It's a bit off! response:	Bokuto-san!
context: Karasuno Fukurodani\Let's play!\We're gonna get this one!\Yeah!\All right! Bring it, Karasuno!\Asahi-san, nice serve!\It's a bit off!\Bokuto-san! response:	Right!
context: Let's play!\We're gonna get this one!\Yeah!\All right! Bring it, Karasuno!\Asahi-san, nice serve!\It's a bit off!\Bokuto-san!\Right! response:	Left, 4!
context: We're gonna get this one!\Yeah!\All right! Bring it, Karasuno!\Asahi-san, nice serve!\It's a bit off!\Bokuto-san!\Right!\Left, 4! response:	Tighten up for the straight.
context: Yeah!\All right! Bring it, Karasuno!\Asahi-san, nice serve!\It's a bit off!\Bokuto-san!\Right!\Left, 4!\Tighten up for the straight. response:	If there's even the slightest gap, it'll get through.
context: All right! Bring it, Karasuno!\Asahi-san, nice serve!\It's a bit off!\Bokuto-san!\Right!\Left, 4!\Tighten up for the straight.\If there's even the slightest gap, it'll get through. response:	Out!
context: Asahi-san, nice serve!\It's a bit off!\Bokuto-san!\Right!\Left, 4!\Tighten up for the straight.\If there's even the slightest gap, it'll get through.\Out! response:	A wipe, huh...
context: It's a bit off!\Bokuto-san!\Right!\Left, 4!\Tighten up for the straight.\If there's even the slightest gap, it'll get through.\Out!\A wipe, huh... response:	So close!
context: Bokuto-san!\Right!\Left, 4!\Tighten up for the straight.\If there's even the slightest gap, it'll get through.\Out!\A wipe, huh...\So close! response:	Don't worry about it, Tsukishima! You were close!
context: Right!\Left, 4!\Tighten up for the straight.\If there's even the slightest gap, it'll get through.\Out!\A wipe, huh...\So close!\Don't worry about it, Tsukishima! You were close! response:	You guys keep getting better every day, and it's annoying.
context: Left, 4!\Tighten up for the straight.\If there's even the slightest gap, it'll get through.\Out!\A wipe, huh...\So close!\Don't worry about it, Tsukishima! You were close!\You guys keep getting better every day, and it's annoying. response:	Right.
context: Tighten up for the straight.\If there's even the slightest gap, it'll get through.\Out!\A wipe, huh...\So close!\Don't worry about it, Tsukishima! You were close!\You guys keep getting better every day, and it's annoying.\Right. response:	Karasuno Fukurodani
context: If there's even the slightest gap, it'll get through.\Out!\A wipe, huh...\So close!\Don't worry about it, Tsukishima! You were close!\You guys keep getting better every day, and it's annoying.\Right.\Karasuno Fukurodani response:	Left, left!
context: Out!\A wipe, huh...\So close!\Don't worry about it, Tsukishima! You were close!\You guys keep getting better every day, and it's annoying.\Right.\Karasuno Fukurodani\Left, left! response:	Whoa, he got it!
context: A wipe, huh...\So close!\Don't worry about it, Tsukishima! You were close!\You guys keep getting better every day, and it's annoying.\Right.\Karasuno Fukurodani\Left, left!\Whoa, he got it! response:	But it's off!
context: So close!\Don't worry about it, Tsukishima! You were close!\You guys keep getting better every day, and it's annoying.\Right.\Karasuno Fukurodani\Left, left!\Whoa, he got it!\But it's off! response:	A quick from there?!
context: Don't worry about it, Tsukishima! You were close!\You guys keep getting better every day, and it's annoying.\Right.\Karasuno Fukurodani\Left, left!\Whoa, he got it!\But it's off!\A quick from there?! response:	Even if the receive is a little off,
context: You guys keep getting better every day, and it's annoying.\Right.\Karasuno Fukurodani\Left, left!\Whoa, he got it!\But it's off!\A quick from there?!\Even if the receive is a little off, response:	they confidently pull off a quick.
context: Right.\Karasuno Fukurodani\Left, left!\Whoa, he got it!\But it's off!\A quick from there?!\Even if the receive is a little off,\they confidently pull off a quick. response:	Their setter's pretty skilled, as well.
context: Karasuno Fukurodani\Left, left!\Whoa, he got it!\But it's off!\A quick from there?!\Even if the receive is a little off,\they confidently pull off a quick.\Their setter's pretty skilled, as well. response:	Nice serve.
context: Left, left!\Whoa, he got it!\But it's off!\A quick from there?!\Even if the receive is a little off,\they confidently pull off a quick.\Their setter's pretty skilled, as well.\Nice serve. response:	Break it off after the first one!
context: Whoa, he got it!\But it's off!\A quick from there?!\Even if the receive is a little off,\they confidently pull off a quick.\Their setter's pretty skilled, as well.\Nice serve.\Break it off after the first one! response:	Their 4 is up front now.
context: But it's off!\A quick from there?!\Even if the receive is a little off,\they confidently pull off a quick.\Their setter's pretty skilled, as well.\Nice serve.\Break it off after the first one!\Their 4 is up front now. response:	Now I can finally hit up front.
context: A quick from there?!\Even if the receive is a little off,\they confidently pull off a quick.\Their setter's pretty skilled, as well.\Nice serve.\Break it off after the first one!\Their 4 is up front now.\Now I can finally hit up front. response:	Nice serve!
context: Even if the receive is a little off,\they confidently pull off a quick.\Their setter's pretty skilled, as well.\Nice serve.\Break it off after the first one!\Their 4 is up front now.\Now I can finally hit up front.\Nice serve! response:	Nishinoya!
context: they confidently pull off a quick.\Their setter's pretty skilled, as well.\Nice serve.\Break it off after the first one!\Their 4 is up front now.\Now I can finally hit up front.\Nice serve!\Nishinoya! response:	Nice receive!
context: Their setter's pretty skilled, as well.\Nice serve.\Break it off after the first one!\Their 4 is up front now.\Now I can finally hit up front.\Nice serve!\Nishinoya!\Nice receive! response:	Nice, monkey!
context: Nice serve.\Break it off after the first one!\Their 4 is up front now.\Now I can finally hit up front.\Nice serve!\Nishinoya!\Nice receive!\Nice, monkey! response:	Give me the last one!
context: Break it off after the first one!\Their 4 is up front now.\Now I can finally hit up front.\Nice serve!\Nishinoya!\Nice receive!\Nice, monkey!\Give me the last one! response:	Right now, our front row is in the rotation where the wall is at its highest.
context: Their 4 is up front now.\Now I can finally hit up front.\Nice serve!\Nishinoya!\Nice receive!\Nice, monkey!\Give me the last one!\Right now, our front row is in the rotation where the wall is at its highest. response:	Make sure you stop the ball!
context: Now I can finally hit up front.\Nice serve!\Nishinoya!\Nice receive!\Nice, monkey!\Give me the last one!\Right now, our front row is in the rotation where the wall is at its highest.\Make sure you stop the ball! response:	That's an insane cut shot...
context: Nice serve!\Nishinoya!\Nice receive!\Nice, monkey!\Give me the last one!\Right now, our front row is in the rotation where the wall is at its highest.\Make sure you stop the ball!\That's an insane cut shot... response:	Hitting at a sharp angle against three blockers is really tricky.
context: Nishinoya!\Nice receive!\Nice, monkey!\Give me the last one!\Right now, our front row is in the rotation where the wall is at its highest.\Make sure you stop the ball!\That's an insane cut shot...\Hitting at a sharp angle against three blockers is really tricky. response:	It can be hard on your shoulders if they're not flexible, too.
context: Nice receive!\Nice, monkey!\Give me the last one!\Right now, our front row is in the rotation where the wall is at its highest.\Make sure you stop the ball!\That's an insane cut shot...\Hitting at a sharp angle against three blockers is really tricky.\It can be hard on your shoulders if they're not flexible, too. response:	All right!
context: Nice, monkey!\Give me the last one!\Right now, our front row is in the rotation where the wall is at its highest.\Make sure you stop the ball!\That's an insane cut shot...\Hitting at a sharp angle against three blockers is really tricky.\It can be hard on your shoulders if they're not flexible, too.\All right! response:	Did you see that, Akaashi?
context: Give me the last one!\Right now, our front row is in the rotation where the wall is at its highest.\Make sure you stop the ball!\That's an insane cut shot...\Hitting at a sharp angle against three blockers is really tricky.\It can be hard on your shoulders if they're not flexible, too.\All right!\Did you see that, Akaashi? response:	Hey, did you see my awesome cut shot right now?
context: Right now, our front row is in the rotation where the wall is at its highest.\Make sure you stop the ball!\That's an insane cut shot...\Hitting at a sharp angle against three blockers is really tricky.\It can be hard on your shoulders if they're not flexible, too.\All right!\Did you see that, Akaashi?\Hey, did you see my awesome cut shot right now? response:	I did. Amazing.
context: Make sure you stop the ball!\That's an insane cut shot...\Hitting at a sharp angle against three blockers is really tricky.\It can be hard on your shoulders if they're not flexible, too.\All right!\Did you see that, Akaashi?\Hey, did you see my awesome cut shot right now?\I did. Amazing. response:	It was pure luck, though!
context: That's an insane cut shot...\Hitting at a sharp angle against three blockers is really tricky.\It can be hard on your shoulders if they're not flexible, too.\All right!\Did you see that, Akaashi?\Hey, did you see my awesome cut shot right now?\I did. Amazing.\It was pure luck, though! response:	Bokuto is so annoying.
context: Hitting at a sharp angle against three blockers is really tricky.\It can be hard on your shoulders if they're not flexible, too.\All right!\Did you see that, Akaashi?\Hey, did you see my awesome cut shot right now?\I did. Amazing.\It was pure luck, though!\Bokuto is so annoying. response:	That's amazing, even if it was luck.
context: It can be hard on your shoulders if they're not flexible, too.\All right!\Did you see that, Akaashi?\Hey, did you see my awesome cut shot right now?\I did. Amazing.\It was pure luck, though!\Bokuto is so annoying.\That's amazing, even if it was luck. response:	I'd love to hit something like that.
context: All right!\Did you see that, Akaashi?\Hey, did you see my awesome cut shot right now?\I did. Amazing.\It was pure luck, though!\Bokuto is so annoying.\That's amazing, even if it was luck.\I'd love to hit something like that. response:	Fukurodani's Bokuto-kun is a real puzzle.
context: Did you see that, Akaashi?\Hey, did you see my awesome cut shot right now?\I did. Amazing.\It was pure luck, though!\Bokuto is so annoying.\That's amazing, even if it was luck.\I'd love to hit something like that.\Fukurodani's Bokuto-kun is a real puzzle. response:	Hey, can I try hitting that again?
context: Hey, did you see my awesome cut shot right now?\I did. Amazing.\It was pure luck, though!\Bokuto is so annoying.\That's amazing, even if it was luck.\I'd love to hit something like that.\Fukurodani's Bokuto-kun is a real puzzle.\Hey, can I try hitting that again? response:	Even when he's your opponent, you kind of want to cheer for him.
context: I did. Amazing.\It was pure luck, though!\Bokuto is so annoying.\That's amazing, even if it was luck.\I'd love to hit something like that.\Fukurodani's Bokuto-kun is a real puzzle.\Hey, can I try hitting that again?\Even when he's your opponent, you kind of want to cheer for him. response:	I wanna do it again!
context: It was pure luck, though!\Bokuto is so annoying.\That's amazing, even if it was luck.\I'd love to hit something like that.\Fukurodani's Bokuto-kun is a real puzzle.\Hey, can I try hitting that again?\Even when he's your opponent, you kind of want to cheer for him.\I wanna do it again! response:	The other team's completely on to you, Bokuto-san.
context: Bokuto is so annoying.\That's amazing, even if it was luck.\I'd love to hit something like that.\Fukurodani's Bokuto-kun is a real puzzle.\Hey, can I try hitting that again?\Even when he's your opponent, you kind of want to cheer for him.\I wanna do it again!\The other team's completely on to you, Bokuto-san. response:	Though that might be because I think he's a player on a completely different level.
context: That's amazing, even if it was luck.\I'd love to hit something like that.\Fukurodani's Bokuto-kun is a real puzzle.\Hey, can I try hitting that again?\Even when he's your opponent, you kind of want to cheer for him.\I wanna do it again!\The other team's completely on to you, Bokuto-san.\Though that might be because I think he's a player on a completely different level. response:	Oh, crap! My bad.
context: I'd love to hit something like that.\Fukurodani's Bokuto-kun is a real puzzle.\Hey, can I try hitting that again?\Even when he's your opponent, you kind of want to cheer for him.\I wanna do it again!\The other team's completely on to you, Bokuto-san.\Though that might be because I think he's a player on a completely different level.\Oh, crap! My bad. response:	Then maybe I'll go for a straight.
context: Fukurodani's Bokuto-kun is a real puzzle.\Hey, can I try hitting that again?\Even when he's your opponent, you kind of want to cheer for him.\I wanna do it again!\The other team's completely on to you, Bokuto-san.\Though that might be because I think he's a player on a completely different level.\Oh, crap! My bad.\Then maybe I'll go for a straight. response:	True...
context: Hey, can I try hitting that again?\Even when he's your opponent, you kind of want to cheer for him.\I wanna do it again!\The other team's completely on to you, Bokuto-san.\Though that might be because I think he's a player on a completely different level.\Oh, crap! My bad.\Then maybe I'll go for a straight.\True... response:	He might just be a player
context: Even when he's your opponent, you kind of want to cheer for him.\I wanna do it again!\The other team's completely on to you, Bokuto-san.\Though that might be because I think he's a player on a completely different level.\Oh, crap! My bad.\Then maybe I'll go for a straight.\True...\He might just be a player response:	who lifts the spirits of both his teammates and his opponents.
context: I wanna do it again!\The other team's completely on to you, Bokuto-san.\Though that might be because I think he's a player on a completely different level.\Oh, crap! My bad.\Then maybe I'll go for a straight.\True...\He might just be a player\who lifts the spirits of both his teammates and his opponents. response:	Karasuno Fukurodani
context: The other team's completely on to you, Bokuto-san.\Though that might be because I think he's a player on a completely different level.\Oh, crap! My bad.\Then maybe I'll go for a straight.\True...\He might just be a player\who lifts the spirits of both his teammates and his opponents.\Karasuno Fukurodani response:	Yeah!
context: Though that might be because I think he's a player on a completely different level.\Oh, crap! My bad.\Then maybe I'll go for a straight.\True...\He might just be a player\who lifts the spirits of both his teammates and his opponents.\Karasuno Fukurodani\Yeah! response:	Tsukishima, nice serve!
context: Oh, crap! My bad.\Then maybe I'll go for a straight.\True...\He might just be a player\who lifts the spirits of both his teammates and his opponents.\Karasuno Fukurodani\Yeah!\Tsukishima, nice serve! response:	A special attack?!
context: Then maybe I'll go for a straight.\True...\He might just be a player\who lifts the spirits of both his teammates and his opponents.\Karasuno Fukurodani\Yeah!\Tsukishima, nice serve!\A special attack?! response:	Yup!
context: True...\He might just be a player\who lifts the spirits of both his teammates and his opponents.\Karasuno Fukurodani\Yeah!\Tsukishima, nice serve!\A special attack?!\Yup! response:	Listen up. The best way to describe this attack
context: He might just be a player\who lifts the spirits of both his teammates and his opponents.\Karasuno Fukurodani\Yeah!\Tsukishima, nice serve!\A special attack?!\Yup!\Listen up. The best way to describe this attack response:	is something born from upsetting the balance of stillness and motion.
context: who lifts the spirits of both his teammates and his opponents.\Karasuno Fukurodani\Yeah!\Tsukishima, nice serve!\A special attack?!\Yup!\Listen up. The best way to describe this attack\is something born from upsetting the balance of stillness and motion. response:	Whoa! Whoa...
context: Karasuno Fukurodani\Yeah!\Tsukishima, nice serve!\A special attack?!\Yup!\Listen up. The best way to describe this attack\is something born from upsetting the balance of stillness and motion.\Whoa! Whoa... response:	There he goes, trying to sound cool again.
context: Yeah!\Tsukishima, nice serve!\A special attack?!\Yup!\Listen up. The best way to describe this attack\is something born from upsetting the balance of stillness and motion.\Whoa! Whoa...\There he goes, trying to sound cool again. response:	Do you have any idea what he's talking about?
context: Tsukishima, nice serve!\A special attack?!\Yup!\Listen up. The best way to describe this attack\is something born from upsetting the balance of stillness and motion.\Whoa! Whoa...\There he goes, trying to sound cool again.\Do you have any idea what he's talking about? response:	I have an idea.
context: A special attack?!\Yup!\Listen up. The best way to describe this attack\is something born from upsetting the balance of stillness and motion.\Whoa! Whoa...\There he goes, trying to sound cool again.\Do you have any idea what he's talking about?\I have an idea. response:	This isn't a move that you use to run away.
context: Yup!\Listen up. The best way to describe this attack\is something born from upsetting the balance of stillness and motion.\Whoa! Whoa...\There he goes, trying to sound cool again.\Do you have any idea what he's talking about?\I have an idea.\This isn't a move that you use to run away. response:	You have to have the perfect timing, the perfect toss,
context: Listen up. The best way to describe this attack\is something born from upsetting the balance of stillness and motion.\Whoa! Whoa...\There he goes, trying to sound cool again.\Do you have any idea what he's talking about?\I have an idea.\This isn't a move that you use to run away.\You have to have the perfect timing, the perfect toss, response:	and look like you're about to hit the perfect spike.
context: is something born from upsetting the balance of stillness and motion.\Whoa! Whoa...\There he goes, trying to sound cool again.\Do you have any idea what he's talking about?\I have an idea.\This isn't a move that you use to run away.\You have to have the perfect timing, the perfect toss,\and look like you're about to hit the perfect spike. response:	When everyone thinks you're about to hit a powerful spike...
context: Whoa! Whoa...\There he goes, trying to sound cool again.\Do you have any idea what he's talking about?\I have an idea.\This isn't a move that you use to run away.\You have to have the perfect timing, the perfect toss,\and look like you're about to hit the perfect spike.\When everyone thinks you're about to hit a powerful spike... response:	More than anything, it works best
context: There he goes, trying to sound cool again.\Do you have any idea what he's talking about?\I have an idea.\This isn't a move that you use to run away.\You have to have the perfect timing, the perfect toss,\and look like you're about to hit the perfect spike.\When everyone thinks you're about to hit a powerful spike...\More than anything, it works best response:	when you think you're about to hit a powerful one yourself.
context: Do you have any idea what he's talking about?\I have an idea.\This isn't a move that you use to run away.\You have to have the perfect timing, the perfect toss,\and look like you're about to hit the perfect spike.\When everyone thinks you're about to hit a powerful spike...\More than anything, it works best\when you think you're about to hit a powerful one yourself. response:	Leave it to me!
context: I have an idea.\This isn't a move that you use to run away.\You have to have the perfect timing, the perfect toss,\and look like you're about to hit the perfect spike.\When everyone thinks you're about to hit a powerful spike...\More than anything, it works best\when you think you're about to hit a powerful one yourself.\Leave it to me! response:	Nice receive!
context: This isn't a move that you use to run away.\You have to have the perfect timing, the perfect toss,\and look like you're about to hit the perfect spike.\When everyone thinks you're about to hit a powerful spike...\More than anything, it works best\when you think you're about to hit a powerful one yourself.\Leave it to me!\Nice receive! response:	Just like you're sneering...
context: You have to have the perfect timing, the perfect toss,\and look like you're about to hit the perfect spike.\When everyone thinks you're about to hit a powerful spike...\More than anything, it works best\when you think you're about to hit a powerful one yourself.\Leave it to me!\Nice receive!\Just like you're sneering... response:	Let them have it!
context: and look like you're about to hit the perfect spike.\When everyone thinks you're about to hit a powerful spike...\More than anything, it works best\when you think you're about to hit a powerful one yourself.\Leave it to me!\Nice receive!\Just like you're sneering...\Let them have it! response:	Ah!
context: When everyone thinks you're about to hit a powerful spike...\More than anything, it works best\when you think you're about to hit a powerful one yourself.\Leave it to me!\Nice receive!\Just like you're sneering...\Let them have it!\Ah! response:	Hinata just...
context: More than anything, it works best\when you think you're about to hit a powerful one yourself.\Leave it to me!\Nice receive!\Just like you're sneering...\Let them have it!\Ah!\Hinata just... response:	When you get a feint in,
context: when you think you're about to hit a powerful one yourself.\Leave it to me!\Nice receive!\Just like you're sneering...\Let them have it!\Ah!\Hinata just...\When you get a feint in, response:	there's a completely different sense of satisfaction than you get from a good spike.
context: Leave it to me!\Nice receive!\Just like you're sneering...\Let them have it!\Ah!\Hinata just...\When you get a feint in,\there's a completely different sense of satisfaction than you get from a good spike. response:	You know how a handful of receivers will dive for the falling ball?
context: Nice receive!\Just like you're sneering...\Let them have it!\Ah!\Hinata just...\When you get a feint in,\there's a completely different sense of satisfaction than you get from a good spike.\You know how a handful of receivers will dive for the falling ball? response:	Yeah.
context: Just like you're sneering...\Let them have it!\Ah!\Hinata just...\When you get a feint in,\there's a completely different sense of satisfaction than you get from a good spike.\You know how a handful of receivers will dive for the falling ball?\Yeah. response:	You're usually eye level with them or above,
context: Let them have it!\Ah!\Hinata just...\When you get a feint in,\there's a completely different sense of satisfaction than you get from a good spike.\You know how a handful of receivers will dive for the falling ball?\Yeah.\You're usually eye level with them or above, response:	but the moment they try to reach for the ball, miss, then look up...
context: Ah!\Hinata just...\When you get a feint in,\there's a completely different sense of satisfaction than you get from a good spike.\You know how a handful of receivers will dive for the falling ball?\Yeah.\You're usually eye level with them or above,\but the moment they try to reach for the ball, miss, then look up... response:	It's the best feeling.
context: Hinata just...\When you get a feint in,\there's a completely different sense of satisfaction than you get from a good spike.\You know how a handful of receivers will dive for the falling ball?\Yeah.\You're usually eye level with them or above,\but the moment they try to reach for the ball, miss, then look up...\It's the best feeling. response:	A feint?!
context: When you get a feint in,\there's a completely different sense of satisfaction than you get from a good spike.\You know how a handful of receivers will dive for the falling ball?\Yeah.\You're usually eye level with them or above,\but the moment they try to reach for the ball, miss, then look up...\It's the best feeling.\A feint?! response:	You're the one who taught it to him.
context: there's a completely different sense of satisfaction than you get from a good spike.\You know how a handful of receivers will dive for the falling ball?\Yeah.\You're usually eye level with them or above,\but the moment they try to reach for the ball, miss, then look up...\It's the best feeling.\A feint?!\You're the one who taught it to him. response:	You actually used your head?
context: You know how a handful of receivers will dive for the falling ball?\Yeah.\You're usually eye level with them or above,\but the moment they try to reach for the ball, miss, then look up...\It's the best feeling.\A feint?!\You're the one who taught it to him.\You actually used your head? response:	You're gonna get a fever.
context: Yeah.\You're usually eye level with them or above,\but the moment they try to reach for the ball, miss, then look up...\It's the best feeling.\A feint?!\You're the one who taught it to him.\You actually used your head?\You're gonna get a fever. response:	You are the only person who doesn't get to say stuff like that to me.
context: You're usually eye level with them or above,\but the moment they try to reach for the ball, miss, then look up...\It's the best feeling.\A feint?!\You're the one who taught it to him.\You actually used your head?\You're gonna get a fever.\You are the only person who doesn't get to say stuff like that to me. response:	Hmph! I'm not gonna let them get any more points.
context: but the moment they try to reach for the ball, miss, then look up...\It's the best feeling.\A feint?!\You're the one who taught it to him.\You actually used your head?\You're gonna get a fever.\You are the only person who doesn't get to say stuff like that to me.\Hmph! I'm not gonna let them get any more points. response:	I don't think that's going to be possible.
context: It's the best feeling.\A feint?!\You're the one who taught it to him.\You actually used your head?\You're gonna get a fever.\You are the only person who doesn't get to say stuff like that to me.\Hmph! I'm not gonna let them get any more points.\I don't think that's going to be possible. response:	Akaashi, back me up once in a while!
context: A feint?!\You're the one who taught it to him.\You actually used your head?\You're gonna get a fever.\You are the only person who doesn't get to say stuff like that to me.\Hmph! I'm not gonna let them get any more points.\I don't think that's going to be possible.\Akaashi, back me up once in a while! response:	Damn that little Shrimpy!
context: You're the one who taught it to him.\You actually used your head?\You're gonna get a fever.\You are the only person who doesn't get to say stuff like that to me.\Hmph! I'm not gonna let them get any more points.\I don't think that's going to be possible.\Akaashi, back me up once in a while!\Damn that little Shrimpy! response:	We're not gonna lose!
context: You actually used your head?\You're gonna get a fever.\You are the only person who doesn't get to say stuff like that to me.\Hmph! I'm not gonna let them get any more points.\I don't think that's going to be possible.\Akaashi, back me up once in a while!\Damn that little Shrimpy!\We're not gonna lose! response:	Karasuno Fukurodani
context: You're gonna get a fever.\You are the only person who doesn't get to say stuff like that to me.\Hmph! I'm not gonna let them get any more points.\I don't think that's going to be possible.\Akaashi, back me up once in a while!\Damn that little Shrimpy!\We're not gonna lose!\Karasuno Fukurodani response:	2! 2!
context: You are the only person who doesn't get to say stuff like that to me.\Hmph! I'm not gonna let them get any more points.\I don't think that's going to be possible.\Akaashi, back me up once in a while!\Damn that little Shrimpy!\We're not gonna lose!\Karasuno Fukurodani\2! 2! response:	All right!
context: Hmph! I'm not gonna let them get any more points.\I don't think that's going to be possible.\Akaashi, back me up once in a while!\Damn that little Shrimpy!\We're not gonna lose!\Karasuno Fukurodani\2! 2!\All right! response:	Ready and...
context: I don't think that's going to be possible.\Akaashi, back me up once in a while!\Damn that little Shrimpy!\We're not gonna lose!\Karasuno Fukurodani\2! 2!\All right!\Ready and... response:	They all seem to be enjoying themselves.
context: Akaashi, back me up once in a while!\Damn that little Shrimpy!\We're not gonna lose!\Karasuno Fukurodani\2! 2!\All right!\Ready and...\They all seem to be enjoying themselves. response:	One touch!
context: Damn that little Shrimpy!\We're not gonna lose!\Karasuno Fukurodani\2! 2!\All right!\Ready and...\They all seem to be enjoying themselves.\One touch! response:	Got it!
context: We're not gonna lose!\Karasuno Fukurodani\2! 2!\All right!\Ready and...\They all seem to be enjoying themselves.\One touch!\Got it! response:	I wonder if it's because of Bokuto-kun's influence.
context: Karasuno Fukurodani\2! 2!\All right!\Ready and...\They all seem to be enjoying themselves.\One touch!\Got it!\I wonder if it's because of Bokuto-kun's influence. response:	All right!
context: 2! 2!\All right!\Ready and...\They all seem to be enjoying themselves.\One touch!\Got it!\I wonder if it's because of Bokuto-kun's influence.\All right! response:	Wow, a dump!
context: All right!\Ready and...\They all seem to be enjoying themselves.\One touch!\Got it!\I wonder if it's because of Bokuto-kun's influence.\All right!\Wow, a dump! response:	Kageyama-kun's doing very well.
context: Ready and...\They all seem to be enjoying themselves.\One touch!\Got it!\I wonder if it's because of Bokuto-kun's influence.\All right!\Wow, a dump!\Kageyama-kun's doing very well. response:	He hasn't missed a jump serve today, either.
context: They all seem to be enjoying themselves.\One touch!\Got it!\I wonder if it's because of Bokuto-kun's influence.\All right!\Wow, a dump!\Kageyama-kun's doing very well.\He hasn't missed a jump serve today, either. response:	Yeah, Kageyama today is like...
context: One touch!\Got it!\I wonder if it's because of Bokuto-kun's influence.\All right!\Wow, a dump!\Kageyama-kun's doing very well.\He hasn't missed a jump serve today, either.\Yeah, Kageyama today is like... response:	Calm and collected.
context: Got it!\I wonder if it's because of Bokuto-kun's influence.\All right!\Wow, a dump!\Kageyama-kun's doing very well.\He hasn't missed a jump serve today, either.\Yeah, Kageyama today is like...\Calm and collected. response:	He gives you the same uneasy feeling as the calm before a storm.
context: I wonder if it's because of Bokuto-kun's influence.\All right!\Wow, a dump!\Kageyama-kun's doing very well.\He hasn't missed a jump serve today, either.\Yeah, Kageyama today is like...\Calm and collected.\He gives you the same uneasy feeling as the calm before a storm. response:	One more, Tsukishima! Nice serve!
context: All right!\Wow, a dump!\Kageyama-kun's doing very well.\He hasn't missed a jump serve today, either.\Yeah, Kageyama today is like...\Calm and collected.\He gives you the same uneasy feeling as the calm before a storm.\One more, Tsukishima! Nice serve! response:	I feel like everything I ate this morning is gone from my stomach,
context: Wow, a dump!\Kageyama-kun's doing very well.\He hasn't missed a jump serve today, either.\Yeah, Kageyama today is like...\Calm and collected.\He gives you the same uneasy feeling as the calm before a storm.\One more, Tsukishima! Nice serve!\I feel like everything I ate this morning is gone from my stomach, response:	but I'm still not hungry.
context: Kageyama-kun's doing very well.\He hasn't missed a jump serve today, either.\Yeah, Kageyama today is like...\Calm and collected.\He gives you the same uneasy feeling as the calm before a storm.\One more, Tsukishima! Nice serve!\I feel like everything I ate this morning is gone from my stomach,\but I'm still not hungry. response:	My body's more responsive than usual,
context: He hasn't missed a jump serve today, either.\Yeah, Kageyama today is like...\Calm and collected.\He gives you the same uneasy feeling as the calm before a storm.\One more, Tsukishima! Nice serve!\I feel like everything I ate this morning is gone from my stomach,\but I'm still not hungry.\My body's more responsive than usual, response:	and I can see everyone moving around me.
context: Yeah, Kageyama today is like...\Calm and collected.\He gives you the same uneasy feeling as the calm before a storm.\One more, Tsukishima! Nice serve!\I feel like everything I ate this morning is gone from my stomach,\but I'm still not hungry.\My body's more responsive than usual,\and I can see everyone moving around me. response:	I can tell how well I'm doing, too.
context: Calm and collected.\He gives you the same uneasy feeling as the calm before a storm.\One more, Tsukishima! Nice serve!\I feel like everything I ate this morning is gone from my stomach,\but I'm still not hungry.\My body's more responsive than usual,\and I can see everyone moving around me.\I can tell how well I'm doing, too. response:	All right!
context: He gives you the same uneasy feeling as the calm before a storm.\One more, Tsukishima! Nice serve!\I feel like everything I ate this morning is gone from my stomach,\but I'm still not hungry.\My body's more responsive than usual,\and I can see everyone moving around me.\I can tell how well I'm doing, too.\All right! response:	The same goes for everyone else.
context: One more, Tsukishima! Nice serve!\I feel like everything I ate this morning is gone from my stomach,\but I'm still not hungry.\My body's more responsive than usual,\and I can see everyone moving around me.\I can tell how well I'm doing, too.\All right!\The same goes for everyone else. response:	Nice, Daichi-san!
context: I feel like everything I ate this morning is gone from my stomach,\but I'm still not hungry.\My body's more responsive than usual,\and I can see everyone moving around me.\I can tell how well I'm doing, too.\All right!\The same goes for everyone else.\Nice, Daichi-san! response:	Is this because of the barbecue?
context: but I'm still not hungry.\My body's more responsive than usual,\and I can see everyone moving around me.\I can tell how well I'm doing, too.\All right!\The same goes for everyone else.\Nice, Daichi-san!\Is this because of the barbecue? response:	Hinata's doing well, too.
context: My body's more responsive than usual,\and I can see everyone moving around me.\I can tell how well I'm doing, too.\All right!\The same goes for everyone else.\Nice, Daichi-san!\Is this because of the barbecue?\Hinata's doing well, too. response:	He's not making any unnecessary movements.
context: and I can see everyone moving around me.\I can tell how well I'm doing, too.\All right!\The same goes for everyone else.\Nice, Daichi-san!\Is this because of the barbecue?\Hinata's doing well, too.\He's not making any unnecessary movements. response:	We just might...
context: I can tell how well I'm doing, too.\All right!\The same goes for everyone else.\Nice, Daichi-san!\Is this because of the barbecue?\Hinata's doing well, too.\He's not making any unnecessary movements.\We just might... response:	But...
context: All right!\The same goes for everyone else.\Nice, Daichi-san!\Is this because of the barbecue?\Hinata's doing well, too.\He's not making any unnecessary movements.\We just might...\But... response:	Asahi-san, nice receive!
context: The same goes for everyone else.\Nice, Daichi-san!\Is this because of the barbecue?\Hinata's doing well, too.\He's not making any unnecessary movements.\We just might...\But...\Asahi-san, nice receive! response:	Is he planning on doing the new quick?
context: Nice, Daichi-san!\Is this because of the barbecue?\Hinata's doing well, too.\He's not making any unnecessary movements.\We just might...\But...\Asahi-san, nice receive!\Is he planning on doing the new quick? response:	But if we miss, the good atmosphere surrounding the team might shatter.
context: Is this because of the barbecue?\Hinata's doing well, too.\He's not making any unnecessary movements.\We just might...\But...\Asahi-san, nice receive!\Is he planning on doing the new quick?\But if we miss, the good atmosphere surrounding the team might shatter. response:	We should just hold off on the new quick
context: Hinata's doing well, too.\He's not making any unnecessary movements.\We just might...\But...\Asahi-san, nice receive!\Is he planning on doing the new quick?\But if we miss, the good atmosphere surrounding the team might shatter.\We should just hold off on the new quick response:	until the chance of success is higher...
context: He's not making any unnecessary movements.\We just might...\But...\Asahi-san, nice receive!\Is he planning on doing the new quick?\But if we miss, the good atmosphere surrounding the team might shatter.\We should just hold off on the new quick\until the chance of success is higher... response:	You're not gonna do it?
context: We just might...\But...\Asahi-san, nice receive!\Is he planning on doing the new quick?\But if we miss, the good atmosphere surrounding the team might shatter.\We should just hold off on the new quick\until the chance of success is higher...\You're not gonna do it? response:	The ball's coming...
context: But...\Asahi-san, nice receive!\Is he planning on doing the new quick?\But if we miss, the good atmosphere surrounding the team might shatter.\We should just hold off on the new quick\until the chance of success is higher...\You're not gonna do it?\The ball's coming... response:	And...
context: Asahi-san, nice receive!\Is he planning on doing the new quick?\But if we miss, the good atmosphere surrounding the team might shatter.\We should just hold off on the new quick\until the chance of success is higher...\You're not gonna do it?\The ball's coming...\And... response:	It stops.
context: Is he planning on doing the new quick?\But if we miss, the good atmosphere surrounding the team might shatter.\We should just hold off on the new quick\until the chance of success is higher...\You're not gonna do it?\The ball's coming...\And...\It stops. response:	You've got to be kidding me!
context: But if we miss, the good atmosphere surrounding the team might shatter.\We should just hold off on the new quick\until the chance of success is higher...\You're not gonna do it?\The ball's coming...\And...\It stops.\You've got to be kidding me! response:	If you're gonna do that, let me know sooner!
context: We should just hold off on the new quick\until the chance of success is higher...\You're not gonna do it?\The ball's coming...\And...\It stops.\You've got to be kidding me!\If you're gonna do that, let me know sooner! response:	I just felt like we could pull it off! Didn't you?!
context: until the chance of success is higher...\You're not gonna do it?\The ball's coming...\And...\It stops.\You've got to be kidding me!\If you're gonna do that, let me know sooner!\I just felt like we could pull it off! Didn't you?! response:	What the heck? Is the weirdo quick making a comeback?
context: You're not gonna do it?\The ball's coming...\And...\It stops.\You've got to be kidding me!\If you're gonna do that, let me know sooner!\I just felt like we could pull it off! Didn't you?!\What the heck? Is the weirdo quick making a comeback? response:	I did, but it was too sudden!
context: The ball's coming...\And...\It stops.\You've got to be kidding me!\If you're gonna do that, let me know sooner!\I just felt like we could pull it off! Didn't you?!\What the heck? Is the weirdo quick making a comeback?\I did, but it was too sudden! response:	Not quite.
context: And...\It stops.\You've got to be kidding me!\If you're gonna do that, let me know sooner!\I just felt like we could pull it off! Didn't you?!\What the heck? Is the weirdo quick making a comeback?\I did, but it was too sudden!\Not quite. response:	I've got to mentally prepare, and stuff!
context: It stops.\You've got to be kidding me!\If you're gonna do that, let me know sooner!\I just felt like we could pull it off! Didn't you?!\What the heck? Is the weirdo quick making a comeback?\I did, but it was too sudden!\Not quite.\I've got to mentally prepare, and stuff! response:	That was... different from the quick they were doing in the beginning.
context: You've got to be kidding me!\If you're gonna do that, let me know sooner!\I just felt like we could pull it off! Didn't you?!\What the heck? Is the weirdo quick making a comeback?\I did, but it was too sudden!\Not quite.\I've got to mentally prepare, and stuff!\That was... different from the quick they were doing in the beginning. response:	Who cares?! We actually did it!
context: If you're gonna do that, let me know sooner!\I just felt like we could pull it off! Didn't you?!\What the heck? Is the weirdo quick making a comeback?\I did, but it was too sudden!\Not quite.\I've got to mentally prepare, and stuff!\That was... different from the quick they were doing in the beginning.\Who cares?! We actually did it! response:	The first...
context: I just felt like we could pull it off! Didn't you?!\What the heck? Is the weirdo quick making a comeback?\I did, but it was too sudden!\Not quite.\I've got to mentally prepare, and stuff!\That was... different from the quick they were doing in the beginning.\Who cares?! We actually did it!\The first... response:	Haikyu!!
context: What the heck? Is the weirdo quick making a comeback?\I did, but it was too sudden!\Not quite.\I've got to mentally prepare, and stuff!\That was... different from the quick they were doing in the beginning.\Who cares?! We actually did it!\The first...\Haikyu!! response:	Haikyu!!
context: I did, but it was too sudden!\Not quite.\I've got to mentally prepare, and stuff!\That was... different from the quick they were doing in the beginning.\Who cares?! We actually did it!\The first...\Haikyu!!\Haikyu!! response:	The ball's coming...
context: Not quite.\I've got to mentally prepare, and stuff!\That was... different from the quick they were doing in the beginning.\Who cares?! We actually did it!\The first...\Haikyu!!\Haikyu!!\The ball's coming... response:	And...
context: I've got to mentally prepare, and stuff!\That was... different from the quick they were doing in the beginning.\Who cares?! We actually did it!\The first...\Haikyu!!\Haikyu!!\The ball's coming...\And... response:	It stops.
context: That was... different from the quick they were doing in the beginning.\Who cares?! We actually did it!\The first...\Haikyu!!\Haikyu!!\The ball's coming...\And...\It stops. response:	Karasuno Fukurodani
context: Who cares?! We actually did it!\The first...\Haikyu!!\Haikyu!!\The ball's coming...\And...\It stops.\Karasuno Fukurodani response:	All right!
context: The first...\Haikyu!!\Haikyu!!\The ball's coming...\And...\It stops.\Karasuno Fukurodani\All right! response:	All right!
context: Haikyu!!\Haikyu!!\The ball's coming...\And...\It stops.\Karasuno Fukurodani\All right!\All right! response:	What the heck was that?!
context: Haikyu!!\The ball's coming...\And...\It stops.\Karasuno Fukurodani\All right!\All right!\What the heck was that?! response:	That was awesome!
context: The ball's coming...\And...\It stops.\Karasuno Fukurodani\All right!\All right!\What the heck was that?!\That was awesome! response:	Nice, Hinata, Kageyama!
context: And...\It stops.\Karasuno Fukurodani\All right!\All right!\What the heck was that?!\That was awesome!\Nice, Hinata, Kageyama! response:	Hey, Akaashi. Was that really that amazing?
context: It stops.\Karasuno Fukurodani\All right!\All right!\What the heck was that?!\That was awesome!\Nice, Hinata, Kageyama!\Hey, Akaashi. Was that really that amazing? response:	Could we do it, too?
context: Karasuno Fukurodani\All right!\All right!\What the heck was that?!\That was awesome!\Nice, Hinata, Kageyama!\Hey, Akaashi. Was that really that amazing?\Could we do it, too? response:	That's something we should never try.
context: All right!\All right!\What the heck was that?!\That was awesome!\Nice, Hinata, Kageyama!\Hey, Akaashi. Was that really that amazing?\Could we do it, too?\That's something we should never try. response:	Hinata hit it like it was nothing,
context: All right!\What the heck was that?!\That was awesome!\Nice, Hinata, Kageyama!\Hey, Akaashi. Was that really that amazing?\Could we do it, too?\That's something we should never try.\Hinata hit it like it was nothing, response:	but I believe it would take a lot of practice to hit a toss like that.
context: What the heck was that?!\That was awesome!\Nice, Hinata, Kageyama!\Hey, Akaashi. Was that really that amazing?\Could we do it, too?\That's something we should never try.\Hinata hit it like it was nothing,\but I believe it would take a lot of practice to hit a toss like that. response:	Not to mention...
context: That was awesome!\Nice, Hinata, Kageyama!\Hey, Akaashi. Was that really that amazing?\Could we do it, too?\That's something we should never try.\Hinata hit it like it was nothing,\but I believe it would take a lot of practice to hit a toss like that.\Not to mention... response:	Making a toss float at the point of impact is an incredible move.
context: Nice, Hinata, Kageyama!\Hey, Akaashi. Was that really that amazing?\Could we do it, too?\That's something we should never try.\Hinata hit it like it was nothing,\but I believe it would take a lot of practice to hit a toss like that.\Not to mention...\Making a toss float at the point of impact is an incredible move. response:	At my skill level, that's impossible.
context: Hey, Akaashi. Was that really that amazing?\Could we do it, too?\That's something we should never try.\Hinata hit it like it was nothing,\but I believe it would take a lot of practice to hit a toss like that.\Not to mention...\Making a toss float at the point of impact is an incredible move.\At my skill level, that's impossible. response:	You're not gonna do it?
context: Could we do it, too?\That's something we should never try.\Hinata hit it like it was nothing,\but I believe it would take a lot of practice to hit a toss like that.\Not to mention...\Making a toss float at the point of impact is an incredible move.\At my skill level, that's impossible.\You're not gonna do it? response:	He encouraged me again, damn it.
context: That's something we should never try.\Hinata hit it like it was nothing,\but I believe it would take a lot of practice to hit a toss like that.\Not to mention...\Making a toss float at the point of impact is an incredible move.\At my skill level, that's impossible.\You're not gonna do it?\He encouraged me again, damn it. response:	What? You wanna start somethin'?
context: Hinata hit it like it was nothing,\but I believe it would take a lot of practice to hit a toss like that.\Not to mention...\Making a toss float at the point of impact is an incredible move.\At my skill level, that's impossible.\You're not gonna do it?\He encouraged me again, damn it.\What? You wanna start somethin'? response:	But that was awesome! So cool!
context: but I believe it would take a lot of practice to hit a toss like that.\Not to mention...\Making a toss float at the point of impact is an incredible move.\At my skill level, that's impossible.\You're not gonna do it?\He encouraged me again, damn it.\What? You wanna start somethin'?\But that was awesome! So cool! response:	It stopped right before my eyes!
context: Not to mention...\Making a toss float at the point of impact is an incredible move.\At my skill level, that's impossible.\You're not gonna do it?\He encouraged me again, damn it.\What? You wanna start somethin'?\But that was awesome! So cool!\It stopped right before my eyes! response:	It was like shoop!
context: Making a toss float at the point of impact is an incredible move.\At my skill level, that's impossible.\You're not gonna do it?\He encouraged me again, damn it.\What? You wanna start somethin'?\But that was awesome! So cool!\It stopped right before my eyes!\It was like shoop! response:	I totally thought it was coming this time,
context: At my skill level, that's impossible.\You're not gonna do it?\He encouraged me again, damn it.\What? You wanna start somethin'?\But that was awesome! So cool!\It stopped right before my eyes!\It was like shoop!\I totally thought it was coming this time, response:	but when it actually stops right in front of you, it's sorta scary!
context: You're not gonna do it?\He encouraged me again, damn it.\What? You wanna start somethin'?\But that was awesome! So cool!\It stopped right before my eyes!\It was like shoop!\I totally thought it was coming this time,\but when it actually stops right in front of you, it's sorta scary! response:	You really are awesome!
context: He encouraged me again, damn it.\What? You wanna start somethin'?\But that was awesome! So cool!\It stopped right before my eyes!\It was like shoop!\I totally thought it was coming this time,\but when it actually stops right in front of you, it's sorta scary!\You really are awesome! response:	Wh-What... You dumbass...
context: What? You wanna start somethin'?\But that was awesome! So cool!\It stopped right before my eyes!\It was like shoop!\I totally thought it was coming this time,\but when it actually stops right in front of you, it's sorta scary!\You really are awesome!\Wh-What... You dumbass... response:	Awesome! So awesome!
context: But that was awesome! So cool!\It stopped right before my eyes!\It was like shoop!\I totally thought it was coming this time,\but when it actually stops right in front of you, it's sorta scary!\You really are awesome!\Wh-What... You dumbass...\Awesome! So awesome! response:	Kageyama's expression right now is indescribable.
context: It stopped right before my eyes!\It was like shoop!\I totally thought it was coming this time,\but when it actually stops right in front of you, it's sorta scary!\You really are awesome!\Wh-What... You dumbass...\Awesome! So awesome!\Kageyama's expression right now is indescribable. response:	You're so awesome, Kageyama!
context: It was like shoop!\I totally thought it was coming this time,\but when it actually stops right in front of you, it's sorta scary!\You really are awesome!\Wh-What... You dumbass...\Awesome! So awesome!\Kageyama's expression right now is indescribable.\You're so awesome, Kageyama! response:	What happened to his mimetic muscles?
context: I totally thought it was coming this time,\but when it actually stops right in front of you, it's sorta scary!\You really are awesome!\Wh-What... You dumbass...\Awesome! So awesome!\Kageyama's expression right now is indescribable.\You're so awesome, Kageyama!\What happened to his mimetic muscles? response:	It's not often that Hinata compliments Kageyama
context: but when it actually stops right in front of you, it's sorta scary!\You really are awesome!\Wh-What... You dumbass...\Awesome! So awesome!\Kageyama's expression right now is indescribable.\You're so awesome, Kageyama!\What happened to his mimetic muscles?\It's not often that Hinata compliments Kageyama response:	in such a straightforward way.
context: You really are awesome!\Wh-What... You dumbass...\Awesome! So awesome!\Kageyama's expression right now is indescribable.\You're so awesome, Kageyama!\What happened to his mimetic muscles?\It's not often that Hinata compliments Kageyama\in such a straightforward way. response:	I'm glad we actually believed in this and waited.
context: Wh-What... You dumbass...\Awesome! So awesome!\Kageyama's expression right now is indescribable.\You're so awesome, Kageyama!\What happened to his mimetic muscles?\It's not often that Hinata compliments Kageyama\in such a straightforward way.\I'm glad we actually believed in this and waited. response:	Yeah.
context: Awesome! So awesome!\Kageyama's expression right now is indescribable.\You're so awesome, Kageyama!\What happened to his mimetic muscles?\It's not often that Hinata compliments Kageyama\in such a straightforward way.\I'm glad we actually believed in this and waited.\Yeah. response:	Anyway, next time, make sure you
context: Kageyama's expression right now is indescribable.\You're so awesome, Kageyama!\What happened to his mimetic muscles?\It's not often that Hinata compliments Kageyama\in such a straightforward way.\I'm glad we actually believed in this and waited.\Yeah.\Anyway, next time, make sure you response:	You did it!
context: You're so awesome, Kageyama!\What happened to his mimetic muscles?\It's not often that Hinata compliments Kageyama\in such a straightforward way.\I'm glad we actually believed in this and waited.\Yeah.\Anyway, next time, make sure you\You did it! response:	You did it! You did it!
context: What happened to his mimetic muscles?\It's not often that Hinata compliments Kageyama\in such a straightforward way.\I'm glad we actually believed in this and waited.\Yeah.\Anyway, next time, make sure you\You did it!\You did it! You did it! response:	Nice kill, Hinata! Kageyama-kun!
context: It's not often that Hinata compliments Kageyama\in such a straightforward way.\I'm glad we actually believed in this and waited.\Yeah.\Anyway, next time, make sure you\You did it!\You did it! You did it!\Nice kill, Hinata! Kageyama-kun! response:	Finally, after three weeks...
context: in such a straightforward way.\I'm glad we actually believed in this and waited.\Yeah.\Anyway, next time, make sure you\You did it!\You did it! You did it!\Nice kill, Hinata! Kageyama-kun!\Finally, after three weeks... response:	Ever since that fight,
context: I'm glad we actually believed in this and waited.\Yeah.\Anyway, next time, make sure you\You did it!\You did it! You did it!\Nice kill, Hinata! Kageyama-kun!\Finally, after three weeks...\Ever since that fight, response:	Hinata and Kageyama-kun stopped talking to each other.
context: Yeah.\Anyway, next time, make sure you\You did it!\You did it! You did it!\Nice kill, Hinata! Kageyama-kun!\Finally, after three weeks...\Ever since that fight,\Hinata and Kageyama-kun stopped talking to each other. response:	But both of them worked hard on improving.
context: Anyway, next time, make sure you\You did it!\You did it! You did it!\Nice kill, Hinata! Kageyama-kun!\Finally, after three weeks...\Ever since that fight,\Hinata and Kageyama-kun stopped talking to each other.\But both of them worked hard on improving. response:	And, now...
context: You did it!\You did it! You did it!\Nice kill, Hinata! Kageyama-kun!\Finally, after three weeks...\Ever since that fight,\Hinata and Kageyama-kun stopped talking to each other.\But both of them worked hard on improving.\And, now... response:	The weirdo duo is back in action!
context: You did it! You did it!\Nice kill, Hinata! Kageyama-kun!\Finally, after three weeks...\Ever since that fight,\Hinata and Kageyama-kun stopped talking to each other.\But both of them worked hard on improving.\And, now...\The weirdo duo is back in action! response:	One more time!
context: Nice kill, Hinata! Kageyama-kun!\Finally, after three weeks...\Ever since that fight,\Hinata and Kageyama-kun stopped talking to each other.\But both of them worked hard on improving.\And, now...\The weirdo duo is back in action!\One more time! response:	I'm so jealous!
context: Finally, after three weeks...\Ever since that fight,\Hinata and Kageyama-kun stopped talking to each other.\But both of them worked hard on improving.\And, now...\The weirdo duo is back in action!\One more time!\I'm so jealous! response:	Let me look cool, too!
context: Ever since that fight,\Hinata and Kageyama-kun stopped talking to each other.\But both of them worked hard on improving.\And, now...\The weirdo duo is back in action!\One more time!\I'm so jealous!\Let me look cool, too! response:	We can't let them beat us.
context: Hinata and Kageyama-kun stopped talking to each other.\But both of them worked hard on improving.\And, now...\The weirdo duo is back in action!\One more time!\I'm so jealous!\Let me look cool, too!\We can't let them beat us. response:	Let's keep up!
context: But both of them worked hard on improving.\And, now...\The weirdo duo is back in action!\One more time!\I'm so jealous!\Let me look cool, too!\We can't let them beat us.\Let's keep up! response:	Hey, hey, hey!
context: And, now...\The weirdo duo is back in action!\One more time!\I'm so jealous!\Let me look cool, too!\We can't let them beat us.\Let's keep up!\Hey, hey, hey! response:	Don't get cocky, you guys!
context: The weirdo duo is back in action!\One more time!\I'm so jealous!\Let me look cool, too!\We can't let them beat us.\Let's keep up!\Hey, hey, hey!\Don't get cocky, you guys! response:	Hey, hey, hey!
context: One more time!\I'm so jealous!\Let me look cool, too!\We can't let them beat us.\Let's keep up!\Hey, hey, hey!\Don't get cocky, you guys!\Hey, hey, hey! response:	All right!
context: I'm so jealous!\Let me look cool, too!\We can't let them beat us.\Let's keep up!\Hey, hey, hey!\Don't get cocky, you guys!\Hey, hey, hey!\All right! response:	All right!
context: Let me look cool, too!\We can't let them beat us.\Let's keep up!\Hey, hey, hey!\Don't get cocky, you guys!\Hey, hey, hey!\All right!\All right! response:	Shoyo...
context: We can't let them beat us.\Let's keep up!\Hey, hey, hey!\Don't get cocky, you guys!\Hey, hey, hey!\All right!\All right!\Shoyo... response:	Maybe if Shrimpy came to our team,
context: Let's keep up!\Hey, hey, hey!\Don't get cocky, you guys!\Hey, hey, hey!\All right!\All right!\Shoyo...\Maybe if Shrimpy came to our team, response:	you'd feel a bit more motivated.
context: Hey, hey, hey!\Don't get cocky, you guys!\Hey, hey, hey!\All right!\All right!\Shoyo...\Maybe if Shrimpy came to our team,\you'd feel a bit more motivated. response:	I wouldn't be able to be on the same team as Shoyo.
context: Don't get cocky, you guys!\Hey, hey, hey!\All right!\All right!\Shoyo...\Maybe if Shrimpy came to our team,\you'd feel a bit more motivated.\I wouldn't be able to be on the same team as Shoyo. response:	Huh? Why?
context: Hey, hey, hey!\All right!\All right!\Shoyo...\Maybe if Shrimpy came to our team,\you'd feel a bit more motivated.\I wouldn't be able to be on the same team as Shoyo.\Huh? Why? response:	If I'm not able to keep doing new things,
context: All right!\All right!\Shoyo...\Maybe if Shrimpy came to our team,\you'd feel a bit more motivated.\I wouldn't be able to be on the same team as Shoyo.\Huh? Why?\If I'm not able to keep doing new things, response:	I wouldn't be able to keep up with Shoyo.
context: All right!\Shoyo...\Maybe if Shrimpy came to our team,\you'd feel a bit more motivated.\I wouldn't be able to be on the same team as Shoyo.\Huh? Why?\If I'm not able to keep doing new things,\I wouldn't be able to keep up with Shoyo. response:	No matter how well I were to play hookie,
context: Shoyo...\Maybe if Shrimpy came to our team,\you'd feel a bit more motivated.\I wouldn't be able to be on the same team as Shoyo.\Huh? Why?\If I'm not able to keep doing new things,\I wouldn't be able to keep up with Shoyo.\No matter how well I were to play hookie, response:	Shoyo would probably find me out.
context: Maybe if Shrimpy came to our team,\you'd feel a bit more motivated.\I wouldn't be able to be on the same team as Shoyo.\Huh? Why?\If I'm not able to keep doing new things,\I wouldn't be able to keep up with Shoyo.\No matter how well I were to play hookie,\Shoyo would probably find me out. response:	Even that genius first-year setter
context: you'd feel a bit more motivated.\I wouldn't be able to be on the same team as Shoyo.\Huh? Why?\If I'm not able to keep doing new things,\I wouldn't be able to keep up with Shoyo.\No matter how well I were to play hookie,\Shoyo would probably find me out.\Even that genius first-year setter response:	hesitated for just a second and Shoyo figured it out.
context: I wouldn't be able to be on the same team as Shoyo.\Huh? Why?\If I'm not able to keep doing new things,\I wouldn't be able to keep up with Shoyo.\No matter how well I were to play hookie,\Shoyo would probably find me out.\Even that genius first-year setter\hesitated for just a second and Shoyo figured it out. response:	That'd be exhausting.
context: Huh? Why?\If I'm not able to keep doing new things,\I wouldn't be able to keep up with Shoyo.\No matter how well I were to play hookie,\Shoyo would probably find me out.\Even that genius first-year setter\hesitated for just a second and Shoyo figured it out.\That'd be exhausting. response:	Huh...
context: If I'm not able to keep doing new things,\I wouldn't be able to keep up with Shoyo.\No matter how well I were to play hookie,\Shoyo would probably find me out.\Even that genius first-year setter\hesitated for just a second and Shoyo figured it out.\That'd be exhausting.\Huh... response:	Then maybe Shrimpy should just stay as our opponent
context: I wouldn't be able to keep up with Shoyo.\No matter how well I were to play hookie,\Shoyo would probably find me out.\Even that genius first-year setter\hesitated for just a second and Shoyo figured it out.\That'd be exhausting.\Huh...\Then maybe Shrimpy should just stay as our opponent response:	and practice partner, and then you'd feel a bit more motivated.
context: No matter how well I were to play hookie,\Shoyo would probably find me out.\Even that genius first-year setter\hesitated for just a second and Shoyo figured it out.\That'd be exhausting.\Huh...\Then maybe Shrimpy should just stay as our opponent\and practice partner, and then you'd feel a bit more motivated. response:	Why?
context: Shoyo would probably find me out.\Even that genius first-year setter\hesitated for just a second and Shoyo figured it out.\That'd be exhausting.\Huh...\Then maybe Shrimpy should just stay as our opponent\and practice partner, and then you'd feel a bit more motivated.\Why? response:	Because whenever you watch Shrimpy play,
context: Even that genius first-year setter\hesitated for just a second and Shoyo figured it out.\That'd be exhausting.\Huh...\Then maybe Shrimpy should just stay as our opponent\and practice partner, and then you'd feel a bit more motivated.\Why?\Because whenever you watch Shrimpy play, response:	you have the same expression on your face as when you're about
context: hesitated for just a second and Shoyo figured it out.\That'd be exhausting.\Huh...\Then maybe Shrimpy should just stay as our opponent\and practice partner, and then you'd feel a bit more motivated.\Why?\Because whenever you watch Shrimpy play,\you have the same expression on your face as when you're about response:	to play a new game you just bought.
context: That'd be exhausting.\Huh...\Then maybe Shrimpy should just stay as our opponent\and practice partner, and then you'd feel a bit more motivated.\Why?\Because whenever you watch Shrimpy play,\you have the same expression on your face as when you're about\to play a new game you just bought. response:	No, I don't.
context: Huh...\Then maybe Shrimpy should just stay as our opponent\and practice partner, and then you'd feel a bit more motivated.\Why?\Because whenever you watch Shrimpy play,\you have the same expression on your face as when you're about\to play a new game you just bought.\No, I don't. response:	And what does that face look like, anyway?
context: Then maybe Shrimpy should just stay as our opponent\and practice partner, and then you'd feel a bit more motivated.\Why?\Because whenever you watch Shrimpy play,\you have the same expression on your face as when you're about\to play a new game you just bought.\No, I don't.\And what does that face look like, anyway? response:	Really excited.
context: and practice partner, and then you'd feel a bit more motivated.\Why?\Because whenever you watch Shrimpy play,\you have the same expression on your face as when you're about\to play a new game you just bought.\No, I don't.\And what does that face look like, anyway?\Really excited. response:	What does that mean? I don't know what you're talking about.
context: Why?\Because whenever you watch Shrimpy play,\you have the same expression on your face as when you're about\to play a new game you just bought.\No, I don't.\And what does that face look like, anyway?\Really excited.\What does that mean? I don't know what you're talking about. response:	I don't make that face.
context: Because whenever you watch Shrimpy play,\you have the same expression on your face as when you're about\to play a new game you just bought.\No, I don't.\And what does that face look like, anyway?\Really excited.\What does that mean? I don't know what you're talking about.\I don't make that face. response:	You do.
context: you have the same expression on your face as when you're about\to play a new game you just bought.\No, I don't.\And what does that face look like, anyway?\Really excited.\What does that mean? I don't know what you're talking about.\I don't make that face.\You do. response:	I do not.
context: to play a new game you just bought.\No, I don't.\And what does that face look like, anyway?\Really excited.\What does that mean? I don't know what you're talking about.\I don't make that face.\You do.\I do not. response:	You do.
context: No, I don't.\And what does that face look like, anyway?\Really excited.\What does that mean? I don't know what you're talking about.\I don't make that face.\You do.\I do not.\You do. response:	I do not.
context: And what does that face look like, anyway?\Really excited.\What does that mean? I don't know what you're talking about.\I don't make that face.\You do.\I do not.\You do.\I do not. response:	U-Um, Ukai-kun...
context: Really excited.\What does that mean? I don't know what you're talking about.\I don't make that face.\You do.\I do not.\You do.\I do not.\U-Um, Ukai-kun... response:	Hm?
context: What does that mean? I don't know what you're talking about.\I don't make that face.\You do.\I do not.\You do.\I do not.\U-Um, Ukai-kun...\Hm? response:	To be honest, at first glance,
context: I don't make that face.\You do.\I do not.\You do.\I do not.\U-Um, Ukai-kun...\Hm?\To be honest, at first glance, response:	I can't tell the difference between this and their previous weirdo quick.
context: You do.\I do not.\You do.\I do not.\U-Um, Ukai-kun...\Hm?\To be honest, at first glance,\I can't tell the difference between this and their previous weirdo quick. response:	Ah...
context: I do not.\You do.\I do not.\U-Um, Ukai-kun...\Hm?\To be honest, at first glance,\I can't tell the difference between this and their previous weirdo quick.\Ah... response:	In the previous quick,
context: You do.\I do not.\U-Um, Ukai-kun...\Hm?\To be honest, at first glance,\I can't tell the difference between this and their previous weirdo quick.\Ah...\In the previous quick, response:	the toss would go right through Hinata's point of impact.
context: I do not.\U-Um, Ukai-kun...\Hm?\To be honest, at first glance,\I can't tell the difference between this and their previous weirdo quick.\Ah...\In the previous quick,\the toss would go right through Hinata's point of impact. response:	Point of Impact
context: U-Um, Ukai-kun...\Hm?\To be honest, at first glance,\I can't tell the difference between this and their previous weirdo quick.\Ah...\In the previous quick,\the toss would go right through Hinata's point of impact.\Point of Impact response:	Conversely, with this new quick,
context: Hm?\To be honest, at first glance,\I can't tell the difference between this and their previous weirdo quick.\Ah...\In the previous quick,\the toss would go right through Hinata's point of impact.\Point of Impact\Conversely, with this new quick, response:	they're trying to make it so that the spiker's highest point of impact
context: To be honest, at first glance,\I can't tell the difference between this and their previous weirdo quick.\Ah...\In the previous quick,\the toss would go right through Hinata's point of impact.\Point of Impact\Conversely, with this new quick,\they're trying to make it so that the spiker's highest point of impact response:	equals the ball's point of arrival.
context: I can't tell the difference between this and their previous weirdo quick.\Ah...\In the previous quick,\the toss would go right through Hinata's point of impact.\Point of Impact\Conversely, with this new quick,\they're trying to make it so that the spiker's highest point of impact\equals the ball's point of arrival. response:	Once the ball's forward momentum reaches zero,
context: Ah...\In the previous quick,\the toss would go right through Hinata's point of impact.\Point of Impact\Conversely, with this new quick,\they're trying to make it so that the spiker's highest point of impact\equals the ball's point of arrival.\Once the ball's forward momentum reaches zero, response:	there's a brief moment that you wouldn't have
context: In the previous quick,\the toss would go right through Hinata's point of impact.\Point of Impact\Conversely, with this new quick,\they're trying to make it so that the spiker's highest point of impact\equals the ball's point of arrival.\Once the ball's forward momentum reaches zero,\there's a brief moment that you wouldn't have response:	if the ball was going straight through.
context: the toss would go right through Hinata's point of impact.\Point of Impact\Conversely, with this new quick,\they're trying to make it so that the spiker's highest point of impact\equals the ball's point of arrival.\Once the ball's forward momentum reaches zero,\there's a brief moment that you wouldn't have\if the ball was going straight through. response:	The difference is ultimately that one moment.
context: Point of Impact\Conversely, with this new quick,\they're trying to make it so that the spiker's highest point of impact\equals the ball's point of arrival.\Once the ball's forward momentum reaches zero,\there's a brief moment that you wouldn't have\if the ball was going straight through.\The difference is ultimately that one moment. response:	It means that Hinata has more options while he's in the air.
context: Conversely, with this new quick,\they're trying to make it so that the spiker's highest point of impact\equals the ball's point of arrival.\Once the ball's forward momentum reaches zero,\there's a brief moment that you wouldn't have\if the ball was going straight through.\The difference is ultimately that one moment.\It means that Hinata has more options while he's in the air. response:	Oh!
context: they're trying to make it so that the spiker's highest point of impact\equals the ball's point of arrival.\Once the ball's forward momentum reaches zero,\there's a brief moment that you wouldn't have\if the ball was going straight through.\The difference is ultimately that one moment.\It means that Hinata has more options while he's in the air.\Oh! response:	I need to make sure
context: equals the ball's point of arrival.\Once the ball's forward momentum reaches zero,\there's a brief moment that you wouldn't have\if the ball was going straight through.\The difference is ultimately that one moment.\It means that Hinata has more options while he's in the air.\Oh!\I need to make sure response:	I bring that geezer to the spring tournament.
context: Once the ball's forward momentum reaches zero,\there's a brief moment that you wouldn't have\if the ball was going straight through.\The difference is ultimately that one moment.\It means that Hinata has more options while he's in the air.\Oh!\I need to make sure\I bring that geezer to the spring tournament. response:	I'm gonna show him their quick in person.
context: there's a brief moment that you wouldn't have\if the ball was going straight through.\The difference is ultimately that one moment.\It means that Hinata has more options while he's in the air.\Oh!\I need to make sure\I bring that geezer to the spring tournament.\I'm gonna show him their quick in person. response:	Nice receive!
context: if the ball was going straight through.\The difference is ultimately that one moment.\It means that Hinata has more options while he's in the air.\Oh!\I need to make sure\I bring that geezer to the spring tournament.\I'm gonna show him their quick in person.\Nice receive! response:	Kill the ball's momentum...
context: The difference is ultimately that one moment.\It means that Hinata has more options while he's in the air.\Oh!\I need to make sure\I bring that geezer to the spring tournament.\I'm gonna show him their quick in person.\Nice receive!\Kill the ball's momentum... response:	Kill it...
context: It means that Hinata has more options while he's in the air.\Oh!\I need to make sure\I bring that geezer to the spring tournament.\I'm gonna show him their quick in person.\Nice receive!\Kill the ball's momentum...\Kill it... response:	Damn it! I'm visualizing the same thing as last time, too!
context: Oh!\I need to make sure\I bring that geezer to the spring tournament.\I'm gonna show him their quick in person.\Nice receive!\Kill the ball's momentum...\Kill it...\Damn it! I'm visualizing the same thing as last time, too! response:	All right!
context: I need to make sure\I bring that geezer to the spring tournament.\I'm gonna show him their quick in person.\Nice receive!\Kill the ball's momentum...\Kill it...\Damn it! I'm visualizing the same thing as last time, too!\All right! response:	Oh, my.
context: I bring that geezer to the spring tournament.\I'm gonna show him their quick in person.\Nice receive!\Kill the ball's momentum...\Kill it...\Damn it! I'm visualizing the same thing as last time, too!\All right!\Oh, my. response:	Lucky! Lucky!
context: I'm gonna show him their quick in person.\Nice receive!\Kill the ball's momentum...\Kill it...\Damn it! I'm visualizing the same thing as last time, too!\All right!\Oh, my.\Lucky! Lucky! response:	Did he lose his incredible concentration from earlier?
context: Nice receive!\Kill the ball's momentum...\Kill it...\Damn it! I'm visualizing the same thing as last time, too!\All right!\Oh, my.\Lucky! Lucky!\Did he lose his incredible concentration from earlier? response:	Don't worry about it, Kageyama-kun!
context: Kill the ball's momentum...\Kill it...\Damn it! I'm visualizing the same thing as last time, too!\All right!\Oh, my.\Lucky! Lucky!\Did he lose his incredible concentration from earlier?\Don't worry about it, Kageyama-kun! response:	Damn it! That pisses me off!
context: Kill it...\Damn it! I'm visualizing the same thing as last time, too!\All right!\Oh, my.\Lucky! Lucky!\Did he lose his incredible concentration from earlier?\Don't worry about it, Kageyama-kun!\Damn it! That pisses me off! response:	Why?! What else am I supposed to say?!
context: Damn it! I'm visualizing the same thing as last time, too!\All right!\Oh, my.\Lucky! Lucky!\Did he lose his incredible concentration from earlier?\Don't worry about it, Kageyama-kun!\Damn it! That pisses me off!\Why?! What else am I supposed to say?! response:	Well, this isn't something that happens easily.
context: All right!\Oh, my.\Lucky! Lucky!\Did he lose his incredible concentration from earlier?\Don't worry about it, Kageyama-kun!\Damn it! That pisses me off!\Why?! What else am I supposed to say?!\Well, this isn't something that happens easily. response:	And what better time...
context: Oh, my.\Lucky! Lucky!\Did he lose his incredible concentration from earlier?\Don't worry about it, Kageyama-kun!\Damn it! That pisses me off!\Why?! What else am I supposed to say?!\Well, this isn't something that happens easily.\And what better time... response:	Karasuno Fukurodani
context: Lucky! Lucky!\Did he lose his incredible concentration from earlier?\Don't worry about it, Kageyama-kun!\Damn it! That pisses me off!\Why?! What else am I supposed to say?!\Well, this isn't something that happens easily.\And what better time...\Karasuno Fukurodani response:	One blocker!
context: Did he lose his incredible concentration from earlier?\Don't worry about it, Kageyama-kun!\Damn it! That pisses me off!\Why?! What else am I supposed to say?!\Well, this isn't something that happens easily.\And what better time...\Karasuno Fukurodani\One blocker! response:	One touch!
context: Don't worry about it, Kageyama-kun!\Damn it! That pisses me off!\Why?! What else am I supposed to say?!\Well, this isn't something that happens easily.\And what better time...\Karasuno Fukurodani\One blocker!\One touch! response:	Got it!
context: Damn it! That pisses me off!\Why?! What else am I supposed to say?!\Well, this isn't something that happens easily.\And what better time...\Karasuno Fukurodani\One blocker!\One touch!\Got it! response:	There's that weird sound!
context: Why?! What else am I supposed to say?!\Well, this isn't something that happens easily.\And what better time...\Karasuno Fukurodani\One blocker!\One touch!\Got it!\There's that weird sound! response:	But a double hit wasn't called!
context: Well, this isn't something that happens easily.\And what better time...\Karasuno Fukurodani\One blocker!\One touch!\Got it!\There's that weird sound!\But a double hit wasn't called! response:	From the libero's toss...
context: And what better time...\Karasuno Fukurodani\One blocker!\One touch!\Got it!\There's that weird sound!\But a double hit wasn't called!\From the libero's toss... response:	It's the ace's...
context: Karasuno Fukurodani\One blocker!\One touch!\Got it!\There's that weird sound!\But a double hit wasn't called!\From the libero's toss...\It's the ace's... response:	The second...
context: One blocker!\One touch!\Got it!\There's that weird sound!\But a double hit wasn't called!\From the libero's toss...\It's the ace's...\The second... response:	It's an out?! So close!
context: One touch!\Got it!\There's that weird sound!\But a double hit wasn't called!\From the libero's toss...\It's the ace's...\The second...\It's an out?! So close! response:	Sorry, my toss was a bit low. Damn it!
context: Got it!\There's that weird sound!\But a double hit wasn't called!\From the libero's toss...\It's the ace's...\The second...\It's an out?! So close!\Sorry, my toss was a bit low. Damn it! response:	I-It was fine!
context: There's that weird sound!\But a double hit wasn't called!\From the libero's toss...\It's the ace's...\The second...\It's an out?! So close!\Sorry, my toss was a bit low. Damn it!\I-It was fine! response:	I actually think it was my mistake.
context: But a double hit wasn't called!\From the libero's toss...\It's the ace's...\The second...\It's an out?! So close!\Sorry, my toss was a bit low. Damn it!\I-It was fine!\I actually think it was my mistake. response:	You need to be honest when I mess up, Asahi-san!
context: From the libero's toss...\It's the ace's...\The second...\It's an out?! So close!\Sorry, my toss was a bit low. Damn it!\I-It was fine!\I actually think it was my mistake.\You need to be honest when I mess up, Asahi-san! response:	Oh, okay...
context: It's the ace's...\The second...\It's an out?! So close!\Sorry, my toss was a bit low. Damn it!\I-It was fine!\I actually think it was my mistake.\You need to be honest when I mess up, Asahi-san!\Oh, okay... response:	I-I'd appreciate it if you could toss the ball up a bit higher.
context: The second...\It's an out?! So close!\Sorry, my toss was a bit low. Damn it!\I-It was fine!\I actually think it was my mistake.\You need to be honest when I mess up, Asahi-san!\Oh, okay...\I-I'd appreciate it if you could toss the ball up a bit higher. response:	They changed this much in a week?
context: It's an out?! So close!\Sorry, my toss was a bit low. Damn it!\I-It was fine!\I actually think it was my mistake.\You need to be honest when I mess up, Asahi-san!\Oh, okay...\I-I'd appreciate it if you could toss the ball up a bit higher.\They changed this much in a week? response:	I know that!
context: Sorry, my toss was a bit low. Damn it!\I-It was fine!\I actually think it was my mistake.\You need to be honest when I mess up, Asahi-san!\Oh, okay...\I-I'd appreciate it if you could toss the ball up a bit higher.\They changed this much in a week?\I know that! response:	That's terrifying.
context: I-It was fine!\I actually think it was my mistake.\You need to be honest when I mess up, Asahi-san!\Oh, okay...\I-I'd appreciate it if you could toss the ball up a bit higher.\They changed this much in a week?\I know that!\That's terrifying. response:	That's it! Keep it up!
context: I actually think it was my mistake.\You need to be honest when I mess up, Asahi-san!\Oh, okay...\I-I'd appreciate it if you could toss the ball up a bit higher.\They changed this much in a week?\I know that!\That's terrifying.\That's it! Keep it up! response:	We still don't have enough experience
context: You need to be honest when I mess up, Asahi-san!\Oh, okay...\I-I'd appreciate it if you could toss the ball up a bit higher.\They changed this much in a week?\I know that!\That's terrifying.\That's it! Keep it up!\We still don't have enough experience response:	to be able to go head-to-head with a powerhouse school
context: Oh, okay...\I-I'd appreciate it if you could toss the ball up a bit higher.\They changed this much in a week?\I know that!\That's terrifying.\That's it! Keep it up!\We still don't have enough experience\to be able to go head-to-head with a powerhouse school response:	while they're on guard.
context: I-I'd appreciate it if you could toss the ball up a bit higher.\They changed this much in a week?\I know that!\That's terrifying.\That's it! Keep it up!\We still don't have enough experience\to be able to go head-to-head with a powerhouse school\while they're on guard. response:	Got it!
context: They changed this much in a week?\I know that!\That's terrifying.\That's it! Keep it up!\We still don't have enough experience\to be able to go head-to-head with a powerhouse school\while they're on guard.\Got it! response:	Left! Left!
context: I know that!\That's terrifying.\That's it! Keep it up!\We still don't have enough experience\to be able to go head-to-head with a powerhouse school\while they're on guard.\Got it!\Left! Left! response:	Karasuno Fukurodani
context: That's terrifying.\That's it! Keep it up!\We still don't have enough experience\to be able to go head-to-head with a powerhouse school\while they're on guard.\Got it!\Left! Left!\Karasuno Fukurodani response:	Two blockers!
context: That's it! Keep it up!\We still don't have enough experience\to be able to go head-to-head with a powerhouse school\while they're on guard.\Got it!\Left! Left!\Karasuno Fukurodani\Two blockers! response:	Our team might not be good at winning right now,
context: We still don't have enough experience\to be able to go head-to-head with a powerhouse school\while they're on guard.\Got it!\Left! Left!\Karasuno Fukurodani\Two blockers!\Our team might not be good at winning right now, response:	Chance ball!
context: to be able to go head-to-head with a powerhouse school\while they're on guard.\Got it!\Left! Left!\Karasuno Fukurodani\Two blockers!\Our team might not be good at winning right now,\Chance ball! response:	Chance ball!
context: while they're on guard.\Got it!\Left! Left!\Karasuno Fukurodani\Two blockers!\Our team might not be good at winning right now,\Chance ball!\Chance ball! response:	Got it!
context: Got it!\Left! Left!\Karasuno Fukurodani\Two blockers!\Our team might not be good at winning right now,\Chance ball!\Chance ball!\Got it! response:	but we'll focus on honing our new weapons.
context: Left! Left!\Karasuno Fukurodani\Two blockers!\Our team might not be good at winning right now,\Chance ball!\Chance ball!\Got it!\but we'll focus on honing our new weapons. response:	Now!
context: Karasuno Fukurodani\Two blockers!\Our team might not be good at winning right now,\Chance ball!\Chance ball!\Got it!\but we'll focus on honing our new weapons.\Now! response:	Spikers from all directions head up about the same time...
context: Two blockers!\Our team might not be good at winning right now,\Chance ball!\Chance ball!\Got it!\but we'll focus on honing our new weapons.\Now!\Spikers from all directions head up about the same time... response:	A synchronized attack on first tempo!
context: Our team might not be good at winning right now,\Chance ball!\Chance ball!\Got it!\but we'll focus on honing our new weapons.\Now!\Spikers from all directions head up about the same time...\A synchronized attack on first tempo! response:	Don't let the blockers pinpoint the target!
context: Chance ball!\Chance ball!\Got it!\but we'll focus on honing our new weapons.\Now!\Spikers from all directions head up about the same time...\A synchronized attack on first tempo!\Don't let the blockers pinpoint the target! response:	All of you, jump up and strike like the toss is going up for you!
context: Chance ball!\Got it!\but we'll focus on honing our new weapons.\Now!\Spikers from all directions head up about the same time...\A synchronized attack on first tempo!\Don't let the blockers pinpoint the target!\All of you, jump up and strike like the toss is going up for you! response:	All right!
context: Got it!\but we'll focus on honing our new weapons.\Now!\Spikers from all directions head up about the same time...\A synchronized attack on first tempo!\Don't let the blockers pinpoint the target!\All of you, jump up and strike like the toss is going up for you!\All right! response:	It feels so awesome when a spike goes through...
context: but we'll focus on honing our new weapons.\Now!\Spikers from all directions head up about the same time...\A synchronized attack on first tempo!\Don't let the blockers pinpoint the target!\All of you, jump up and strike like the toss is going up for you!\All right!\It feels so awesome when a spike goes through... response:	He's crying...
context: Now!\Spikers from all directions head up about the same time...\A synchronized attack on first tempo!\Don't let the blockers pinpoint the target!\All of you, jump up and strike like the toss is going up for you!\All right!\It feels so awesome when a spike goes through...\He's crying... response:	All right!
context: Spikers from all directions head up about the same time...\A synchronized attack on first tempo!\Don't let the blockers pinpoint the target!\All of you, jump up and strike like the toss is going up for you!\All right!\It feels so awesome when a spike goes through...\He's crying...\All right! response:	He's babbling...
context: A synchronized attack on first tempo!\Don't let the blockers pinpoint the target!\All of you, jump up and strike like the toss is going up for you!\All right!\It feels so awesome when a spike goes through...\He's crying...\All right!\He's babbling... response:	Well, it's been so long since I made a spike this awesome.
context: Don't let the blockers pinpoint the target!\All of you, jump up and strike like the toss is going up for you!\All right!\It feels so awesome when a spike goes through...\He's crying...\All right!\He's babbling...\Well, it's been so long since I made a spike this awesome. response:	Damn it! Where do you guys get off using a synchro attack like that?
context: All of you, jump up and strike like the toss is going up for you!\All right!\It feels so awesome when a spike goes through...\He's crying...\All right!\He's babbling...\Well, it's been so long since I made a spike this awesome.\Damn it! Where do you guys get off using a synchro attack like that? response:	Kageyama, nice toss!
context: All right!\It feels so awesome when a spike goes through...\He's crying...\All right!\He's babbling...\Well, it's been so long since I made a spike this awesome.\Damn it! Where do you guys get off using a synchro attack like that?\Kageyama, nice toss! response:	Thank you!
context: It feels so awesome when a spike goes through...\He's crying...\All right!\He's babbling...\Well, it's been so long since I made a spike this awesome.\Damn it! Where do you guys get off using a synchro attack like that?\Kageyama, nice toss!\Thank you! response:	Tanaka-kun, nice kill!
context: He's crying...\All right!\He's babbling...\Well, it's been so long since I made a spike this awesome.\Damn it! Where do you guys get off using a synchro attack like that?\Kageyama, nice toss!\Thank you!\Tanaka-kun, nice kill! response:	Thanks!
context: All right!\He's babbling...\Well, it's been so long since I made a spike this awesome.\Damn it! Where do you guys get off using a synchro attack like that?\Kageyama, nice toss!\Thank you!\Tanaka-kun, nice kill!\Thanks! response:	Always something new, huh?
context: He's babbling...\Well, it's been so long since I made a spike this awesome.\Damn it! Where do you guys get off using a synchro attack like that?\Kageyama, nice toss!\Thank you!\Tanaka-kun, nice kill!\Thanks!\Always something new, huh? response:	Don't look the other way!
context: Well, it's been so long since I made a spike this awesome.\Damn it! Where do you guys get off using a synchro attack like that?\Kageyama, nice toss!\Thank you!\Tanaka-kun, nice kill!\Thanks!\Always something new, huh?\Don't look the other way! response:	The third...
context: Damn it! Where do you guys get off using a synchro attack like that?\Kageyama, nice toss!\Thank you!\Tanaka-kun, nice kill!\Thanks!\Always something new, huh?\Don't look the other way!\The third... response:	That was a synchronized attack on first tempo...
context: Kageyama, nice toss!\Thank you!\Tanaka-kun, nice kill!\Thanks!\Always something new, huh?\Don't look the other way!\The third...\That was a synchronized attack on first tempo... response:	It went through so smoothly!
context: Thank you!\Tanaka-kun, nice kill!\Thanks!\Always something new, huh?\Don't look the other way!\The third...\That was a synchronized attack on first tempo...\It went through so smoothly! response:	Yeah.
context: Tanaka-kun, nice kill!\Thanks!\Always something new, huh?\Don't look the other way!\The third...\That was a synchronized attack on first tempo...\It went through so smoothly!\Yeah. response:	Against their three blockers,
context: Thanks!\Always something new, huh?\Don't look the other way!\The third...\That was a synchronized attack on first tempo...\It went through so smoothly!\Yeah.\Against their three blockers, response:	our attack, including the back row attack, had four players advancing at once.
context: Always something new, huh?\Don't look the other way!\The third...\That was a synchronized attack on first tempo...\It went through so smoothly!\Yeah.\Against their three blockers,\our attack, including the back row attack, had four players advancing at once. response:	They weren't able to mark all of them.
context: Don't look the other way!\The third...\That was a synchronized attack on first tempo...\It went through so smoothly!\Yeah.\Against their three blockers,\our attack, including the back row attack, had four players advancing at once.\They weren't able to mark all of them. response:	Is something wrong?
context: The third...\That was a synchronized attack on first tempo...\It went through so smoothly!\Yeah.\Against their three blockers,\our attack, including the back row attack, had four players advancing at once.\They weren't able to mark all of them.\Is something wrong? response:	No...
context: That was a synchronized attack on first tempo...\It went through so smoothly!\Yeah.\Against their three blockers,\our attack, including the back row attack, had four players advancing at once.\They weren't able to mark all of them.\Is something wrong?\No... response:	There's just something I want to try out now.
context: It went through so smoothly!\Yeah.\Against their three blockers,\our attack, including the back row attack, had four players advancing at once.\They weren't able to mark all of them.\Is something wrong?\No...\There's just something I want to try out now. response:	Damn it!
context: Yeah.\Against their three blockers,\our attack, including the back row attack, had four players advancing at once.\They weren't able to mark all of them.\Is something wrong?\No...\There's just something I want to try out now.\Damn it! response:	All right!
context: Against their three blockers,\our attack, including the back row attack, had four players advancing at once.\They weren't able to mark all of them.\Is something wrong?\No...\There's just something I want to try out now.\Damn it!\All right! response:	Karasuno's at the top of their game.
context: our attack, including the back row attack, had four players advancing at once.\They weren't able to mark all of them.\Is something wrong?\No...\There's just something I want to try out now.\Damn it!\All right!\Karasuno's at the top of their game. response:	The messy attacks they were trying on the first day are finally succeeding.
context: They weren't able to mark all of them.\Is something wrong?\No...\There's just something I want to try out now.\Damn it!\All right!\Karasuno's at the top of their game.\The messy attacks they were trying on the first day are finally succeeding. response:	All right!
context: Is something wrong?\No...\There's just something I want to try out now.\Damn it!\All right!\Karasuno's at the top of their game.\The messy attacks they were trying on the first day are finally succeeding.\All right! response:	Karasuno Fukurodani
context: No...\There's just something I want to try out now.\Damn it!\All right!\Karasuno's at the top of their game.\The messy attacks they were trying on the first day are finally succeeding.\All right!\Karasuno Fukurodani response:	Yes, yes, yes!
context: There's just something I want to try out now.\Damn it!\All right!\Karasuno's at the top of their game.\The messy attacks they were trying on the first day are finally succeeding.\All right!\Karasuno Fukurodani\Yes, yes, yes! response:	We're actually neck-and-neck
context: Damn it!\All right!\Karasuno's at the top of their game.\The messy attacks they were trying on the first day are finally succeeding.\All right!\Karasuno Fukurodani\Yes, yes, yes!\We're actually neck-and-neck response:	with Fukurodani at the last part of the game.
context: All right!\Karasuno's at the top of their game.\The messy attacks they were trying on the first day are finally succeeding.\All right!\Karasuno Fukurodani\Yes, yes, yes!\We're actually neck-and-neck\with Fukurodani at the last part of the game. response:	Yeah!
context: Karasuno's at the top of their game.\The messy attacks they were trying on the first day are finally succeeding.\All right!\Karasuno Fukurodani\Yes, yes, yes!\We're actually neck-and-neck\with Fukurodani at the last part of the game.\Yeah! response:	That doesn't mean you should get too confident.
context: The messy attacks they were trying on the first day are finally succeeding.\All right!\Karasuno Fukurodani\Yes, yes, yes!\We're actually neck-and-neck\with Fukurodani at the last part of the game.\Yeah!\That doesn't mean you should get too confident. response:	The real battle begins now.
context: All right!\Karasuno Fukurodani\Yes, yes, yes!\We're actually neck-and-neck\with Fukurodani at the last part of the game.\Yeah!\That doesn't mean you should get too confident.\The real battle begins now. response:	Right!
context: Karasuno Fukurodani\Yes, yes, yes!\We're actually neck-and-neck\with Fukurodani at the last part of the game.\Yeah!\That doesn't mean you should get too confident.\The real battle begins now.\Right! response:	It's true that we should be on our guard,
context: Yes, yes, yes!\We're actually neck-and-neck\with Fukurodani at the last part of the game.\Yeah!\That doesn't mean you should get too confident.\The real battle begins now.\Right!\It's true that we should be on our guard, response:	but it's also true that all of the cogs you have created
context: We're actually neck-and-neck\with Fukurodani at the last part of the game.\Yeah!\That doesn't mean you should get too confident.\The real battle begins now.\Right!\It's true that we should be on our guard,\but it's also true that all of the cogs you have created response:	are now starting to fit together.
context: with Fukurodani at the last part of the game.\Yeah!\That doesn't mean you should get too confident.\The real battle begins now.\Right!\It's true that we should be on our guard,\but it's also true that all of the cogs you have created\are now starting to fit together. response:	Please continue to perfect them
context: Yeah!\That doesn't mean you should get too confident.\The real battle begins now.\Right!\It's true that we should be on our guard,\but it's also true that all of the cogs you have created\are now starting to fit together.\Please continue to perfect them response:	while you're playing this match.
context: That doesn't mean you should get too confident.\The real battle begins now.\Right!\It's true that we should be on our guard,\but it's also true that all of the cogs you have created\are now starting to fit together.\Please continue to perfect them\while you're playing this match. response:	Right!
context: The real battle begins now.\Right!\It's true that we should be on our guard,\but it's also true that all of the cogs you have created\are now starting to fit together.\Please continue to perfect them\while you're playing this match.\Right! response:	Also, just as planned,
context: Right!\It's true that we should be on our guard,\but it's also true that all of the cogs you have created\are now starting to fit together.\Please continue to perfect them\while you're playing this match.\Right!\Also, just as planned, response:	you haven't been letting their ace spike too freely.
context: It's true that we should be on our guard,\but it's also true that all of the cogs you have created\are now starting to fit together.\Please continue to perfect them\while you're playing this match.\Right!\Also, just as planned,\you haven't been letting their ace spike too freely. response:	Though there was that one ridiculous cut shot...
context: but it's also true that all of the cogs you have created\are now starting to fit together.\Please continue to perfect them\while you're playing this match.\Right!\Also, just as planned,\you haven't been letting their ace spike too freely.\Though there was that one ridiculous cut shot... response:	But that was because Tsukishima was able to put in one touch.
context: are now starting to fit together.\Please continue to perfect them\while you're playing this match.\Right!\Also, just as planned,\you haven't been letting their ace spike too freely.\Though there was that one ridiculous cut shot...\But that was because Tsukishima was able to put in one touch. response:	Oh, right.
context: Please continue to perfect them\while you're playing this match.\Right!\Also, just as planned,\you haven't been letting their ace spike too freely.\Though there was that one ridiculous cut shot...\But that was because Tsukishima was able to put in one touch.\Oh, right. response:	If you can keep their 4 back, we just might be able to do this.
context: while you're playing this match.\Right!\Also, just as planned,\you haven't been letting their ace spike too freely.\Though there was that one ridiculous cut shot...\But that was because Tsukishima was able to put in one touch.\Oh, right.\If you can keep their 4 back, we just might be able to do this. response:	Let's finish this!
context: Right!\Also, just as planned,\you haven't been letting their ace spike too freely.\Though there was that one ridiculous cut shot...\But that was because Tsukishima was able to put in one touch.\Oh, right.\If you can keep their 4 back, we just might be able to do this.\Let's finish this! response:	Right!
context: Also, just as planned,\you haven't been letting their ace spike too freely.\Though there was that one ridiculous cut shot...\But that was because Tsukishima was able to put in one touch.\Oh, right.\If you can keep their 4 back, we just might be able to do this.\Let's finish this!\Right! response:	We're having a difficult time, but let's stay calm.
context: you haven't been letting their ace spike too freely.\Though there was that one ridiculous cut shot...\But that was because Tsukishima was able to put in one touch.\Oh, right.\If you can keep their 4 back, we just might be able to do this.\Let's finish this!\Right!\We're having a difficult time, but let's stay calm. response:	We can't Karasuno's attacks faze us.
context: Though there was that one ridiculous cut shot...\But that was because Tsukishima was able to put in one touch.\Oh, right.\If you can keep their 4 back, we just might be able to do this.\Let's finish this!\Right!\We're having a difficult time, but let's stay calm.\We can't Karasuno's attacks faze us. response:	Yeah!
context: But that was because Tsukishima was able to put in one touch.\Oh, right.\If you can keep their 4 back, we just might be able to do this.\Let's finish this!\Right!\We're having a difficult time, but let's stay calm.\We can't Karasuno's attacks faze us.\Yeah! response:	Right.
context: Oh, right.\If you can keep their 4 back, we just might be able to do this.\Let's finish this!\Right!\We're having a difficult time, but let's stay calm.\We can't Karasuno's attacks faze us.\Yeah!\Right. response:	Bokuto-san? Were you listening?
context: If you can keep their 4 back, we just might be able to do this.\Let's finish this!\Right!\We're having a difficult time, but let's stay calm.\We can't Karasuno's attacks faze us.\Yeah!\Right.\Bokuto-san? Were you listening? response:	Wha? Yeah, I was listening.
context: Let's finish this!\Right!\We're having a difficult time, but let's stay calm.\We can't Karasuno's attacks faze us.\Yeah!\Right.\Bokuto-san? Were you listening?\Wha? Yeah, I was listening. response:	Come on, let's do this already.
context: Right!\We're having a difficult time, but let's stay calm.\We can't Karasuno's attacks faze us.\Yeah!\Right.\Bokuto-san? Were you listening?\Wha? Yeah, I was listening.\Come on, let's do this already. response:	Could that mean...
context: We're having a difficult time, but let's stay calm.\We can't Karasuno's attacks faze us.\Yeah!\Right.\Bokuto-san? Were you listening?\Wha? Yeah, I was listening.\Come on, let's do this already.\Could that mean... response:	Karasuno Fukurodani
context: We can't Karasuno's attacks faze us.\Yeah!\Right.\Bokuto-san? Were you listening?\Wha? Yeah, I was listening.\Come on, let's do this already.\Could that mean...\Karasuno Fukurodani response:	All right!
context: Yeah!\Right.\Bokuto-san? Were you listening?\Wha? Yeah, I was listening.\Come on, let's do this already.\Could that mean...\Karasuno Fukurodani\All right! response:	Damn it! I'm sorry!
context: Right.\Bokuto-san? Were you listening?\Wha? Yeah, I was listening.\Come on, let's do this already.\Could that mean...\Karasuno Fukurodani\All right!\Damn it! I'm sorry! response:	It was our chance to turn things around...
context: Bokuto-san? Were you listening?\Wha? Yeah, I was listening.\Come on, let's do this already.\Could that mean...\Karasuno Fukurodani\All right!\Damn it! I'm sorry!\It was our chance to turn things around... response:	Don't worry about it!
context: Wha? Yeah, I was listening.\Come on, let's do this already.\Could that mean...\Karasuno Fukurodani\All right!\Damn it! I'm sorry!\It was our chance to turn things around...\Don't worry about it! response:	Nice try, Noya-san!
context: Come on, let's do this already.\Could that mean...\Karasuno Fukurodani\All right!\Damn it! I'm sorry!\It was our chance to turn things around...\Don't worry about it!\Nice try, Noya-san! response:	All right! I'm gonna blow them away with my serve.
context: Could that mean...\Karasuno Fukurodani\All right!\Damn it! I'm sorry!\It was our chance to turn things around...\Don't worry about it!\Nice try, Noya-san!\All right! I'm gonna blow them away with my serve. response:	Bokuto, nice serve!
context: Karasuno Fukurodani\All right!\Damn it! I'm sorry!\It was our chance to turn things around...\Don't worry about it!\Nice try, Noya-san!\All right! I'm gonna blow them away with my serve.\Bokuto, nice serve! response:	Bokuto-san, stay calm.
context: All right!\Damn it! I'm sorry!\It was our chance to turn things around...\Don't worry about it!\Nice try, Noya-san!\All right! I'm gonna blow them away with my serve.\Bokuto, nice serve!\Bokuto-san, stay calm. response:	I am calm!
context: Damn it! I'm sorry!\It was our chance to turn things around...\Don't worry about it!\Nice try, Noya-san!\All right! I'm gonna blow them away with my serve.\Bokuto, nice serve!\Bokuto-san, stay calm.\I am calm! response:	This isn't good. He's losing his temper.
context: It was our chance to turn things around...\Don't worry about it!\Nice try, Noya-san!\All right! I'm gonna blow them away with my serve.\Bokuto, nice serve!\Bokuto-san, stay calm.\I am calm!\This isn't good. He's losing his temper. response:	All right! Here I go!
context: Don't worry about it!\Nice try, Noya-san!\All right! I'm gonna blow them away with my serve.\Bokuto, nice serve!\Bokuto-san, stay calm.\I am calm!\This isn't good. He's losing his temper.\All right! Here I go! response:	Damn it! I'm sorry!
context: Nice try, Noya-san!\All right! I'm gonna blow them away with my serve.\Bokuto, nice serve!\Bokuto-san, stay calm.\I am calm!\This isn't good. He's losing his temper.\All right! Here I go!\Damn it! I'm sorry! response:	Calm down.
context: All right! I'm gonna blow them away with my serve.\Bokuto, nice serve!\Bokuto-san, stay calm.\I am calm!\This isn't good. He's losing his temper.\All right! Here I go!\Damn it! I'm sorry!\Calm down. response:	Don't worry about it...
context: Bokuto, nice serve!\Bokuto-san, stay calm.\I am calm!\This isn't good. He's losing his temper.\All right! Here I go!\Damn it! I'm sorry!\Calm down.\Don't worry about it... response:	I'm sorry!
context: Bokuto-san, stay calm.\I am calm!\This isn't good. He's losing his temper.\All right! Here I go!\Damn it! I'm sorry!\Calm down.\Don't worry about it...\I'm sorry! response:	Karasuno Fukurodani
context: I am calm!\This isn't good. He's losing his temper.\All right! Here I go!\Damn it! I'm sorry!\Calm down.\Don't worry about it...\I'm sorry!\Karasuno Fukurodani response:	Hey, Karasuno caught up with them again.
context: This isn't good. He's losing his temper.\All right! Here I go!\Damn it! I'm sorry!\Calm down.\Don't worry about it...\I'm sorry!\Karasuno Fukurodani\Hey, Karasuno caught up with them again. response:	Yeah...
context: All right! Here I go!\Damn it! I'm sorry!\Calm down.\Don't worry about it...\I'm sorry!\Karasuno Fukurodani\Hey, Karasuno caught up with them again.\Yeah... response:	Are they actually going to turn the tables at the last minute?
context: Damn it! I'm sorry!\Calm down.\Don't worry about it...\I'm sorry!\Karasuno Fukurodani\Hey, Karasuno caught up with them again.\Yeah...\Are they actually going to turn the tables at the last minute? response:	Their 4 can hit from anywhere.
context: Calm down.\Don't worry about it...\I'm sorry!\Karasuno Fukurodani\Hey, Karasuno caught up with them again.\Yeah...\Are they actually going to turn the tables at the last minute?\Their 4 can hit from anywhere. response:	We're gonna use our serves and try to keep him in check.
context: Don't worry about it...\I'm sorry!\Karasuno Fukurodani\Hey, Karasuno caught up with them again.\Yeah...\Are they actually going to turn the tables at the last minute?\Their 4 can hit from anywhere.\We're gonna use our serves and try to keep him in check. response:	Right.
context: I'm sorry!\Karasuno Fukurodani\Hey, Karasuno caught up with them again.\Yeah...\Are they actually going to turn the tables at the last minute?\Their 4 can hit from anywhere.\We're gonna use our serves and try to keep him in check.\Right. response:	Crap! I aimed too far for the corner.
context: Karasuno Fukurodani\Hey, Karasuno caught up with them again.\Yeah...\Are they actually going to turn the tables at the last minute?\Their 4 can hit from anywhere.\We're gonna use our serves and try to keep him in check.\Right.\Crap! I aimed too far for the corner. response:	You jerk!
context: Hey, Karasuno caught up with them again.\Yeah...\Are they actually going to turn the tables at the last minute?\Their 4 can hit from anywhere.\We're gonna use our serves and try to keep him in check.\Right.\Crap! I aimed too far for the corner.\You jerk! response:	Whoa...
context: Yeah...\Are they actually going to turn the tables at the last minute?\Their 4 can hit from anywhere.\We're gonna use our serves and try to keep him in check.\Right.\Crap! I aimed too far for the corner.\You jerk!\Whoa... response:	It barely made it in. Lucky!
context: Are they actually going to turn the tables at the last minute?\Their 4 can hit from anywhere.\We're gonna use our serves and try to keep him in check.\Right.\Crap! I aimed too far for the corner.\You jerk!\Whoa...\It barely made it in. Lucky! response:	Give it to me!
context: Their 4 can hit from anywhere.\We're gonna use our serves and try to keep him in check.\Right.\Crap! I aimed too far for the corner.\You jerk!\Whoa...\It barely made it in. Lucky!\Give it to me! response:	I'll finish this in one hit!
context: We're gonna use our serves and try to keep him in check.\Right.\Crap! I aimed too far for the corner.\You jerk!\Whoa...\It barely made it in. Lucky!\Give it to me!\I'll finish this in one hit! response:	Seconds
context: Right.\Crap! I aimed too far for the corner.\You jerk!\Whoa...\It barely made it in. Lucky!\Give it to me!\I'll finish this in one hit!\Seconds response:	There are few possibilities
context: Crap! I aimed too far for the corner.\You jerk!\Whoa...\It barely made it in. Lucky!\Give it to me!\I'll finish this in one hit!\Seconds\There are few possibilities response:	when giving a toss to Bokuto-san while he's a bit angry.
context: You jerk!\Whoa...\It barely made it in. Lucky!\Give it to me!\I'll finish this in one hit!\Seconds\There are few possibilities\when giving a toss to Bokuto-san while he's a bit angry. response:	Seconds
context: Whoa...\It barely made it in. Lucky!\Give it to me!\I'll finish this in one hit!\Seconds\There are few possibilities\when giving a toss to Bokuto-san while he's a bit angry.\Seconds response:	A: If he scores normally, there will be no problems.
context: It barely made it in. Lucky!\Give it to me!\I'll finish this in one hit!\Seconds\There are few possibilities\when giving a toss to Bokuto-san while he's a bit angry.\Seconds\A: If he scores normally, there will be no problems. response:	All right!
context: Give it to me!\I'll finish this in one hit!\Seconds\There are few possibilities\when giving a toss to Bokuto-san while he's a bit angry.\Seconds\A: If he scores normally, there will be no problems.\All right! response:	B: If he misses, or he's blocked again,
context: I'll finish this in one hit!\Seconds\There are few possibilities\when giving a toss to Bokuto-san while he's a bit angry.\Seconds\A: If he scores normally, there will be no problems.\All right!\B: If he misses, or he's blocked again, response:	he may start to feel even worse.
context: Seconds\There are few possibilities\when giving a toss to Bokuto-san while he's a bit angry.\Seconds\A: If he scores normally, there will be no problems.\All right!\B: If he misses, or he's blocked again,\he may start to feel even worse. response:	C: If I don't give him a pass...
context: There are few possibilities\when giving a toss to Bokuto-san while he's a bit angry.\Seconds\A: If he scores normally, there will be no problems.\All right!\B: If he misses, or he's blocked again,\he may start to feel even worse.\C: If I don't give him a pass... response:	Hmph! I don't care anymore!
context: when giving a toss to Bokuto-san while he's a bit angry.\Seconds\A: If he scores normally, there will be no problems.\All right!\B: If he misses, or he's blocked again,\he may start to feel even worse.\C: If I don't give him a pass...\Hmph! I don't care anymore! response:	he may become uncooperative.
context: Seconds\A: If he scores normally, there will be no problems.\All right!\B: If he misses, or he's blocked again,\he may start to feel even worse.\C: If I don't give him a pass...\Hmph! I don't care anymore!\he may become uncooperative. response:	C is the most annoying.
context: A: If he scores normally, there will be no problems.\All right!\B: If he misses, or he's blocked again,\he may start to feel even worse.\C: If I don't give him a pass...\Hmph! I don't care anymore!\he may become uncooperative.\C is the most annoying. response:	Bokuto-san!
context: All right!\B: If he misses, or he's blocked again,\he may start to feel even worse.\C: If I don't give him a pass...\Hmph! I don't care anymore!\he may become uncooperative.\C is the most annoying.\Bokuto-san! response:	Three blockers!
context: B: If he misses, or he's blocked again,\he may start to feel even worse.\C: If I don't give him a pass...\Hmph! I don't care anymore!\he may become uncooperative.\C is the most annoying.\Bokuto-san!\Three blockers! response:	All right!
context: he may start to feel even worse.\C: If I don't give him a pass...\Hmph! I don't care anymore!\he may become uncooperative.\C is the most annoying.\Bokuto-san!\Three blockers!\All right! response:	Got it!
context: C: If I don't give him a pass...\Hmph! I don't care anymore!\he may become uncooperative.\C is the most annoying.\Bokuto-san!\Three blockers!\All right!\Got it! response:	One more time, Akaashi!
context: Hmph! I don't care anymore!\he may become uncooperative.\C is the most annoying.\Bokuto-san!\Three blockers!\All right!\Got it!\One more time, Akaashi! response:	Here.
context: he may become uncooperative.\C is the most annoying.\Bokuto-san!\Three blockers!\All right!\Got it!\One more time, Akaashi!\Here. response:	All right!
context: C is the most annoying.\Bokuto-san!\Three blockers!\All right!\Got it!\One more time, Akaashi!\Here.\All right! response:	This time, we're gonna stop it!
context: Bokuto-san!\Three blockers!\All right!\Got it!\One more time, Akaashi!\Here.\All right!\This time, we're gonna stop it! response:	Ready, and...
context: Three blockers!\All right!\Got it!\One more time, Akaashi!\Here.\All right!\This time, we're gonna stop it!\Ready, and... response:	Ah...
context: All right!\Got it!\One more time, Akaashi!\Here.\All right!\This time, we're gonna stop it!\Ready, and...\Ah... response:	Gah.
context: Got it!\One more time, Akaashi!\Here.\All right!\This time, we're gonna stop it!\Ready, and...\Ah...\Gah. response:	All right!
context: One more time, Akaashi!\Here.\All right!\This time, we're gonna stop it!\Ready, and...\Ah...\Gah.\All right! response:	Karasuno Fukurodani
context: Here.\All right!\This time, we're gonna stop it!\Ready, and...\Ah...\Gah.\All right!\Karasuno Fukurodani response:	Wow, Karasuno turned it around!
context: All right!\This time, we're gonna stop it!\Ready, and...\Ah...\Gah.\All right!\Karasuno Fukurodani\Wow, Karasuno turned it around! response:	Isn't this the first time this week Karasuno has taken the lead?
context: This time, we're gonna stop it!\Ready, and...\Ah...\Gah.\All right!\Karasuno Fukurodani\Wow, Karasuno turned it around!\Isn't this the first time this week Karasuno has taken the lead? response:	It could be.
context: Ready, and...\Ah...\Gah.\All right!\Karasuno Fukurodani\Wow, Karasuno turned it around!\Isn't this the first time this week Karasuno has taken the lead?\It could be. response:	W-Was that a block?
context: Ah...\Gah.\All right!\Karasuno Fukurodani\Wow, Karasuno turned it around!\Isn't this the first time this week Karasuno has taken the lead?\It could be.\W-Was that a block? response:	No... It didn't seem to make it over the net,
context: Gah.\All right!\Karasuno Fukurodani\Wow, Karasuno turned it around!\Isn't this the first time this week Karasuno has taken the lead?\It could be.\W-Was that a block?\No... It didn't seem to make it over the net, response:	so it was a spike miss.
context: All right!\Karasuno Fukurodani\Wow, Karasuno turned it around!\Isn't this the first time this week Karasuno has taken the lead?\It could be.\W-Was that a block?\No... It didn't seem to make it over the net,\so it was a spike miss. response:	Oh, could this mean...
context: Karasuno Fukurodani\Wow, Karasuno turned it around!\Isn't this the first time this week Karasuno has taken the lead?\It could be.\W-Was that a block?\No... It didn't seem to make it over the net,\so it was a spike miss.\Oh, could this mean... response:	Aw, man... Is this happening now?
context: Wow, Karasuno turned it around!\Isn't this the first time this week Karasuno has taken the lead?\It could be.\W-Was that a block?\No... It didn't seem to make it over the net,\so it was a spike miss.\Oh, could this mean...\Aw, man... Is this happening now? response:	Seriously? Isn't it a bit early?
context: Isn't this the first time this week Karasuno has taken the lead?\It could be.\W-Was that a block?\No... It didn't seem to make it over the net,\so it was a spike miss.\Oh, could this mean...\Aw, man... Is this happening now?\Seriously? Isn't it a bit early? response:	Wow, already?
context: It could be.\W-Was that a block?\No... It didn't seem to make it over the net,\so it was a spike miss.\Oh, could this mean...\Aw, man... Is this happening now?\Seriously? Isn't it a bit early?\Wow, already? response:	It's early...
context: W-Was that a block?\No... It didn't seem to make it over the net,\so it was a spike miss.\Oh, could this mean...\Aw, man... Is this happening now?\Seriously? Isn't it a bit early?\Wow, already?\It's early... response:	Jeez, here it comes...
context: No... It didn't seem to make it over the net,\so it was a spike miss.\Oh, could this mean...\Aw, man... Is this happening now?\Seriously? Isn't it a bit early?\Wow, already?\It's early...\Jeez, here it comes... response:	Akaashi...
context: so it was a spike miss.\Oh, could this mean...\Aw, man... Is this happening now?\Seriously? Isn't it a bit early?\Wow, already?\It's early...\Jeez, here it comes...\Akaashi... response:	Don't toss to me anymore!
context: Oh, could this mean...\Aw, man... Is this happening now?\Seriously? Isn't it a bit early?\Wow, already?\It's early...\Jeez, here it comes...\Akaashi...\Don't toss to me anymore! response:	There it is! Bokuto's emo mode!
context: Aw, man... Is this happening now?\Seriously? Isn't it a bit early?\Wow, already?\It's early...\Jeez, here it comes...\Akaashi...\Don't toss to me anymore!\There it is! Bokuto's emo mode! response:	What the...
context: Seriously? Isn't it a bit early?\Wow, already?\It's early...\Jeez, here it comes...\Akaashi...\Don't toss to me anymore!\There it is! Bokuto's emo mode!\What the... response:	All right.
context: Wow, already?\It's early...\Jeez, here it comes...\Akaashi...\Don't toss to me anymore!\There it is! Bokuto's emo mode!\What the...\All right. response:	Huh?
context: It's early...\Jeez, here it comes...\Akaashi...\Don't toss to me anymore!\There it is! Bokuto's emo mode!\What the...\All right.\Huh? response:	Then please calm down in the time that I'm not tossing to you.
context: Jeez, here it comes...\Akaashi...\Don't toss to me anymore!\There it is! Bokuto's emo mode!\What the...\All right.\Huh?\Then please calm down in the time that I'm not tossing to you. response:	Does this mean our chance has arrived?
context: Akaashi...\Don't toss to me anymore!\There it is! Bokuto's emo mode!\What the...\All right.\Huh?\Then please calm down in the time that I'm not tossing to you.\Does this mean our chance has arrived? response:	Yeah! We can win this match!
context: Don't toss to me anymore!\There it is! Bokuto's emo mode!\What the...\All right.\Huh?\Then please calm down in the time that I'm not tossing to you.\Does this mean our chance has arrived?\Yeah! We can win this match! response:	I don't know what's going on,
context: There it is! Bokuto's emo mode!\What the...\All right.\Huh?\Then please calm down in the time that I'm not tossing to you.\Does this mean our chance has arrived?\Yeah! We can win this match!\I don't know what's going on, response:	but their ace doesn't seem to be doing well.
context: What the...\All right.\Huh?\Then please calm down in the time that I'm not tossing to you.\Does this mean our chance has arrived?\Yeah! We can win this match!\I don't know what's going on,\but their ace doesn't seem to be doing well. response:	Let's keep it up!
context: All right.\Huh?\Then please calm down in the time that I'm not tossing to you.\Does this mean our chance has arrived?\Yeah! We can win this match!\I don't know what's going on,\but their ace doesn't seem to be doing well.\Let's keep it up! response:	Yeah!
context: Huh?\Then please calm down in the time that I'm not tossing to you.\Does this mean our chance has arrived?\Yeah! We can win this match!\I don't know what's going on,\but their ace doesn't seem to be doing well.\Let's keep it up!\Yeah! response:	Hinata, we're gonna use that quick again.
context: Then please calm down in the time that I'm not tossing to you.\Does this mean our chance has arrived?\Yeah! We can win this match!\I don't know what's going on,\but their ace doesn't seem to be doing well.\Let's keep it up!\Yeah!\Hinata, we're gonna use that quick again. response:	I'll give you the toss that you want.
context: Does this mean our chance has arrived?\Yeah! We can win this match!\I don't know what's going on,\but their ace doesn't seem to be doing well.\Let's keep it up!\Yeah!\Hinata, we're gonna use that quick again.\I'll give you the toss that you want. response:	Trust me, and jump.
context: Yeah! We can win this match!\I don't know what's going on,\but their ace doesn't seem to be doing well.\Let's keep it up!\Yeah!\Hinata, we're gonna use that quick again.\I'll give you the toss that you want.\Trust me, and jump. response:	Yeah!
context: I don't know what's going on,\but their ace doesn't seem to be doing well.\Let's keep it up!\Yeah!\Hinata, we're gonna use that quick again.\I'll give you the toss that you want.\Trust me, and jump.\Yeah! response:	We're going to take our new weapons
context: but their ace doesn't seem to be doing well.\Let's keep it up!\Yeah!\Hinata, we're gonna use that quick again.\I'll give you the toss that you want.\Trust me, and jump.\Yeah!\We're going to take our new weapons response:	and defeat Fukurodani!
context: Let's keep it up!\Yeah!\Hinata, we're gonna use that quick again.\I'll give you the toss that you want.\Trust me, and jump.\Yeah!\We're going to take our new weapons\and defeat Fukurodani! response:	We might finally be able to beat Fukurodani!
context: Yeah!\Hinata, we're gonna use that quick again.\I'll give you the toss that you want.\Trust me, and jump.\Yeah!\We're going to take our new weapons\and defeat Fukurodani!\We might finally be able to beat Fukurodani! response:	Their ace even said not to toss to him anymore.
context: Hinata, we're gonna use that quick again.\I'll give you the toss that you want.\Trust me, and jump.\Yeah!\We're going to take our new weapons\and defeat Fukurodani!\We might finally be able to beat Fukurodani!\Their ace even said not to toss to him anymore. response:	I wonder if we'll be able to eat more meat if we win.
context: I'll give you the toss that you want.\Trust me, and jump.\Yeah!\We're going to take our new weapons\and defeat Fukurodani!\We might finally be able to beat Fukurodani!\Their ace even said not to toss to him anymore.\I wonder if we'll be able to eat more meat if we win. response:	But does that mean we won't be able to eat any if we lose?
context: Trust me, and jump.\Yeah!\We're going to take our new weapons\and defeat Fukurodani!\We might finally be able to beat Fukurodani!\Their ace even said not to toss to him anymore.\I wonder if we'll be able to eat more meat if we win.\But does that mean we won't be able to eat any if we lose? response:	We're gonna win no matter what!
context: Yeah!\We're going to take our new weapons\and defeat Fukurodani!\We might finally be able to beat Fukurodani!\Their ace even said not to toss to him anymore.\I wonder if we'll be able to eat more meat if we win.\But does that mean we won't be able to eat any if we lose?\We're gonna win no matter what! response:	Episode 11: Above
context: We're going to take our new weapons\and defeat Fukurodani!\We might finally be able to beat Fukurodani!\Their ace even said not to toss to him anymore.\I wonder if we'll be able to eat more meat if we win.\But does that mean we won't be able to eat any if we lose?\We're gonna win no matter what!\Episode 11: Above response:	Next time on Haikyu!! : Above.