context: I brought tea. response:	Here you go.
context: I brought tea.\Here you go. response:	Thank you.
context: I brought tea.\Here you go.\Thank you. response:	It's delicious.
context: I brought tea.\Here you go.\Thank you.\It's delicious. response:	Here you go.
context: I brought tea.\Here you go.\Thank you.\It's delicious.\Here you go. response:	Thank you very much, Asahina-san.
context: I brought tea.\Here you go.\Thank you.\It's delicious.\Here you go.\Thank you very much, Asahina-san. response:	Haruhi established the SOS Brigade back in May...
context: I brought tea.\Here you go.\Thank you.\It's delicious.\Here you go.\Thank you very much, Asahina-san.\Haruhi established the SOS Brigade back in May... response:	Actually, during that period...
context: I brought tea.\Here you go.\Thank you.\It's delicious.\Here you go.\Thank you very much, Asahina-san.\Haruhi established the SOS Brigade back in May...\Actually, during that period... response:	Well, let's just leave that aside.
context: Here you go.\Thank you.\It's delicious.\Here you go.\Thank you very much, Asahina-san.\Haruhi established the SOS Brigade back in May...\Actually, during that period...\Well, let's just leave that aside. response:	Today's story goes like this.
context: Thank you.\It's delicious.\Here you go.\Thank you very much, Asahina-san.\Haruhi established the SOS Brigade back in May...\Actually, during that period...\Well, let's just leave that aside.\Today's story goes like this. response:	Everyone!
context: It's delicious.\Here you go.\Thank you very much, Asahina-san.\Haruhi established the SOS Brigade back in May...\Actually, during that period...\Well, let's just leave that aside.\Today's story goes like this.\Everyone! response:	We're entering the baseball tournament!
context: Here you go.\Thank you very much, Asahina-san.\Haruhi established the SOS Brigade back in May...\Actually, during that period...\Well, let's just leave that aside.\Today's story goes like this.\Everyone!\We're entering the baseball tournament! response:	Ninth
context: Thank you very much, Asahina-san.\Haruhi established the SOS Brigade back in May...\Actually, during that period...\Well, let's just leave that aside.\Today's story goes like this.\Everyone!\We're entering the baseball tournament!\Ninth response:	City
context: Haruhi established the SOS Brigade back in May...\Actually, during that period...\Well, let's just leave that aside.\Today's story goes like this.\Everyone!\We're entering the baseball tournament!\Ninth\City response:	Amateur
context: Actually, during that period...\Well, let's just leave that aside.\Today's story goes like this.\Everyone!\We're entering the baseball tournament!\Ninth\City\Amateur response:	Baseball
context: Well, let's just leave that aside.\Today's story goes like this.\Everyone!\We're entering the baseball tournament!\Ninth\City\Amateur\Baseball response:	Tournament
context: Today's story goes like this.\Everyone!\We're entering the baseball tournament!\Ninth\City\Amateur\Baseball\Tournament response:	Accepting Teams
context: Everyone!\We're entering the baseball tournament!\Ninth\City\Amateur\Baseball\Tournament\Accepting Teams response:	Ninth
context: We're entering the baseball tournament!\Ninth\City\Amateur\Baseball\Tournament\Accepting Teams\Ninth response:	City
context: Ninth\City\Amateur\Baseball\Tournament\Accepting Teams\Ninth\City response:	Amateur
context: City\Amateur\Baseball\Tournament\Accepting Teams\Ninth\City\Amateur response:	Baseball
context: Amateur\Baseball\Tournament\Accepting Teams\Ninth\City\Amateur\Baseball response:	Tournament
context: Baseball\Tournament\Accepting Teams\Ninth\City\Amateur\Baseball\Tournament response:	Accepting Teams
context: Tournament\Accepting Teams\Ninth\City\Amateur\Baseball\Tournament\Accepting Teams response:	Ninth
context: Accepting Teams\Ninth\City\Amateur\Baseball\Tournament\Accepting Teams\Ninth response:	City
context: Ninth\City\Amateur\Baseball\Tournament\Accepting Teams\Ninth\City response:	Amateur
context: City\Amateur\Baseball\Tournament\Accepting Teams\Ninth\City\Amateur response:	Baseball
context: Amateur\Baseball\Tournament\Accepting Teams\Ninth\City\Amateur\Baseball response:	Tournament
context: Baseball\Tournament\Accepting Teams\Ninth\City\Amateur\Baseball\Tournament response:	Accepting Teams
context: Tournament\Accepting Teams\Ninth\City\Amateur\Baseball\Tournament\Accepting Teams response:	Since that day...
context: Accepting Teams\Ninth\City\Amateur\Baseball\Tournament\Accepting Teams\Since that day... response:	Thermodynamics
context: Ninth\City\Amateur\Baseball\Tournament\Accepting Teams\Since that day...\Thermodynamics response:	Particle Theory
context: City\Amateur\Baseball\Tournament\Accepting Teams\Since that day...\Thermodynamics\Particle Theory response:	Astrodynamics
context: Amateur\Baseball\Tournament\Accepting Teams\Since that day...\Thermodynamics\Particle Theory\Astrodynamics response:	Because...
context: Baseball\Tournament\Accepting Teams\Since that day...\Thermodynamics\Particle Theory\Astrodynamics\Because... response:	Whenever her face lights up with that smile...
context: Tournament\Accepting Teams\Since that day...\Thermodynamics\Particle Theory\Astrodynamics\Because...\Whenever her face lights up with that smile... response:	What did you say we're entering?
context: Accepting Teams\Since that day...\Thermodynamics\Particle Theory\Astrodynamics\Because...\Whenever her face lights up with that smile...\What did you say we're entering? response:	This!
context: Since that day...\Thermodynamics\Particle Theory\Astrodynamics\Because...\Whenever her face lights up with that smile...\What did you say we're entering?\This! response:	The Boredom of Haruhi Suzumiya
context: Thermodynamics\Particle Theory\Astrodynamics\Because...\Whenever her face lights up with that smile...\What did you say we're entering?\This!\The Boredom of Haruhi Suzumiya response:	The Ninth City Amateur Baseball Tournament.
context: Particle Theory\Astrodynamics\Because...\Whenever her face lights up with that smile...\What did you say we're entering?\This!\The Boredom of Haruhi Suzumiya\The Ninth City Amateur Baseball Tournament. response:	So. Who's entering?
context: Astrodynamics\Because...\Whenever her face lights up with that smile...\What did you say we're entering?\This!\The Boredom of Haruhi Suzumiya\The Ninth City Amateur Baseball Tournament.\So. Who's entering? response:	In this grass-lot baseball tournament?
context: Because...\Whenever her face lights up with that smile...\What did you say we're entering?\This!\The Boredom of Haruhi Suzumiya\The Ninth City Amateur Baseball Tournament.\So. Who's entering?\In this grass-lot baseball tournament? response:	We are, obviously!
context: Whenever her face lights up with that smile...\What did you say we're entering?\This!\The Boredom of Haruhi Suzumiya\The Ninth City Amateur Baseball Tournament.\So. Who's entering?\In this grass-lot baseball tournament?\We are, obviously! response:	When you say we...
context: What did you say we're entering?\This!\The Boredom of Haruhi Suzumiya\The Ninth City Amateur Baseball Tournament.\So. Who's entering?\In this grass-lot baseball tournament?\We are, obviously!\When you say we... response:	- We'll need to find four more people.
context: This!\The Boredom of Haruhi Suzumiya\The Ninth City Amateur Baseball Tournament.\So. Who's entering?\In this grass-lot baseball tournament?\We are, obviously!\When you say we...\- We'll need to find four more people. response:	As usual, she only hears the things she wants to hear.
context: The Boredom of Haruhi Suzumiya\The Ninth City Amateur Baseball Tournament.\So. Who's entering?\In this grass-lot baseball tournament?\We are, obviously!\When you say we...\- We'll need to find four more people.\As usual, she only hears the things she wants to hear. response:	Do you know the rules for baseball?
context: The Ninth City Amateur Baseball Tournament.\So. Who's entering?\In this grass-lot baseball tournament?\We are, obviously!\When you say we...\- We'll need to find four more people.\As usual, she only hears the things she wants to hear.\Do you know the rules for baseball? response:	Of course, I know the rules.
context: So. Who's entering?\In this grass-lot baseball tournament?\We are, obviously!\When you say we...\- We'll need to find four more people.\As usual, she only hears the things she wants to hear.\Do you know the rules for baseball?\Of course, I know the rules. response:	I joined the baseball team for a bit...
context: In this grass-lot baseball tournament?\We are, obviously!\When you say we...\- We'll need to find four more people.\As usual, she only hears the things she wants to hear.\Do you know the rules for baseball?\Of course, I know the rules.\I joined the baseball team for a bit... response:	But it was dead boring so I left immediately.
context: We are, obviously!\When you say we...\- We'll need to find four more people.\As usual, she only hears the things she wants to hear.\Do you know the rules for baseball?\Of course, I know the rules.\I joined the baseball team for a bit...\But it was dead boring so I left immediately. response:	So why do we have to participate in a tournament...
context: When you say we...\- We'll need to find four more people.\As usual, she only hears the things she wants to hear.\Do you know the rules for baseball?\Of course, I know the rules.\I joined the baseball team for a bit...\But it was dead boring so I left immediately.\So why do we have to participate in a tournament... response:	This is a chance to make our existence known around the world!
context: - We'll need to find four more people.\As usual, she only hears the things she wants to hear.\Do you know the rules for baseball?\Of course, I know the rules.\I joined the baseball team for a bit...\But it was dead boring so I left immediately.\So why do we have to participate in a tournament...\This is a chance to make our existence known around the world! response:	If we win this tournament...
context: As usual, she only hears the things she wants to hear.\Do you know the rules for baseball?\Of course, I know the rules.\I joined the baseball team for a bit...\But it was dead boring so I left immediately.\So why do we have to participate in a tournament...\This is a chance to make our existence known around the world!\If we win this tournament... response:	It's a great opportunity!
context: Do you know the rules for baseball?\Of course, I know the rules.\I joined the baseball team for a bit...\But it was dead boring so I left immediately.\So why do we have to participate in a tournament...\This is a chance to make our existence known around the world!\If we win this tournament...\It's a great opportunity! response:	Right?
context: Of course, I know the rules.\I joined the baseball team for a bit...\But it was dead boring so I left immediately.\So why do we have to participate in a tournament...\This is a chance to make our existence known around the world!\If we win this tournament...\It's a great opportunity!\Right? response:	Isn't it a nice idea, Mikuru-chan?
context: I joined the baseball team for a bit...\But it was dead boring so I left immediately.\So why do we have to participate in a tournament...\This is a chance to make our existence known around the world!\If we win this tournament...\It's a great opportunity!\Right?\Isn't it a nice idea, Mikuru-chan? response:	Um, but...
context: But it was dead boring so I left immediately.\So why do we have to participate in a tournament...\This is a chance to make our existence known around the world!\If we win this tournament...\It's a great opportunity!\Right?\Isn't it a nice idea, Mikuru-chan?\Um, but... response:	Right?
context: So why do we have to participate in a tournament...\This is a chance to make our existence known around the world!\If we win this tournament...\It's a great opportunity!\Right?\Isn't it a nice idea, Mikuru-chan?\Um, but...\Right? response:	Baseball sounds good, yeah?
context: This is a chance to make our existence known around the world!\If we win this tournament...\It's a great opportunity!\Right?\Isn't it a nice idea, Mikuru-chan?\Um, but...\Right?\Baseball sounds good, yeah? response:	Just so you know, we're aiming for the championship!
context: If we win this tournament...\It's a great opportunity!\Right?\Isn't it a nice idea, Mikuru-chan?\Um, but...\Right?\Baseball sounds good, yeah?\Just so you know, we're aiming for the championship! response:	Not a single loss will be tolerated!
context: It's a great opportunity!\Right?\Isn't it a nice idea, Mikuru-chan?\Um, but...\Right?\Baseball sounds good, yeah?\Just so you know, we're aiming for the championship!\Not a single loss will be tolerated! response:	I really hate to lose!
context: Right?\Isn't it a nice idea, Mikuru-chan?\Um, but...\Right?\Baseball sounds good, yeah?\Just so you know, we're aiming for the championship!\Not a single loss will be tolerated!\I really hate to lose! response:	Okay?
context: Isn't it a nice idea, Mikuru-chan?\Um, but...\Right?\Baseball sounds good, yeah?\Just so you know, we're aiming for the championship!\Not a single loss will be tolerated!\I really hate to lose!\Okay? response:	Why not?
context: Um, but...\Right?\Baseball sounds good, yeah?\Just so you know, we're aiming for the championship!\Not a single loss will be tolerated!\I really hate to lose!\Okay?\Why not? response:	Don't give your consent so cheerfully.
context: Right?\Baseball sounds good, yeah?\Just so you know, we're aiming for the championship!\Not a single loss will be tolerated!\I really hate to lose!\Okay?\Why not?\Don't give your consent so cheerfully. response:	How about objecting every once in a while?
context: Baseball sounds good, yeah?\Just so you know, we're aiming for the championship!\Not a single loss will be tolerated!\I really hate to lose!\Okay?\Why not?\Don't give your consent so cheerfully.\How about objecting every once in a while? response:	It sounds much more productive than walking around in search of...
context: Just so you know, we're aiming for the championship!\Not a single loss will be tolerated!\I really hate to lose!\Okay?\Why not?\Don't give your consent so cheerfully.\How about objecting every once in a while?\It sounds much more productive than walking around in search of... response:	So? When's the game?
context: Not a single loss will be tolerated!\I really hate to lose!\Okay?\Why not?\Don't give your consent so cheerfully.\How about objecting every once in a while?\It sounds much more productive than walking around in search of...\So? When's the game? response:	This Sunday.
context: I really hate to lose!\Okay?\Why not?\Don't give your consent so cheerfully.\How about objecting every once in a while?\It sounds much more productive than walking around in search of...\So? When's the game?\This Sunday. response:	The day after tomorrow!?
context: Okay?\Why not?\Don't give your consent so cheerfully.\How about objecting every once in a while?\It sounds much more productive than walking around in search of...\So? When's the game?\This Sunday.\The day after tomorrow!? response:	That's way too soon!
context: Why not?\Don't give your consent so cheerfully.\How about objecting every once in a while?\It sounds much more productive than walking around in search of...\So? When's the game?\This Sunday.\The day after tomorrow!?\That's way too soon! response:	But I already turned in the application.
context: Don't give your consent so cheerfully.\How about objecting every once in a while?\It sounds much more productive than walking around in search of...\So? When's the game?\This Sunday.\The day after tomorrow!?\That's way too soon!\But I already turned in the application. response:	Don't worry.
context: How about objecting every once in a while?\It sounds much more productive than walking around in search of...\So? When's the game?\This Sunday.\The day after tomorrow!?\That's way too soon!\But I already turned in the application.\Don't worry. response:	I named the team SOS Brigade!
context: It sounds much more productive than walking around in search of...\So? When's the game?\This Sunday.\The day after tomorrow!?\That's way too soon!\But I already turned in the application.\Don't worry.\I named the team SOS Brigade! response:	There won't be any mistakes in that department!
context: So? When's the game?\This Sunday.\The day after tomorrow!?\That's way too soon!\But I already turned in the application.\Don't worry.\I named the team SOS Brigade!\There won't be any mistakes in that department! response:	Where are you planning on pulling together the other members from?
context: This Sunday.\The day after tomorrow!?\That's way too soon!\But I already turned in the application.\Don't worry.\I named the team SOS Brigade!\There won't be any mistakes in that department!\Where are you planning on pulling together the other members from? response:	Just grab any bored-looking people we see walking around.
context: The day after tomorrow!?\That's way too soon!\But I already turned in the application.\Don't worry.\I named the team SOS Brigade!\There won't be any mistakes in that department!\Where are you planning on pulling together the other members from?\Just grab any bored-looking people we see walking around. response:	She's serious about that.
context: That's way too soon!\But I already turned in the application.\Don't worry.\I named the team SOS Brigade!\There won't be any mistakes in that department!\Where are you planning on pulling together the other members from?\Just grab any bored-looking people we see walking around.\She's serious about that. response:	Got it.
context: But I already turned in the application.\Don't worry.\I named the team SOS Brigade!\There won't be any mistakes in that department!\Where are you planning on pulling together the other members from?\Just grab any bored-looking people we see walking around.\She's serious about that.\Got it. response:	You just sit tight.
context: Don't worry.\I named the team SOS Brigade!\There won't be any mistakes in that department!\Where are you planning on pulling together the other members from?\Just grab any bored-looking people we see walking around.\She's serious about that.\Got it.\You just sit tight. response:	First off, Taniguchi and Kunikida probably don't have anything to do.
context: I named the team SOS Brigade!\There won't be any mistakes in that department!\Where are you planning on pulling together the other members from?\Just grab any bored-looking people we see walking around.\She's serious about that.\Got it.\You just sit tight.\First off, Taniguchi and Kunikida probably don't have anything to do. response:	Those are fine!
context: There won't be any mistakes in that department!\Where are you planning on pulling together the other members from?\Just grab any bored-looking people we see walking around.\She's serious about that.\Got it.\You just sit tight.\First off, Taniguchi and Kunikida probably don't have anything to do.\Those are fine! response:	Haruhi referred to classmates as objects.
context: Where are you planning on pulling together the other members from?\Just grab any bored-looking people we see walking around.\She's serious about that.\Got it.\You just sit tight.\First off, Taniguchi and Kunikida probably don't have anything to do.\Those are fine!\Haruhi referred to classmates as objects. response:	Let's see...
context: Just grab any bored-looking people we see walking around.\She's serious about that.\Got it.\You just sit tight.\First off, Taniguchi and Kunikida probably don't have anything to do.\Those are fine!\Haruhi referred to classmates as objects.\Let's see... response:	Two more, huh?
context: She's serious about that.\Got it.\You just sit tight.\First off, Taniguchi and Kunikida probably don't have anything to do.\Those are fine!\Haruhi referred to classmates as objects.\Let's see...\Two more, huh? response:	Um...
context: Got it.\You just sit tight.\First off, Taniguchi and Kunikida probably don't have anything to do.\Those are fine!\Haruhi referred to classmates as objects.\Let's see...\Two more, huh?\Um... response:	If it's okay, my friend...
context: You just sit tight.\First off, Taniguchi and Kunikida probably don't have anything to do.\Those are fine!\Haruhi referred to classmates as objects.\Let's see...\Two more, huh?\Um...\If it's okay, my friend... response:	Then we'll do that!
context: First off, Taniguchi and Kunikida probably don't have anything to do.\Those are fine!\Haruhi referred to classmates as objects.\Let's see...\Two more, huh?\Um...\If it's okay, my friend...\Then we'll do that! response:	Anyone works, apparently.
context: Those are fine!\Haruhi referred to classmates as objects.\Let's see...\Two more, huh?\Um...\If it's okay, my friend...\Then we'll do that!\Anyone works, apparently. response:	Wait.
context: Haruhi referred to classmates as objects.\Let's see...\Two more, huh?\Um...\If it's okay, my friend...\Then we'll do that!\Anyone works, apparently.\Wait. response:	Asahina-san's friend?
context: Let's see...\Two more, huh?\Um...\If it's okay, my friend...\Then we'll do that!\Anyone works, apparently.\Wait.\Asahina-san's friend? response:	That's making me a little worried.
context: Two more, huh?\Um...\If it's okay, my friend...\Then we'll do that!\Anyone works, apparently.\Wait.\Asahina-san's friend?\That's making me a little worried. response:	Her friend from when and where?
context: Um...\If it's okay, my friend...\Then we'll do that!\Anyone works, apparently.\Wait.\Asahina-san's friend?\That's making me a little worried.\Her friend from when and where? response:	It's okay.
context: If it's okay, my friend...\Then we'll do that!\Anyone works, apparently.\Wait.\Asahina-san's friend?\That's making me a little worried.\Her friend from when and where?\It's okay. response:	She's from this time...
context: Then we'll do that!\Anyone works, apparently.\Wait.\Asahina-san's friend?\That's making me a little worried.\Her friend from when and where?\It's okay.\She's from this time... response:	Then, allow me to join in.
context: Anyone works, apparently.\Wait.\Asahina-san's friend?\That's making me a little worried.\Her friend from when and where?\It's okay.\She's from this time...\Then, allow me to join in. response:	I can think of an acquaintance who has expressed interest in our...
context: Wait.\Asahina-san's friend?\That's making me a little worried.\Her friend from when and where?\It's okay.\She's from this time...\Then, allow me to join in.\I can think of an acquaintance who has expressed interest in our... response:	I'll take care of it.
context: Asahina-san's friend?\That's making me a little worried.\Her friend from when and where?\It's okay.\She's from this time...\Then, allow me to join in.\I can think of an acquaintance who has expressed interest in our...\I'll take care of it. response:	With that decided, let's start training!
context: That's making me a little worried.\Her friend from when and where?\It's okay.\She's from this time...\Then, allow me to join in.\I can think of an acquaintance who has expressed interest in our...\I'll take care of it.\With that decided, let's start training! response:	Training!
context: Her friend from when and where?\It's okay.\She's from this time...\Then, allow me to join in.\I can think of an acquaintance who has expressed interest in our...\I'll take care of it.\With that decided, let's start training!\Training! response:	Training, you say?
context: It's okay.\She's from this time...\Then, allow me to join in.\I can think of an acquaintance who has expressed interest in our...\I'll take care of it.\With that decided, let's start training!\Training!\Training, you say? response:	Right this instant?
context: She's from this time...\Then, allow me to join in.\I can think of an acquaintance who has expressed interest in our...\I'll take care of it.\With that decided, let's start training!\Training!\Training, you say?\Right this instant? response:	That's right!
context: Then, allow me to join in.\I can think of an acquaintance who has expressed interest in our...\I'll take care of it.\With that decided, let's start training!\Training!\Training, you say?\Right this instant?\That's right! response:	Where!?
context: I can think of an acquaintance who has expressed interest in our...\I'll take care of it.\With that decided, let's start training!\Training!\Training, you say?\Right this instant?\That's right!\Where!? response:	Over there!
context: I'll take care of it.\With that decided, let's start training!\Training!\Training, you say?\Right this instant?\That's right!\Where!?\Over there! response:	Okay! Okay!
context: With that decided, let's start training!\Training!\Training, you say?\Right this instant?\That's right!\Where!?\Over there!\Okay! Okay! response:	And so we ended up participating in a tomfoolery of a baseball tournament.
context: Training!\Training, you say?\Right this instant?\That's right!\Where!?\Over there!\Okay! Okay!\And so we ended up participating in a tomfoolery of a baseball tournament. response:	Why is that?
context: Training, you say?\Right this instant?\That's right!\Where!?\Over there!\Okay! Okay!\And so we ended up participating in a tomfoolery of a baseball tournament.\Why is that? response:	The answer is simple.
context: Right this instant?\That's right!\Where!?\Over there!\Okay! Okay!\And so we ended up participating in a tomfoolery of a baseball tournament.\Why is that?\The answer is simple. response:	Basically, Haruhi was just...
context: That's right!\Where!?\Over there!\Okay! Okay!\And so we ended up participating in a tomfoolery of a baseball tournament.\Why is that?\The answer is simple.\Basically, Haruhi was just... response:	Hey, you.
context: Where!?\Over there!\Okay! Okay!\And so we ended up participating in a tomfoolery of a baseball tournament.\Why is that?\The answer is simple.\Basically, Haruhi was just...\Hey, you. response:	Let us use this place.
context: Over there!\Okay! Okay!\And so we ended up participating in a tomfoolery of a baseball tournament.\Why is that?\The answer is simple.\Basically, Haruhi was just...\Hey, you.\Let us use this place. response:	And your baseball equipment, too.
context: Okay! Okay!\And so we ended up participating in a tomfoolery of a baseball tournament.\Why is that?\The answer is simple.\Basically, Haruhi was just...\Hey, you.\Let us use this place.\And your baseball equipment, too. response:	What are you talking about?
context: And so we ended up participating in a tomfoolery of a baseball tournament.\Why is that?\The answer is simple.\Basically, Haruhi was just...\Hey, you.\Let us use this place.\And your baseball equipment, too.\What are you talking about? response:	We have to practice baseball right away.
context: Why is that?\The answer is simple.\Basically, Haruhi was just...\Hey, you.\Let us use this place.\And your baseball equipment, too.\What are you talking about?\We have to practice baseball right away. response:	You're in the way, so leave.
context: The answer is simple.\Basically, Haruhi was just...\Hey, you.\Let us use this place.\And your baseball equipment, too.\What are you talking about?\We have to practice baseball right away.\You're in the way, so leave. response:	Like hell we're gonna leave!
context: Basically, Haruhi was just...\Hey, you.\Let us use this place.\And your baseball equipment, too.\What are you talking about?\We have to practice baseball right away.\You're in the way, so leave.\Like hell we're gonna leave! response:	It's just for a little while!
context: Hey, you.\Let us use this place.\And your baseball equipment, too.\What are you talking about?\We have to practice baseball right away.\You're in the way, so leave.\Like hell we're gonna leave!\It's just for a little while! response:	Right, Mikuru-chan?
context: Let us use this place.\And your baseball equipment, too.\What are you talking about?\We have to practice baseball right away.\You're in the way, so leave.\Like hell we're gonna leave!\It's just for a little while!\Right, Mikuru-chan? response:	Um...
context: And your baseball equipment, too.\What are you talking about?\We have to practice baseball right away.\You're in the way, so leave.\Like hell we're gonna leave!\It's just for a little while!\Right, Mikuru-chan?\Um... response:	A predictable adolescent response.
context: What are you talking about?\We have to practice baseball right away.\You're in the way, so leave.\Like hell we're gonna leave!\It's just for a little while!\Right, Mikuru-chan?\Um...\A predictable adolescent response. response:	Okay!
context: We have to practice baseball right away.\You're in the way, so leave.\Like hell we're gonna leave!\It's just for a little while!\Right, Mikuru-chan?\Um...\A predictable adolescent response.\Okay! response:	Let's start with a thousand hits!
context: You're in the way, so leave.\Like hell we're gonna leave!\It's just for a little while!\Right, Mikuru-chan?\Um...\A predictable adolescent response.\Okay!\Let's start with a thousand hits! response:	Here we go!
context: Like hell we're gonna leave!\It's just for a little while!\Right, Mikuru-chan?\Um...\A predictable adolescent response.\Okay!\Let's start with a thousand hits!\Here we go! response:	The future of the SOS Brigade rests upon that ball!
context: It's just for a little while!\Right, Mikuru-chan?\Um...\A predictable adolescent response.\Okay!\Let's start with a thousand hits!\Here we go!\The future of the SOS Brigade rests upon that ball! response:	Catch it!
context: Right, Mikuru-chan?\Um...\A predictable adolescent response.\Okay!\Let's start with a thousand hits!\Here we go!\The future of the SOS Brigade rests upon that ball!\Catch it! response:	This is the first I've heard about our future resting upon such a minuscule ball.
context: Um...\A predictable adolescent response.\Okay!\Let's start with a thousand hits!\Here we go!\The future of the SOS Brigade rests upon that ball!\Catch it!\This is the first I've heard about our future resting upon such a minuscule ball. response:	Another round!
context: A predictable adolescent response.\Okay!\Let's start with a thousand hits!\Here we go!\The future of the SOS Brigade rests upon that ball!\Catch it!\This is the first I've heard about our future resting upon such a minuscule ball.\Another round! response:	Mikuru-chan! Here we go!
context: Okay!\Let's start with a thousand hits!\Here we go!\The future of the SOS Brigade rests upon that ball!\Catch it!\This is the first I've heard about our future resting upon such a minuscule ball.\Another round!\Mikuru-chan! Here we go! response:	It hurts!
context: Let's start with a thousand hits!\Here we go!\The future of the SOS Brigade rests upon that ball!\Catch it!\This is the first I've heard about our future resting upon such a minuscule ball.\Another round!\Mikuru-chan! Here we go!\It hurts! response:	Are you okay?
context: Here we go!\The future of the SOS Brigade rests upon that ball!\Catch it!\This is the first I've heard about our future resting upon such a minuscule ball.\Another round!\Mikuru-chan! Here we go!\It hurts!\Are you okay? response:	Can you stand?
context: The future of the SOS Brigade rests upon that ball!\Catch it!\This is the first I've heard about our future resting upon such a minuscule ball.\Another round!\Mikuru-chan! Here we go!\It hurts!\Are you okay?\Can you stand? response:	You mustn't, Kyon-kun.
context: Catch it!\This is the first I've heard about our future resting upon such a minuscule ball.\Another round!\Mikuru-chan! Here we go!\It hurts!\Are you okay?\Can you stand?\You mustn't, Kyon-kun. response:	If you're nice to me...
context: This is the first I've heard about our future resting upon such a minuscule ball.\Another round!\Mikuru-chan! Here we go!\It hurts!\Are you okay?\Can you stand?\You mustn't, Kyon-kun.\If you're nice to me... response:	Hey! Kyon!
context: Another round!\Mikuru-chan! Here we go!\It hurts!\Are you okay?\Can you stand?\You mustn't, Kyon-kun.\If you're nice to me...\Hey! Kyon! response:	Mikuru-chan!
context: Mikuru-chan! Here we go!\It hurts!\Are you okay?\Can you stand?\You mustn't, Kyon-kun.\If you're nice to me...\Hey! Kyon!\Mikuru-chan! response:	Come back here!
context: It hurts!\Are you okay?\Can you stand?\You mustn't, Kyon-kun.\If you're nice to me...\Hey! Kyon!\Mikuru-chan!\Come back here! response:	She's retiring due to injury!
context: Are you okay?\Can you stand?\You mustn't, Kyon-kun.\If you're nice to me...\Hey! Kyon!\Mikuru-chan!\Come back here!\She's retiring due to injury! response:	That's enough.
context: Can you stand?\You mustn't, Kyon-kun.\If you're nice to me...\Hey! Kyon!\Mikuru-chan!\Come back here!\She's retiring due to injury!\That's enough. response:	Next, the baseball team take the field!
context: You mustn't, Kyon-kun.\If you're nice to me...\Hey! Kyon!\Mikuru-chan!\Come back here!\She's retiring due to injury!\That's enough.\Next, the baseball team take the field! response:	Why us?
context: If you're nice to me...\Hey! Kyon!\Mikuru-chan!\Come back here!\She's retiring due to injury!\That's enough.\Next, the baseball team take the field!\Why us? response:	Okay!
context: Hey! Kyon!\Mikuru-chan!\Come back here!\She's retiring due to injury!\That's enough.\Next, the baseball team take the field!\Why us?\Okay! response:	That's enough for today.
context: Mikuru-chan!\Come back here!\She's retiring due to injury!\That's enough.\Next, the baseball team take the field!\Why us?\Okay!\That's enough for today. response:	Quite amazing.
context: Come back here!\She's retiring due to injury!\That's enough.\Next, the baseball team take the field!\Why us?\Okay!\That's enough for today.\Quite amazing. response:	That was exactly one thousand.
context: She's retiring due to injury!\That's enough.\Next, the baseball team take the field!\Why us?\Okay!\That's enough for today.\Quite amazing.\That was exactly one thousand. response:	The fact that you counted to one thousand is what's amazing.
context: That's enough.\Next, the baseball team take the field!\Why us?\Okay!\That's enough for today.\Quite amazing.\That was exactly one thousand.\The fact that you counted to one thousand is what's amazing. response:	Hey, Nagato.
context: Next, the baseball team take the field!\Why us?\Okay!\That's enough for today.\Quite amazing.\That was exactly one thousand.\The fact that you counted to one thousand is what's amazing.\Hey, Nagato. response:	Could you make it rain on the day of the game?
context: Why us?\Okay!\That's enough for today.\Quite amazing.\That was exactly one thousand.\The fact that you counted to one thousand is what's amazing.\Hey, Nagato.\Could you make it rain on the day of the game? response:	A huge one that'll cancel the game.
context: Okay!\That's enough for today.\Quite amazing.\That was exactly one thousand.\The fact that you counted to one thousand is what's amazing.\Hey, Nagato.\Could you make it rain on the day of the game?\A huge one that'll cancel the game. response:	It is possible.
context: That's enough for today.\Quite amazing.\That was exactly one thousand.\The fact that you counted to one thousand is what's amazing.\Hey, Nagato.\Could you make it rain on the day of the game?\A huge one that'll cancel the game.\It is possible. response:	However, it is not recommended.
context: Quite amazing.\That was exactly one thousand.\The fact that you counted to one thousand is what's amazing.\Hey, Nagato.\Could you make it rain on the day of the game?\A huge one that'll cancel the game.\It is possible.\However, it is not recommended. response:	Why's that?
context: That was exactly one thousand.\The fact that you counted to one thousand is what's amazing.\Hey, Nagato.\Could you make it rain on the day of the game?\A huge one that'll cancel the game.\It is possible.\However, it is not recommended.\Why's that? response:	Alterations to the local environmental data...
context: The fact that you counted to one thousand is what's amazing.\Hey, Nagato.\Could you make it rain on the day of the game?\A huge one that'll cancel the game.\It is possible.\However, it is not recommended.\Why's that?\Alterations to the local environmental data... response:	How long will these aftereffects last?
context: Hey, Nagato.\Could you make it rain on the day of the game?\A huge one that'll cancel the game.\It is possible.\However, it is not recommended.\Why's that?\Alterations to the local environmental data...\How long will these aftereffects last? response:	Between a few centuries and ten millennia.
context: Could you make it rain on the day of the game?\A huge one that'll cancel the game.\It is possible.\However, it is not recommended.\Why's that?\Alterations to the local environmental data...\How long will these aftereffects last?\Between a few centuries and ten millennia. response:	Then I guess we probably shouldn't.
context: A huge one that'll cancel the game.\It is possible.\However, it is not recommended.\Why's that?\Alterations to the local environmental data...\How long will these aftereffects last?\Between a few centuries and ten millennia.\Then I guess we probably shouldn't. response:	Yes.
context: It is possible.\However, it is not recommended.\Why's that?\Alterations to the local environmental data...\How long will these aftereffects last?\Between a few centuries and ten millennia.\Then I guess we probably shouldn't.\Yes. response:	And just like that...
context: However, it is not recommended.\Why's that?\Alterations to the local environmental data...\How long will these aftereffects last?\Between a few centuries and ten millennia.\Then I guess we probably shouldn't.\Yes.\And just like that... response:	It really didn't need to come.
context: Why's that?\Alterations to the local environmental data...\How long will these aftereffects last?\Between a few centuries and ten millennia.\Then I guess we probably shouldn't.\Yes.\And just like that...\It really didn't need to come. response:	So you're Kyon-kun?
context: Alterations to the local environmental data...\How long will these aftereffects last?\Between a few centuries and ten millennia.\Then I guess we probably shouldn't.\Yes.\And just like that...\It really didn't need to come.\So you're Kyon-kun? response:	I've heard a lot about you from Mikuru!
context: How long will these aftereffects last?\Between a few centuries and ten millennia.\Then I guess we probably shouldn't.\Yes.\And just like that...\It really didn't need to come.\So you're Kyon-kun?\I've heard a lot about you from Mikuru! response:	Um.
context: Between a few centuries and ten millennia.\Then I guess we probably shouldn't.\Yes.\And just like that...\It really didn't need to come.\So you're Kyon-kun?\I've heard a lot about you from Mikuru!\Um. response:	This is my friend, Tsuruya-san.
context: Then I guess we probably shouldn't.\Yes.\And just like that...\It really didn't need to come.\So you're Kyon-kun?\I've heard a lot about you from Mikuru!\Um.\This is my friend, Tsuruya-san. response:	I'm Taniguchi!
context: Yes.\And just like that...\It really didn't need to come.\So you're Kyon-kun?\I've heard a lot about you from Mikuru!\Um.\This is my friend, Tsuruya-san.\I'm Taniguchi! response:	It's a pleasure to meet you.
context: And just like that...\It really didn't need to come.\So you're Kyon-kun?\I've heard a lot about you from Mikuru!\Um.\This is my friend, Tsuruya-san.\I'm Taniguchi!\It's a pleasure to meet you. response:	I'm Kunikida.
context: It really didn't need to come.\So you're Kyon-kun?\I've heard a lot about you from Mikuru!\Um.\This is my friend, Tsuruya-san.\I'm Taniguchi!\It's a pleasure to meet you.\I'm Kunikida. response:	Man...
context: So you're Kyon-kun?\I've heard a lot about you from Mikuru!\Um.\This is my friend, Tsuruya-san.\I'm Taniguchi!\It's a pleasure to meet you.\I'm Kunikida.\Man... response:	I couldn't turn down a request from my buddy Kyon!
context: I've heard a lot about you from Mikuru!\Um.\This is my friend, Tsuruya-san.\I'm Taniguchi!\It's a pleasure to meet you.\I'm Kunikida.\Man...\I couldn't turn down a request from my buddy Kyon! response:	Taniguchi-kun...
context: Um.\This is my friend, Tsuruya-san.\I'm Taniguchi!\It's a pleasure to meet you.\I'm Kunikida.\Man...\I couldn't turn down a request from my buddy Kyon!\Taniguchi-kun... response:	Oh, boy...
context: This is my friend, Tsuruya-san.\I'm Taniguchi!\It's a pleasure to meet you.\I'm Kunikida.\Man...\I couldn't turn down a request from my buddy Kyon!\Taniguchi-kun...\Oh, boy... response:	I'll remember that!
context: I'm Taniguchi!\It's a pleasure to meet you.\I'm Kunikida.\Man...\I couldn't turn down a request from my buddy Kyon!\Taniguchi-kun...\Oh, boy...\I'll remember that! response:	Kyon!
context: It's a pleasure to meet you.\I'm Kunikida.\Man...\I couldn't turn down a request from my buddy Kyon!\Taniguchi-kun...\Oh, boy...\I'll remember that!\Kyon! response:	Let's have fun today!
context: I'm Kunikida.\Man...\I couldn't turn down a request from my buddy Kyon!\Taniguchi-kun...\Oh, boy...\I'll remember that!\Kyon!\Let's have fun today! response:	Come here for a second.
context: Man...\I couldn't turn down a request from my buddy Kyon!\Taniguchi-kun...\Oh, boy...\I'll remember that!\Kyon!\Let's have fun today!\Come here for a second. response:	What are you thinking!?
context: I couldn't turn down a request from my buddy Kyon!\Taniguchi-kun...\Oh, boy...\I'll remember that!\Kyon!\Let's have fun today!\Come here for a second.\What are you thinking!? response:	You're going to have that thing play baseball?
context: Taniguchi-kun...\Oh, boy...\I'll remember that!\Kyon!\Let's have fun today!\Come here for a second.\What are you thinking!?\You're going to have that thing play baseball? response:	Hey, I watched a game the other day.
context: Oh, boy...\I'll remember that!\Kyon!\Let's have fun today!\Come here for a second.\What are you thinking!?\You're going to have that thing play baseball?\Hey, I watched a game the other day. response:	Thing is a bit rude now.
context: I'll remember that!\Kyon!\Let's have fun today!\Come here for a second.\What are you thinking!?\You're going to have that thing play baseball?\Hey, I watched a game the other day.\Thing is a bit rude now. response:	The catcher...
context: Kyon!\Let's have fun today!\Come here for a second.\What are you thinking!?\You're going to have that thing play baseball?\Hey, I watched a game the other day.\Thing is a bit rude now.\The catcher... response:	That thing is still my sister.
context: Let's have fun today!\Come here for a second.\What are you thinking!?\You're going to have that thing play baseball?\Hey, I watched a game the other day.\Thing is a bit rude now.\The catcher...\That thing is still my sister. response:	She introduced herself as an 11-year-old fifth grader.
context: Come here for a second.\What are you thinking!?\You're going to have that thing play baseball?\Hey, I watched a game the other day.\Thing is a bit rude now.\The catcher...\That thing is still my sister.\She introduced herself as an 11-year-old fifth grader. response:	She's such a sweet little girl that it's hard to believe she's related to you.
context: What are you thinking!?\You're going to have that thing play baseball?\Hey, I watched a game the other day.\Thing is a bit rude now.\The catcher...\That thing is still my sister.\She introduced herself as an 11-year-old fifth grader.\She's such a sweet little girl that it's hard to believe she's related to you. response:	He hit a home run!
context: You're going to have that thing play baseball?\Hey, I watched a game the other day.\Thing is a bit rude now.\The catcher...\That thing is still my sister.\She introduced herself as an 11-year-old fifth grader.\She's such a sweet little girl that it's hard to believe she's related to you.\He hit a home run! response:	Anyway, the baseball tournament we're entering is open to the general public!
context: Hey, I watched a game the other day.\Thing is a bit rude now.\The catcher...\That thing is still my sister.\She introduced herself as an 11-year-old fifth grader.\She's such a sweet little girl that it's hard to believe she's related to you.\He hit a home run!\Anyway, the baseball tournament we're entering is open to the general public! response:	This isn't Little League!
context: Thing is a bit rude now.\The catcher...\That thing is still my sister.\She introduced herself as an 11-year-old fifth grader.\She's such a sweet little girl that it's hard to believe she's related to you.\He hit a home run!\Anyway, the baseball tournament we're entering is open to the general public!\This isn't Little League! response:	I know that, Miss Haruhi!
context: The catcher...\That thing is still my sister.\She introduced herself as an 11-year-old fifth grader.\She's such a sweet little girl that it's hard to believe she's related to you.\He hit a home run!\Anyway, the baseball tournament we're entering is open to the general public!\This isn't Little League!\I know that, Miss Haruhi! response:	That is exactly why I brought my sister!
context: That thing is still my sister.\She introduced herself as an 11-year-old fifth grader.\She's such a sweet little girl that it's hard to believe she's related to you.\He hit a home run!\Anyway, the baseball tournament we're entering is open to the general public!\This isn't Little League!\I know that, Miss Haruhi!\That is exactly why I brought my sister! response:	Our chance of victory is nil.
context: She introduced herself as an 11-year-old fifth grader.\She's such a sweet little girl that it's hard to believe she's related to you.\He hit a home run!\Anyway, the baseball tournament we're entering is open to the general public!\This isn't Little League!\I know that, Miss Haruhi!\That is exactly why I brought my sister!\Our chance of victory is nil. response:	Regardless, this is Haruhi we're talking about.
context: She's such a sweet little girl that it's hard to believe she's related to you.\He hit a home run!\Anyway, the baseball tournament we're entering is open to the general public!\This isn't Little League!\I know that, Miss Haruhi!\That is exactly why I brought my sister!\Our chance of victory is nil.\Regardless, this is Haruhi we're talking about. response:	Watch us end up winning by accident!
context: He hit a home run!\Anyway, the baseball tournament we're entering is open to the general public!\This isn't Little League!\I know that, Miss Haruhi!\That is exactly why I brought my sister!\Our chance of victory is nil.\Regardless, this is Haruhi we're talking about.\Watch us end up winning by accident! response:	That would definitely be a pain in the ass.
context: Anyway, the baseball tournament we're entering is open to the general public!\This isn't Little League!\I know that, Miss Haruhi!\That is exactly why I brought my sister!\Our chance of victory is nil.\Regardless, this is Haruhi we're talking about.\Watch us end up winning by accident!\That would definitely be a pain in the ass. response:	If we add a fifth grader into the mix...
context: This isn't Little League!\I know that, Miss Haruhi!\That is exactly why I brought my sister!\Our chance of victory is nil.\Regardless, this is Haruhi we're talking about.\Watch us end up winning by accident!\That would definitely be a pain in the ass.\If we add a fifth grader into the mix... response:	That's why I was really happy when I got to come along today!
context: I know that, Miss Haruhi!\That is exactly why I brought my sister!\Our chance of victory is nil.\Regardless, this is Haruhi we're talking about.\Watch us end up winning by accident!\That would definitely be a pain in the ass.\If we add a fifth grader into the mix...\That's why I was really happy when I got to come along today! response:	Very well.
context: That is exactly why I brought my sister!\Our chance of victory is nil.\Regardless, this is Haruhi we're talking about.\Watch us end up winning by accident!\That would definitely be a pain in the ass.\If we add a fifth grader into the mix...\That's why I was really happy when I got to come along today!\Very well. response:	It's a good enough handicap.
context: Our chance of victory is nil.\Regardless, this is Haruhi we're talking about.\Watch us end up winning by accident!\That would definitely be a pain in the ass.\If we add a fifth grader into the mix...\That's why I was really happy when I got to come along today!\Very well.\It's a good enough handicap. response:	I'd feel bad if we slaughtered the other team.
context: Regardless, this is Haruhi we're talking about.\Watch us end up winning by accident!\That would definitely be a pain in the ass.\If we add a fifth grader into the mix...\That's why I was really happy when I got to come along today!\Very well.\It's a good enough handicap.\I'd feel bad if we slaughtered the other team. response:	Apparently, she seriously intends on winning.
context: Watch us end up winning by accident!\That would definitely be a pain in the ass.\If we add a fifth grader into the mix...\That's why I was really happy when I got to come along today!\Very well.\It's a good enough handicap.\I'd feel bad if we slaughtered the other team.\Apparently, she seriously intends on winning. response:	By the way...
context: That would definitely be a pain in the ass.\If we add a fifth grader into the mix...\That's why I was really happy when I got to come along today!\Very well.\It's a good enough handicap.\I'd feel bad if we slaughtered the other team.\Apparently, she seriously intends on winning.\By the way... response:	What are we going to do?
context: If we add a fifth grader into the mix...\That's why I was really happy when I got to come along today!\Very well.\It's a good enough handicap.\I'd feel bad if we slaughtered the other team.\Apparently, she seriously intends on winning.\By the way...\What are we going to do? response:	I already thought that through.
context: That's why I was really happy when I got to come along today!\Very well.\It's a good enough handicap.\I'd feel bad if we slaughtered the other team.\Apparently, she seriously intends on winning.\By the way...\What are we going to do?\I already thought that through. response:	You don't have any problems with deciding through this, right?
context: Very well.\It's a good enough handicap.\I'd feel bad if we slaughtered the other team.\Apparently, she seriously intends on winning.\By the way...\What are we going to do?\I already thought that through.\You don't have any problems with deciding through this, right? response:	One for batting order and one for field position.
context: It's a good enough handicap.\I'd feel bad if we slaughtered the other team.\Apparently, she seriously intends on winning.\By the way...\What are we going to do?\I already thought that through.\You don't have any problems with deciding through this, right?\One for batting order and one for field position. response:	Also, I'm the pitcher and lead-off.
context: I'd feel bad if we slaughtered the other team.\Apparently, she seriously intends on winning.\By the way...\What are we going to do?\I already thought that through.\You don't have any problems with deciding through this, right?\One for batting order and one for field position.\Also, I'm the pitcher and lead-off. response:	So all you came up with was a method to decide.
context: Apparently, she seriously intends on winning.\By the way...\What are we going to do?\I already thought that through.\You don't have any problems with deciding through this, right?\One for batting order and one for field position.\Also, I'm the pitcher and lead-off.\So all you came up with was a method to decide. response:	What?
context: By the way...\What are we going to do?\I already thought that through.\You don't have any problems with deciding through this, right?\One for batting order and one for field position.\Also, I'm the pitcher and lead-off.\So all you came up with was a method to decide.\What? response:	Do you have a problem with that?
context: What are we going to do?\I already thought that through.\You don't have any problems with deciding through this, right?\One for batting order and one for field position.\Also, I'm the pitcher and lead-off.\So all you came up with was a method to decide.\What?\Do you have a problem with that? response:	It's a democratic method.
context: I already thought that through.\You don't have any problems with deciding through this, right?\One for batting order and one for field position.\Also, I'm the pitcher and lead-off.\So all you came up with was a method to decide.\What?\Do you have a problem with that?\It's a democratic method. response:	They used lottery to choose their government in ancient Greece!
context: You don't have any problems with deciding through this, right?\One for batting order and one for field position.\Also, I'm the pitcher and lead-off.\So all you came up with was a method to decide.\What?\Do you have a problem with that?\It's a democratic method.\They used lottery to choose their government in ancient Greece! response:	Taniguchi
context: One for batting order and one for field position.\Also, I'm the pitcher and lead-off.\So all you came up with was a method to decide.\What?\Do you have a problem with that?\It's a democratic method.\They used lottery to choose their government in ancient Greece!\Taniguchi response:	Yuki
context: Also, I'm the pitcher and lead-off.\So all you came up with was a method to decide.\What?\Do you have a problem with that?\It's a democratic method.\They used lottery to choose their government in ancient Greece!\Taniguchi\Yuki response:	Tsuruya-san
context: So all you came up with was a method to decide.\What?\Do you have a problem with that?\It's a democratic method.\They used lottery to choose their government in ancient Greece!\Taniguchi\Yuki\Tsuruya-san response:	Kyon
context: What?\Do you have a problem with that?\It's a democratic method.\They used lottery to choose their government in ancient Greece!\Taniguchi\Yuki\Tsuruya-san\Kyon response:	Mikuru-chan
context: Do you have a problem with that?\It's a democratic method.\They used lottery to choose their government in ancient Greece!\Taniguchi\Yuki\Tsuruya-san\Kyon\Mikuru-chan response:	Koizumi-kun
context: It's a democratic method.\They used lottery to choose their government in ancient Greece!\Taniguchi\Yuki\Tsuruya-san\Kyon\Mikuru-chan\Koizumi-kun response:	Don't compare the ancient Greek government system to modern Japan batting order selection!
context: They used lottery to choose their government in ancient Greece!\Taniguchi\Yuki\Tsuruya-san\Kyon\Mikuru-chan\Koizumi-kun\Don't compare the ancient Greek government system to modern Japan batting order selection! response:	Kunikida
context: Taniguchi\Yuki\Tsuruya-san\Kyon\Mikuru-chan\Koizumi-kun\Don't compare the ancient Greek government system to modern Japan batting order selection!\Kunikida response:	Kyon's Sister
context: Yuki\Tsuruya-san\Kyon\Mikuru-chan\Koizumi-kun\Don't compare the ancient Greek government system to modern Japan batting order selection!\Kunikida\Kyon's Sister response:	Tsuruya-san
context: Tsuruya-san\Kyon\Mikuru-chan\Koizumi-kun\Don't compare the ancient Greek government system to modern Japan batting order selection!\Kunikida\Kyon's Sister\Tsuruya-san response:	And you're the only one who gets to choose your own position.
context: Kyon\Mikuru-chan\Koizumi-kun\Don't compare the ancient Greek government system to modern Japan batting order selection!\Kunikida\Kyon's Sister\Tsuruya-san\And you're the only one who gets to choose your own position. response:	How is that democratic?
context: Mikuru-chan\Koizumi-kun\Don't compare the ancient Greek government system to modern Japan batting order selection!\Kunikida\Kyon's Sister\Tsuruya-san\And you're the only one who gets to choose your own position.\How is that democratic? response:	Name
context: Koizumi-kun\Don't compare the ancient Greek government system to modern Japan batting order selection!\Kunikida\Kyon's Sister\Tsuruya-san\And you're the only one who gets to choose your own position.\How is that democratic?\Name response:	Position
context: Don't compare the ancient Greek government system to modern Japan batting order selection!\Kunikida\Kyon's Sister\Tsuruya-san\And you're the only one who gets to choose your own position.\How is that democratic?\Name\Position response:	Haruhi Suzumiya
context: Kunikida\Kyon's Sister\Tsuruya-san\And you're the only one who gets to choose your own position.\How is that democratic?\Name\Position\Haruhi Suzumiya response:	Pitcher
context: Kyon's Sister\Tsuruya-san\And you're the only one who gets to choose your own position.\How is that democratic?\Name\Position\Haruhi Suzumiya\Pitcher response:	Mikuru-chan
context: Tsuruya-san\And you're the only one who gets to choose your own position.\How is that democratic?\Name\Position\Haruhi Suzumiya\Pitcher\Mikuru-chan response:	Right
context: And you're the only one who gets to choose your own position.\How is that democratic?\Name\Position\Haruhi Suzumiya\Pitcher\Mikuru-chan\Right response:	Yuki
context: How is that democratic?\Name\Position\Haruhi Suzumiya\Pitcher\Mikuru-chan\Right\Yuki response:	Center
context: Name\Position\Haruhi Suzumiya\Pitcher\Mikuru-chan\Right\Yuki\Center response:	Kyon
context: Position\Haruhi Suzumiya\Pitcher\Mikuru-chan\Right\Yuki\Center\Kyon response:	Second
context: Haruhi Suzumiya\Pitcher\Mikuru-chan\Right\Yuki\Center\Kyon\Second response:	Oh, well.
context: Pitcher\Mikuru-chan\Right\Yuki\Center\Kyon\Second\Oh, well. response:	Kyon's Sister
context: Mikuru-chan\Right\Yuki\Center\Kyon\Second\Oh, well.\Kyon's Sister response:	Left
context: Right\Yuki\Center\Kyon\Second\Oh, well.\Kyon's Sister\Left response:	Looks like I'll get to go home even sooner than expected.
context: Yuki\Center\Kyon\Second\Oh, well.\Kyon's Sister\Left\Looks like I'll get to go home even sooner than expected. response:	Koizumi-kun
context: Center\Kyon\Second\Oh, well.\Kyon's Sister\Left\Looks like I'll get to go home even sooner than expected.\Koizumi-kun response:	Catcher
context: Kyon\Second\Oh, well.\Kyon's Sister\Left\Looks like I'll get to go home even sooner than expected.\Koizumi-kun\Catcher response:	Kunikida
context: Second\Oh, well.\Kyon's Sister\Left\Looks like I'll get to go home even sooner than expected.\Koizumi-kun\Catcher\Kunikida response:	First
context: Oh, well.\Kyon's Sister\Left\Looks like I'll get to go home even sooner than expected.\Koizumi-kun\Catcher\Kunikida\First response:	Tsuruya-san
context: Kyon's Sister\Left\Looks like I'll get to go home even sooner than expected.\Koizumi-kun\Catcher\Kunikida\First\Tsuruya-san response:	Third
context: Left\Looks like I'll get to go home even sooner than expected.\Koizumi-kun\Catcher\Kunikida\First\Tsuruya-san\Third response:	After all, we were just told that...
context: Looks like I'll get to go home even sooner than expected.\Koizumi-kun\Catcher\Kunikida\First\Tsuruya-san\Third\After all, we were just told that... response:	Taniguchi
context: Koizumi-kun\Catcher\Kunikida\First\Tsuruya-san\Third\After all, we were just told that...\Taniguchi response:	Short
context: Catcher\Kunikida\First\Tsuruya-san\Third\After all, we were just told that...\Taniguchi\Short response:	The leading candidate to win this tournament.
context: Kunikida\First\Tsuruya-san\Third\After all, we were just told that...\Taniguchi\Short\The leading candidate to win this tournament. response:	The game is called at ten runs...
context: First\Tsuruya-san\Third\After all, we were just told that...\Taniguchi\Short\The leading candidate to win this tournament.\The game is called at ten runs... response:	Play ball!
context: Tsuruya-san\Third\After all, we were just told that...\Taniguchi\Short\The leading candidate to win this tournament.\The game is called at ten runs...\Play ball! response:	That was a totally weak pitch!
context: Third\After all, we were just told that...\Taniguchi\Short\The leading candidate to win this tournament.\The game is called at ten runs...\Play ball!\That was a totally weak pitch! response:	The rest of you follow my lead!
context: After all, we were just told that...\Taniguchi\Short\The leading candidate to win this tournament.\The game is called at ten runs...\Play ball!\That was a totally weak pitch!\The rest of you follow my lead! response:	Please go easy on me...
context: Taniguchi\Short\The leading candidate to win this tournament.\The game is called at ten runs...\Play ball!\That was a totally weak pitch!\The rest of you follow my lead!\Please go easy on me... response:	Strike!
context: Short\The leading candidate to win this tournament.\The game is called at ten runs...\Play ball!\That was a totally weak pitch!\The rest of you follow my lead!\Please go easy on me...\Strike! response:	How dare you throw a real pitch at Asahina-san!?
context: The leading candidate to win this tournament.\The game is called at ten runs...\Play ball!\That was a totally weak pitch!\The rest of you follow my lead!\Please go easy on me...\Strike!\How dare you throw a real pitch at Asahina-san!? response:	If you hit her, there will immediate brawling!
context: The game is called at ten runs...\Play ball!\That was a totally weak pitch!\The rest of you follow my lead!\Please go easy on me...\Strike!\How dare you throw a real pitch at Asahina-san!?\If you hit her, there will immediate brawling! response:	A brawling bash!
context: Play ball!\That was a totally weak pitch!\The rest of you follow my lead!\Please go easy on me...\Strike!\How dare you throw a real pitch at Asahina-san!?\If you hit her, there will immediate brawling!\A brawling bash! response:	Strike!
context: That was a totally weak pitch!\The rest of you follow my lead!\Please go easy on me...\Strike!\How dare you throw a real pitch at Asahina-san!?\If you hit her, there will immediate brawling!\A brawling bash!\Strike! response:	Mikuru-chan!
context: The rest of you follow my lead!\Please go easy on me...\Strike!\How dare you throw a real pitch at Asahina-san!?\If you hit her, there will immediate brawling!\A brawling bash!\Strike!\Mikuru-chan! response:	Swing like this!
context: Please go easy on me...\Strike!\How dare you throw a real pitch at Asahina-san!?\If you hit her, there will immediate brawling!\A brawling bash!\Strike!\Mikuru-chan!\Swing like this! response:	Like this!
context: Strike!\How dare you throw a real pitch at Asahina-san!?\If you hit her, there will immediate brawling!\A brawling bash!\Strike!\Mikuru-chan!\Swing like this!\Like this! response:	Strikeout!
context: How dare you throw a real pitch at Asahina-san!?\If you hit her, there will immediate brawling!\A brawling bash!\Strike!\Mikuru-chan!\Swing like this!\Like this!\Strikeout! response:	Hey!
context: If you hit her, there will immediate brawling!\A brawling bash!\Strike!\Mikuru-chan!\Swing like this!\Like this!\Strikeout!\Hey! response:	Why aren't you swinging the bat!?
context: A brawling bash!\Strike!\Mikuru-chan!\Swing like this!\Like this!\Strikeout!\Hey!\Why aren't you swinging the bat!? response:	Strike!
context: Strike!\Mikuru-chan!\Swing like this!\Like this!\Strikeout!\Hey!\Why aren't you swinging the bat!?\Strike! response:	Strike!
context: Mikuru-chan!\Swing like this!\Like this!\Strikeout!\Hey!\Why aren't you swinging the bat!?\Strike!\Strike! response:	Strikeout!
context: Swing like this!\Like this!\Strikeout!\Hey!\Why aren't you swinging the bat!?\Strike!\Strike!\Strikeout! response:	Yuki!
context: Like this!\Strikeout!\Hey!\Why aren't you swinging the bat!?\Strike!\Strike!\Strikeout!\Yuki! response:	You can't hit the ball if you don't swing!
context: Strikeout!\Hey!\Why aren't you swinging the bat!?\Strike!\Strike!\Strikeout!\Yuki!\You can't hit the ball if you don't swing! response:	Kyon!
context: Hey!\Why aren't you swinging the bat!?\Strike!\Strike!\Strikeout!\Yuki!\You can't hit the ball if you don't swing!\Kyon! response:	You better get a hit!
context: Why aren't you swinging the bat!?\Strike!\Strike!\Strikeout!\Yuki!\You can't hit the ball if you don't swing!\Kyon!\You better get a hit! response:	You're clean-up!
context: Strike!\Strike!\Strikeout!\Yuki!\You can't hit the ball if you don't swing!\Kyon!\You better get a hit!\You're clean-up! response:	What can you possibly expect from a clean-up chosen through lottery?
context: Strike!\Strikeout!\Yuki!\You can't hit the ball if you don't swing!\Kyon!\You better get a hit!\You're clean-up!\What can you possibly expect from a clean-up chosen through lottery? response:	Strike!
context: Strikeout!\Yuki!\You can't hit the ball if you don't swing!\Kyon!\You better get a hit!\You're clean-up!\What can you possibly expect from a clean-up chosen through lottery?\Strike! response:	Haruhi doubled off this pitch?
context: Yuki!\You can't hit the ball if you don't swing!\Kyon!\You better get a hit!\You're clean-up!\What can you possibly expect from a clean-up chosen through lottery?\Strike!\Haruhi doubled off this pitch? response:	Strike!
context: You can't hit the ball if you don't swing!\Kyon!\You better get a hit!\You're clean-up!\What can you possibly expect from a clean-up chosen through lottery?\Strike!\Haruhi doubled off this pitch?\Strike! response:	Strikeout!
context: Kyon!\You better get a hit!\You're clean-up!\What can you possibly expect from a clean-up chosen through lottery?\Strike!\Haruhi doubled off this pitch?\Strike!\Strikeout! response:	Moron!
context: You better get a hit!\You're clean-up!\What can you possibly expect from a clean-up chosen through lottery?\Strike!\Haruhi doubled off this pitch?\Strike!\Strikeout!\Moron! response:	What are you doing!?
context: You're clean-up!\What can you possibly expect from a clean-up chosen through lottery?\Strike!\Haruhi doubled off this pitch?\Strike!\Strikeout!\Moron!\What are you doing!? response:	Crap.
context: What can you possibly expect from a clean-up chosen through lottery?\Strike!\Haruhi doubled off this pitch?\Strike!\Strikeout!\Moron!\What are you doing!?\Crap. response:	Let's shut them out!
context: Strike!\Haruhi doubled off this pitch?\Strike!\Strikeout!\Moron!\What are you doing!?\Crap.\Let's shut them out! response:	Play!
context: Haruhi doubled off this pitch?\Strike!\Strikeout!\Moron!\What are you doing!?\Crap.\Let's shut them out!\Play! response:	Strike!
context: Strike!\Strikeout!\Moron!\What are you doing!?\Crap.\Let's shut them out!\Play!\Strike! response:	Strike!
context: Strikeout!\Moron!\What are you doing!?\Crap.\Let's shut them out!\Play!\Strike!\Strike! response:	Strikeout!
context: Moron!\What are you doing!?\Crap.\Let's shut them out!\Play!\Strike!\Strike!\Strikeout! response:	Nice pitching!
context: What are you doing!?\Crap.\Let's shut them out!\Play!\Strike!\Strike!\Strikeout!\Nice pitching! response:	Too easy! Too easy!
context: Crap.\Let's shut them out!\Play!\Strike!\Strike!\Strikeout!\Nice pitching!\Too easy! Too easy! response:	Foul ball!
context: Let's shut them out!\Play!\Strike!\Strike!\Strikeout!\Nice pitching!\Too easy! Too easy!\Foul ball! response:	If all you can throw is straight pitches in the strike zone...
context: Play!\Strike!\Strike!\Strikeout!\Nice pitching!\Too easy! Too easy!\Foul ball!\If all you can throw is straight pitches in the strike zone... response:	And our defense has more holes than an anthill in a savanna.
context: Strike!\Strike!\Strikeout!\Nice pitching!\Too easy! Too easy!\Foul ball!\If all you can throw is straight pitches in the strike zone...\And our defense has more holes than an anthill in a savanna. response:	No!
context: Strike!\Strikeout!\Nice pitching!\Too easy! Too easy!\Foul ball!\If all you can throw is straight pitches in the strike zone...\And our defense has more holes than an anthill in a savanna.\No! response:	U-Um...
context: Strikeout!\Nice pitching!\Too easy! Too easy!\Foul ball!\If all you can throw is straight pitches in the strike zone...\And our defense has more holes than an anthill in a savanna.\No!\U-Um... response:	Like a sieve!
context: Nice pitching!\Too easy! Too easy!\Foul ball!\If all you can throw is straight pitches in the strike zone...\And our defense has more holes than an anthill in a savanna.\No!\U-Um...\Like a sieve! response:	The fact that we only gave up two runs this inning...
context: Too easy! Too easy!\Foul ball!\If all you can throw is straight pitches in the strike zone...\And our defense has more holes than an anthill in a savanna.\No!\U-Um...\Like a sieve!\The fact that we only gave up two runs this inning... response:	Great play!
context: Foul ball!\If all you can throw is straight pitches in the strike zone...\And our defense has more holes than an anthill in a savanna.\No!\U-Um...\Like a sieve!\The fact that we only gave up two runs this inning...\Great play! response:	I suppose that everyone wants to take it easy on Sunday.
context: If all you can throw is straight pitches in the strike zone...\And our defense has more holes than an anthill in a savanna.\No!\U-Um...\Like a sieve!\The fact that we only gave up two runs this inning...\Great play!\I suppose that everyone wants to take it easy on Sunday. response:	Way to go!
context: And our defense has more holes than an anthill in a savanna.\No!\U-Um...\Like a sieve!\The fact that we only gave up two runs this inning...\Great play!\I suppose that everyone wants to take it easy on Sunday.\Way to go! response:	SOS Brigade
context: No!\U-Um...\Like a sieve!\The fact that we only gave up two runs this inning...\Great play!\I suppose that everyone wants to take it easy on Sunday.\Way to go!\SOS Brigade response:	Kamigahara
context: U-Um...\Like a sieve!\The fact that we only gave up two runs this inning...\Great play!\I suppose that everyone wants to take it easy on Sunday.\Way to go!\SOS Brigade\Kamigahara response:	Pirates
context: Like a sieve!\The fact that we only gave up two runs this inning...\Great play!\I suppose that everyone wants to take it easy on Sunday.\Way to go!\SOS Brigade\Kamigahara\Pirates response:	Strikeout!
context: The fact that we only gave up two runs this inning...\Great play!\I suppose that everyone wants to take it easy on Sunday.\Way to go!\SOS Brigade\Kamigahara\Pirates\Strikeout! response:	Continuing, our offensive in the top of the next inning came to an abrupt end...
context: Great play!\I suppose that everyone wants to take it easy on Sunday.\Way to go!\SOS Brigade\Kamigahara\Pirates\Strikeout!\Continuing, our offensive in the top of the next inning came to an abrupt end... response:	Strikeout!
context: I suppose that everyone wants to take it easy on Sunday.\Way to go!\SOS Brigade\Kamigahara\Pirates\Strikeout!\Continuing, our offensive in the top of the next inning came to an abrupt end...\Strikeout! response:	Strikeout!
context: Way to go!\SOS Brigade\Kamigahara\Pirates\Strikeout!\Continuing, our offensive in the top of the next inning came to an abrupt end...\Strikeout!\Strikeout! response:	SOS Brigade
context: SOS Brigade\Kamigahara\Pirates\Strikeout!\Continuing, our offensive in the top of the next inning came to an abrupt end...\Strikeout!\Strikeout!\SOS Brigade response:	Kamigahara
context: Kamigahara\Pirates\Strikeout!\Continuing, our offensive in the top of the next inning came to an abrupt end...\Strikeout!\Strikeout!\SOS Brigade\Kamigahara response:	Pirates
context: Pirates\Strikeout!\Continuing, our offensive in the top of the next inning came to an abrupt end...\Strikeout!\Strikeout!\SOS Brigade\Kamigahara\Pirates response:	It looks like we can end this in the next inning.
context: Strikeout!\Continuing, our offensive in the top of the next inning came to an abrupt end...\Strikeout!\Strikeout!\SOS Brigade\Kamigahara\Pirates\It looks like we can end this in the next inning. response:	Out!
context: Continuing, our offensive in the top of the next inning came to an abrupt end...\Strikeout!\Strikeout!\SOS Brigade\Kamigahara\Pirates\It looks like we can end this in the next inning.\Out! response:	That's a toughie.
context: Strikeout!\Strikeout!\SOS Brigade\Kamigahara\Pirates\It looks like we can end this in the next inning.\Out!\That's a toughie. response:	Just getting the bat on the ball took everything I had.
context: Strikeout!\SOS Brigade\Kamigahara\Pirates\It looks like we can end this in the next inning.\Out!\That's a toughie.\Just getting the bat on the ball took everything I had. response:	It looks like we're going to need that.
context: SOS Brigade\Kamigahara\Pirates\It looks like we can end this in the next inning.\Out!\That's a toughie.\Just getting the bat on the ball took everything I had.\It looks like we're going to need that. response:	Hey! Timeout!
context: Kamigahara\Pirates\It looks like we can end this in the next inning.\Out!\That's a toughie.\Just getting the bat on the ball took everything I had.\It looks like we're going to need that.\Hey! Timeout! response:	W-Wait!
context: Pirates\It looks like we can end this in the next inning.\Out!\That's a toughie.\Just getting the bat on the ball took everything I had.\It looks like we're going to need that.\Hey! Timeout!\W-Wait! response:	Suzumiya-san!
context: It looks like we can end this in the next inning.\Out!\That's a toughie.\Just getting the bat on the ball took everything I had.\It looks like we're going to need that.\Hey! Timeout!\W-Wait!\Suzumiya-san! response:	S-Stop it!
context: Out!\That's a toughie.\Just getting the bat on the ball took everything I had.\It looks like we're going to need that.\Hey! Timeout!\W-Wait!\Suzumiya-san!\S-Stop it! response:	- Stupid! Come on!
context: That's a toughie.\Just getting the bat on the ball took everything I had.\It looks like we're going to need that.\Hey! Timeout!\W-Wait!\Suzumiya-san!\S-Stop it!\- Stupid! Come on! response:	Get undressed and change!
context: Just getting the bat on the ball took everything I had.\It looks like we're going to need that.\Hey! Timeout!\W-Wait!\Suzumiya-san!\S-Stop it!\- Stupid! Come on!\Get undressed and change! response:	Mikuru!
context: It looks like we're going to need that.\Hey! Timeout!\W-Wait!\Suzumiya-san!\S-Stop it!\- Stupid! Come on!\Get undressed and change!\Mikuru! response:	- Looking good there.
context: Hey! Timeout!\W-Wait!\Suzumiya-san!\S-Stop it!\- Stupid! Come on!\Get undressed and change!\Mikuru!\- Looking good there. response:	Can I take a picture?
context: W-Wait!\Suzumiya-san!\S-Stop it!\- Stupid! Come on!\Get undressed and change!\Mikuru!\- Looking good there.\Can I take a picture? response:	It's so cute!
context: Suzumiya-san!\S-Stop it!\- Stupid! Come on!\Get undressed and change!\Mikuru!\- Looking good there.\Can I take a picture?\It's so cute! response:	It might go better with a ponytail.
context: S-Stop it!\- Stupid! Come on!\Get undressed and change!\Mikuru!\- Looking good there.\Can I take a picture?\It's so cute!\It might go better with a ponytail. response:	Come on.
context: - Stupid! Come on!\Get undressed and change!\Mikuru!\- Looking good there.\Can I take a picture?\It's so cute!\It might go better with a ponytail.\Come on. response:	Start cheering.
context: Get undressed and change!\Mikuru!\- Looking good there.\Can I take a picture?\It's so cute!\It might go better with a ponytail.\Come on.\Start cheering. response:	Um... How do I do that?
context: Mikuru!\- Looking good there.\Can I take a picture?\It's so cute!\It might go better with a ponytail.\Come on.\Start cheering.\Um... How do I do that? response:	Like this!
context: - Looking good there.\Can I take a picture?\It's so cute!\It might go better with a ponytail.\Come on.\Start cheering.\Um... How do I do that?\Like this! response:	C'mon! Yell it loud and clear!
context: Can I take a picture?\It's so cute!\It might go better with a ponytail.\Come on.\Start cheering.\Um... How do I do that?\Like this!\C'mon! Yell it loud and clear! response:	E-Everybody!
context: It's so cute!\It might go better with a ponytail.\Come on.\Start cheering.\Um... How do I do that?\Like this!\C'mon! Yell it loud and clear!\E-Everybody! response:	Please hit the ball!
context: It might go better with a ponytail.\Come on.\Start cheering.\Um... How do I do that?\Like this!\C'mon! Yell it loud and clear!\E-Everybody!\Please hit the ball! response:	Please do your best!
context: Come on.\Start cheering.\Um... How do I do that?\Like this!\C'mon! Yell it loud and clear!\E-Everybody!\Please hit the ball!\Please do your best! response:	Just watch me!
context: Start cheering.\Um... How do I do that?\Like this!\C'mon! Yell it loud and clear!\E-Everybody!\Please hit the ball!\Please do your best!\Just watch me! response:	Strikeout!
context: Um... How do I do that?\Like this!\C'mon! Yell it loud and clear!\E-Everybody!\Please hit the ball!\Please do your best!\Just watch me!\Strikeout! response:	There's no way I can hit that.
context: Like this!\C'mon! Yell it loud and clear!\E-Everybody!\Please hit the ball!\Please do your best!\Just watch me!\Strikeout!\There's no way I can hit that. response:	No matter.
context: C'mon! Yell it loud and clear!\E-Everybody!\Please hit the ball!\Please do your best!\Just watch me!\Strikeout!\There's no way I can hit that.\No matter. response:	I wasn't expecting anything from you.
context: E-Everybody!\Please hit the ball!\Please do your best!\Just watch me!\Strikeout!\There's no way I can hit that.\No matter.\I wasn't expecting anything from you. response:	Safe!
context: Please hit the ball!\Please do your best!\Just watch me!\Strikeout!\There's no way I can hit that.\No matter.\I wasn't expecting anything from you.\Safe! response:	Mikuru-chan!
context: Please do your best!\Just watch me!\Strikeout!\There's no way I can hit that.\No matter.\I wasn't expecting anything from you.\Safe!\Mikuru-chan! response:	You better hit it this time!
context: Just watch me!\Strikeout!\There's no way I can hit that.\No matter.\I wasn't expecting anything from you.\Safe!\Mikuru-chan!\You better hit it this time! response:	- Mikuru! You can do it!
context: Strikeout!\There's no way I can hit that.\No matter.\I wasn't expecting anything from you.\Safe!\Mikuru-chan!\You better hit it this time!\- Mikuru! You can do it! response:	Asahina-san!
context: There's no way I can hit that.\No matter.\I wasn't expecting anything from you.\Safe!\Mikuru-chan!\You better hit it this time!\- Mikuru! You can do it!\Asahina-san! response:	Strike!
context: No matter.\I wasn't expecting anything from you.\Safe!\Mikuru-chan!\You better hit it this time!\- Mikuru! You can do it!\Asahina-san!\Strike! response:	Mikuru-chan!
context: I wasn't expecting anything from you.\Safe!\Mikuru-chan!\You better hit it this time!\- Mikuru! You can do it!\Asahina-san!\Strike!\Mikuru-chan! response:	This! This!
context: Safe!\Mikuru-chan!\You better hit it this time!\- Mikuru! You can do it!\Asahina-san!\Strike!\Mikuru-chan!\This! This! response:	What is she doing?
context: Mikuru-chan!\You better hit it this time!\- Mikuru! You can do it!\Asahina-san!\Strike!\Mikuru-chan!\This! This!\What is she doing? response:	Is she trying to reduce the magic points of the opposing pitcher?
context: You better hit it this time!\- Mikuru! You can do it!\Asahina-san!\Strike!\Mikuru-chan!\This! This!\What is she doing?\Is she trying to reduce the magic points of the opposing pitcher? response:	It would appear that she's giving a sign.
context: - Mikuru! You can do it!\Asahina-san!\Strike!\Mikuru-chan!\This! This!\What is she doing?\Is she trying to reduce the magic points of the opposing pitcher?\It would appear that she's giving a sign. response:	Did we ever decide on any signs?
context: Asahina-san!\Strike!\Mikuru-chan!\This! This!\What is she doing?\Is she trying to reduce the magic points of the opposing pitcher?\It would appear that she's giving a sign.\Did we ever decide on any signs? response:	No.
context: Strike!\Mikuru-chan!\This! This!\What is she doing?\Is she trying to reduce the magic points of the opposing pitcher?\It would appear that she's giving a sign.\Did we ever decide on any signs?\No. response:	However...
context: Mikuru-chan!\This! This!\What is she doing?\Is she trying to reduce the magic points of the opposing pitcher?\It would appear that she's giving a sign.\Did we ever decide on any signs?\No.\However... response:	A squeeze towards first with two outs?
context: This! This!\What is she doing?\Is she trying to reduce the magic points of the opposing pitcher?\It would appear that she's giving a sign.\Did we ever decide on any signs?\No.\However...\A squeeze towards first with two outs? response:	Even one of those lame duck managers could do a better job than this.
context: What is she doing?\Is she trying to reduce the magic points of the opposing pitcher?\It would appear that she's giving a sign.\Did we ever decide on any signs?\No.\However...\A squeeze towards first with two outs?\Even one of those lame duck managers could do a better job than this. response:	Presuming that Asahina-san's chances of hitting the ball are practically none...
context: Is she trying to reduce the magic points of the opposing pitcher?\It would appear that she's giving a sign.\Did we ever decide on any signs?\No.\However...\A squeeze towards first with two outs?\Even one of those lame duck managers could do a better job than this.\Presuming that Asahina-san's chances of hitting the ball are practically none... response:	They've all figured it out though.
context: It would appear that she's giving a sign.\Did we ever decide on any signs?\No.\However...\A squeeze towards first with two outs?\Even one of those lame duck managers could do a better job than this.\Presuming that Asahina-san's chances of hitting the ball are practically none...\They've all figured it out though. response:	Strike!
context: Did we ever decide on any signs?\No.\However...\A squeeze towards first with two outs?\Even one of those lame duck managers could do a better job than this.\Presuming that Asahina-san's chances of hitting the ball are practically none...\They've all figured it out though.\Strike! response:	Strikeout!
context: No.\However...\A squeeze towards first with two outs?\Even one of those lame duck managers could do a better job than this.\Presuming that Asahina-san's chances of hitting the ball are practically none...\They've all figured it out though.\Strike!\Strikeout! response:	Mikuru-chan!
context: However...\A squeeze towards first with two outs?\Even one of those lame duck managers could do a better job than this.\Presuming that Asahina-san's chances of hitting the ball are practically none...\They've all figured it out though.\Strike!\Strikeout!\Mikuru-chan! response:	Come over here and buckle down for some pain!
context: A squeeze towards first with two outs?\Even one of those lame duck managers could do a better job than this.\Presuming that Asahina-san's chances of hitting the ball are practically none...\They've all figured it out though.\Strike!\Strikeout!\Mikuru-chan!\Come over here and buckle down for some pain! response:	This is punishment! Punishment!
context: Even one of those lame duck managers could do a better job than this.\Presuming that Asahina-san's chances of hitting the ball are practically none...\They've all figured it out though.\Strike!\Strikeout!\Mikuru-chan!\Come over here and buckle down for some pain!\This is punishment! Punishment! response:	Let everyone look at your funny face.
context: Presuming that Asahina-san's chances of hitting the ball are practically none...\They've all figured it out though.\Strike!\Strikeout!\Mikuru-chan!\Come over here and buckle down for some pain!\This is punishment! Punishment!\Let everyone look at your funny face. response:	Please stop...
context: They've all figured it out though.\Strike!\Strikeout!\Mikuru-chan!\Come over here and buckle down for some pain!\This is punishment! Punishment!\Let everyone look at your funny face.\Please stop... response:	Are you an idiot?
context: Strike!\Strikeout!\Mikuru-chan!\Come over here and buckle down for some pain!\This is punishment! Punishment!\Let everyone look at your funny face.\Please stop...\Are you an idiot? response:	It's your fault for giving signs that make no sense.
context: Strikeout!\Mikuru-chan!\Come over here and buckle down for some pain!\This is punishment! Punishment!\Let everyone look at your funny face.\Please stop...\Are you an idiot?\It's your fault for giving signs that make no sense. response:	Just steal home by yourself or whatever.
context: Mikuru-chan!\Come over here and buckle down for some pain!\This is punishment! Punishment!\Let everyone look at your funny face.\Please stop...\Are you an idiot?\It's your fault for giving signs that make no sense.\Just steal home by yourself or whatever. response:	Things have taken a bad turn.
context: Come over here and buckle down for some pain!\This is punishment! Punishment!\Let everyone look at your funny face.\Please stop...\Are you an idiot?\It's your fault for giving signs that make no sense.\Just steal home by yourself or whatever.\Things have taken a bad turn. response:	I really don't want to hear it, but go ahead.
context: This is punishment! Punishment!\Let everyone look at your funny face.\Please stop...\Are you an idiot?\It's your fault for giving signs that make no sense.\Just steal home by yourself or whatever.\Things have taken a bad turn.\I really don't want to hear it, but go ahead. response:	Closed space has appeared on a scale never before witnessed.
context: Let everyone look at your funny face.\Please stop...\Are you an idiot?\It's your fault for giving signs that make no sense.\Just steal home by yourself or whatever.\Things have taken a bad turn.\I really don't want to hear it, but go ahead.\Closed space has appeared on a scale never before witnessed. response:	It appears to be expanding at an alarming rate.
context: Please stop...\Are you an idiot?\It's your fault for giving signs that make no sense.\Just steal home by yourself or whatever.\Things have taken a bad turn.\I really don't want to hear it, but go ahead.\Closed space has appeared on a scale never before witnessed.\It appears to be expanding at an alarming rate. response:	As long as Suzumiya-san retains her foul mood, it will continue to expand...
context: Are you an idiot?\It's your fault for giving signs that make no sense.\Just steal home by yourself or whatever.\Things have taken a bad turn.\I really don't want to hear it, but go ahead.\Closed space has appeared on a scale never before witnessed.\It appears to be expanding at an alarming rate.\As long as Suzumiya-san retains her foul mood, it will continue to expand... response:	Just because we're losing?
context: It's your fault for giving signs that make no sense.\Just steal home by yourself or whatever.\Things have taken a bad turn.\I really don't want to hear it, but go ahead.\Closed space has appeared on a scale never before witnessed.\It appears to be expanding at an alarming rate.\As long as Suzumiya-san retains her foul mood, it will continue to expand...\Just because we're losing? response:	She's so full of it.
context: Just steal home by yourself or whatever.\Things have taken a bad turn.\I really don't want to hear it, but go ahead.\Closed space has appeared on a scale never before witnessed.\It appears to be expanding at an alarming rate.\As long as Suzumiya-san retains her foul mood, it will continue to expand...\Just because we're losing?\She's so full of it. response:	You sound as though it doesn't concern yourself...
context: Things have taken a bad turn.\I really don't want to hear it, but go ahead.\Closed space has appeared on a scale never before witnessed.\It appears to be expanding at an alarming rate.\As long as Suzumiya-san retains her foul mood, it will continue to expand...\Just because we're losing?\She's so full of it.\You sound as though it doesn't concern yourself... response:	After all, we drew lots to determine the batting order.
context: I really don't want to hear it, but go ahead.\Closed space has appeared on a scale never before witnessed.\It appears to be expanding at an alarming rate.\As long as Suzumiya-san retains her foul mood, it will continue to expand...\Just because we're losing?\She's so full of it.\You sound as though it doesn't concern yourself...\After all, we drew lots to determine the batting order. response:	And consequently, you became clean-up.
context: Closed space has appeared on a scale never before witnessed.\It appears to be expanding at an alarming rate.\As long as Suzumiya-san retains her foul mood, it will continue to expand...\Just because we're losing?\She's so full of it.\You sound as though it doesn't concern yourself...\After all, we drew lots to determine the batting order.\And consequently, you became clean-up. response:	I'm not particularly happy about it.
context: It appears to be expanding at an alarming rate.\As long as Suzumiya-san retains her foul mood, it will continue to expand...\Just because we're losing?\She's so full of it.\You sound as though it doesn't concern yourself...\After all, we drew lots to determine the batting order.\And consequently, you became clean-up.\I'm not particularly happy about it. response:	You became the clean-up batter...
context: As long as Suzumiya-san retains her foul mood, it will continue to expand...\Just because we're losing?\She's so full of it.\You sound as though it doesn't concern yourself...\After all, we drew lots to determine the batting order.\And consequently, you became clean-up.\I'm not particularly happy about it.\You became the clean-up batter... response:	It wasn't coincidence.
context: Just because we're losing?\She's so full of it.\You sound as though it doesn't concern yourself...\After all, we drew lots to determine the batting order.\And consequently, you became clean-up.\I'm not particularly happy about it.\You became the clean-up batter...\It wasn't coincidence. response:	And then...
context: She's so full of it.\You sound as though it doesn't concern yourself...\After all, we drew lots to determine the batting order.\And consequently, you became clean-up.\I'm not particularly happy about it.\You became the clean-up batter...\It wasn't coincidence.\And then... response:	So sorry about that.
context: You sound as though it doesn't concern yourself...\After all, we drew lots to determine the batting order.\And consequently, you became clean-up.\I'm not particularly happy about it.\You became the clean-up batter...\It wasn't coincidence.\And then...\So sorry about that. response:	In any case...
context: After all, we drew lots to determine the batting order.\And consequently, you became clean-up.\I'm not particularly happy about it.\You became the clean-up batter...\It wasn't coincidence.\And then...\So sorry about that.\In any case... response:	If the game ends now...
context: And consequently, you became clean-up.\I'm not particularly happy about it.\You became the clean-up batter...\It wasn't coincidence.\And then...\So sorry about that.\In any case...\If the game ends now... response:	Come on!
context: I'm not particularly happy about it.\You became the clean-up batter...\It wasn't coincidence.\And then...\So sorry about that.\In any case...\If the game ends now...\Come on! response:	We're starting!
context: You became the clean-up batter...\It wasn't coincidence.\And then...\So sorry about that.\In any case...\If the game ends now...\Come on!\We're starting! response:	We must do all we can to hold them to two runs.
context: It wasn't coincidence.\And then...\So sorry about that.\In any case...\If the game ends now...\Come on!\We're starting!\We must do all we can to hold them to two runs. response:	Two outs. Runners on first and second.
context: And then...\So sorry about that.\In any case...\If the game ends now...\Come on!\We're starting!\We must do all we can to hold them to two runs.\Two outs. Runners on first and second. response:	SOS Brigade
context: So sorry about that.\In any case...\If the game ends now...\Come on!\We're starting!\We must do all we can to hold them to two runs.\Two outs. Runners on first and second.\SOS Brigade response:	Kamigahara
context: In any case...\If the game ends now...\Come on!\We're starting!\We must do all we can to hold them to two runs.\Two outs. Runners on first and second.\SOS Brigade\Kamigahara response:	Pirates
context: If the game ends now...\Come on!\We're starting!\We must do all we can to hold them to two runs.\Two outs. Runners on first and second.\SOS Brigade\Kamigahara\Pirates response:	Current score: 0-9.
context: Come on!\We're starting!\We must do all we can to hold them to two runs.\Two outs. Runners on first and second.\SOS Brigade\Kamigahara\Pirates\Current score: 0-9. response:	The game will be over in another run.
context: We're starting!\We must do all we can to hold them to two runs.\Two outs. Runners on first and second.\SOS Brigade\Kamigahara\Pirates\Current score: 0-9.\The game will be over in another run. response:	It's coming towards me!
context: We must do all we can to hold them to two runs.\Two outs. Runners on first and second.\SOS Brigade\Kamigahara\Pirates\Current score: 0-9.\The game will be over in another run.\It's coming towards me! response:	Make it...
context: Two outs. Runners on first and second.\SOS Brigade\Kamigahara\Pirates\Current score: 0-9.\The game will be over in another run.\It's coming towards me!\Make it... response:	Make it!
context: SOS Brigade\Kamigahara\Pirates\Current score: 0-9.\The game will be over in another run.\It's coming towards me!\Make it...\Make it! response:	Amazing!
context: Kamigahara\Pirates\Current score: 0-9.\The game will be over in another run.\It's coming towards me!\Make it...\Make it!\Amazing! response:	Nice play!
context: Pirates\Current score: 0-9.\The game will be over in another run.\It's coming towards me!\Make it...\Make it!\Amazing!\Nice play! response:	Way to go, you!
context: Current score: 0-9.\The game will be over in another run.\It's coming towards me!\Make it...\Make it!\Amazing!\Nice play!\Way to go, you! response:	- That's my buddy!
context: The game will be over in another run.\It's coming towards me!\Make it...\Make it!\Amazing!\Nice play!\Way to go, you!\- That's my buddy! response:	Picking up where we left off...
context: It's coming towards me!\Make it...\Make it!\Amazing!\Nice play!\Way to go, you!\- That's my buddy!\Picking up where we left off... response:	Your face is really close.
context: Make it...\Make it!\Amazing!\Nice play!\Way to go, you!\- That's my buddy!\Picking up where we left off...\Your face is really close. response:	What do you want?
context: Make it!\Amazing!\Nice play!\Way to go, you!\- That's my buddy!\Picking up where we left off...\Your face is really close.\What do you want? response:	During the previous incident, when you and Suzumiya-san were in the other world...
context: Amazing!\Nice play!\Way to go, you!\- That's my buddy!\Picking up where we left off...\Your face is really close.\What do you want?\During the previous incident, when you and Suzumiya-san were in the other world... response:	Don't remind me of that.
context: Nice play!\Way to go, you!\- That's my buddy!\Picking up where we left off...\Your face is really close.\What do you want?\During the previous incident, when you and Suzumiya-san were in the other world...\Don't remind me of that. response:	If we use that method again...
context: Way to go, you!\- That's my buddy!\Picking up where we left off...\Your face is really close.\What do you want?\During the previous incident, when you and Suzumiya-san were in the other world...\Don't remind me of that.\If we use that method again... response:	I refuse.
context: - That's my buddy!\Picking up where we left off...\Your face is really close.\What do you want?\During the previous incident, when you and Suzumiya-san were in the other world...\Don't remind me of that.\If we use that method again...\I refuse. response:	I thought you would say that.
context: Picking up where we left off...\Your face is really close.\What do you want?\During the previous incident, when you and Suzumiya-san were in the other world...\Don't remind me of that.\If we use that method again...\I refuse.\I thought you would say that. response:	Then I shall go secure our means to victory.
context: Your face is really close.\What do you want?\During the previous incident, when you and Suzumiya-san were in the other world...\Don't remind me of that.\If we use that method again...\I refuse.\I thought you would say that.\Then I shall go secure our means to victory. response:	After all...
context: What do you want?\During the previous incident, when you and Suzumiya-san were in the other world...\Don't remind me of that.\If we use that method again...\I refuse.\I thought you would say that.\Then I shall go secure our means to victory.\After all... response:	Nagato-san's finally...
context: During the previous incident, when you and Suzumiya-san were in the other world...\Don't remind me of that.\If we use that method again...\I refuse.\I thought you would say that.\Then I shall go secure our means to victory.\After all...\Nagato-san's finally... response:	Is something up with her?
context: Don't remind me of that.\If we use that method again...\I refuse.\I thought you would say that.\Then I shall go secure our means to victory.\After all...\Nagato-san's finally...\Is something up with her? response:	She seems to be reciting an incantation.
context: If we use that method again...\I refuse.\I thought you would say that.\Then I shall go secure our means to victory.\After all...\Nagato-san's finally...\Is something up with her?\She seems to be reciting an incantation. response:	Incantation?
context: I refuse.\I thought you would say that.\Then I shall go secure our means to victory.\After all...\Nagato-san's finally...\Is something up with her?\She seems to be reciting an incantation.\Incantation? response:	What's that?
context: I thought you would say that.\Then I shall go secure our means to victory.\After all...\Nagato-san's finally...\Is something up with her?\She seems to be reciting an incantation.\Incantation?\What's that? response:	Um...
context: Then I shall go secure our means to victory.\After all...\Nagato-san's finally...\Is something up with her?\She seems to be reciting an incantation.\Incantation?\What's that?\Um... response:	Classified information.
context: After all...\Nagato-san's finally...\Is something up with her?\She seems to be reciting an incantation.\Incantation?\What's that?\Um...\Classified information. response:	An incantation, huh...
context: Nagato-san's finally...\Is something up with her?\She seems to be reciting an incantation.\Incantation?\What's that?\Um...\Classified information.\An incantation, huh... response:	That was incredible!
context: Is something up with her?\She seems to be reciting an incantation.\Incantation?\What's that?\Um...\Classified information.\An incantation, huh...\That was incredible! response:	Where are you hiding that strength?
context: She seems to be reciting an incantation.\Incantation?\What's that?\Um...\Classified information.\An incantation, huh...\That was incredible!\Where are you hiding that strength? response:	This has been modified with a boost in attribute data.
context: Incantation?\What's that?\Um...\Classified information.\An incantation, huh...\That was incredible!\Where are you hiding that strength?\This has been modified with a boost in attribute data. response:	What's that mean?
context: What's that?\Um...\Classified information.\An incantation, huh...\That was incredible!\Where are you hiding that strength?\This has been modified with a boost in attribute data.\What's that mean? response:	Homing mode.
context: Um...\Classified information.\An incantation, huh...\That was incredible!\Where are you hiding that strength?\This has been modified with a boost in attribute data.\What's that mean?\Homing mode. response:	That ball's gone!
context: Classified information.\An incantation, huh...\That was incredible!\Where are you hiding that strength?\This has been modified with a boost in attribute data.\What's that mean?\Homing mode.\That ball's gone! response:	I see. Homing mode, is it.
context: An incantation, huh...\That was incredible!\Where are you hiding that strength?\This has been modified with a boost in attribute data.\What's that mean?\Homing mode.\That ball's gone!\I see. Homing mode, is it. response:	Oh, boy...
context: That was incredible!\Where are you hiding that strength?\This has been modified with a boost in attribute data.\What's that mean?\Homing mode.\That ball's gone!\I see. Homing mode, is it.\Oh, boy... response:	There's a limit to ridiculousness.
context: Where are you hiding that strength?\This has been modified with a boost in attribute data.\What's that mean?\Homing mode.\That ball's gone!\I see. Homing mode, is it.\Oh, boy...\There's a limit to ridiculousness. response:	Whatever the case...
context: This has been modified with a boost in attribute data.\What's that mean?\Homing mode.\That ball's gone!\I see. Homing mode, is it.\Oh, boy...\There's a limit to ridiculousness.\Whatever the case... response:	In a variety of ways...
context: What's that mean?\Homing mode.\That ball's gone!\I see. Homing mode, is it.\Oh, boy...\There's a limit to ridiculousness.\Whatever the case...\In a variety of ways... response:	That's enough.
context: Homing mode.\That ball's gone!\I see. Homing mode, is it.\Oh, boy...\There's a limit to ridiculousness.\Whatever the case...\In a variety of ways...\That's enough. response:	I see.
context: That ball's gone!\I see. Homing mode, is it.\Oh, boy...\There's a limit to ridiculousness.\Whatever the case...\In a variety of ways...\That's enough.\I see. response:	Strike!
context: I see. Homing mode, is it.\Oh, boy...\There's a limit to ridiculousness.\Whatever the case...\In a variety of ways...\That's enough.\I see.\Strike! response:	Strike!
context: Oh, boy...\There's a limit to ridiculousness.\Whatever the case...\In a variety of ways...\That's enough.\I see.\Strike!\Strike! response:	Strike!
context: There's a limit to ridiculousness.\Whatever the case...\In a variety of ways...\That's enough.\I see.\Strike!\Strike!\Strike! response:	I'd forgotten...
context: Whatever the case...\In a variety of ways...\That's enough.\I see.\Strike!\Strike!\Strike!\I'd forgotten... response:	Which means the next inning will be dropped.
context: In a variety of ways...\That's enough.\I see.\Strike!\Strike!\Strike!\I'd forgotten...\Which means the next inning will be dropped. response:	If we last through this inning, we'll win.
context: That's enough.\I see.\Strike!\Strike!\Strike!\I'd forgotten...\Which means the next inning will be dropped.\If we last through this inning, we'll win. response:	Is it really okay for us to win?
context: I see.\Strike!\Strike!\Strike!\I'd forgotten...\Which means the next inning will be dropped.\If we last through this inning, we'll win.\Is it really okay for us to win? response:	We cannot afford the alternative.
context: Strike!\Strike!\Strike!\I'd forgotten...\Which means the next inning will be dropped.\If we last through this inning, we'll win.\Is it really okay for us to win?\We cannot afford the alternative. response:	Thanks to our efforts...
context: Strike!\Strike!\I'd forgotten...\Which means the next inning will be dropped.\If we last through this inning, we'll win.\Is it really okay for us to win?\We cannot afford the alternative.\Thanks to our efforts... response:	But if they make a comeback now, it'll be a walk-off loss.
context: Strike!\I'd forgotten...\Which means the next inning will be dropped.\If we last through this inning, we'll win.\Is it really okay for us to win?\We cannot afford the alternative.\Thanks to our efforts...\But if they make a comeback now, it'll be a walk-off loss. response:	There's no need to think about how bad of a mood Haruhi will be in then.
context: I'd forgotten...\Which means the next inning will be dropped.\If we last through this inning, we'll win.\Is it really okay for us to win?\We cannot afford the alternative.\Thanks to our efforts...\But if they make a comeback now, it'll be a walk-off loss.\There's no need to think about how bad of a mood Haruhi will be in then. response:	And so I have an idea concerning that.
context: Which means the next inning will be dropped.\If we last through this inning, we'll win.\Is it really okay for us to win?\We cannot afford the alternative.\Thanks to our efforts...\But if they make a comeback now, it'll be a walk-off loss.\There's no need to think about how bad of a mood Haruhi will be in then.\And so I have an idea concerning that. response:	Seriously?
context: If we last through this inning, we'll win.\Is it really okay for us to win?\We cannot afford the alternative.\Thanks to our efforts...\But if they make a comeback now, it'll be a walk-off loss.\There's no need to think about how bad of a mood Haruhi will be in then.\And so I have an idea concerning that.\Seriously? response:	Very serious.
context: Is it really okay for us to win?\We cannot afford the alternative.\Thanks to our efforts...\But if they make a comeback now, it'll be a walk-off loss.\There's no need to think about how bad of a mood Haruhi will be in then.\And so I have an idea concerning that.\Seriously?\Very serious. response:	To make it through this inning while giving up a minimal number of runs...
context: We cannot afford the alternative.\Thanks to our efforts...\But if they make a comeback now, it'll be a walk-off loss.\There's no need to think about how bad of a mood Haruhi will be in then.\And so I have an idea concerning that.\Seriously?\Very serious.\To make it through this inning while giving up a minimal number of runs... response:	Oh, boy...
context: Thanks to our efforts...\But if they make a comeback now, it'll be a walk-off loss.\There's no need to think about how bad of a mood Haruhi will be in then.\And so I have an idea concerning that.\Seriously?\Very serious.\To make it through this inning while giving up a minimal number of runs...\Oh, boy... response:	Ball!
context: But if they make a comeback now, it'll be a walk-off loss.\There's no need to think about how bad of a mood Haruhi will be in then.\And so I have an idea concerning that.\Seriously?\Very serious.\To make it through this inning while giving up a minimal number of runs...\Oh, boy...\Ball! response:	Hey!
context: There's no need to think about how bad of a mood Haruhi will be in then.\And so I have an idea concerning that.\Seriously?\Very serious.\To make it through this inning while giving up a minimal number of runs...\Oh, boy...\Ball!\Hey! response:	Be serious about it!
context: And so I have an idea concerning that.\Seriously?\Very serious.\To make it through this inning while giving up a minimal number of runs...\Oh, boy...\Ball!\Hey!\Be serious about it! response:	I let you take my place...
context: Seriously?\Very serious.\To make it through this inning while giving up a minimal number of runs...\Oh, boy...\Ball!\Hey!\Be serious about it!\I let you take my place... response:	I know.
context: Very serious.\To make it through this inning while giving up a minimal number of runs...\Oh, boy...\Ball!\Hey!\Be serious about it!\I let you take my place...\I know. response:	After all, the fate of the world rests on my pitching.
context: To make it through this inning while giving up a minimal number of runs...\Oh, boy...\Ball!\Hey!\Be serious about it!\I let you take my place...\I know.\After all, the fate of the world rests on my pitching. response:	The world sure isn't worth much these days.
context: Oh, boy...\Ball!\Hey!\Be serious about it!\I let you take my place...\I know.\After all, the fate of the world rests on my pitching.\The world sure isn't worth much these days. response:	Thanks to this Mysterious Ball...
context: Ball!\Hey!\Be serious about it!\I let you take my place...\I know.\After all, the fate of the world rests on my pitching.\The world sure isn't worth much these days.\Thanks to this Mysterious Ball... response:	Strike!
context: Hey!\Be serious about it!\I let you take my place...\I know.\After all, the fate of the world rests on my pitching.\The world sure isn't worth much these days.\Thanks to this Mysterious Ball...\Strike! response:	S-Strike two!
context: Be serious about it!\I let you take my place...\I know.\After all, the fate of the world rests on my pitching.\The world sure isn't worth much these days.\Thanks to this Mysterious Ball...\Strike!\S-Strike two! response:	Strikeout!
context: I let you take my place...\I know.\After all, the fate of the world rests on my pitching.\The world sure isn't worth much these days.\Thanks to this Mysterious Ball...\Strike!\S-Strike two!\Strikeout! response:	The next pitcher struck out in three pitches...
context: I know.\After all, the fate of the world rests on my pitching.\The world sure isn't worth much these days.\Thanks to this Mysterious Ball...\Strike!\S-Strike two!\Strikeout!\The next pitcher struck out in three pitches... response:	Strikeout!
context: After all, the fate of the world rests on my pitching.\The world sure isn't worth much these days.\Thanks to this Mysterious Ball...\Strike!\S-Strike two!\Strikeout!\The next pitcher struck out in three pitches...\Strikeout! response:	Strike two!
context: The world sure isn't worth much these days.\Thanks to this Mysterious Ball...\Strike!\S-Strike two!\Strikeout!\The next pitcher struck out in three pitches...\Strikeout!\Strike two! response:	Kyon!
context: Thanks to this Mysterious Ball...\Strike!\S-Strike two!\Strikeout!\The next pitcher struck out in three pitches...\Strikeout!\Strike two!\Kyon! response:	Finish it with the next pitch!
context: Strike!\S-Strike two!\Strikeout!\The next pitcher struck out in three pitches...\Strikeout!\Strike two!\Kyon!\Finish it with the next pitch! response:	I don't need you to tell me to end the game.
context: S-Strike two!\Strikeout!\The next pitcher struck out in three pitches...\Strikeout!\Strike two!\Kyon!\Finish it with the next pitch!\I don't need you to tell me to end the game. response:	Sorry, Kamigahara Pirates.
context: Strikeout!\The next pitcher struck out in three pitches...\Strikeout!\Strike two!\Kyon!\Finish it with the next pitch!\I don't need you to tell me to end the game.\Sorry, Kamigahara Pirates. response:	Lucky!
context: The next pitcher struck out in three pitches...\Strikeout!\Strike two!\Kyon!\Finish it with the next pitch!\I don't need you to tell me to end the game.\Sorry, Kamigahara Pirates.\Lucky! response:	It's a wild pitch, Nagato!
context: Strikeout!\Strike two!\Kyon!\Finish it with the next pitch!\I don't need you to tell me to end the game.\Sorry, Kamigahara Pirates.\Lucky!\It's a wild pitch, Nagato! response:	Pick up the ball and throw it!
context: Strike two!\Kyon!\Finish it with the next pitch!\I don't need you to tell me to end the game.\Sorry, Kamigahara Pirates.\Lucky!\It's a wild pitch, Nagato!\Pick up the ball and throw it! response:	Hurry up!
context: Kyon!\Finish it with the next pitch!\I don't need you to tell me to end the game.\Sorry, Kamigahara Pirates.\Lucky!\It's a wild pitch, Nagato!\Pick up the ball and throw it!\Hurry up! response:	Second!
context: Finish it with the next pitch!\I don't need you to tell me to end the game.\Sorry, Kamigahara Pirates.\Lucky!\It's a wild pitch, Nagato!\Pick up the ball and throw it!\Hurry up!\Second! response:	Here!
context: I don't need you to tell me to end the game.\Sorry, Kamigahara Pirates.\Lucky!\It's a wild pitch, Nagato!\Pick up the ball and throw it!\Hurry up!\Second!\Here! response:	Huh?
context: Sorry, Kamigahara Pirates.\Lucky!\It's a wild pitch, Nagato!\Pick up the ball and throw it!\Hurry up!\Second!\Here!\Huh? response:	I'm terribly sorry.
context: Lucky!\It's a wild pitch, Nagato!\Pick up the ball and throw it!\Hurry up!\Second!\Here!\Huh?\I'm terribly sorry. response:	We happen to be a slightly unreasonable group.
context: It's a wild pitch, Nagato!\Pick up the ball and throw it!\Hurry up!\Second!\Here!\Huh?\I'm terribly sorry.\We happen to be a slightly unreasonable group. response:	G-Game over!
context: Pick up the ball and throw it!\Hurry up!\Second!\Here!\Huh?\I'm terribly sorry.\We happen to be a slightly unreasonable group.\G-Game over! response:	Thanks to Nagato's bogus magic...
context: Hurry up!\Second!\Here!\Huh?\I'm terribly sorry.\We happen to be a slightly unreasonable group.\G-Game over!\Thanks to Nagato's bogus magic... response:	What shall we do about the next game?
context: Second!\Here!\Huh?\I'm terribly sorry.\We happen to be a slightly unreasonable group.\G-Game over!\Thanks to Nagato's bogus magic...\What shall we do about the next game? response:	Continuing onto the next round...
context: Here!\Huh?\I'm terribly sorry.\We happen to be a slightly unreasonable group.\G-Game over!\Thanks to Nagato's bogus magic...\What shall we do about the next game?\Continuing onto the next round... response:	The truth is that I need to go help my colleagues soon.
context: Huh?\I'm terribly sorry.\We happen to be a slightly unreasonable group.\G-Game over!\Thanks to Nagato's bogus magic...\What shall we do about the next game?\Continuing onto the next round...\The truth is that I need to go help my colleagues soon. response:	We'll be short on members, too.
context: I'm terribly sorry.\We happen to be a slightly unreasonable group.\G-Game over!\Thanks to Nagato's bogus magic...\What shall we do about the next game?\Continuing onto the next round...\The truth is that I need to go help my colleagues soon.\We'll be short on members, too. response:	Let's forfeit.
context: We happen to be a slightly unreasonable group.\G-Game over!\Thanks to Nagato's bogus magic...\What shall we do about the next game?\Continuing onto the next round...\The truth is that I need to go help my colleagues soon.\We'll be short on members, too.\Let's forfeit. response:	That sounds best.
context: G-Game over!\Thanks to Nagato's bogus magic...\What shall we do about the next game?\Continuing onto the next round...\The truth is that I need to go help my colleagues soon.\We'll be short on members, too.\Let's forfeit.\That sounds best. response:	It would appear that it is a bad idea to allow Suzumiya-san to be bored.
context: Thanks to Nagato's bogus magic...\What shall we do about the next game?\Continuing onto the next round...\The truth is that I need to go help my colleagues soon.\We'll be short on members, too.\Let's forfeit.\That sounds best.\It would appear that it is a bad idea to allow Suzumiya-san to be bored. response:	We should take that into consideration during future endeavors.
context: What shall we do about the next game?\Continuing onto the next round...\The truth is that I need to go help my colleagues soon.\We'll be short on members, too.\Let's forfeit.\That sounds best.\It would appear that it is a bad idea to allow Suzumiya-san to be bored.\We should take that into consideration during future endeavors. response:	You've had your fun, right?
context: Continuing onto the next round...\The truth is that I need to go help my colleagues soon.\We'll be short on members, too.\Let's forfeit.\That sounds best.\It would appear that it is a bad idea to allow Suzumiya-san to be bored.\We should take that into consideration during future endeavors.\You've had your fun, right? response:	Koizumi had to leave because something came up.
context: The truth is that I need to go help my colleagues soon.\We'll be short on members, too.\Let's forfeit.\That sounds best.\It would appear that it is a bad idea to allow Suzumiya-san to be bored.\We should take that into consideration during future endeavors.\You've had your fun, right?\Koizumi had to leave because something came up. response:	My legs and arms are completely worn out.
context: We'll be short on members, too.\Let's forfeit.\That sounds best.\It would appear that it is a bad idea to allow Suzumiya-san to be bored.\We should take that into consideration during future endeavors.\You've had your fun, right?\Koizumi had to leave because something came up.\My legs and arms are completely worn out. response:	If it's okay with you, I guess that's fine.
context: Let's forfeit.\That sounds best.\It would appear that it is a bad idea to allow Suzumiya-san to be bored.\We should take that into consideration during future endeavors.\You've had your fun, right?\Koizumi had to leave because something came up.\My legs and arms are completely worn out.\If it's okay with you, I guess that's fine. response:	I'm pretty hungry anyway.
context: That sounds best.\It would appear that it is a bad idea to allow Suzumiya-san to be bored.\We should take that into consideration during future endeavors.\You've had your fun, right?\Koizumi had to leave because something came up.\My legs and arms are completely worn out.\If it's okay with you, I guess that's fine.\I'm pretty hungry anyway. response:	Let's go have lunch!
context: It would appear that it is a bad idea to allow Suzumiya-san to be bored.\We should take that into consideration during future endeavors.\You've had your fun, right?\Koizumi had to leave because something came up.\My legs and arms are completely worn out.\If it's okay with you, I guess that's fine.\I'm pretty hungry anyway.\Let's go have lunch! response:	Yeah, yeah.
context: We should take that into consideration during future endeavors.\You've had your fun, right?\Koizumi had to leave because something came up.\My legs and arms are completely worn out.\If it's okay with you, I guess that's fine.\I'm pretty hungry anyway.\Let's go have lunch!\Yeah, yeah. response:	Thank you so much!
context: You've had your fun, right?\Koizumi had to leave because something came up.\My legs and arms are completely worn out.\If it's okay with you, I guess that's fine.\I'm pretty hungry anyway.\Let's go have lunch!\Yeah, yeah.\Thank you so much! response:	Not at all.
context: Koizumi had to leave because something came up.\My legs and arms are completely worn out.\If it's okay with you, I guess that's fine.\I'm pretty hungry anyway.\Let's go have lunch!\Yeah, yeah.\Thank you so much!\Not at all. response:	I'll be going then.
context: My legs and arms are completely worn out.\If it's okay with you, I guess that's fine.\I'm pretty hungry anyway.\Let's go have lunch!\Yeah, yeah.\Thank you so much!\Not at all.\I'll be going then. response:	Wait.
context: If it's okay with you, I guess that's fine.\I'm pretty hungry anyway.\Let's go have lunch!\Yeah, yeah.\Thank you so much!\Not at all.\I'll be going then.\Wait. response:	About that bat...
context: I'm pretty hungry anyway.\Let's go have lunch!\Yeah, yeah.\Thank you so much!\Not at all.\I'll be going then.\Wait.\About that bat... response:	I didn't know I had it in me.
context: Let's go have lunch!\Yeah, yeah.\Thank you so much!\Not at all.\I'll be going then.\Wait.\About that bat...\I didn't know I had it in me. response:	So you're Yuki Nagato-chan?
context: Yeah, yeah.\Thank you so much!\Not at all.\I'll be going then.\Wait.\About that bat...\I didn't know I had it in me.\So you're Yuki Nagato-chan? response:	I must have talent for baseball.
context: Thank you so much!\Not at all.\I'll be going then.\Wait.\About that bat...\I didn't know I had it in me.\So you're Yuki Nagato-chan?\I must have talent for baseball. response:	I've heard a lot about you from Mikuru.
context: Not at all.\I'll be going then.\Wait.\About that bat...\I didn't know I had it in me.\So you're Yuki Nagato-chan?\I must have talent for baseball.\I've heard a lot about you from Mikuru. response:	Everybody eat up!
context: I'll be going then.\Wait.\About that bat...\I didn't know I had it in me.\So you're Yuki Nagato-chan?\I must have talent for baseball.\I've heard a lot about you from Mikuru.\Everybody eat up! response:	It's all Kyon's treat!
context: Wait.\About that bat...\I didn't know I had it in me.\So you're Yuki Nagato-chan?\I must have talent for baseball.\I've heard a lot about you from Mikuru.\Everybody eat up!\It's all Kyon's treat! response:	Oh, well.
context: About that bat...\I didn't know I had it in me.\So you're Yuki Nagato-chan?\I must have talent for baseball.\I've heard a lot about you from Mikuru.\Everybody eat up!\It's all Kyon's treat!\Oh, well. response:	I managed to get my hands on some unexpected extra cash.
context: I didn't know I had it in me.\So you're Yuki Nagato-chan?\I must have talent for baseball.\I've heard a lot about you from Mikuru.\Everybody eat up!\It's all Kyon's treat!\Oh, well.\I managed to get my hands on some unexpected extra cash. response:	Here's to the success of the Kamigahara Pirates.
context: So you're Yuki Nagato-chan?\I must have talent for baseball.\I've heard a lot about you from Mikuru.\Everybody eat up!\It's all Kyon's treat!\Oh, well.\I managed to get my hands on some unexpected extra cash.\Here's to the success of the Kamigahara Pirates. response:	C'mon! C'mon! Swing harder!
context: I must have talent for baseball.\I've heard a lot about you from Mikuru.\Everybody eat up!\It's all Kyon's treat!\Oh, well.\I managed to get my hands on some unexpected extra cash.\Here's to the success of the Kamigahara Pirates.\C'mon! C'mon! Swing harder! response:	Sorry I'm late!
context: I've heard a lot about you from Mikuru.\Everybody eat up!\It's all Kyon's treat!\Oh, well.\I managed to get my hands on some unexpected extra cash.\Here's to the success of the Kamigahara Pirates.\C'mon! C'mon! Swing harder!\Sorry I'm late! response:	Hey!
context: Everybody eat up!\It's all Kyon's treat!\Oh, well.\I managed to get my hands on some unexpected extra cash.\Here's to the success of the Kamigahara Pirates.\C'mon! C'mon! Swing harder!\Sorry I'm late!\Hey! response:	Which one do you want to do next?
context: It's all Kyon's treat!\Oh, well.\I managed to get my hands on some unexpected extra cash.\Here's to the success of the Kamigahara Pirates.\C'mon! C'mon! Swing harder!\Sorry I'm late!\Hey!\Which one do you want to do next? response:	Soccer
context: Oh, well.\I managed to get my hands on some unexpected extra cash.\Here's to the success of the Kamigahara Pirates.\C'mon! C'mon! Swing harder!\Sorry I'm late!\Hey!\Which one do you want to do next?\Soccer response:	Tournament
context: I managed to get my hands on some unexpected extra cash.\Here's to the success of the Kamigahara Pirates.\C'mon! C'mon! Swing harder!\Sorry I'm late!\Hey!\Which one do you want to do next?\Soccer\Tournament response:	American
context: Here's to the success of the Kamigahara Pirates.\C'mon! C'mon! Swing harder!\Sorry I'm late!\Hey!\Which one do you want to do next?\Soccer\Tournament\American response:	Football
context: C'mon! C'mon! Swing harder!\Sorry I'm late!\Hey!\Which one do you want to do next?\Soccer\Tournament\American\Football response:	Tournament
context: Sorry I'm late!\Hey!\Which one do you want to do next?\Soccer\Tournament\American\Football\Tournament response:	Soccer
context: Hey!\Which one do you want to do next?\Soccer\Tournament\American\Football\Tournament\Soccer response:	Tournament
context: Which one do you want to do next?\Soccer\Tournament\American\Football\Tournament\Soccer\Tournament response:	American
context: Soccer\Tournament\American\Football\Tournament\Soccer\Tournament\American response:	Football
context: Tournament\American\Football\Tournament\Soccer\Tournament\American\Football response:	Tournament
context: American\Football\Tournament\Soccer\Tournament\American\Football\Tournament response:	Soccer
context: Football\Tournament\Soccer\Tournament\American\Football\Tournament\Soccer response:	Tournament
context: Tournament\Soccer\Tournament\American\Football\Tournament\Soccer\Tournament response:	American
context: Soccer\Tournament\American\Football\Tournament\Soccer\Tournament\American response:	Football
context: Tournament\American\Football\Tournament\Soccer\Tournament\American\Football response:	Tournament
context: American\Football\Tournament\Soccer\Tournament\American\Football\Tournament response:	How many people do you need for soccer and American football?
context: Football\Tournament\Soccer\Tournament\American\Football\Tournament\How many people do you need for soccer and American football? response:	Will the members from last time be enough?
context: Tournament\Soccer\Tournament\American\Football\Tournament\How many people do you need for soccer and American football?\Will the members from last time be enough? response:	Thermodynamics
context: Soccer\Tournament\American\Football\Tournament\How many people do you need for soccer and American football?\Will the members from last time be enough?\Thermodynamics response:	Particle Theory
context: Tournament\American\Football\Tournament\How many people do you need for soccer and American football?\Will the members from last time be enough?\Thermodynamics\Particle Theory response:	Astrodynamics
context: American\Football\Tournament\How many people do you need for soccer and American football?\Will the members from last time be enough?\Thermodynamics\Particle Theory\Astrodynamics response:	As I watched Haruhi's first-class smile...
context: Football\Tournament\How many people do you need for soccer and American football?\Will the members from last time be enough?\Thermodynamics\Particle Theory\Astrodynamics\As I watched Haruhi's first-class smile... response:	American football! No!
context: Tournament\How many people do you need for soccer and American football?\Will the members from last time be enough?\Thermodynamics\Particle Theory\Astrodynamics\As I watched Haruhi's first-class smile...\American football! No! response:	Make it Japanese croquet!