context: Up you go! response:	And, again!
context: Up you go!\And, again! response:	Hang on a minute.
context: Up you go!\And, again!\Hang on a minute. response:	I'm almost done.
context: Up you go!\And, again!\Hang on a minute.\I'm almost done. response:	Get off the counter!
context: Up you go!\And, again!\Hang on a minute.\I'm almost done.\Get off the counter! response:	Morning.
context: Up you go!\And, again!\Hang on a minute.\I'm almost done.\Get off the counter!\Morning. response:	Good morning.
context: Up you go!\And, again!\Hang on a minute.\I'm almost done.\Get off the counter!\Morning.\Good morning. response:	And down you go.
context: Up you go!\And, again!\Hang on a minute.\I'm almost done.\Get off the counter!\Morning.\Good morning.\And down you go. response:	Wakana, can I get some food?
context: And, again!\Hang on a minute.\I'm almost done.\Get off the counter!\Morning.\Good morning.\And down you go.\Wakana, can I get some food? response:	In a sec. I'm feeding Dora first.
context: Hang on a minute.\I'm almost done.\Get off the counter!\Morning.\Good morning.\And down you go.\Wakana, can I get some food?\In a sec. I'm feeding Dora first. response:	For you.
context: I'm almost done.\Get off the counter!\Morning.\Good morning.\And down you go.\Wakana, can I get some food?\In a sec. I'm feeding Dora first.\For you. response:	And you.
context: Get off the counter!\Morning.\Good morning.\And down you go.\Wakana, can I get some food?\In a sec. I'm feeding Dora first.\For you.\And you. response:	What is this?
context: Morning.\Good morning.\And down you go.\Wakana, can I get some food?\In a sec. I'm feeding Dora first.\For you.\And you.\What is this? response:	Leftovers from last night.
context: Good morning.\And down you go.\Wakana, can I get some food?\In a sec. I'm feeding Dora first.\For you.\And you.\What is this?\Leftovers from last night. response:	Hey.
context: And down you go.\Wakana, can I get some food?\In a sec. I'm feeding Dora first.\For you.\And you.\What is this?\Leftovers from last night.\Hey. response:	It's because you always make too much for dinner, Dad.
context: Wakana, can I get some food?\In a sec. I'm feeding Dora first.\For you.\And you.\What is this?\Leftovers from last night.\Hey.\It's because you always make too much for dinner, Dad. response:	You could at least jazz it up with some egg or sauce, or something.
context: In a sec. I'm feeding Dora first.\For you.\And you.\What is this?\Leftovers from last night.\Hey.\It's because you always make too much for dinner, Dad.\You could at least jazz it up with some egg or sauce, or something. response:	I have to go now,
context: For you.\And you.\What is this?\Leftovers from last night.\Hey.\It's because you always make too much for dinner, Dad.\You could at least jazz it up with some egg or sauce, or something.\I have to go now, response:	so please wash the dishes when you're done.
context: And you.\What is this?\Leftovers from last night.\Hey.\It's because you always make too much for dinner, Dad.\You could at least jazz it up with some egg or sauce, or something.\I have to go now,\so please wash the dishes when you're done. response:	What?
context: What is this?\Leftovers from last night.\Hey.\It's because you always make too much for dinner, Dad.\You could at least jazz it up with some egg or sauce, or something.\I have to go now,\so please wash the dishes when you're done.\What? response:	Don't what me.
context: Leftovers from last night.\Hey.\It's because you always make too much for dinner, Dad.\You could at least jazz it up with some egg or sauce, or something.\I have to go now,\so please wash the dishes when you're done.\What?\Don't what me. response:	And you should get up earlier.
context: Hey.\It's because you always make too much for dinner, Dad.\You could at least jazz it up with some egg or sauce, or something.\I have to go now,\so please wash the dishes when you're done.\What?\Don't what me.\And you should get up earlier. response:	Don't click your tongue at me.
context: It's because you always make too much for dinner, Dad.\You could at least jazz it up with some egg or sauce, or something.\I have to go now,\so please wash the dishes when you're done.\What?\Don't what me.\And you should get up earlier.\Don't click your tongue at me. response:	I'm off.
context: You could at least jazz it up with some egg or sauce, or something.\I have to go now,\so please wash the dishes when you're done.\What?\Don't what me.\And you should get up earlier.\Don't click your tongue at me.\I'm off. response:	Huh?
context: I have to go now,\so please wash the dishes when you're done.\What?\Don't what me.\And you should get up earlier.\Don't click your tongue at me.\I'm off.\Huh? response:	Hey, do you know what happened to the flowers I left here?
context: so please wash the dishes when you're done.\What?\Don't what me.\And you should get up earlier.\Don't click your tongue at me.\I'm off.\Huh?\Hey, do you know what happened to the flowers I left here? response:	I planted them.
context: What?\Don't what me.\And you should get up earlier.\Don't click your tongue at me.\I'm off.\Huh?\Hey, do you know what happened to the flowers I left here?\I planted them. response:	You planted them?
context: Don't what me.\And you should get up earlier.\Don't click your tongue at me.\I'm off.\Huh?\Hey, do you know what happened to the flowers I left here?\I planted them.\You planted them? response:	In the garden.
context: And you should get up earlier.\Don't click your tongue at me.\I'm off.\Huh?\Hey, do you know what happened to the flowers I left here?\I planted them.\You planted them?\In the garden. response:	Why?
context: Don't click your tongue at me.\I'm off.\Huh?\Hey, do you know what happened to the flowers I left here?\I planted them.\You planted them?\In the garden.\Why? response:	You looked busy.
context: I'm off.\Huh?\Hey, do you know what happened to the flowers I left here?\I planted them.\You planted them?\In the garden.\Why?\You looked busy. response:	I told you I was taking those to school!
context: Huh?\Hey, do you know what happened to the flowers I left here?\I planted them.\You planted them?\In the garden.\Why?\You looked busy.\I told you I was taking those to school! response:	You did? When?
context: Hey, do you know what happened to the flowers I left here?\I planted them.\You planted them?\In the garden.\Why?\You looked busy.\I told you I was taking those to school!\You did? When? response:	I can't believe this!
context: I planted them.\You planted them?\In the garden.\Why?\You looked busy.\I told you I was taking those to school!\You did? When?\I can't believe this! response:	Have a good day.
context: You planted them?\In the garden.\Why?\You looked busy.\I told you I was taking those to school!\You did? When?\I can't believe this!\Have a good day. response:	Bye!
context: In the garden.\Why?\You looked busy.\I told you I was taking those to school!\You did? When?\I can't believe this!\Have a good day.\Bye! response:	Episode 1 Running and Inviting
context: Why?\You looked busy.\I told you I was taking those to school!\You did? When?\I can't believe this!\Have a good day.\Bye!\Episode 1 Running and Inviting response:	Sabure, whoa.
context: You looked busy.\I told you I was taking those to school!\You did? When?\I can't believe this!\Have a good day.\Bye!\Episode 1 Running and Inviting\Sabure, whoa. response:	Miyamoto!
context: I told you I was taking those to school!\You did? When?\I can't believe this!\Have a good day.\Bye!\Episode 1 Running and Inviting\Sabure, whoa.\Miyamoto! response:	Oh, good morning.
context: You did? When?\I can't believe this!\Have a good day.\Bye!\Episode 1 Running and Inviting\Sabure, whoa.\Miyamoto!\Oh, good morning. response:	On your way to practice, too?
context: I can't believe this!\Have a good day.\Bye!\Episode 1 Running and Inviting\Sabure, whoa.\Miyamoto!\Oh, good morning.\On your way to practice, too? response:	Yeah.
context: Have a good day.\Bye!\Episode 1 Running and Inviting\Sabure, whoa.\Miyamoto!\Oh, good morning.\On your way to practice, too?\Yeah. response:	Isn't it kind of sad to play batminton by yourself?
context: Bye!\Episode 1 Running and Inviting\Sabure, whoa.\Miyamoto!\Oh, good morning.\On your way to practice, too?\Yeah.\Isn't it kind of sad to play batminton by yourself? response:	It's bad minton.
context: Episode 1 Running and Inviting\Sabure, whoa.\Miyamoto!\Oh, good morning.\On your way to practice, too?\Yeah.\Isn't it kind of sad to play batminton by yourself?\It's bad minton. response:	Good luck, forever alone!
context: Sabure, whoa.\Miyamoto!\Oh, good morning.\On your way to practice, too?\Yeah.\Isn't it kind of sad to play batminton by yourself?\It's bad minton.\Good luck, forever alone! response:	Shut up.
context: Miyamoto!\Oh, good morning.\On your way to practice, too?\Yeah.\Isn't it kind of sad to play batminton by yourself?\It's bad minton.\Good luck, forever alone!\Shut up. response:	Are you okay with taking the train home?
context: Oh, good morning.\On your way to practice, too?\Yeah.\Isn't it kind of sad to play batminton by yourself?\It's bad minton.\Good luck, forever alone!\Shut up.\Are you okay with taking the train home? response:	Yeah. See you later.
context: On your way to practice, too?\Yeah.\Isn't it kind of sad to play batminton by yourself?\It's bad minton.\Good luck, forever alone!\Shut up.\Are you okay with taking the train home?\Yeah. See you later. response:	Shirohamazaka High School
context: Yeah.\Isn't it kind of sad to play batminton by yourself?\It's bad minton.\Good luck, forever alone!\Shut up.\Are you okay with taking the train home?\Yeah. See you later.\Shirohamazaka High School response:	Thank you so much.
context: Isn't it kind of sad to play batminton by yourself?\It's bad minton.\Good luck, forever alone!\Shut up.\Are you okay with taking the train home?\Yeah. See you later.\Shirohamazaka High School\Thank you so much. response:	Anything for our best customer.
context: It's bad minton.\Good luck, forever alone!\Shut up.\Are you okay with taking the train home?\Yeah. See you later.\Shirohamazaka High School\Thank you so much.\Anything for our best customer. response:	It's Saturday, so I'll be home early.
context: Good luck, forever alone!\Shut up.\Are you okay with taking the train home?\Yeah. See you later.\Shirohamazaka High School\Thank you so much.\Anything for our best customer.\It's Saturday, so I'll be home early. response:	See you in the evening!
context: Shut up.\Are you okay with taking the train home?\Yeah. See you later.\Shirohamazaka High School\Thank you so much.\Anything for our best customer.\It's Saturday, so I'll be home early.\See you in the evening! response:	If you keep eating like that, you'll get fat.
context: Are you okay with taking the train home?\Yeah. See you later.\Shirohamazaka High School\Thank you so much.\Anything for our best customer.\It's Saturday, so I'll be home early.\See you in the evening!\If you keep eating like that, you'll get fat. response:	I'm off, Sabure.
context: Yeah. See you later.\Shirohamazaka High School\Thank you so much.\Anything for our best customer.\It's Saturday, so I'll be home early.\See you in the evening!\If you keep eating like that, you'll get fat.\I'm off, Sabure. response:	Bye!
context: Shirohamazaka High School\Thank you so much.\Anything for our best customer.\It's Saturday, so I'll be home early.\See you in the evening!\If you keep eating like that, you'll get fat.\I'm off, Sabure.\Bye! response:	Running out, headlong
context: Thank you so much.\Anything for our best customer.\It's Saturday, so I'll be home early.\See you in the evening!\If you keep eating like that, you'll get fat.\I'm off, Sabure.\Bye!\Running out, headlong response:	toward a miracle.
context: Anything for our best customer.\It's Saturday, so I'll be home early.\See you in the evening!\If you keep eating like that, you'll get fat.\I'm off, Sabure.\Bye!\Running out, headlong\toward a miracle. response:	Looking up, waving at the light.
context: It's Saturday, so I'll be home early.\See you in the evening!\If you keep eating like that, you'll get fat.\I'm off, Sabure.\Bye!\Running out, headlong\toward a miracle.\Looking up, waving at the light. response:	Connecting our unstoppable feelings.
context: See you in the evening!\If you keep eating like that, you'll get fat.\I'm off, Sabure.\Bye!\Running out, headlong\toward a miracle.\Looking up, waving at the light.\Connecting our unstoppable feelings. response:	Stop there.
context: If you keep eating like that, you'll get fat.\I'm off, Sabure.\Bye!\Running out, headlong\toward a miracle.\Looking up, waving at the light.\Connecting our unstoppable feelings.\Stop there. response:	You all need to listen to the other sections.
context: I'm off, Sabure.\Bye!\Running out, headlong\toward a miracle.\Looking up, waving at the light.\Connecting our unstoppable feelings.\Stop there.\You all need to listen to the other sections. response:	Sopranos, tone it down.
context: Bye!\Running out, headlong\toward a miracle.\Looking up, waving at the light.\Connecting our unstoppable feelings.\Stop there.\You all need to listen to the other sections.\Sopranos, tone it down. response:	Tenors, mezzo-forte.
context: Running out, headlong\toward a miracle.\Looking up, waving at the light.\Connecting our unstoppable feelings.\Stop there.\You all need to listen to the other sections.\Sopranos, tone it down.\Tenors, mezzo-forte. response:	I shouldn't have to keep telling you this.
context: toward a miracle.\Looking up, waving at the light.\Connecting our unstoppable feelings.\Stop there.\You all need to listen to the other sections.\Sopranos, tone it down.\Tenors, mezzo-forte.\I shouldn't have to keep telling you this. response:	There's only a month left until the recital.
context: Looking up, waving at the light.\Connecting our unstoppable feelings.\Stop there.\You all need to listen to the other sections.\Sopranos, tone it down.\Tenors, mezzo-forte.\I shouldn't have to keep telling you this.\There's only a month left until the recital. response:	We'll work on the sections after school.
context: Connecting our unstoppable feelings.\Stop there.\You all need to listen to the other sections.\Sopranos, tone it down.\Tenors, mezzo-forte.\I shouldn't have to keep telling you this.\There's only a month left until the recital.\We'll work on the sections after school. response:	Dismissed.
context: Stop there.\You all need to listen to the other sections.\Sopranos, tone it down.\Tenors, mezzo-forte.\I shouldn't have to keep telling you this.\There's only a month left until the recital.\We'll work on the sections after school.\Dismissed. response:	Miyamoto-san.
context: You all need to listen to the other sections.\Sopranos, tone it down.\Tenors, mezzo-forte.\I shouldn't have to keep telling you this.\There's only a month left until the recital.\We'll work on the sections after school.\Dismissed.\Miyamoto-san. response:	Bow.
context: Sopranos, tone it down.\Tenors, mezzo-forte.\I shouldn't have to keep telling you this.\There's only a month left until the recital.\We'll work on the sections after school.\Dismissed.\Miyamoto-san.\Bow. response:	Thank you very much!
context: Tenors, mezzo-forte.\I shouldn't have to keep telling you this.\There's only a month left until the recital.\We'll work on the sections after school.\Dismissed.\Miyamoto-san.\Bow.\Thank you very much! response:	You want to sing, don't you?
context: I shouldn't have to keep telling you this.\There's only a month left until the recital.\We'll work on the sections after school.\Dismissed.\Miyamoto-san.\Bow.\Thank you very much!\You want to sing, don't you? response:	Huh?
context: There's only a month left until the recital.\We'll work on the sections after school.\Dismissed.\Miyamoto-san.\Bow.\Thank you very much!\You want to sing, don't you?\Huh? response:	I have the song memorized,
context: We'll work on the sections after school.\Dismissed.\Miyamoto-san.\Bow.\Thank you very much!\You want to sing, don't you?\Huh?\I have the song memorized, response:	so you don't need to turn the pages for me anymore.
context: Dismissed.\Miyamoto-san.\Bow.\Thank you very much!\You want to sing, don't you?\Huh?\I have the song memorized,\so you don't need to turn the pages for me anymore. response:	Oh?
context: Miyamoto-san.\Bow.\Thank you very much!\You want to sing, don't you?\Huh?\I have the song memorized,\so you don't need to turn the pages for me anymore.\Oh? response:	This is our last performance this year,
context: Bow.\Thank you very much!\You want to sing, don't you?\Huh?\I have the song memorized,\so you don't need to turn the pages for me anymore.\Oh?\This is our last performance this year, response:	so why don't you talk to the vice principal?
context: Thank you very much!\You want to sing, don't you?\Huh?\I have the song memorized,\so you don't need to turn the pages for me anymore.\Oh?\This is our last performance this year,\so why don't you talk to the vice principal? response:	Great idea! I will!
context: You want to sing, don't you?\Huh?\I have the song memorized,\so you don't need to turn the pages for me anymore.\Oh?\This is our last performance this year,\so why don't you talk to the vice principal?\Great idea! I will! response:	Good morning, Sakai-san!
context: Huh?\I have the song memorized,\so you don't need to turn the pages for me anymore.\Oh?\This is our last performance this year,\so why don't you talk to the vice principal?\Great idea! I will!\Good morning, Sakai-san! response:	Morning.
context: I have the song memorized,\so you don't need to turn the pages for me anymore.\Oh?\This is our last performance this year,\so why don't you talk to the vice principal?\Great idea! I will!\Good morning, Sakai-san!\Morning. response:	Oh wow, your plant is really cute!
context: so you don't need to turn the pages for me anymore.\Oh?\This is our last performance this year,\so why don't you talk to the vice principal?\Great idea! I will!\Good morning, Sakai-san!\Morning.\Oh wow, your plant is really cute! response:	Are those fresh flowers?
context: Oh?\This is our last performance this year,\so why don't you talk to the vice principal?\Great idea! I will!\Good morning, Sakai-san!\Morning.\Oh wow, your plant is really cute!\Are those fresh flowers? response:	Yeah.
context: This is our last performance this year,\so why don't you talk to the vice principal?\Great idea! I will!\Good morning, Sakai-san!\Morning.\Oh wow, your plant is really cute!\Are those fresh flowers?\Yeah. response:	I snipped some hydrangeas from home.
context: so why don't you talk to the vice principal?\Great idea! I will!\Good morning, Sakai-san!\Morning.\Oh wow, your plant is really cute!\Are those fresh flowers?\Yeah.\I snipped some hydrangeas from home. response:	Home?
context: Great idea! I will!\Good morning, Sakai-san!\Morning.\Oh wow, your plant is really cute!\Are those fresh flowers?\Yeah.\I snipped some hydrangeas from home.\Home? response:	Morning!
context: Good morning, Sakai-san!\Morning.\Oh wow, your plant is really cute!\Are those fresh flowers?\Yeah.\I snipped some hydrangeas from home.\Home?\Morning! response:	Hey!
context: Morning.\Oh wow, your plant is really cute!\Are those fresh flowers?\Yeah.\I snipped some hydrangeas from home.\Home?\Morning!\Hey! response:	Good timing, Konatsu. Help me wrap these.
context: Oh wow, your plant is really cute!\Are those fresh flowers?\Yeah.\I snipped some hydrangeas from home.\Home?\Morning!\Hey!\Good timing, Konatsu. Help me wrap these. response:	Hurry, before Miss Takahashi shows up!
context: Are those fresh flowers?\Yeah.\I snipped some hydrangeas from home.\Home?\Morning!\Hey!\Good timing, Konatsu. Help me wrap these.\Hurry, before Miss Takahashi shows up! response:	You should have done that at home.
context: Yeah.\I snipped some hydrangeas from home.\Home?\Morning!\Hey!\Good timing, Konatsu. Help me wrap these.\Hurry, before Miss Takahashi shows up!\You should have done that at home. response:	Sawa, I need your help over here, too!
context: I snipped some hydrangeas from home.\Home?\Morning!\Hey!\Good timing, Konatsu. Help me wrap these.\Hurry, before Miss Takahashi shows up!\You should have done that at home.\Sawa, I need your help over here, too! response:	Sure, one second.
context: Home?\Morning!\Hey!\Good timing, Konatsu. Help me wrap these.\Hurry, before Miss Takahashi shows up!\You should have done that at home.\Sawa, I need your help over here, too!\Sure, one second. response:	Konatsu, can I see your math printout?
context: Morning!\Hey!\Good timing, Konatsu. Help me wrap these.\Hurry, before Miss Takahashi shows up!\You should have done that at home.\Sawa, I need your help over here, too!\Sure, one second.\Konatsu, can I see your math printout? response:	Ta-da!
context: Hey!\Good timing, Konatsu. Help me wrap these.\Hurry, before Miss Takahashi shows up!\You should have done that at home.\Sawa, I need your help over here, too!\Sure, one second.\Konatsu, can I see your math printout?\Ta-da! response:	You guys are my slaves today.
context: Good timing, Konatsu. Help me wrap these.\Hurry, before Miss Takahashi shows up!\You should have done that at home.\Sawa, I need your help over here, too!\Sure, one second.\Konatsu, can I see your math printout?\Ta-da!\You guys are my slaves today. response:	Where in Austria did you live?
context: Hurry, before Miss Takahashi shows up!\You should have done that at home.\Sawa, I need your help over here, too!\Sure, one second.\Konatsu, can I see your math printout?\Ta-da!\You guys are my slaves today.\Where in Austria did you live? response:	In Wien.
context: You should have done that at home.\Sawa, I need your help over here, too!\Sure, one second.\Konatsu, can I see your math printout?\Ta-da!\You guys are my slaves today.\Where in Austria did you live?\In Wien. response:	Wien? Oh, you mean Vienna.
context: Sawa, I need your help over here, too!\Sure, one second.\Konatsu, can I see your math printout?\Ta-da!\You guys are my slaves today.\Where in Austria did you live?\In Wien.\Wien? Oh, you mean Vienna. response:	I'm sorry I wasn't able to get a uniform on time.
context: Sure, one second.\Konatsu, can I see your math printout?\Ta-da!\You guys are my slaves today.\Where in Austria did you live?\In Wien.\Wien? Oh, you mean Vienna.\I'm sorry I wasn't able to get a uniform on time. response:	Don't worry about it.
context: Konatsu, can I see your math printout?\Ta-da!\You guys are my slaves today.\Where in Austria did you live?\In Wien.\Wien? Oh, you mean Vienna.\I'm sorry I wasn't able to get a uniform on time.\Don't worry about it. response:	It must be very hard to move back here
context: Ta-da!\You guys are my slaves today.\Where in Austria did you live?\In Wien.\Wien? Oh, you mean Vienna.\I'm sorry I wasn't able to get a uniform on time.\Don't worry about it.\It must be very hard to move back here response:	in your third year of high school.
context: You guys are my slaves today.\Where in Austria did you live?\In Wien.\Wien? Oh, you mean Vienna.\I'm sorry I wasn't able to get a uniform on time.\Don't worry about it.\It must be very hard to move back here\in your third year of high school. response:	I'll have someone show you around after school.
context: Where in Austria did you live?\In Wien.\Wien? Oh, you mean Vienna.\I'm sorry I wasn't able to get a uniform on time.\Don't worry about it.\It must be very hard to move back here\in your third year of high school.\I'll have someone show you around after school. response:	Thank you very much.
context: In Wien.\Wien? Oh, you mean Vienna.\I'm sorry I wasn't able to get a uniform on time.\Don't worry about it.\It must be very hard to move back here\in your third year of high school.\I'll have someone show you around after school.\Thank you very much. response:	Tanaka! Late again?
context: Wien? Oh, you mean Vienna.\I'm sorry I wasn't able to get a uniform on time.\Don't worry about it.\It must be very hard to move back here\in your third year of high school.\I'll have someone show you around after school.\Thank you very much.\Tanaka! Late again? response:	Wait right here. I'll call you in shortly.
context: I'm sorry I wasn't able to get a uniform on time.\Don't worry about it.\It must be very hard to move back here\in your third year of high school.\I'll have someone show you around after school.\Thank you very much.\Tanaka! Late again?\Wait right here. I'll call you in shortly. response:	Okay.
context: Don't worry about it.\It must be very hard to move back here\in your third year of high school.\I'll have someone show you around after school.\Thank you very much.\Tanaka! Late again?\Wait right here. I'll call you in shortly.\Okay. response:	All right, class, take your seats.
context: It must be very hard to move back here\in your third year of high school.\I'll have someone show you around after school.\Thank you very much.\Tanaka! Late again?\Wait right here. I'll call you in shortly.\Okay.\All right, class, take your seats. response:	Today, we'll
context: in your third year of high school.\I'll have someone show you around after school.\Thank you very much.\Tanaka! Late again?\Wait right here. I'll call you in shortly.\Okay.\All right, class, take your seats.\Today, we'll response:	Present bouquets!
context: I'll have someone show you around after school.\Thank you very much.\Tanaka! Late again?\Wait right here. I'll call you in shortly.\Okay.\All right, class, take your seats.\Today, we'll\Present bouquets! response:	Miss Takai Thank You So Much! Have a Healthy Baby! Boy or Girl?
context: Thank you very much.\Tanaka! Late again?\Wait right here. I'll call you in shortly.\Okay.\All right, class, take your seats.\Today, we'll\Present bouquets!\Miss Takai Thank You So Much! Have a Healthy Baby! Boy or Girl? response:	Thank you! Congratulations!
context: Tanaka! Late again?\Wait right here. I'll call you in shortly.\Okay.\All right, class, take your seats.\Today, we'll\Present bouquets!\Miss Takai Thank You So Much! Have a Healthy Baby! Boy or Girl?\Thank you! Congratulations! response:	It's just maternity leave,
context: Wait right here. I'll call you in shortly.\Okay.\All right, class, take your seats.\Today, we'll\Present bouquets!\Miss Takai Thank You So Much! Have a Healthy Baby! Boy or Girl?\Thank you! Congratulations!\It's just maternity leave, response:	but if I'm not back by graduation, I'm sorry.
context: Okay.\All right, class, take your seats.\Today, we'll\Present bouquets!\Miss Takai Thank You So Much! Have a Healthy Baby! Boy or Girl?\Thank you! Congratulations!\It's just maternity leave,\but if I'm not back by graduation, I'm sorry. response:	Could we do our graduation ceremony right now?
context: All right, class, take your seats.\Today, we'll\Present bouquets!\Miss Takai Thank You So Much! Have a Healthy Baby! Boy or Girl?\Thank you! Congratulations!\It's just maternity leave,\but if I'm not back by graduation, I'm sorry.\Could we do our graduation ceremony right now? response:	Hey.
context: Today, we'll\Present bouquets!\Miss Takai Thank You So Much! Have a Healthy Baby! Boy or Girl?\Thank you! Congratulations!\It's just maternity leave,\but if I'm not back by graduation, I'm sorry.\Could we do our graduation ceremony right now?\Hey. response:	What, you wanna sing Pomp and Circumstance with everyone?
context: Present bouquets!\Miss Takai Thank You So Much! Have a Healthy Baby! Boy or Girl?\Thank you! Congratulations!\It's just maternity leave,\but if I'm not back by graduation, I'm sorry.\Could we do our graduation ceremony right now?\Hey.\What, you wanna sing Pomp and Circumstance with everyone? response:	Sakai-san, would you sing it?
context: Miss Takai Thank You So Much! Have a Healthy Baby! Boy or Girl?\Thank you! Congratulations!\It's just maternity leave,\but if I'm not back by graduation, I'm sorry.\Could we do our graduation ceremony right now?\Hey.\What, you wanna sing Pomp and Circumstance with everyone?\Sakai-san, would you sing it? response:	Yeah, could you?
context: Thank you! Congratulations!\It's just maternity leave,\but if I'm not back by graduation, I'm sorry.\Could we do our graduation ceremony right now?\Hey.\What, you wanna sing Pomp and Circumstance with everyone?\Sakai-san, would you sing it?\Yeah, could you? response:	You've been studying music, right?
context: It's just maternity leave,\but if I'm not back by graduation, I'm sorry.\Could we do our graduation ceremony right now?\Hey.\What, you wanna sing Pomp and Circumstance with everyone?\Sakai-san, would you sing it?\Yeah, could you?\You've been studying music, right? response:	I want to hear you sing!
context: but if I'm not back by graduation, I'm sorry.\Could we do our graduation ceremony right now?\Hey.\What, you wanna sing Pomp and Circumstance with everyone?\Sakai-san, would you sing it?\Yeah, could you?\You've been studying music, right?\I want to hear you sing! response:	All right, all right.
context: Could we do our graduation ceremony right now?\Hey.\What, you wanna sing Pomp and Circumstance with everyone?\Sakai-san, would you sing it?\Yeah, could you?\You've been studying music, right?\I want to hear you sing!\All right, all right. response:	You all know who I want to hear last today.
context: Hey.\What, you wanna sing Pomp and Circumstance with everyone?\Sakai-san, would you sing it?\Yeah, could you?\You've been studying music, right?\I want to hear you sing!\All right, all right.\You all know who I want to hear last today. response:	Our repeat offender.
context: What, you wanna sing Pomp and Circumstance with everyone?\Sakai-san, would you sing it?\Yeah, could you?\You've been studying music, right?\I want to hear you sing!\All right, all right.\You all know who I want to hear last today.\Our repeat offender. response:	Tanaka Taichi!
context: Sakai-san, would you sing it?\Yeah, could you?\You've been studying music, right?\I want to hear you sing!\All right, all right.\You all know who I want to hear last today.\Our repeat offender.\Tanaka Taichi! response:	Huh?
context: Yeah, could you?\You've been studying music, right?\I want to hear you sing!\All right, all right.\You all know who I want to hear last today.\Our repeat offender.\Tanaka Taichi!\Huh? response:	I come early every morning for practice! I wasn't late today, either!
context: You've been studying music, right?\I want to hear you sing!\All right, all right.\You all know who I want to hear last today.\Our repeat offender.\Tanaka Taichi!\Huh?\I come early every morning for practice! I wasn't late today, either! response:	Excuses, excuses.
context: I want to hear you sing!\All right, all right.\You all know who I want to hear last today.\Our repeat offender.\Tanaka Taichi!\Huh?\I come early every morning for practice! I wasn't late today, either!\Excuses, excuses. response:	Oh, men.
context: All right, all right.\You all know who I want to hear last today.\Our repeat offender.\Tanaka Taichi!\Huh?\I come early every morning for practice! I wasn't late today, either!\Excuses, excuses.\Oh, men. response:	Fine, then I'll sing.
context: You all know who I want to hear last today.\Our repeat offender.\Tanaka Taichi!\Huh?\I come early every morning for practice! I wasn't late today, either!\Excuses, excuses.\Oh, men.\Fine, then I'll sing. response:	I will now perform Shirahamazaka High's school song.
context: Our repeat offender.\Tanaka Taichi!\Huh?\I come early every morning for practice! I wasn't late today, either!\Excuses, excuses.\Oh, men.\Fine, then I'll sing.\I will now perform Shirahamazaka High's school song. response:	I want to hear the voice of the white beach,
context: Tanaka Taichi!\Huh?\I come early every morning for practice! I wasn't late today, either!\Excuses, excuses.\Oh, men.\Fine, then I'll sing.\I will now perform Shirahamazaka High's school song.\I want to hear the voice of the white beach, response:	so let's climb that winding slope.
context: Huh?\I come early every morning for practice! I wasn't late today, either!\Excuses, excuses.\Oh, men.\Fine, then I'll sing.\I will now perform Shirahamazaka High's school song.\I want to hear the voice of the white beach,\so let's climb that winding slope. response:	Oh, no!
context: I come early every morning for practice! I wasn't late today, either!\Excuses, excuses.\Oh, men.\Fine, then I'll sing.\I will now perform Shirahamazaka High's school song.\I want to hear the voice of the white beach,\so let's climb that winding slope.\Oh, no! response:	My dear friends...
context: Excuses, excuses.\Oh, men.\Fine, then I'll sing.\I will now perform Shirahamazaka High's school song.\I want to hear the voice of the white beach,\so let's climb that winding slope.\Oh, no!\My dear friends... response:	I'm so sorry!
context: Oh, men.\Fine, then I'll sing.\I will now perform Shirahamazaka High's school song.\I want to hear the voice of the white beach,\so let's climb that winding slope.\Oh, no!\My dear friends...\I'm so sorry! response:	I've been away from Japan for twelve years,
context: Fine, then I'll sing.\I will now perform Shirahamazaka High's school song.\I want to hear the voice of the white beach,\so let's climb that winding slope.\Oh, no!\My dear friends...\I'm so sorry!\I've been away from Japan for twelve years, response:	but I'll try my best to get used to everything quickly.
context: I will now perform Shirahamazaka High's school song.\I want to hear the voice of the white beach,\so let's climb that winding slope.\Oh, no!\My dear friends...\I'm so sorry!\I've been away from Japan for twelve years,\but I'll try my best to get used to everything quickly. response:	Right now, as my only friends are books,
context: I want to hear the voice of the white beach,\so let's climb that winding slope.\Oh, no!\My dear friends...\I'm so sorry!\I've been away from Japan for twelve years,\but I'll try my best to get used to everything quickly.\Right now, as my only friends are books, response:	I beseech you to bless me with your favor.
context: so let's climb that winding slope.\Oh, no!\My dear friends...\I'm so sorry!\I've been away from Japan for twelve years,\but I'll try my best to get used to everything quickly.\Right now, as my only friends are books,\I beseech you to bless me with your favor. response:	Kneeling?
context: Oh, no!\My dear friends...\I'm so sorry!\I've been away from Japan for twelve years,\but I'll try my best to get used to everything quickly.\Right now, as my only friends are books,\I beseech you to bless me with your favor.\Kneeling? response:	It is now noon.
context: My dear friends...\I'm so sorry!\I've been away from Japan for twelve years,\but I'll try my best to get used to everything quickly.\Right now, as my only friends are books,\I beseech you to bless me with your favor.\Kneeling?\It is now noon. response:	Tanaka, please show him around.
context: I'm so sorry!\I've been away from Japan for twelve years,\but I'll try my best to get used to everything quickly.\Right now, as my only friends are books,\I beseech you to bless me with your favor.\Kneeling?\It is now noon.\Tanaka, please show him around. response:	Okay. Let's go.
context: I've been away from Japan for twelve years,\but I'll try my best to get used to everything quickly.\Right now, as my only friends are books,\I beseech you to bless me with your favor.\Kneeling?\It is now noon.\Tanaka, please show him around.\Okay. Let's go. response:	Thank you.
context: but I'll try my best to get used to everything quickly.\Right now, as my only friends are books,\I beseech you to bless me with your favor.\Kneeling?\It is now noon.\Tanaka, please show him around.\Okay. Let's go.\Thank you. response:	Sakai, can you help me carry these?
context: Right now, as my only friends are books,\I beseech you to bless me with your favor.\Kneeling?\It is now noon.\Tanaka, please show him around.\Okay. Let's go.\Thank you.\Sakai, can you help me carry these? response:	Sure.
context: I beseech you to bless me with your favor.\Kneeling?\It is now noon.\Tanaka, please show him around.\Okay. Let's go.\Thank you.\Sakai, can you help me carry these?\Sure. response:	Have you gotten used to the general curriculum?
context: Kneeling?\It is now noon.\Tanaka, please show him around.\Okay. Let's go.\Thank you.\Sakai, can you help me carry these?\Sure.\Have you gotten used to the general curriculum? response:	Yes.
context: It is now noon.\Tanaka, please show him around.\Okay. Let's go.\Thank you.\Sakai, can you help me carry these?\Sure.\Have you gotten used to the general curriculum?\Yes. response:	And you've made some friends?
context: Tanaka, please show him around.\Okay. Let's go.\Thank you.\Sakai, can you help me carry these?\Sure.\Have you gotten used to the general curriculum?\Yes.\And you've made some friends? response:	I guess.
context: Okay. Let's go.\Thank you.\Sakai, can you help me carry these?\Sure.\Have you gotten used to the general curriculum?\Yes.\And you've made some friends?\I guess. response:	Do you have a boyfriend?
context: Thank you.\Sakai, can you help me carry these?\Sure.\Have you gotten used to the general curriculum?\Yes.\And you've made some friends?\I guess.\Do you have a boyfriend? response:	Can you please drop this?
context: Sakai, can you help me carry these?\Sure.\Have you gotten used to the general curriculum?\Yes.\And you've made some friends?\I guess.\Do you have a boyfriend?\Can you please drop this? response:	If you hold out a little longer, I'll set you up with my kid.
context: Sure.\Have you gotten used to the general curriculum?\Yes.\And you've made some friends?\I guess.\Do you have a boyfriend?\Can you please drop this?\If you hold out a little longer, I'll set you up with my kid. response:	You're having a boy?
context: Have you gotten used to the general curriculum?\Yes.\And you've made some friends?\I guess.\Do you have a boyfriend?\Can you please drop this?\If you hold out a little longer, I'll set you up with my kid.\You're having a boy? response:	Does it have to be a boy?
context: Yes.\And you've made some friends?\I guess.\Do you have a boyfriend?\Can you please drop this?\If you hold out a little longer, I'll set you up with my kid.\You're having a boy?\Does it have to be a boy? response:	Of course.
context: And you've made some friends?\I guess.\Do you have a boyfriend?\Can you please drop this?\If you hold out a little longer, I'll set you up with my kid.\You're having a boy?\Does it have to be a boy?\Of course. response:	Hang on.
context: I guess.\Do you have a boyfriend?\Can you please drop this?\If you hold out a little longer, I'll set you up with my kid.\You're having a boy?\Does it have to be a boy?\Of course.\Hang on. response:	I'm going to grab my car keys.
context: Do you have a boyfriend?\Can you please drop this?\If you hold out a little longer, I'll set you up with my kid.\You're having a boy?\Does it have to be a boy?\Of course.\Hang on.\I'm going to grab my car keys. response:	You came all the way here to talk about this?
context: Can you please drop this?\If you hold out a little longer, I'll set you up with my kid.\You're having a boy?\Does it have to be a boy?\Of course.\Hang on.\I'm going to grab my car keys.\You came all the way here to talk about this? response:	Well...
context: If you hold out a little longer, I'll set you up with my kid.\You're having a boy?\Does it have to be a boy?\Of course.\Hang on.\I'm going to grab my car keys.\You came all the way here to talk about this?\Well... response:	I'm well aware Ueno-san has the music memorized.
context: You're having a boy?\Does it have to be a boy?\Of course.\Hang on.\I'm going to grab my car keys.\You came all the way here to talk about this?\Well...\I'm well aware Ueno-san has the music memorized. response:	Her focus is piano, after all.
context: Does it have to be a boy?\Of course.\Hang on.\I'm going to grab my car keys.\You came all the way here to talk about this?\Well...\I'm well aware Ueno-san has the music memorized.\Her focus is piano, after all. response:	Then why do I need to turn the pages for her?
context: Of course.\Hang on.\I'm going to grab my car keys.\You came all the way here to talk about this?\Well...\I'm well aware Ueno-san has the music memorized.\Her focus is piano, after all.\Then why do I need to turn the pages for her? response:	Music is not a game.
context: Hang on.\I'm going to grab my car keys.\You came all the way here to talk about this?\Well...\I'm well aware Ueno-san has the music memorized.\Her focus is piano, after all.\Then why do I need to turn the pages for her?\Music is not a game. response:	This joint recital is an event with a rich tradition,
context: I'm going to grab my car keys.\You came all the way here to talk about this?\Well...\I'm well aware Ueno-san has the music memorized.\Her focus is piano, after all.\Then why do I need to turn the pages for her?\Music is not a game.\This joint recital is an event with a rich tradition, response:	featuring not only the high schools of this district,
context: You came all the way here to talk about this?\Well...\I'm well aware Ueno-san has the music memorized.\Her focus is piano, after all.\Then why do I need to turn the pages for her?\Music is not a game.\This joint recital is an event with a rich tradition,\featuring not only the high schools of this district, response:	but professional performers are invited, as well.
context: Well...\I'm well aware Ueno-san has the music memorized.\Her focus is piano, after all.\Then why do I need to turn the pages for her?\Music is not a game.\This joint recital is an event with a rich tradition,\featuring not only the high schools of this district,\but professional performers are invited, as well. response:	35th Joint Recital
context: I'm well aware Ueno-san has the music memorized.\Her focus is piano, after all.\Then why do I need to turn the pages for her?\Music is not a game.\This joint recital is an event with a rich tradition,\featuring not only the high schools of this district,\but professional performers are invited, as well.\35th Joint Recital response:	Professors from music colleges will also be coming to listen.
context: Her focus is piano, after all.\Then why do I need to turn the pages for her?\Music is not a game.\This joint recital is an event with a rich tradition,\featuring not only the high schools of this district,\but professional performers are invited, as well.\35th Joint Recital\Professors from music colleges will also be coming to listen. response:	For music students, this is a priceless opportunity.
context: Then why do I need to turn the pages for her?\Music is not a game.\This joint recital is an event with a rich tradition,\featuring not only the high schools of this district,\but professional performers are invited, as well.\35th Joint Recital\Professors from music colleges will also be coming to listen.\For music students, this is a priceless opportunity. response:	Remind me, what did you do at this function last year?
context: Music is not a game.\This joint recital is an event with a rich tradition,\featuring not only the high schools of this district,\but professional performers are invited, as well.\35th Joint Recital\Professors from music colleges will also be coming to listen.\For music students, this is a priceless opportunity.\Remind me, what did you do at this function last year? response:	But that's why I've been...
context: This joint recital is an event with a rich tradition,\featuring not only the high schools of this district,\but professional performers are invited, as well.\35th Joint Recital\Professors from music colleges will also be coming to listen.\For music students, this is a priceless opportunity.\Remind me, what did you do at this function last year?\But that's why I've been... response:	Anybody can love music.
context: featuring not only the high schools of this district,\but professional performers are invited, as well.\35th Joint Recital\Professors from music colleges will also be coming to listen.\For music students, this is a priceless opportunity.\Remind me, what did you do at this function last year?\But that's why I've been...\Anybody can love music. response:	For music to love you, however, is another story entirely.
context: but professional performers are invited, as well.\35th Joint Recital\Professors from music colleges will also be coming to listen.\For music students, this is a priceless opportunity.\Remind me, what did you do at this function last year?\But that's why I've been...\Anybody can love music.\For music to love you, however, is another story entirely. response:	It takes a special something to move people's hearts,
context: 35th Joint Recital\Professors from music colleges will also be coming to listen.\For music students, this is a priceless opportunity.\Remind me, what did you do at this function last year?\But that's why I've been...\Anybody can love music.\For music to love you, however, is another story entirely.\It takes a special something to move people's hearts, response:	and you don't have it.
context: Professors from music colleges will also be coming to listen.\For music students, this is a priceless opportunity.\Remind me, what did you do at this function last year?\But that's why I've been...\Anybody can love music.\For music to love you, however, is another story entirely.\It takes a special something to move people's hearts,\and you don't have it. response:	Abandon your aspirations to sing on stage.
context: For music students, this is a priceless opportunity.\Remind me, what did you do at this function last year?\But that's why I've been...\Anybody can love music.\For music to love you, however, is another story entirely.\It takes a special something to move people's hearts,\and you don't have it.\Abandon your aspirations to sing on stage. response:	Once the recital is over
context: Remind me, what did you do at this function last year?\But that's why I've been...\Anybody can love music.\For music to love you, however, is another story entirely.\It takes a special something to move people's hearts,\and you don't have it.\Abandon your aspirations to sing on stage.\Once the recital is over response:	Then I quit.
context: But that's why I've been...\Anybody can love music.\For music to love you, however, is another story entirely.\It takes a special something to move people's hearts,\and you don't have it.\Abandon your aspirations to sing on stage.\Once the recital is over\Then I quit. response:	Excuse me?
context: Anybody can love music.\For music to love you, however, is another story entirely.\It takes a special something to move people's hearts,\and you don't have it.\Abandon your aspirations to sing on stage.\Once the recital is over\Then I quit.\Excuse me? response:	I quit!
context: For music to love you, however, is another story entirely.\It takes a special something to move people's hearts,\and you don't have it.\Abandon your aspirations to sing on stage.\Once the recital is over\Then I quit.\Excuse me?\I quit! response:	Miyamoto-san.
context: It takes a special something to move people's hearts,\and you don't have it.\Abandon your aspirations to sing on stage.\Once the recital is over\Then I quit.\Excuse me?\I quit!\Miyamoto-san. response:	If you're serious, submit a formal request.
context: and you don't have it.\Abandon your aspirations to sing on stage.\Once the recital is over\Then I quit.\Excuse me?\I quit!\Miyamoto-san.\If you're serious, submit a formal request. response:	What gives you the right to act like you know me?!
context: Abandon your aspirations to sing on stage.\Once the recital is over\Then I quit.\Excuse me?\I quit!\Miyamoto-san.\If you're serious, submit a formal request.\What gives you the right to act like you know me?! response:	Nobody knows if they can sing, until they try!
context: Once the recital is over\Then I quit.\Excuse me?\I quit!\Miyamoto-san.\If you're serious, submit a formal request.\What gives you the right to act like you know me?!\Nobody knows if they can sing, until they try! response:	Don't underestimate me just because I'm a general
context: Then I quit.\Excuse me?\I quit!\Miyamoto-san.\If you're serious, submit a formal request.\What gives you the right to act like you know me?!\Nobody knows if they can sing, until they try!\Don't underestimate me just because I'm a general response:	Blergh! You cow!
context: Excuse me?\I quit!\Miyamoto-san.\If you're serious, submit a formal request.\What gives you the right to act like you know me?!\Nobody knows if they can sing, until they try!\Don't underestimate me just because I'm a general\Blergh! You cow! response:	What are you doing?
context: I quit!\Miyamoto-san.\If you're serious, submit a formal request.\What gives you the right to act like you know me?!\Nobody knows if they can sing, until they try!\Don't underestimate me just because I'm a general\Blergh! You cow!\What are you doing? response:	That's it. Thank you.
context: Miyamoto-san.\If you're serious, submit a formal request.\What gives you the right to act like you know me?!\Nobody knows if they can sing, until they try!\Don't underestimate me just because I'm a general\Blergh! You cow!\What are you doing?\That's it. Thank you. response:	That reminds me.
context: If you're serious, submit a formal request.\What gives you the right to act like you know me?!\Nobody knows if they can sing, until they try!\Don't underestimate me just because I'm a general\Blergh! You cow!\What are you doing?\That's it. Thank you.\That reminds me. response:	Do you have your phone on you?
context: What gives you the right to act like you know me?!\Nobody knows if they can sing, until they try!\Don't underestimate me just because I'm a general\Blergh! You cow!\What are you doing?\That's it. Thank you.\That reminds me.\Do you have your phone on you? response:	Huh?
context: Nobody knows if they can sing, until they try!\Don't underestimate me just because I'm a general\Blergh! You cow!\What are you doing?\That's it. Thank you.\That reminds me.\Do you have your phone on you?\Huh? response:	That's my address.
context: Don't underestimate me just because I'm a general\Blergh! You cow!\What are you doing?\That's it. Thank you.\That reminds me.\Do you have your phone on you?\Huh?\That's my address. response:	Contact me if anything comes up.
context: Blergh! You cow!\What are you doing?\That's it. Thank you.\That reminds me.\Do you have your phone on you?\Huh?\That's my address.\Contact me if anything comes up. response:	Like what?
context: What are you doing?\That's it. Thank you.\That reminds me.\Do you have your phone on you?\Huh?\That's my address.\Contact me if anything comes up.\Like what? response:	Like if you find a boyfriend.
context: That's it. Thank you.\That reminds me.\Do you have your phone on you?\Huh?\That's my address.\Contact me if anything comes up.\Like what?\Like if you find a boyfriend. response:	And come see the baby once it's born.
context: That reminds me.\Do you have your phone on you?\Huh?\That's my address.\Contact me if anything comes up.\Like what?\Like if you find a boyfriend.\And come see the baby once it's born. response:	Sorry, but I want to eat before I go to club.
context: Do you have your phone on you?\Huh?\That's my address.\Contact me if anything comes up.\Like what?\Like if you find a boyfriend.\And come see the baby once it's born.\Sorry, but I want to eat before I go to club. response:	What club?
context: Huh?\That's my address.\Contact me if anything comes up.\Like what?\Like if you find a boyfriend.\And come see the baby once it's born.\Sorry, but I want to eat before I go to club.\What club? response:	Badminton.
context: That's my address.\Contact me if anything comes up.\Like what?\Like if you find a boyfriend.\And come see the baby once it's born.\Sorry, but I want to eat before I go to club.\What club?\Badminton. response:	I'm the only member right now,
context: Contact me if anything comes up.\Like what?\Like if you find a boyfriend.\And come see the baby once it's born.\Sorry, but I want to eat before I go to club.\What club?\Badminton.\I'm the only member right now, response:	but today I get to practice with
context: Like what?\Like if you find a boyfriend.\And come see the baby once it's born.\Sorry, but I want to eat before I go to club.\What club?\Badminton.\I'm the only member right now,\but today I get to practice with response:	my sister at her university.
context: Like if you find a boyfriend.\And come see the baby once it's born.\Sorry, but I want to eat before I go to club.\What club?\Badminton.\I'm the only member right now,\but today I get to practice with\my sister at her university. response:	Sister is for a girl?
context: And come see the baby once it's born.\Sorry, but I want to eat before I go to club.\What club?\Badminton.\I'm the only member right now,\but today I get to practice with\my sister at her university.\Sister is for a girl? response:	What was the word for a male sibling?
context: Sorry, but I want to eat before I go to club.\What club?\Badminton.\I'm the only member right now,\but today I get to practice with\my sister at her university.\Sister is for a girl?\What was the word for a male sibling? response:	Brother.
context: What club?\Badminton.\I'm the only member right now,\but today I get to practice with\my sister at her university.\Sister is for a girl?\What was the word for a male sibling?\Brother. response:	Oh yeah.
context: Badminton.\I'm the only member right now,\but today I get to practice with\my sister at her university.\Sister is for a girl?\What was the word for a male sibling?\Brother.\Oh yeah. response:	I tried brushing up through books,
context: I'm the only member right now,\but today I get to practice with\my sister at her university.\Sister is for a girl?\What was the word for a male sibling?\Brother.\Oh yeah.\I tried brushing up through books, response:	but I've still got a lot to learn.
context: but today I get to practice with\my sister at her university.\Sister is for a girl?\What was the word for a male sibling?\Brother.\Oh yeah.\I tried brushing up through books,\but I've still got a lot to learn. response:	Do those books explain how to eat ramen, as well?
context: my sister at her university.\Sister is for a girl?\What was the word for a male sibling?\Brother.\Oh yeah.\I tried brushing up through books,\but I've still got a lot to learn.\Do those books explain how to eat ramen, as well? response:	Of course!
context: Sister is for a girl?\What was the word for a male sibling?\Brother.\Oh yeah.\I tried brushing up through books,\but I've still got a lot to learn.\Do those books explain how to eat ramen, as well?\Of course! response:	You can't be serious!
context: What was the word for a male sibling?\Brother.\Oh yeah.\I tried brushing up through books,\but I've still got a lot to learn.\Do those books explain how to eat ramen, as well?\Of course!\You can't be serious! response:	You shouldn't have to quit!
context: Brother.\Oh yeah.\I tried brushing up through books,\but I've still got a lot to learn.\Do those books explain how to eat ramen, as well?\Of course!\You can't be serious!\You shouldn't have to quit! response:	She's doesn't understand anything!
context: Oh yeah.\I tried brushing up through books,\but I've still got a lot to learn.\Do those books explain how to eat ramen, as well?\Of course!\You can't be serious!\You shouldn't have to quit!\She's doesn't understand anything! response:	I'm going to go have a talk with her.
context: I tried brushing up through books,\but I've still got a lot to learn.\Do those books explain how to eat ramen, as well?\Of course!\You can't be serious!\You shouldn't have to quit!\She's doesn't understand anything!\I'm going to go have a talk with her. response:	W-Wait, Sawa!
context: but I've still got a lot to learn.\Do those books explain how to eat ramen, as well?\Of course!\You can't be serious!\You shouldn't have to quit!\She's doesn't understand anything!\I'm going to go have a talk with her.\W-Wait, Sawa! response:	Wait! Stop! I said, stop!
context: Do those books explain how to eat ramen, as well?\Of course!\You can't be serious!\You shouldn't have to quit!\She's doesn't understand anything!\I'm going to go have a talk with her.\W-Wait, Sawa!\Wait! Stop! I said, stop! response:	It's just, I'm already a senior...
context: Of course!\You can't be serious!\You shouldn't have to quit!\She's doesn't understand anything!\I'm going to go have a talk with her.\W-Wait, Sawa!\Wait! Stop! I said, stop!\It's just, I'm already a senior... response:	Singing might be the most important thing in my life right now,
context: You can't be serious!\You shouldn't have to quit!\She's doesn't understand anything!\I'm going to go have a talk with her.\W-Wait, Sawa!\Wait! Stop! I said, stop!\It's just, I'm already a senior...\Singing might be the most important thing in my life right now, response:	but soon I'll be graduating, going to college, getting a job.
context: You shouldn't have to quit!\She's doesn't understand anything!\I'm going to go have a talk with her.\W-Wait, Sawa!\Wait! Stop! I said, stop!\It's just, I'm already a senior...\Singing might be the most important thing in my life right now,\but soon I'll be graduating, going to college, getting a job. response:	These days are almost over.
context: She's doesn't understand anything!\I'm going to go have a talk with her.\W-Wait, Sawa!\Wait! Stop! I said, stop!\It's just, I'm already a senior...\Singing might be the most important thing in my life right now,\but soon I'll be graduating, going to college, getting a job.\These days are almost over. response:	So if she won't let me sing, I should just quit.
context: I'm going to go have a talk with her.\W-Wait, Sawa!\Wait! Stop! I said, stop!\It's just, I'm already a senior...\Singing might be the most important thing in my life right now,\but soon I'll be graduating, going to college, getting a job.\These days are almost over.\So if she won't let me sing, I should just quit. response:	But then what?
context: W-Wait, Sawa!\Wait! Stop! I said, stop!\It's just, I'm already a senior...\Singing might be the most important thing in my life right now,\but soon I'll be graduating, going to college, getting a job.\These days are almost over.\So if she won't let me sing, I should just quit.\But then what? response:	I know, I haven't had a chance to sing!
context: Wait! Stop! I said, stop!\It's just, I'm already a senior...\Singing might be the most important thing in my life right now,\but soon I'll be graduating, going to college, getting a job.\These days are almost over.\So if she won't let me sing, I should just quit.\But then what?\I know, I haven't had a chance to sing! response:	I really want to sing,
context: It's just, I'm already a senior...\Singing might be the most important thing in my life right now,\but soon I'll be graduating, going to college, getting a job.\These days are almost over.\So if she won't let me sing, I should just quit.\But then what?\I know, I haven't had a chance to sing!\I really want to sing, response:	so I'm going to start a new choir group.
context: Singing might be the most important thing in my life right now,\but soon I'll be graduating, going to college, getting a job.\These days are almost over.\So if she won't let me sing, I should just quit.\But then what?\I know, I haven't had a chance to sing!\I really want to sing,\so I'm going to start a new choir group. response:	So...
context: but soon I'll be graduating, going to college, getting a job.\These days are almost over.\So if she won't let me sing, I should just quit.\But then what?\I know, I haven't had a chance to sing!\I really want to sing,\so I'm going to start a new choir group.\So... response:	So you have to sing with me, Sawa!
context: These days are almost over.\So if she won't let me sing, I should just quit.\But then what?\I know, I haven't had a chance to sing!\I really want to sing,\so I'm going to start a new choir group.\So...\So you have to sing with me, Sawa! response:	Me?! But I have a terrible voice.
context: So if she won't let me sing, I should just quit.\But then what?\I know, I haven't had a chance to sing!\I really want to sing,\so I'm going to start a new choir group.\So...\So you have to sing with me, Sawa!\Me?! But I have a terrible voice. response:	Not true!
context: But then what?\I know, I haven't had a chance to sing!\I really want to sing,\so I'm going to start a new choir group.\So...\So you have to sing with me, Sawa!\Me?! But I have a terrible voice.\Not true! response:	You have a powerful voice.
context: I know, I haven't had a chance to sing!\I really want to sing,\so I'm going to start a new choir group.\So...\So you have to sing with me, Sawa!\Me?! But I have a terrible voice.\Not true!\You have a powerful voice. response:	But I'm already doing archery.
context: I really want to sing,\so I'm going to start a new choir group.\So...\So you have to sing with me, Sawa!\Me?! But I have a terrible voice.\Not true!\You have a powerful voice.\But I'm already doing archery. response:	Do both.
context: so I'm going to start a new choir group.\So...\So you have to sing with me, Sawa!\Me?! But I have a terrible voice.\Not true!\You have a powerful voice.\But I'm already doing archery.\Do both. response:	Are you allowed to start a new club?
context: So...\So you have to sing with me, Sawa!\Me?! But I have a terrible voice.\Not true!\You have a powerful voice.\But I'm already doing archery.\Do both.\Are you allowed to start a new club? response:	I think so.
context: So you have to sing with me, Sawa!\Me?! But I have a terrible voice.\Not true!\You have a powerful voice.\But I'm already doing archery.\Do both.\Are you allowed to start a new club?\I think so. response:	How?
context: Me?! But I have a terrible voice.\Not true!\You have a powerful voice.\But I'm already doing archery.\Do both.\Are you allowed to start a new club?\I think so.\How? response:	You put the name of the club and what it's for here.
context: Not true!\You have a powerful voice.\But I'm already doing archery.\Do both.\Are you allowed to start a new club?\I think so.\How?\You put the name of the club and what it's for here. response:	Here, you put the president, and here the advisor.
context: You have a powerful voice.\But I'm already doing archery.\Do both.\Are you allowed to start a new club?\I think so.\How?\You put the name of the club and what it's for here.\Here, you put the president, and here the advisor. response:	You need the principal's seal here.
context: But I'm already doing archery.\Do both.\Are you allowed to start a new club?\I think so.\How?\You put the name of the club and what it's for here.\Here, you put the president, and here the advisor.\You need the principal's seal here. response:	Then, you submit this to the student council
context: Do both.\Are you allowed to start a new club?\I think so.\How?\You put the name of the club and what it's for here.\Here, you put the president, and here the advisor.\You need the principal's seal here.\Then, you submit this to the student council response:	with the club members' applications.
context: Are you allowed to start a new club?\I think so.\How?\You put the name of the club and what it's for here.\Here, you put the president, and here the advisor.\You need the principal's seal here.\Then, you submit this to the student council\with the club members' applications. response:	Okay.
context: I think so.\How?\You put the name of the club and what it's for here.\Here, you put the president, and here the advisor.\You need the principal's seal here.\Then, you submit this to the student council\with the club members' applications.\Okay. response:	You need at least five people to start.
context: How?\You put the name of the club and what it's for here.\Here, you put the president, and here the advisor.\You need the principal's seal here.\Then, you submit this to the student council\with the club members' applications.\Okay.\You need at least five people to start. response:	Do you think you can do that?
context: You put the name of the club and what it's for here.\Here, you put the president, and here the advisor.\You need the principal's seal here.\Then, you submit this to the student council\with the club members' applications.\Okay.\You need at least five people to start.\Do you think you can do that? response:	I've got myself and Sawa,
context: Here, you put the president, and here the advisor.\You need the principal's seal here.\Then, you submit this to the student council\with the club members' applications.\Okay.\You need at least five people to start.\Do you think you can do that?\I've got myself and Sawa, response:	and I was thinking I could invite Sakai-san.
context: You need the principal's seal here.\Then, you submit this to the student council\with the club members' applications.\Okay.\You need at least five people to start.\Do you think you can do that?\I've got myself and Sawa,\and I was thinking I could invite Sakai-san. response:	She'd be great to have on board!
context: Then, you submit this to the student council\with the club members' applications.\Okay.\You need at least five people to start.\Do you think you can do that?\I've got myself and Sawa,\and I was thinking I could invite Sakai-san.\She'd be great to have on board! response:	Yeah...
context: with the club members' applications.\Okay.\You need at least five people to start.\Do you think you can do that?\I've got myself and Sawa,\and I was thinking I could invite Sakai-san.\She'd be great to have on board!\Yeah... response:	This might not be a good time, though.
context: Okay.\You need at least five people to start.\Do you think you can do that?\I've got myself and Sawa,\and I was thinking I could invite Sakai-san.\She'd be great to have on board!\Yeah...\This might not be a good time, though. response:	Why's that?
context: You need at least five people to start.\Do you think you can do that?\I've got myself and Sawa,\and I was thinking I could invite Sakai-san.\She'd be great to have on board!\Yeah...\This might not be a good time, though.\Why's that? response:	Well, she didn't have enough general credits,
context: Do you think you can do that?\I've got myself and Sawa,\and I was thinking I could invite Sakai-san.\She'd be great to have on board!\Yeah...\This might not be a good time, though.\Why's that?\Well, she didn't have enough general credits, response:	so she's taking supplementary classes.
context: I've got myself and Sawa,\and I was thinking I could invite Sakai-san.\She'd be great to have on board!\Yeah...\This might not be a good time, though.\Why's that?\Well, she didn't have enough general credits,\so she's taking supplementary classes. response:	But a girl like you might be a good catalyst for her.
context: and I was thinking I could invite Sakai-san.\She'd be great to have on board!\Yeah...\This might not be a good time, though.\Why's that?\Well, she didn't have enough general credits,\so she's taking supplementary classes.\But a girl like you might be a good catalyst for her. response:	A girl like me?
context: She'd be great to have on board!\Yeah...\This might not be a good time, though.\Why's that?\Well, she didn't have enough general credits,\so she's taking supplementary classes.\But a girl like you might be a good catalyst for her.\A girl like me? response:	A cheerful, nice, and pretty girl.
context: Yeah...\This might not be a good time, though.\Why's that?\Well, she didn't have enough general credits,\so she's taking supplementary classes.\But a girl like you might be a good catalyst for her.\A girl like me?\A cheerful, nice, and pretty girl. response:	Thank you!
context: This might not be a good time, though.\Why's that?\Well, she didn't have enough general credits,\so she's taking supplementary classes.\But a girl like you might be a good catalyst for her.\A girl like me?\A cheerful, nice, and pretty girl.\Thank you! response:	An earnest girl who's easy to understand.
context: Why's that?\Well, she didn't have enough general credits,\so she's taking supplementary classes.\But a girl like you might be a good catalyst for her.\A girl like me?\A cheerful, nice, and pretty girl.\Thank you!\An earnest girl who's easy to understand. response:	I hope they don't have a weird chemical reaction and explode.
context: Well, she didn't have enough general credits,\so she's taking supplementary classes.\But a girl like you might be a good catalyst for her.\A girl like me?\A cheerful, nice, and pretty girl.\Thank you!\An earnest girl who's easy to understand.\I hope they don't have a weird chemical reaction and explode. response:	Good luck to you, too!
context: so she's taking supplementary classes.\But a girl like you might be a good catalyst for her.\A girl like me?\A cheerful, nice, and pretty girl.\Thank you!\An earnest girl who's easy to understand.\I hope they don't have a weird chemical reaction and explode.\Good luck to you, too! response:	Oh, thank you.
context: But a girl like you might be a good catalyst for her.\A girl like me?\A cheerful, nice, and pretty girl.\Thank you!\An earnest girl who's easy to understand.\I hope they don't have a weird chemical reaction and explode.\Good luck to you, too!\Oh, thank you. response:	To the left, there's the general studies building,
context: A girl like me?\A cheerful, nice, and pretty girl.\Thank you!\An earnest girl who's easy to understand.\I hope they don't have a weird chemical reaction and explode.\Good luck to you, too!\Oh, thank you.\To the left, there's the general studies building, response:	and to the right is the music building.
context: A cheerful, nice, and pretty girl.\Thank you!\An earnest girl who's easy to understand.\I hope they don't have a weird chemical reaction and explode.\Good luck to you, too!\Oh, thank you.\To the left, there's the general studies building,\and to the right is the music building. response:	On the left is the general studies...
context: Thank you!\An earnest girl who's easy to understand.\I hope they don't have a weird chemical reaction and explode.\Good luck to you, too!\Oh, thank you.\To the left, there's the general studies building,\and to the right is the music building.\On the left is the general studies... response:	This is the inner courtyard.
context: An earnest girl who's easy to understand.\I hope they don't have a weird chemical reaction and explode.\Good luck to you, too!\Oh, thank you.\To the left, there's the general studies building,\and to the right is the music building.\On the left is the general studies...\This is the inner courtyard. response:	If you're out here eating, watch out for black kites.
context: I hope they don't have a weird chemical reaction and explode.\Good luck to you, too!\Oh, thank you.\To the left, there's the general studies building,\and to the right is the music building.\On the left is the general studies...\This is the inner courtyard.\If you're out here eating, watch out for black kites. response:	Okay.
context: Good luck to you, too!\Oh, thank you.\To the left, there's the general studies building,\and to the right is the music building.\On the left is the general studies...\This is the inner courtyard.\If you're out here eating, watch out for black kites.\Okay. response:	Watch out for black kites.
context: Oh, thank you.\To the left, there's the general studies building,\and to the right is the music building.\On the left is the general studies...\This is the inner courtyard.\If you're out here eating, watch out for black kites.\Okay.\Watch out for black kites. response:	And that's the gym over there.
context: To the left, there's the general studies building,\and to the right is the music building.\On the left is the general studies...\This is the inner courtyard.\If you're out here eating, watch out for black kites.\Okay.\Watch out for black kites.\And that's the gym over there. response:	That is the gym.
context: and to the right is the music building.\On the left is the general studies...\This is the inner courtyard.\If you're out here eating, watch out for black kites.\Okay.\Watch out for black kites.\And that's the gym over there.\That is the gym. response:	Do you bike here?
context: On the left is the general studies...\This is the inner courtyard.\If you're out here eating, watch out for black kites.\Okay.\Watch out for black kites.\And that's the gym over there.\That is the gym.\Do you bike here? response:	Do I what?
context: This is the inner courtyard.\If you're out here eating, watch out for black kites.\Okay.\Watch out for black kites.\And that's the gym over there.\That is the gym.\Do you bike here?\Do I what? response:	Do you ride your bike to come to school?
context: If you're out here eating, watch out for black kites.\Okay.\Watch out for black kites.\And that's the gym over there.\That is the gym.\Do you bike here?\Do I what?\Do you ride your bike to come to school? response:	Oh, no, I come by train.
context: Okay.\Watch out for black kites.\And that's the gym over there.\That is the gym.\Do you bike here?\Do I what?\Do you ride your bike to come to school?\Oh, no, I come by train. response:	Then I guess I don't have to show you the bike rack.
context: Watch out for black kites.\And that's the gym over there.\That is the gym.\Do you bike here?\Do I what?\Do you ride your bike to come to school?\Oh, no, I come by train.\Then I guess I don't have to show you the bike rack. response:	My club starts soon, so I have to go.
context: And that's the gym over there.\That is the gym.\Do you bike here?\Do I what?\Do you ride your bike to come to school?\Oh, no, I come by train.\Then I guess I don't have to show you the bike rack.\My club starts soon, so I have to go. response:	Okay.
context: That is the gym.\Do you bike here?\Do I what?\Do you ride your bike to come to school?\Oh, no, I come by train.\Then I guess I don't have to show you the bike rack.\My club starts soon, so I have to go.\Okay. response:	Thank you so much.
context: Do you bike here?\Do I what?\Do you ride your bike to come to school?\Oh, no, I come by train.\Then I guess I don't have to show you the bike rack.\My club starts soon, so I have to go.\Okay.\Thank you so much. response:	I think you should look into getting a different book.
context: Do I what?\Do you ride your bike to come to school?\Oh, no, I come by train.\Then I guess I don't have to show you the bike rack.\My club starts soon, so I have to go.\Okay.\Thank you so much.\I think you should look into getting a different book. response:	Ki no Tsurayuki wrote about a ficticious woman who,
context: Do you ride your bike to come to school?\Oh, no, I come by train.\Then I guess I don't have to show you the bike rack.\My club starts soon, so I have to go.\Okay.\Thank you so much.\I think you should look into getting a different book.\Ki no Tsurayuki wrote about a ficticious woman who, response:	on her travels, met many...
context: Oh, no, I come by train.\Then I guess I don't have to show you the bike rack.\My club starts soon, so I have to go.\Okay.\Thank you so much.\I think you should look into getting a different book.\Ki no Tsurayuki wrote about a ficticious woman who,\on her travels, met many... response:	All right, then let's stop here.
context: Then I guess I don't have to show you the bike rack.\My club starts soon, so I have to go.\Okay.\Thank you so much.\I think you should look into getting a different book.\Ki no Tsurayuki wrote about a ficticious woman who,\on her travels, met many...\All right, then let's stop here. response:	Starting next week, a new student will be joining our class.
context: My club starts soon, so I have to go.\Okay.\Thank you so much.\I think you should look into getting a different book.\Ki no Tsurayuki wrote about a ficticious woman who,\on her travels, met many...\All right, then let's stop here.\Starting next week, a new student will be joining our class. response:	Yes.
context: Okay.\Thank you so much.\I think you should look into getting a different book.\Ki no Tsurayuki wrote about a ficticious woman who,\on her travels, met many...\All right, then let's stop here.\Starting next week, a new student will be joining our class.\Yes. response:	Thank you.
context: Thank you so much.\I think you should look into getting a different book.\Ki no Tsurayuki wrote about a ficticious woman who,\on her travels, met many...\All right, then let's stop here.\Starting next week, a new student will be joining our class.\Yes.\Thank you. response:	Sakai-san!
context: I think you should look into getting a different book.\Ki no Tsurayuki wrote about a ficticious woman who,\on her travels, met many...\All right, then let's stop here.\Starting next week, a new student will be joining our class.\Yes.\Thank you.\Sakai-san! response:	Let's walk home together part way.
context: Ki no Tsurayuki wrote about a ficticious woman who,\on her travels, met many...\All right, then let's stop here.\Starting next week, a new student will be joining our class.\Yes.\Thank you.\Sakai-san!\Let's walk home together part way. response:	The uniforms for the music students are really cute.
context: on her travels, met many...\All right, then let's stop here.\Starting next week, a new student will be joining our class.\Yes.\Thank you.\Sakai-san!\Let's walk home together part way.\The uniforms for the music students are really cute. response:	You think so?
context: All right, then let's stop here.\Starting next week, a new student will be joining our class.\Yes.\Thank you.\Sakai-san!\Let's walk home together part way.\The uniforms for the music students are really cute.\You think so? response:	Do you ride your bike when it rains, too?
context: Starting next week, a new student will be joining our class.\Yes.\Thank you.\Sakai-san!\Let's walk home together part way.\The uniforms for the music students are really cute.\You think so?\Do you ride your bike when it rains, too? response:	Usually.
context: Yes.\Thank you.\Sakai-san!\Let's walk home together part way.\The uniforms for the music students are really cute.\You think so?\Do you ride your bike when it rains, too?\Usually. response:	What's this about?
context: Thank you.\Sakai-san!\Let's walk home together part way.\The uniforms for the music students are really cute.\You think so?\Do you ride your bike when it rains, too?\Usually.\What's this about? response:	Huh? What do you mean?
context: Sakai-san!\Let's walk home together part way.\The uniforms for the music students are really cute.\You think so?\Do you ride your bike when it rains, too?\Usually.\What's this about?\Huh? What do you mean? response:	We've never walked home together before.
context: Let's walk home together part way.\The uniforms for the music students are really cute.\You think so?\Do you ride your bike when it rains, too?\Usually.\What's this about?\Huh? What do you mean?\We've never walked home together before. response:	Yeah, well, I've been wanting to get to know you better.
context: The uniforms for the music students are really cute.\You think so?\Do you ride your bike when it rains, too?\Usually.\What's this about?\Huh? What do you mean?\We've never walked home together before.\Yeah, well, I've been wanting to get to know you better. response:	You quit the choir club, didn't you?
context: You think so?\Do you ride your bike when it rains, too?\Usually.\What's this about?\Huh? What do you mean?\We've never walked home together before.\Yeah, well, I've been wanting to get to know you better.\You quit the choir club, didn't you? response:	How do you know about that?
context: Do you ride your bike when it rains, too?\Usually.\What's this about?\Huh? What do you mean?\We've never walked home together before.\Yeah, well, I've been wanting to get to know you better.\You quit the choir club, didn't you?\How do you know about that? response:	Sorry. I saw it.
context: Usually.\What's this about?\Huh? What do you mean?\We've never walked home together before.\Yeah, well, I've been wanting to get to know you better.\You quit the choir club, didn't you?\How do you know about that?\Sorry. I saw it. response:	Really?!
context: What's this about?\Huh? What do you mean?\We've never walked home together before.\Yeah, well, I've been wanting to get to know you better.\You quit the choir club, didn't you?\How do you know about that?\Sorry. I saw it.\Really?! response:	That's so embarassing!
context: Huh? What do you mean?\We've never walked home together before.\Yeah, well, I've been wanting to get to know you better.\You quit the choir club, didn't you?\How do you know about that?\Sorry. I saw it.\Really?!\That's so embarassing! response:	What are you doing?
context: We've never walked home together before.\Yeah, well, I've been wanting to get to know you better.\You quit the choir club, didn't you?\How do you know about that?\Sorry. I saw it.\Really?!\That's so embarassing!\What are you doing? response:	I overwrote the shame, so none of it would be left.
context: Yeah, well, I've been wanting to get to know you better.\You quit the choir club, didn't you?\How do you know about that?\Sorry. I saw it.\Really?!\That's so embarassing!\What are you doing?\I overwrote the shame, so none of it would be left. response:	Now, we're even.
context: You quit the choir club, didn't you?\How do you know about that?\Sorry. I saw it.\Really?!\That's so embarassing!\What are you doing?\I overwrote the shame, so none of it would be left.\Now, we're even. response:	What are you talking about?
context: How do you know about that?\Sorry. I saw it.\Really?!\That's so embarassing!\What are you doing?\I overwrote the shame, so none of it would be left.\Now, we're even.\What are you talking about? response:	I want to start a new choir club.
context: Sorry. I saw it.\Really?!\That's so embarassing!\What are you doing?\I overwrote the shame, so none of it would be left.\Now, we're even.\What are you talking about?\I want to start a new choir club. response:	Our school is coordinating the joint
context: Really?!\That's so embarassing!\What are you doing?\I overwrote the shame, so none of it would be left.\Now, we're even.\What are you talking about?\I want to start a new choir club.\Our school is coordinating the joint response:	recital this year, so I think if I talk to the principal directly,
context: That's so embarassing!\What are you doing?\I overwrote the shame, so none of it would be left.\Now, we're even.\What are you talking about?\I want to start a new choir club.\Our school is coordinating the joint\recital this year, so I think if I talk to the principal directly, response:	I might have a chance.
context: What are you doing?\I overwrote the shame, so none of it would be left.\Now, we're even.\What are you talking about?\I want to start a new choir club.\Our school is coordinating the joint\recital this year, so I think if I talk to the principal directly,\I might have a chance. response:	I was wondering if you'd be interested in
context: I overwrote the shame, so none of it would be left.\Now, we're even.\What are you talking about?\I want to start a new choir club.\Our school is coordinating the joint\recital this year, so I think if I talk to the principal directly,\I might have a chance.\I was wondering if you'd be interested in response:	No.
context: Now, we're even.\What are you talking about?\I want to start a new choir club.\Our school is coordinating the joint\recital this year, so I think if I talk to the principal directly,\I might have a chance.\I was wondering if you'd be interested in\No. response:	Huh?
context: What are you talking about?\I want to start a new choir club.\Our school is coordinating the joint\recital this year, so I think if I talk to the principal directly,\I might have a chance.\I was wondering if you'd be interested in\No.\Huh? response:	Absolutely not. I stopped singing.
context: I want to start a new choir club.\Our school is coordinating the joint\recital this year, so I think if I talk to the principal directly,\I might have a chance.\I was wondering if you'd be interested in\No.\Huh?\Absolutely not. I stopped singing. response:	Huh? Is this because of your supplementary classes?
context: Our school is coordinating the joint\recital this year, so I think if I talk to the principal directly,\I might have a chance.\I was wondering if you'd be interested in\No.\Huh?\Absolutely not. I stopped singing.\Huh? Is this because of your supplementary classes? response:	We don't have to have rehearsals every day,
context: recital this year, so I think if I talk to the principal directly,\I might have a chance.\I was wondering if you'd be interested in\No.\Huh?\Absolutely not. I stopped singing.\Huh? Is this because of your supplementary classes?\We don't have to have rehearsals every day, response:	so I'm sure you'd be fine.
context: I might have a chance.\I was wondering if you'd be interested in\No.\Huh?\Absolutely not. I stopped singing.\Huh? Is this because of your supplementary classes?\We don't have to have rehearsals every day,\so I'm sure you'd be fine. response:	I know it's a crazy challenge,
context: I was wondering if you'd be interested in\No.\Huh?\Absolutely not. I stopped singing.\Huh? Is this because of your supplementary classes?\We don't have to have rehearsals every day,\so I'm sure you'd be fine.\I know it's a crazy challenge, response:	but I think if we sing together,
context: No.\Huh?\Absolutely not. I stopped singing.\Huh? Is this because of your supplementary classes?\We don't have to have rehearsals every day,\so I'm sure you'd be fine.\I know it's a crazy challenge,\but I think if we sing together, response:	it could lead to something incredible!
context: Huh?\Absolutely not. I stopped singing.\Huh? Is this because of your supplementary classes?\We don't have to have rehearsals every day,\so I'm sure you'd be fine.\I know it's a crazy challenge,\but I think if we sing together,\it could lead to something incredible! response:	Please?
context: Absolutely not. I stopped singing.\Huh? Is this because of your supplementary classes?\We don't have to have rehearsals every day,\so I'm sure you'd be fine.\I know it's a crazy challenge,\but I think if we sing together,\it could lead to something incredible!\Please? response:	It would be so much fun!
context: Huh? Is this because of your supplementary classes?\We don't have to have rehearsals every day,\so I'm sure you'd be fine.\I know it's a crazy challenge,\but I think if we sing together,\it could lead to something incredible!\Please?\It would be so much fun! response:	Starting to sing now?
context: We don't have to have rehearsals every day,\so I'm sure you'd be fine.\I know it's a crazy challenge,\but I think if we sing together,\it could lead to something incredible!\Please?\It would be so much fun!\Starting to sing now? response:	I'd never enjoy it.
context: so I'm sure you'd be fine.\I know it's a crazy challenge,\but I think if we sing together,\it could lead to something incredible!\Please?\It would be so much fun!\Starting to sing now?\I'd never enjoy it. response:	Why not?
context: I know it's a crazy challenge,\but I think if we sing together,\it could lead to something incredible!\Please?\It would be so much fun!\Starting to sing now?\I'd never enjoy it.\Why not? response:	If you pretend it's fun, it might
context: but I think if we sing together,\it could lead to something incredible!\Please?\It would be so much fun!\Starting to sing now?\I'd never enjoy it.\Why not?\If you pretend it's fun, it might response:	actually become fun after a while!
context: it could lead to something incredible!\Please?\It would be so much fun!\Starting to sing now?\I'd never enjoy it.\Why not?\If you pretend it's fun, it might\actually become fun after a while! response:	If you just want to sing for fun,
context: Please?\It would be so much fun!\Starting to sing now?\I'd never enjoy it.\Why not?\If you pretend it's fun, it might\actually become fun after a while!\If you just want to sing for fun, response:	why don't you go to karaoke or something?
context: It would be so much fun!\Starting to sing now?\I'd never enjoy it.\Why not?\If you pretend it's fun, it might\actually become fun after a while!\If you just want to sing for fun,\why don't you go to karaoke or something? response:	Don't involve me in your games!
context: Starting to sing now?\I'd never enjoy it.\Why not?\If you pretend it's fun, it might\actually become fun after a while!\If you just want to sing for fun,\why don't you go to karaoke or something?\Don't involve me in your games! response:	It's not a game.
context: I'd never enjoy it.\Why not?\If you pretend it's fun, it might\actually become fun after a while!\If you just want to sing for fun,\why don't you go to karaoke or something?\Don't involve me in your games!\It's not a game. response:	Then what is it?
context: Why not?\If you pretend it's fun, it might\actually become fun after a while!\If you just want to sing for fun,\why don't you go to karaoke or something?\Don't involve me in your games!\It's not a game.\Then what is it? response:	What do you sing for?
context: If you pretend it's fun, it might\actually become fun after a while!\If you just want to sing for fun,\why don't you go to karaoke or something?\Don't involve me in your games!\It's not a game.\Then what is it?\What do you sing for? response:	Well, that's...
context: actually become fun after a while!\If you just want to sing for fun,\why don't you go to karaoke or something?\Don't involve me in your games!\It's not a game.\Then what is it?\What do you sing for?\Well, that's... response:	Whatever! Just because you're having fun,
context: If you just want to sing for fun,\why don't you go to karaoke or something?\Don't involve me in your games!\It's not a game.\Then what is it?\What do you sing for?\Well, that's...\Whatever! Just because you're having fun, response:	it doesn't mean you're not serious!
context: why don't you go to karaoke or something?\Don't involve me in your games!\It's not a game.\Then what is it?\What do you sing for?\Well, that's...\Whatever! Just because you're having fun,\it doesn't mean you're not serious! response:	That doesn't answer my question.
context: Don't involve me in your games!\It's not a game.\Then what is it?\What do you sing for?\Well, that's...\Whatever! Just because you're having fun,\it doesn't mean you're not serious!\That doesn't answer my question. response:	I'm dead serious about this!
context: It's not a game.\Then what is it?\What do you sing for?\Well, that's...\Whatever! Just because you're having fun,\it doesn't mean you're not serious!\That doesn't answer my question.\I'm dead serious about this! response:	Maybe so, but don't get me involved.
context: Then what is it?\What do you sing for?\Well, that's...\Whatever! Just because you're having fun,\it doesn't mean you're not serious!\That doesn't answer my question.\I'm dead serious about this!\Maybe so, but don't get me involved. response:	I don't want to regret giving up before I even tried!
context: What do you sing for?\Well, that's...\Whatever! Just because you're having fun,\it doesn't mean you're not serious!\That doesn't answer my question.\I'm dead serious about this!\Maybe so, but don't get me involved.\I don't want to regret giving up before I even tried! response:	By the way, I heard that you're crazy about sweets.
context: Well, that's...\Whatever! Just because you're having fun,\it doesn't mean you're not serious!\That doesn't answer my question.\I'm dead serious about this!\Maybe so, but don't get me involved.\I don't want to regret giving up before I even tried!\By the way, I heard that you're crazy about sweets. response:	That's right! Especially homemade ones.
context: Whatever! Just because you're having fun,\it doesn't mean you're not serious!\That doesn't answer my question.\I'm dead serious about this!\Maybe so, but don't get me involved.\I don't want to regret giving up before I even tried!\By the way, I heard that you're crazy about sweets.\That's right! Especially homemade ones. response:	Honestly, Dora.
context: it doesn't mean you're not serious!\That doesn't answer my question.\I'm dead serious about this!\Maybe so, but don't get me involved.\I don't want to regret giving up before I even tried!\By the way, I heard that you're crazy about sweets.\That's right! Especially homemade ones.\Honestly, Dora. response:	Makoto, you're not in any clubs, right?
context: That doesn't answer my question.\I'm dead serious about this!\Maybe so, but don't get me involved.\I don't want to regret giving up before I even tried!\By the way, I heard that you're crazy about sweets.\That's right! Especially homemade ones.\Honestly, Dora.\Makoto, you're not in any clubs, right? response:	Don't just barge in here, you hag!
context: I'm dead serious about this!\Maybe so, but don't get me involved.\I don't want to regret giving up before I even tried!\By the way, I heard that you're crazy about sweets.\That's right! Especially homemade ones.\Honestly, Dora.\Makoto, you're not in any clubs, right?\Don't just barge in here, you hag! response:	I'm making a choir club. You'll join, right?
context: Maybe so, but don't get me involved.\I don't want to regret giving up before I even tried!\By the way, I heard that you're crazy about sweets.\That's right! Especially homemade ones.\Honestly, Dora.\Makoto, you're not in any clubs, right?\Don't just barge in here, you hag!\I'm making a choir club. You'll join, right? response:	What?
context: I don't want to regret giving up before I even tried!\By the way, I heard that you're crazy about sweets.\That's right! Especially homemade ones.\Honestly, Dora.\Makoto, you're not in any clubs, right?\Don't just barge in here, you hag!\I'm making a choir club. You'll join, right?\What? response:	I left the application form on your desk,
context: By the way, I heard that you're crazy about sweets.\That's right! Especially homemade ones.\Honestly, Dora.\Makoto, you're not in any clubs, right?\Don't just barge in here, you hag!\I'm making a choir club. You'll join, right?\What?\I left the application form on your desk, response:	so just fill it out and bring it back to me.
context: That's right! Especially homemade ones.\Honestly, Dora.\Makoto, you're not in any clubs, right?\Don't just barge in here, you hag!\I'm making a choir club. You'll join, right?\What?\I left the application form on your desk,\so just fill it out and bring it back to me. response:	Stay out of my room!
context: Honestly, Dora.\Makoto, you're not in any clubs, right?\Don't just barge in here, you hag!\I'm making a choir club. You'll join, right?\What?\I left the application form on your desk,\so just fill it out and bring it back to me.\Stay out of my room! response:	If you don't bring me back that application,
context: Makoto, you're not in any clubs, right?\Don't just barge in here, you hag!\I'm making a choir club. You'll join, right?\What?\I left the application form on your desk,\so just fill it out and bring it back to me.\Stay out of my room!\If you don't bring me back that application, response:	I'm going to tell mom about your secret porn stash.
context: Don't just barge in here, you hag!\I'm making a choir club. You'll join, right?\What?\I left the application form on your desk,\so just fill it out and bring it back to me.\Stay out of my room!\If you don't bring me back that application,\I'm going to tell mom about your secret porn stash. response:	Huh?
context: I'm making a choir club. You'll join, right?\What?\I left the application form on your desk,\so just fill it out and bring it back to me.\Stay out of my room!\If you don't bring me back that application,\I'm going to tell mom about your secret porn stash.\Huh? response:	I've started at my new school.
context: What?\I left the application form on your desk,\so just fill it out and bring it back to me.\Stay out of my room!\If you don't bring me back that application,\I'm going to tell mom about your secret porn stash.\Huh?\I've started at my new school. response:	I tried to prepare as much as possible, by reading books,
context: I left the application form on your desk,\so just fill it out and bring it back to me.\Stay out of my room!\If you don't bring me back that application,\I'm going to tell mom about your secret porn stash.\Huh?\I've started at my new school.\I tried to prepare as much as possible, by reading books, response:	but Japanese customs are quite complicated,
context: so just fill it out and bring it back to me.\Stay out of my room!\If you don't bring me back that application,\I'm going to tell mom about your secret porn stash.\Huh?\I've started at my new school.\I tried to prepare as much as possible, by reading books,\but Japanese customs are quite complicated, response:	and it's not easy to avoid mistakes.
context: Stay out of my room!\If you don't bring me back that application,\I'm going to tell mom about your secret porn stash.\Huh?\I've started at my new school.\I tried to prepare as much as possible, by reading books,\but Japanese customs are quite complicated,\and it's not easy to avoid mistakes. response:	I'm going to try hard to make Japan
context: If you don't bring me back that application,\I'm going to tell mom about your secret porn stash.\Huh?\I've started at my new school.\I tried to prepare as much as possible, by reading books,\but Japanese customs are quite complicated,\and it's not easy to avoid mistakes.\I'm going to try hard to make Japan response:	feel like my home again.
context: I'm going to tell mom about your secret porn stash.\Huh?\I've started at my new school.\I tried to prepare as much as possible, by reading books,\but Japanese customs are quite complicated,\and it's not easy to avoid mistakes.\I'm going to try hard to make Japan\feel like my home again. response:	I hope I can show you Japan, someday.
context: Huh?\I've started at my new school.\I tried to prepare as much as possible, by reading books,\but Japanese customs are quite complicated,\and it's not easy to avoid mistakes.\I'm going to try hard to make Japan\feel like my home again.\I hope I can show you Japan, someday. response:	When that time comes...
context: I've started at my new school.\I tried to prepare as much as possible, by reading books,\but Japanese customs are quite complicated,\and it's not easy to avoid mistakes.\I'm going to try hard to make Japan\feel like my home again.\I hope I can show you Japan, someday.\When that time comes... response:	Two more people, huh?
context: I tried to prepare as much as possible, by reading books,\but Japanese customs are quite complicated,\and it's not easy to avoid mistakes.\I'm going to try hard to make Japan\feel like my home again.\I hope I can show you Japan, someday.\When that time comes...\Two more people, huh? response:	Starting a club is fine,
context: but Japanese customs are quite complicated,\and it's not easy to avoid mistakes.\I'm going to try hard to make Japan\feel like my home again.\I hope I can show you Japan, someday.\When that time comes...\Two more people, huh?\Starting a club is fine, response:	but are you really sure you want to perform at the recital?
context: and it's not easy to avoid mistakes.\I'm going to try hard to make Japan\feel like my home again.\I hope I can show you Japan, someday.\When that time comes...\Two more people, huh?\Starting a club is fine,\but are you really sure you want to perform at the recital? response:	It's going to be hard to find members now.
context: I'm going to try hard to make Japan\feel like my home again.\I hope I can show you Japan, someday.\When that time comes...\Two more people, huh?\Starting a club is fine,\but are you really sure you want to perform at the recital?\It's going to be hard to find members now. response:	You know that, right?
context: feel like my home again.\I hope I can show you Japan, someday.\When that time comes...\Two more people, huh?\Starting a club is fine,\but are you really sure you want to perform at the recital?\It's going to be hard to find members now.\You know that, right? response:	Is this because you made Sakai-san mad?
context: I hope I can show you Japan, someday.\When that time comes...\Two more people, huh?\Starting a club is fine,\but are you really sure you want to perform at the recital?\It's going to be hard to find members now.\You know that, right?\Is this because you made Sakai-san mad? response:	Or is it what the vice principal said to you?
context: When that time comes...\Two more people, huh?\Starting a club is fine,\but are you really sure you want to perform at the recital?\It's going to be hard to find members now.\You know that, right?\Is this because you made Sakai-san mad?\Or is it what the vice principal said to you? response:	Ah, both.
context: Two more people, huh?\Starting a club is fine,\but are you really sure you want to perform at the recital?\It's going to be hard to find members now.\You know that, right?\Is this because you made Sakai-san mad?\Or is it what the vice principal said to you?\Ah, both. response:	I guess you really did screw up at last year's recital.
context: Starting a club is fine,\but are you really sure you want to perform at the recital?\It's going to be hard to find members now.\You know that, right?\Is this because you made Sakai-san mad?\Or is it what the vice principal said to you?\Ah, both.\I guess you really did screw up at last year's recital. response:	It's not funny!
context: but are you really sure you want to perform at the recital?\It's going to be hard to find members now.\You know that, right?\Is this because you made Sakai-san mad?\Or is it what the vice principal said to you?\Ah, both.\I guess you really did screw up at last year's recital.\It's not funny! response:	That's why I've been doing all this different training.
context: It's going to be hard to find members now.\You know that, right?\Is this because you made Sakai-san mad?\Or is it what the vice principal said to you?\Ah, both.\I guess you really did screw up at last year's recital.\It's not funny!\That's why I've been doing all this different training. response:	I'm not that person anymore.
context: You know that, right?\Is this because you made Sakai-san mad?\Or is it what the vice principal said to you?\Ah, both.\I guess you really did screw up at last year's recital.\It's not funny!\That's why I've been doing all this different training.\I'm not that person anymore. response:	Can I have some cream, please?
context: Is this because you made Sakai-san mad?\Or is it what the vice principal said to you?\Ah, both.\I guess you really did screw up at last year's recital.\It's not funny!\That's why I've been doing all this different training.\I'm not that person anymore.\Can I have some cream, please? response:	Listen to me!
context: Or is it what the vice principal said to you?\Ah, both.\I guess you really did screw up at last year's recital.\It's not funny!\That's why I've been doing all this different training.\I'm not that person anymore.\Can I have some cream, please?\Listen to me! response:	I hear you, loud and clear.
context: Ah, both.\I guess you really did screw up at last year's recital.\It's not funny!\That's why I've been doing all this different training.\I'm not that person anymore.\Can I have some cream, please?\Listen to me!\I hear you, loud and clear. response:	You're going to go practice today too, right?
context: I guess you really did screw up at last year's recital.\It's not funny!\That's why I've been doing all this different training.\I'm not that person anymore.\Can I have some cream, please?\Listen to me!\I hear you, loud and clear.\You're going to go practice today too, right? response:	Of course.
context: It's not funny!\That's why I've been doing all this different training.\I'm not that person anymore.\Can I have some cream, please?\Listen to me!\I hear you, loud and clear.\You're going to go practice today too, right?\Of course. response:	This one's on you.
context: That's why I've been doing all this different training.\I'm not that person anymore.\Can I have some cream, please?\Listen to me!\I hear you, loud and clear.\You're going to go practice today too, right?\Of course.\This one's on you. response:	Why?
context: I'm not that person anymore.\Can I have some cream, please?\Listen to me!\I hear you, loud and clear.\You're going to go practice today too, right?\Of course.\This one's on you.\Why? response:	Because you laughed.
context: Can I have some cream, please?\Listen to me!\I hear you, loud and clear.\You're going to go practice today too, right?\Of course.\This one's on you.\Why?\Because you laughed. response:	Tasty Croquettes
context: Listen to me!\I hear you, loud and clear.\You're going to go practice today too, right?\Of course.\This one's on you.\Why?\Because you laughed.\Tasty Croquettes response:	Fly, fly, fly!
context: I hear you, loud and clear.\You're going to go practice today too, right?\Of course.\This one's on you.\Why?\Because you laughed.\Tasty Croquettes\Fly, fly, fly! response:	What you really need, is a sparkle in your eyes.
context: You're going to go practice today too, right?\Of course.\This one's on you.\Why?\Because you laughed.\Tasty Croquettes\Fly, fly, fly!\What you really need, is a sparkle in your eyes. response:	Fly, fly, fly!
context: Of course.\This one's on you.\Why?\Because you laughed.\Tasty Croquettes\Fly, fly, fly!\What you really need, is a sparkle in your eyes.\Fly, fly, fly! response:	Using my body, I'll run as far as I want, my way.
context: This one's on you.\Why?\Because you laughed.\Tasty Croquettes\Fly, fly, fly!\What you really need, is a sparkle in your eyes.\Fly, fly, fly!\Using my body, I'll run as far as I want, my way. response:	The soul forever believes
context: Why?\Because you laughed.\Tasty Croquettes\Fly, fly, fly!\What you really need, is a sparkle in your eyes.\Fly, fly, fly!\Using my body, I'll run as far as I want, my way.\The soul forever believes response:	in something we can't see. Isn't that all right?
context: Because you laughed.\Tasty Croquettes\Fly, fly, fly!\What you really need, is a sparkle in your eyes.\Fly, fly, fly!\Using my body, I'll run as far as I want, my way.\The soul forever believes\in something we can't see. Isn't that all right? response:	Even yesterday...
context: Tasty Croquettes\Fly, fly, fly!\What you really need, is a sparkle in your eyes.\Fly, fly, fly!\Using my body, I'll run as far as I want, my way.\The soul forever believes\in something we can't see. Isn't that all right?\Even yesterday... response:	Sakai.
context: Fly, fly, fly!\What you really need, is a sparkle in your eyes.\Fly, fly, fly!\Using my body, I'll run as far as I want, my way.\The soul forever believes\in something we can't see. Isn't that all right?\Even yesterday...\Sakai. response:	Whatcha doing here?
context: What you really need, is a sparkle in your eyes.\Fly, fly, fly!\Using my body, I'll run as far as I want, my way.\The soul forever believes\in something we can't see. Isn't that all right?\Even yesterday...\Sakai.\Whatcha doing here? response:	Oh, Tanaka-kun?
context: Fly, fly, fly!\Using my body, I'll run as far as I want, my way.\The soul forever believes\in something we can't see. Isn't that all right?\Even yesterday...\Sakai.\Whatcha doing here?\Oh, Tanaka-kun? response:	I'm back.
context: Using my body, I'll run as far as I want, my way.\The soul forever believes\in something we can't see. Isn't that all right?\Even yesterday...\Sakai.\Whatcha doing here?\Oh, Tanaka-kun?\I'm back. response:	Even then, I just want to laugh it off.
context: The soul forever believes\in something we can't see. Isn't that all right?\Even yesterday...\Sakai.\Whatcha doing here?\Oh, Tanaka-kun?\I'm back.\Even then, I just want to laugh it off. response:	People will be people.
context: in something we can't see. Isn't that all right?\Even yesterday...\Sakai.\Whatcha doing here?\Oh, Tanaka-kun?\I'm back.\Even then, I just want to laugh it off.\People will be people. response:	Huh?
context: Even yesterday...\Sakai.\Whatcha doing here?\Oh, Tanaka-kun?\I'm back.\Even then, I just want to laugh it off.\People will be people.\Huh? response:	Was she singing?
context: Sakai.\Whatcha doing here?\Oh, Tanaka-kun?\I'm back.\Even then, I just want to laugh it off.\People will be people.\Huh?\Was she singing? response:	Today a holiday or something?
context: Whatcha doing here?\Oh, Tanaka-kun?\I'm back.\Even then, I just want to laugh it off.\People will be people.\Huh?\Was she singing?\Today a holiday or something? response:	Why?!
context: Oh, Tanaka-kun?\I'm back.\Even then, I just want to laugh it off.\People will be people.\Huh?\Was she singing?\Today a holiday or something?\Why?! response:	Were you just singing?
context: I'm back.\Even then, I just want to laugh it off.\People will be people.\Huh?\Was she singing?\Today a holiday or something?\Why?!\Were you just singing? response:	So this is sukiyaki?
context: Even then, I just want to laugh it off.\People will be people.\Huh?\Was she singing?\Today a holiday or something?\Why?!\Were you just singing?\So this is sukiyaki? response:	Two cakes, please.
context: People will be people.\Huh?\Was she singing?\Today a holiday or something?\Why?!\Were you just singing?\So this is sukiyaki?\Two cakes, please. response:	This is our last chance!
context: Huh?\Was she singing?\Today a holiday or something?\Why?!\Were you just singing?\So this is sukiyaki?\Two cakes, please.\This is our last chance! response:	Episode 2 Gathering and Struggling
context: Was she singing?\Today a holiday or something?\Why?!\Were you just singing?\So this is sukiyaki?\Two cakes, please.\This is our last chance!\Episode 2 Gathering and Struggling response:	Sakai-san, I'm going to find the answer you wanted last time.