context: Alright! response:	Take this!
context: Alright!\Take this! response:	You're mine!
context: Alright!\Take this!\You're mine! response:	Now that we've found more members,
context: Alright!\Take this!\You're mine!\Now that we've found more members, response:	the Little Busters seems even more like a baseball team.
context: Alright!\Take this!\You're mine!\Now that we've found more members,\the Little Busters seems even more like a baseball team. response:	I'm sorry...
context: Alright!\Take this!\You're mine!\Now that we've found more members,\the Little Busters seems even more like a baseball team.\I'm sorry... response:	Leave it to me, Kudryavka-kun!
context: Alright!\Take this!\You're mine!\Now that we've found more members,\the Little Busters seems even more like a baseball team.\I'm sorry...\Leave it to me, Kudryavka-kun! response:	We've got this!
context: Alright!\Take this!\You're mine!\Now that we've found more members,\the Little Busters seems even more like a baseball team.\I'm sorry...\Leave it to me, Kudryavka-kun!\We've got this! response:	Home run!
context: Take this!\You're mine!\Now that we've found more members,\the Little Busters seems even more like a baseball team.\I'm sorry...\Leave it to me, Kudryavka-kun!\We've got this!\Home run! response:	What the heck are you doing, Cuckoogayer?!
context: You're mine!\Now that we've found more members,\the Little Busters seems even more like a baseball team.\I'm sorry...\Leave it to me, Kudryavka-kun!\We've got this!\Home run!\What the heck are you doing, Cuckoogayer?! response:	That was your own fault.
context: Now that we've found more members,\the Little Busters seems even more like a baseball team.\I'm sorry...\Leave it to me, Kudryavka-kun!\We've got this!\Home run!\What the heck are you doing, Cuckoogayer?!\That was your own fault. response:	What was that?!
context: the Little Busters seems even more like a baseball team.\I'm sorry...\Leave it to me, Kudryavka-kun!\We've got this!\Home run!\What the heck are you doing, Cuckoogayer?!\That was your own fault.\What was that?! response:	Show some respect for Muscles!
context: I'm sorry...\Leave it to me, Kudryavka-kun!\We've got this!\Home run!\What the heck are you doing, Cuckoogayer?!\That was your own fault.\What was that?!\Show some respect for Muscles! response:	You're what I can't respect.
context: Leave it to me, Kudryavka-kun!\We've got this!\Home run!\What the heck are you doing, Cuckoogayer?!\That was your own fault.\What was that?!\Show some respect for Muscles!\You're what I can't respect. response:	This really is the best.
context: We've got this!\Home run!\What the heck are you doing, Cuckoogayer?!\That was your own fault.\What was that?!\Show some respect for Muscles!\You're what I can't respect.\This really is the best. response:	But fun times like this can't go on forever.
context: Home run!\What the heck are you doing, Cuckoogayer?!\That was your own fault.\What was that?!\Show some respect for Muscles!\You're what I can't respect.\This really is the best.\But fun times like this can't go on forever. response:	Kyousuke will graduate in less than a year.
context: What the heck are you doing, Cuckoogayer?!\That was your own fault.\What was that?!\Show some respect for Muscles!\You're what I can't respect.\This really is the best.\But fun times like this can't go on forever.\Kyousuke will graduate in less than a year. response:	It won't be long before we all go our separate ways.
context: That was your own fault.\What was that?!\Show some respect for Muscles!\You're what I can't respect.\This really is the best.\But fun times like this can't go on forever.\Kyousuke will graduate in less than a year.\It won't be long before we all go our separate ways. response:	Strike!
context: What was that?!\Show some respect for Muscles!\You're what I can't respect.\This really is the best.\But fun times like this can't go on forever.\Kyousuke will graduate in less than a year.\It won't be long before we all go our separate ways.\Strike! response:	I did it!
context: Show some respect for Muscles!\You're what I can't respect.\This really is the best.\But fun times like this can't go on forever.\Kyousuke will graduate in less than a year.\It won't be long before we all go our separate ways.\Strike!\I did it! response:	That's your first strike ever, Rin.
context: You're what I can't respect.\This really is the best.\But fun times like this can't go on forever.\Kyousuke will graduate in less than a year.\It won't be long before we all go our separate ways.\Strike!\I did it!\That's your first strike ever, Rin. response:	You can call me the Fastball King from now on!
context: This really is the best.\But fun times like this can't go on forever.\Kyousuke will graduate in less than a year.\It won't be long before we all go our separate ways.\Strike!\I did it!\That's your first strike ever, Rin.\You can call me the Fastball King from now on! response:	Hey! Fastball King!
context: But fun times like this can't go on forever.\Kyousuke will graduate in less than a year.\It won't be long before we all go our separate ways.\Strike!\I did it!\That's your first strike ever, Rin.\You can call me the Fastball King from now on!\Hey! Fastball King! response:	I wonder why...
context: Kyousuke will graduate in less than a year.\It won't be long before we all go our separate ways.\Strike!\I did it!\That's your first strike ever, Rin.\You can call me the Fastball King from now on!\Hey! Fastball King!\I wonder why... response:	At that very moment,
context: It won't be long before we all go our separate ways.\Strike!\I did it!\That's your first strike ever, Rin.\You can call me the Fastball King from now on!\Hey! Fastball King!\I wonder why...\At that very moment, response:	I recalled that mysterious letter.
context: Strike!\I did it!\That's your first strike ever, Rin.\You can call me the Fastball King from now on!\Hey! Fastball King!\I wonder why...\At that very moment,\I recalled that mysterious letter. response:	Yay!
context: I did it!\That's your first strike ever, Rin.\You can call me the Fastball King from now on!\Hey! Fastball King!\I wonder why...\At that very moment,\I recalled that mysterious letter.\Yay! response:	Komari-chan's homemade chocolate cookies!
context: That's your first strike ever, Rin.\You can call me the Fastball King from now on!\Hey! Fastball King!\I wonder why...\At that very moment,\I recalled that mysterious letter.\Yay!\Komari-chan's homemade chocolate cookies! response:	Down the hatch!
context: You can call me the Fastball King from now on!\Hey! Fastball King!\I wonder why...\At that very moment,\I recalled that mysterious letter.\Yay!\Komari-chan's homemade chocolate cookies!\Down the hatch! response:	Wafu!
context: Hey! Fastball King!\I wonder why...\At that very moment,\I recalled that mysterious letter.\Yay!\Komari-chan's homemade chocolate cookies!\Down the hatch!\Wafu! response:	Thank you very much!
context: I wonder why...\At that very moment,\I recalled that mysterious letter.\Yay!\Komari-chan's homemade chocolate cookies!\Down the hatch!\Wafu!\Thank you very much! response:	Hey, Rin-chan, why don't you eat with us?
context: At that very moment,\I recalled that mysterious letter.\Yay!\Komari-chan's homemade chocolate cookies!\Down the hatch!\Wafu!\Thank you very much!\Hey, Rin-chan, why don't you eat with us? response:	They're delicious!
context: I recalled that mysterious letter.\Yay!\Komari-chan's homemade chocolate cookies!\Down the hatch!\Wafu!\Thank you very much!\Hey, Rin-chan, why don't you eat with us?\They're delicious! response:	Bye.
context: Yay!\Komari-chan's homemade chocolate cookies!\Down the hatch!\Wafu!\Thank you very much!\Hey, Rin-chan, why don't you eat with us?\They're delicious!\Bye. response:	But they're so good...
context: Komari-chan's homemade chocolate cookies!\Down the hatch!\Wafu!\Thank you very much!\Hey, Rin-chan, why don't you eat with us?\They're delicious!\Bye.\But they're so good... response:	That's too bad.
context: Down the hatch!\Wafu!\Thank you very much!\Hey, Rin-chan, why don't you eat with us?\They're delicious!\Bye.\But they're so good...\That's too bad. response:	It seems there's still no cure for Rin-kun's shyness.
context: Wafu!\Thank you very much!\Hey, Rin-chan, why don't you eat with us?\They're delicious!\Bye.\But they're so good...\That's too bad.\It seems there's still no cure for Rin-kun's shyness. response:	Rin, what about the other girls?
context: Thank you very much!\Hey, Rin-chan, why don't you eat with us?\They're delicious!\Bye.\But they're so good...\That's too bad.\It seems there's still no cure for Rin-kun's shyness.\Rin, what about the other girls? response:	Shut up!
context: Hey, Rin-chan, why don't you eat with us?\They're delicious!\Bye.\But they're so good...\That's too bad.\It seems there's still no cure for Rin-kun's shyness.\Rin, what about the other girls?\Shut up! response:	Why do you guys have whiskers?
context: They're delicious!\Bye.\But they're so good...\That's too bad.\It seems there's still no cure for Rin-kun's shyness.\Rin, what about the other girls?\Shut up!\Why do you guys have whiskers? response:	Are whiskers that handy?
context: Bye.\But they're so good...\That's too bad.\It seems there's still no cure for Rin-kun's shyness.\Rin, what about the other girls?\Shut up!\Why do you guys have whiskers?\Are whiskers that handy? response:	Don't they get in the way?
context: But they're so good...\That's too bad.\It seems there's still no cure for Rin-kun's shyness.\Rin, what about the other girls?\Shut up!\Why do you guys have whiskers?\Are whiskers that handy?\Don't they get in the way? response:	Like when you're drinking milk.
context: That's too bad.\It seems there's still no cure for Rin-kun's shyness.\Rin, what about the other girls?\Shut up!\Why do you guys have whiskers?\Are whiskers that handy?\Don't they get in the way?\Like when you're drinking milk. response:	Boing, boing.
context: It seems there's still no cure for Rin-kun's shyness.\Rin, what about the other girls?\Shut up!\Why do you guys have whiskers?\Are whiskers that handy?\Don't they get in the way?\Like when you're drinking milk.\Boing, boing. response:	Boing. Boing!
context: Rin, what about the other girls?\Shut up!\Why do you guys have whiskers?\Are whiskers that handy?\Don't they get in the way?\Like when you're drinking milk.\Boing, boing.\Boing. Boing! response:	Oh no!
context: Shut up!\Why do you guys have whiskers?\Are whiskers that handy?\Don't they get in the way?\Like when you're drinking milk.\Boing, boing.\Boing. Boing!\Oh no! response:	Stick back on! Stick back!
context: Why do you guys have whiskers?\Are whiskers that handy?\Don't they get in the way?\Like when you're drinking milk.\Boing, boing.\Boing. Boing!\Oh no!\Stick back on! Stick back! response:	It won't...
context: Are whiskers that handy?\Don't they get in the way?\Like when you're drinking milk.\Boing, boing.\Boing. Boing!\Oh no!\Stick back on! Stick back!\It won't... response:	What now?
context: Don't they get in the way?\Like when you're drinking milk.\Boing, boing.\Boing. Boing!\Oh no!\Stick back on! Stick back!\It won't...\What now? response:	Should I get hair tonic?
context: Like when you're drinking milk.\Boing, boing.\Boing. Boing!\Oh no!\Stick back on! Stick back!\It won't...\What now?\Should I get hair tonic? response:	Is that something I should ask a cat?
context: Boing, boing.\Boing. Boing!\Oh no!\Stick back on! Stick back!\It won't...\What now?\Should I get hair tonic?\Is that something I should ask a cat? response:	Another fell out?!
context: Boing. Boing!\Oh no!\Stick back on! Stick back!\It won't...\What now?\Should I get hair tonic?\Is that something I should ask a cat?\Another fell out?! response:	Or... are you just shedding?
context: Oh no!\Stick back on! Stick back!\It won't...\What now?\Should I get hair tonic?\Is that something I should ask a cat?\Another fell out?!\Or... are you just shedding? response:	Oh, okay...
context: Stick back on! Stick back!\It won't...\What now?\Should I get hair tonic?\Is that something I should ask a cat?\Another fell out?!\Or... are you just shedding?\Oh, okay... response:	It's Riki!
context: It won't...\What now?\Should I get hair tonic?\Is that something I should ask a cat?\Another fell out?!\Or... are you just shedding?\Oh, okay...\It's Riki! response:	Hey, Rin, why don't you try getting closer to the girls?
context: What now?\Should I get hair tonic?\Is that something I should ask a cat?\Another fell out?!\Or... are you just shedding?\Oh, okay...\It's Riki!\Hey, Rin, why don't you try getting closer to the girls? response:	I've told you this plenty of times.
context: Should I get hair tonic?\Is that something I should ask a cat?\Another fell out?!\Or... are you just shedding?\Oh, okay...\It's Riki!\Hey, Rin, why don't you try getting closer to the girls?\I've told you this plenty of times. response:	Masato, Kengo, and I can't hang around with you forever.
context: Is that something I should ask a cat?\Another fell out?!\Or... are you just shedding?\Oh, okay...\It's Riki!\Hey, Rin, why don't you try getting closer to the girls?\I've told you this plenty of times.\Masato, Kengo, and I can't hang around with you forever. response:	When we all graduate, you'll...
context: Another fell out?!\Or... are you just shedding?\Oh, okay...\It's Riki!\Hey, Rin, why don't you try getting closer to the girls?\I've told you this plenty of times.\Masato, Kengo, and I can't hang around with you forever.\When we all graduate, you'll... response:	Mind your own beeswax.
context: Or... are you just shedding?\Oh, okay...\It's Riki!\Hey, Rin, why don't you try getting closer to the girls?\I've told you this plenty of times.\Masato, Kengo, and I can't hang around with you forever.\When we all graduate, you'll...\Mind your own beeswax. response:	Hey! Don't!
context: Oh, okay...\It's Riki!\Hey, Rin, why don't you try getting closer to the girls?\I've told you this plenty of times.\Masato, Kengo, and I can't hang around with you forever.\When we all graduate, you'll...\Mind your own beeswax.\Hey! Don't! response:	Quit it!
context: It's Riki!\Hey, Rin, why don't you try getting closer to the girls?\I've told you this plenty of times.\Masato, Kengo, and I can't hang around with you forever.\When we all graduate, you'll...\Mind your own beeswax.\Hey! Don't!\Quit it! response:	Huh?
context: Hey, Rin, why don't you try getting closer to the girls?\I've told you this plenty of times.\Masato, Kengo, and I can't hang around with you forever.\When we all graduate, you'll...\Mind your own beeswax.\Hey! Don't!\Quit it!\Huh? response:	Riki!
context: I've told you this plenty of times.\Masato, Kengo, and I can't hang around with you forever.\When we all graduate, you'll...\Mind your own beeswax.\Hey! Don't!\Quit it!\Huh?\Riki! response:	Lennon brought another letter!
context: Masato, Kengo, and I can't hang around with you forever.\When we all graduate, you'll...\Mind your own beeswax.\Hey! Don't!\Quit it!\Huh?\Riki!\Lennon brought another letter! response:	It's been a while!
context: When we all graduate, you'll...\Mind your own beeswax.\Hey! Don't!\Quit it!\Huh?\Riki!\Lennon brought another letter!\It's been a while! response:	A letter?
context: Mind your own beeswax.\Hey! Don't!\Quit it!\Huh?\Riki!\Lennon brought another letter!\It's been a while!\A letter? response:	Those mysterious letters.
context: Hey! Don't!\Quit it!\Huh?\Riki!\Lennon brought another letter!\It's been a while!\A letter?\Those mysterious letters. response:	If we clear all the tasks, they said they'd tell us the secret of the world.
context: Quit it!\Huh?\Riki!\Lennon brought another letter!\It's been a while!\A letter?\Those mysterious letters.\If we clear all the tasks, they said they'd tell us the secret of the world. response:	We have a second task here.
context: Huh?\Riki!\Lennon brought another letter!\It's been a while!\A letter?\Those mysterious letters.\If we clear all the tasks, they said they'd tell us the secret of the world.\We have a second task here. response:	What is it?
context: Riki!\Lennon brought another letter!\It's been a while!\A letter?\Those mysterious letters.\If we clear all the tasks, they said they'd tell us the secret of the world.\We have a second task here.\What is it? response:	Save the cafeteria.
context: Lennon brought another letter!\It's been a while!\A letter?\Those mysterious letters.\If we clear all the tasks, they said they'd tell us the secret of the world.\We have a second task here.\What is it?\Save the cafeteria. response:	Save the cafeteria?
context: It's been a while!\A letter?\Those mysterious letters.\If we clear all the tasks, they said they'd tell us the secret of the world.\We have a second task here.\What is it?\Save the cafeteria.\Save the cafeteria? response:	Is there a problem with the cafeteria or something?
context: A letter?\Those mysterious letters.\If we clear all the tasks, they said they'd tell us the secret of the world.\We have a second task here.\What is it?\Save the cafeteria.\Save the cafeteria?\Is there a problem with the cafeteria or something? response:	I know!
context: Those mysterious letters.\If we clear all the tasks, they said they'd tell us the secret of the world.\We have a second task here.\What is it?\Save the cafeteria.\Save the cafeteria?\Is there a problem with the cafeteria or something?\I know! response:	The croquette soba is super disgusting.
context: If we clear all the tasks, they said they'd tell us the secret of the world.\We have a second task here.\What is it?\Save the cafeteria.\Save the cafeteria?\Is there a problem with the cafeteria or something?\I know!\The croquette soba is super disgusting. response:	It's a big problem.
context: We have a second task here.\What is it?\Save the cafeteria.\Save the cafeteria?\Is there a problem with the cafeteria or something?\I know!\The croquette soba is super disgusting.\It's a big problem. response:	Isn't that a matter of taste?
context: What is it?\Save the cafeteria.\Save the cafeteria?\Is there a problem with the cafeteria or something?\I know!\The croquette soba is super disgusting.\It's a big problem.\Isn't that a matter of taste? response:	The cafeteria will be saved if the croquette soba is taken off the menu.
context: Save the cafeteria.\Save the cafeteria?\Is there a problem with the cafeteria or something?\I know!\The croquette soba is super disgusting.\It's a big problem.\Isn't that a matter of taste?\The cafeteria will be saved if the croquette soba is taken off the menu. response:	Really?
context: Save the cafeteria?\Is there a problem with the cafeteria or something?\I know!\The croquette soba is super disgusting.\It's a big problem.\Isn't that a matter of taste?\The cafeteria will be saved if the croquette soba is taken off the menu.\Really? response:	Then are there any other problems?
context: Is there a problem with the cafeteria or something?\I know!\The croquette soba is super disgusting.\It's a big problem.\Isn't that a matter of taste?\The cafeteria will be saved if the croquette soba is taken off the menu.\Really?\Then are there any other problems? response:	Why don't we ask the cafeteria ladies?
context: I know!\The croquette soba is super disgusting.\It's a big problem.\Isn't that a matter of taste?\The cafeteria will be saved if the croquette soba is taken off the menu.\Really?\Then are there any other problems?\Why don't we ask the cafeteria ladies? response:	Excuse me...
context: The croquette soba is super disgusting.\It's a big problem.\Isn't that a matter of taste?\The cafeteria will be saved if the croquette soba is taken off the menu.\Really?\Then are there any other problems?\Why don't we ask the cafeteria ladies?\Excuse me... response:	Have there been any problems with the cafeteria lately?
context: It's a big problem.\Isn't that a matter of taste?\The cafeteria will be saved if the croquette soba is taken off the menu.\Really?\Then are there any other problems?\Why don't we ask the cafeteria ladies?\Excuse me...\Have there been any problems with the cafeteria lately? response:	Problems, huh?
context: Isn't that a matter of taste?\The cafeteria will be saved if the croquette soba is taken off the menu.\Really?\Then are there any other problems?\Why don't we ask the cafeteria ladies?\Excuse me...\Have there been any problems with the cafeteria lately?\Problems, huh? response:	Like any trouble or anything.
context: The cafeteria will be saved if the croquette soba is taken off the menu.\Really?\Then are there any other problems?\Why don't we ask the cafeteria ladies?\Excuse me...\Have there been any problems with the cafeteria lately?\Problems, huh?\Like any trouble or anything. response:	No, not really.
context: Really?\Then are there any other problems?\Why don't we ask the cafeteria ladies?\Excuse me...\Have there been any problems with the cafeteria lately?\Problems, huh?\Like any trouble or anything.\No, not really. response:	You all eat everything we make.
context: Then are there any other problems?\Why don't we ask the cafeteria ladies?\Excuse me...\Have there been any problems with the cafeteria lately?\Problems, huh?\Like any trouble or anything.\No, not really.\You all eat everything we make. response:	We're always happy about that.
context: Why don't we ask the cafeteria ladies?\Excuse me...\Have there been any problems with the cafeteria lately?\Problems, huh?\Like any trouble or anything.\No, not really.\You all eat everything we make.\We're always happy about that. response:	But the croquette soba is disgusting!
context: Excuse me...\Have there been any problems with the cafeteria lately?\Problems, huh?\Like any trouble or anything.\No, not really.\You all eat everything we make.\We're always happy about that.\But the croquette soba is disgusting! response:	We put that on the menu because some students requested it.
context: Have there been any problems with the cafeteria lately?\Problems, huh?\Like any trouble or anything.\No, not really.\You all eat everything we make.\We're always happy about that.\But the croquette soba is disgusting!\We put that on the menu because some students requested it. response:	They serve them at some street stalls.
context: Problems, huh?\Like any trouble or anything.\No, not really.\You all eat everything we make.\We're always happy about that.\But the croquette soba is disgusting!\We put that on the menu because some students requested it.\They serve them at some street stalls. response:	The croquettes get all mushy from the soup.
context: Like any trouble or anything.\No, not really.\You all eat everything we make.\We're always happy about that.\But the croquette soba is disgusting!\We put that on the menu because some students requested it.\They serve them at some street stalls.\The croquettes get all mushy from the soup. response:	Mushy croquettes are super disgusting!
context: No, not really.\You all eat everything we make.\We're always happy about that.\But the croquette soba is disgusting!\We put that on the menu because some students requested it.\They serve them at some street stalls.\The croquettes get all mushy from the soup.\Mushy croquettes are super disgusting! response:	Oh my.
context: You all eat everything we make.\We're always happy about that.\But the croquette soba is disgusting!\We put that on the menu because some students requested it.\They serve them at some street stalls.\The croquettes get all mushy from the soup.\Mushy croquettes are super disgusting!\Oh my. response:	Natsume Rin.
context: We're always happy about that.\But the croquette soba is disgusting!\We put that on the menu because some students requested it.\They serve them at some street stalls.\The croquettes get all mushy from the soup.\Mushy croquettes are super disgusting!\Oh my.\Natsume Rin. response:	It seems you don't understand.
context: But the croquette soba is disgusting!\We put that on the menu because some students requested it.\They serve them at some street stalls.\The croquettes get all mushy from the soup.\Mushy croquettes are super disgusting!\Oh my.\Natsume Rin.\It seems you don't understand. response:	Those who do can't live without it!
context: We put that on the menu because some students requested it.\They serve them at some street stalls.\The croquettes get all mushy from the soup.\Mushy croquettes are super disgusting!\Oh my.\Natsume Rin.\It seems you don't understand.\Those who do can't live without it! response:	Slurping a croquette soaked mushy in soup!
context: They serve them at some street stalls.\The croquettes get all mushy from the soup.\Mushy croquettes are super disgusting!\Oh my.\Natsume Rin.\It seems you don't understand.\Those who do can't live without it!\Slurping a croquette soaked mushy in soup! response:	You! Sasasasasa Sasami!
context: The croquettes get all mushy from the soup.\Mushy croquettes are super disgusting!\Oh my.\Natsume Rin.\It seems you don't understand.\Those who do can't live without it!\Slurping a croquette soaked mushy in soup!\You! Sasasasasa Sasami! response:	It's Sasasegawa Sasami!
context: Mushy croquettes are super disgusting!\Oh my.\Natsume Rin.\It seems you don't understand.\Those who do can't live without it!\Slurping a croquette soaked mushy in soup!\You! Sasasasasa Sasami!\It's Sasasegawa Sasami! response:	The sparkling ace of the softball team, and...
context: Oh my.\Natsume Rin.\It seems you don't understand.\Those who do can't live without it!\Slurping a croquette soaked mushy in soup!\You! Sasasasasa Sasami!\It's Sasasegawa Sasami!\The sparkling ace of the softball team, and... response:	Viva, croquette soba!
context: Natsume Rin.\It seems you don't understand.\Those who do can't live without it!\Slurping a croquette soaked mushy in soup!\You! Sasasasasa Sasami!\It's Sasasegawa Sasami!\The sparkling ace of the softball team, and...\Viva, croquette soba! response:	Viva, croquette soba!
context: It seems you don't understand.\Those who do can't live without it!\Slurping a croquette soaked mushy in soup!\You! Sasasasasa Sasami!\It's Sasasegawa Sasami!\The sparkling ace of the softball team, and...\Viva, croquette soba!\Viva, croquette soba! response:	So the person who requested croquette soba was...
context: Those who do can't live without it!\Slurping a croquette soaked mushy in soup!\You! Sasasasasa Sasami!\It's Sasasegawa Sasami!\The sparkling ace of the softball team, and...\Viva, croquette soba!\Viva, croquette soba!\So the person who requested croquette soba was... response:	Me.
context: Slurping a croquette soaked mushy in soup!\You! Sasasasasa Sasami!\It's Sasasegawa Sasami!\The sparkling ace of the softball team, and...\Viva, croquette soba!\Viva, croquette soba!\So the person who requested croquette soba was...\Me. response:	Is there a problem?
context: You! Sasasasasa Sasami!\It's Sasasegawa Sasami!\The sparkling ace of the softball team, and...\Viva, croquette soba!\Viva, croquette soba!\So the person who requested croquette soba was...\Me.\Is there a problem? response:	It should be taken off the menu immediately!
context: It's Sasasegawa Sasami!\The sparkling ace of the softball team, and...\Viva, croquette soba!\Viva, croquette soba!\So the person who requested croquette soba was...\Me.\Is there a problem?\It should be taken off the menu immediately! response:	Even though you like your tempura soba?
context: The sparkling ace of the softball team, and...\Viva, croquette soba!\Viva, croquette soba!\So the person who requested croquette soba was...\Me.\Is there a problem?\It should be taken off the menu immediately!\Even though you like your tempura soba? response:	I saw you last week.
context: Viva, croquette soba!\Viva, croquette soba!\So the person who requested croquette soba was...\Me.\Is there a problem?\It should be taken off the menu immediately!\Even though you like your tempura soba?\I saw you last week. response:	You were slurping up totally mushy tempura in soup.
context: Viva, croquette soba!\So the person who requested croquette soba was...\Me.\Is there a problem?\It should be taken off the menu immediately!\Even though you like your tempura soba?\I saw you last week.\You were slurping up totally mushy tempura in soup. response:	Tempura tastes good when it's mushy!
context: So the person who requested croquette soba was...\Me.\Is there a problem?\It should be taken off the menu immediately!\Even though you like your tempura soba?\I saw you last week.\You were slurping up totally mushy tempura in soup.\Tempura tastes good when it's mushy! response:	It's not the same with croquettes!
context: Me.\Is there a problem?\It should be taken off the menu immediately!\Even though you like your tempura soba?\I saw you last week.\You were slurping up totally mushy tempura in soup.\Tempura tastes good when it's mushy!\It's not the same with croquettes! response:	You insolent rogue!
context: Is there a problem?\It should be taken off the menu immediately!\Even though you like your tempura soba?\I saw you last week.\You were slurping up totally mushy tempura in soup.\Tempura tastes good when it's mushy!\It's not the same with croquettes!\You insolent rogue! response:	I will not simply stand back while you insult the mushy croquettes I love so much!
context: It should be taken off the menu immediately!\Even though you like your tempura soba?\I saw you last week.\You were slurping up totally mushy tempura in soup.\Tempura tastes good when it's mushy!\It's not the same with croquettes!\You insolent rogue!\I will not simply stand back while you insult the mushy croquettes I love so much! response:	Um... Excuse me...
context: Even though you like your tempura soba?\I saw you last week.\You were slurping up totally mushy tempura in soup.\Tempura tastes good when it's mushy!\It's not the same with croquettes!\You insolent rogue!\I will not simply stand back while you insult the mushy croquettes I love so much!\Um... Excuse me... response:	Silence, outfielder!
context: I saw you last week.\You were slurping up totally mushy tempura in soup.\Tempura tastes good when it's mushy!\It's not the same with croquettes!\You insolent rogue!\I will not simply stand back while you insult the mushy croquettes I love so much!\Um... Excuse me...\Silence, outfielder! response:	I'm a catcher...
context: You were slurping up totally mushy tempura in soup.\Tempura tastes good when it's mushy!\It's not the same with croquettes!\You insolent rogue!\I will not simply stand back while you insult the mushy croquettes I love so much!\Um... Excuse me...\Silence, outfielder!\I'm a catcher... response:	Girls! You know what to do!
context: Tempura tastes good when it's mushy!\It's not the same with croquettes!\You insolent rogue!\I will not simply stand back while you insult the mushy croquettes I love so much!\Um... Excuse me...\Silence, outfielder!\I'm a catcher...\Girls! You know what to do! response:	Like this?!
context: It's not the same with croquettes!\You insolent rogue!\I will not simply stand back while you insult the mushy croquettes I love so much!\Um... Excuse me...\Silence, outfielder!\I'm a catcher...\Girls! You know what to do!\Like this?! response:	Ow! Take this!
context: You insolent rogue!\I will not simply stand back while you insult the mushy croquettes I love so much!\Um... Excuse me...\Silence, outfielder!\I'm a catcher...\Girls! You know what to do!\Like this?!\Ow! Take this! response:	What now?
context: I will not simply stand back while you insult the mushy croquettes I love so much!\Um... Excuse me...\Silence, outfielder!\I'm a catcher...\Girls! You know what to do!\Like this?!\Ow! Take this!\What now? response:	How can you be so useless?!
context: Um... Excuse me...\Silence, outfielder!\I'm a catcher...\Girls! You know what to do!\Like this?!\Ow! Take this!\What now?\How can you be so useless?! response:	I'll handle this myself!
context: Silence, outfielder!\I'm a catcher...\Girls! You know what to do!\Like this?!\Ow! Take this!\What now?\How can you be so useless?!\I'll handle this myself! response:	Ow!
context: I'm a catcher...\Girls! You know what to do!\Like this?!\Ow! Take this!\What now?\How can you be so useless?!\I'll handle this myself!\Ow! response:	Take this!
context: Girls! You know what to do!\Like this?!\Ow! Take this!\What now?\How can you be so useless?!\I'll handle this myself!\Ow!\Take this! response:	Now we know who's right!
context: Like this?!\Ow! Take this!\What now?\How can you be so useless?!\I'll handle this myself!\Ow!\Take this!\Now we know who's right! response:	Viva, croquette soba!
context: Ow! Take this!\What now?\How can you be so useless?!\I'll handle this myself!\Ow!\Take this!\Now we know who's right!\Viva, croquette soba! response:	Damn it...
context: What now?\How can you be so useless?!\I'll handle this myself!\Ow!\Take this!\Now we know who's right!\Viva, croquette soba!\Damn it... response:	So how are we supposed to save the cafeteria?
context: How can you be so useless?!\I'll handle this myself!\Ow!\Take this!\Now we know who's right!\Viva, croquette soba!\Damn it...\So how are we supposed to save the cafeteria? response:	No idea...
context: I'll handle this myself!\Ow!\Take this!\Now we know who's right!\Viva, croquette soba!\Damn it...\So how are we supposed to save the cafeteria?\No idea... response:	Besides, we don't even know if there's a meaning to those letters in the first place.
context: Ow!\Take this!\Now we know who's right!\Viva, croquette soba!\Damn it...\So how are we supposed to save the cafeteria?\No idea...\Besides, we don't even know if there's a meaning to those letters in the first place. response:	We don't know who's writing them, either.
context: Take this!\Now we know who's right!\Viva, croquette soba!\Damn it...\So how are we supposed to save the cafeteria?\No idea...\Besides, we don't even know if there's a meaning to those letters in the first place.\We don't know who's writing them, either. response:	But if we clear all the tasks, they'll tell us the secret of the world!
context: Now we know who's right!\Viva, croquette soba!\Damn it...\So how are we supposed to save the cafeteria?\No idea...\Besides, we don't even know if there's a meaning to those letters in the first place.\We don't know who's writing them, either.\But if we clear all the tasks, they'll tell us the secret of the world! response:	I wonder what the secret of the world is...
context: Viva, croquette soba!\Damn it...\So how are we supposed to save the cafeteria?\No idea...\Besides, we don't even know if there's a meaning to those letters in the first place.\We don't know who's writing them, either.\But if we clear all the tasks, they'll tell us the secret of the world!\I wonder what the secret of the world is... response:	Rin was set on doing it until she learned the secret.
context: Damn it...\So how are we supposed to save the cafeteria?\No idea...\Besides, we don't even know if there's a meaning to those letters in the first place.\We don't know who's writing them, either.\But if we clear all the tasks, they'll tell us the secret of the world!\I wonder what the secret of the world is...\Rin was set on doing it until she learned the secret. response:	The same way she would keep buying snacks until she won a free one.
context: So how are we supposed to save the cafeteria?\No idea...\Besides, we don't even know if there's a meaning to those letters in the first place.\We don't know who's writing them, either.\But if we clear all the tasks, they'll tell us the secret of the world!\I wonder what the secret of the world is...\Rin was set on doing it until she learned the secret.\The same way she would keep buying snacks until she won a free one. response:	The way she did when she was young.
context: No idea...\Besides, we don't even know if there's a meaning to those letters in the first place.\We don't know who's writing them, either.\But if we clear all the tasks, they'll tell us the secret of the world!\I wonder what the secret of the world is...\Rin was set on doing it until she learned the secret.\The same way she would keep buying snacks until she won a free one.\The way she did when she was young. response:	But what kind of secret could this world have?
context: Besides, we don't even know if there's a meaning to those letters in the first place.\We don't know who's writing them, either.\But if we clear all the tasks, they'll tell us the secret of the world!\I wonder what the secret of the world is...\Rin was set on doing it until she learned the secret.\The same way she would keep buying snacks until she won a free one.\The way she did when she was young.\But what kind of secret could this world have? response:	All there is here is an unchanging everyday life.
context: We don't know who's writing them, either.\But if we clear all the tasks, they'll tell us the secret of the world!\I wonder what the secret of the world is...\Rin was set on doing it until she learned the secret.\The same way she would keep buying snacks until she won a free one.\The way she did when she was young.\But what kind of secret could this world have?\All there is here is an unchanging everyday life. response:	But...
context: But if we clear all the tasks, they'll tell us the secret of the world!\I wonder what the secret of the world is...\Rin was set on doing it until she learned the secret.\The same way she would keep buying snacks until she won a free one.\The way she did when she was young.\But what kind of secret could this world have?\All there is here is an unchanging everyday life.\But... response:	If I had to name something that made me uneasy, it would be...
context: I wonder what the secret of the world is...\Rin was set on doing it until she learned the secret.\The same way she would keep buying snacks until she won a free one.\The way she did when she was young.\But what kind of secret could this world have?\All there is here is an unchanging everyday life.\But...\If I had to name something that made me uneasy, it would be... response:	Narcolepsy.
context: Rin was set on doing it until she learned the secret.\The same way she would keep buying snacks until she won a free one.\The way she did when she was young.\But what kind of secret could this world have?\All there is here is an unchanging everyday life.\But...\If I had to name something that made me uneasy, it would be...\Narcolepsy. response:	I don't know when I might fall asleep.
context: The same way she would keep buying snacks until she won a free one.\The way she did when she was young.\But what kind of secret could this world have?\All there is here is an unchanging everyday life.\But...\If I had to name something that made me uneasy, it would be...\Narcolepsy.\I don't know when I might fall asleep. response:	Without any warning.
context: The way she did when she was young.\But what kind of secret could this world have?\All there is here is an unchanging everyday life.\But...\If I had to name something that made me uneasy, it would be...\Narcolepsy.\I don't know when I might fall asleep.\Without any warning. response:	Riki, this is bad!
context: But what kind of secret could this world have?\All there is here is an unchanging everyday life.\But...\If I had to name something that made me uneasy, it would be...\Narcolepsy.\I don't know when I might fall asleep.\Without any warning.\Riki, this is bad! response:	Listen, it's really bad!
context: All there is here is an unchanging everyday life.\But...\If I had to name something that made me uneasy, it would be...\Narcolepsy.\I don't know when I might fall asleep.\Without any warning.\Riki, this is bad!\Listen, it's really bad! response:	Okay.
context: But...\If I had to name something that made me uneasy, it would be...\Narcolepsy.\I don't know when I might fall asleep.\Without any warning.\Riki, this is bad!\Listen, it's really bad!\Okay. response:	I was shocked, too.
context: If I had to name something that made me uneasy, it would be...\Narcolepsy.\I don't know when I might fall asleep.\Without any warning.\Riki, this is bad!\Listen, it's really bad!\Okay.\I was shocked, too. response:	It gave me the shivers!
context: Narcolepsy.\I don't know when I might fall asleep.\Without any warning.\Riki, this is bad!\Listen, it's really bad!\Okay.\I was shocked, too.\It gave me the shivers! response:	Okay, just tell me.
context: I don't know when I might fall asleep.\Without any warning.\Riki, this is bad!\Listen, it's really bad!\Okay.\I was shocked, too.\It gave me the shivers!\Okay, just tell me. response:	Listen, it's really bad!
context: Without any warning.\Riki, this is bad!\Listen, it's really bad!\Okay.\I was shocked, too.\It gave me the shivers!\Okay, just tell me.\Listen, it's really bad! response:	I'm listening as hard as I can!
context: Riki, this is bad!\Listen, it's really bad!\Okay.\I was shocked, too.\It gave me the shivers!\Okay, just tell me.\Listen, it's really bad!\I'm listening as hard as I can! response:	None of the cafeteria ladies are there.
context: Listen, it's really bad!\Okay.\I was shocked, too.\It gave me the shivers!\Okay, just tell me.\Listen, it's really bad!\I'm listening as hard as I can!\None of the cafeteria ladies are there. response:	Man, I'm hungry.
context: Okay.\I was shocked, too.\It gave me the shivers!\Okay, just tell me.\Listen, it's really bad!\I'm listening as hard as I can!\None of the cafeteria ladies are there.\Man, I'm hungry. response:	Wake up already!
context: I was shocked, too.\It gave me the shivers!\Okay, just tell me.\Listen, it's really bad!\I'm listening as hard as I can!\None of the cafeteria ladies are there.\Man, I'm hungry.\Wake up already! response:	Hurry and come with me!
context: It gave me the shivers!\Okay, just tell me.\Listen, it's really bad!\I'm listening as hard as I can!\None of the cafeteria ladies are there.\Man, I'm hungry.\Wake up already!\Hurry and come with me! response:	Look.
context: Okay, just tell me.\Listen, it's really bad!\I'm listening as hard as I can!\None of the cafeteria ladies are there.\Man, I'm hungry.\Wake up already!\Hurry and come with me!\Look. response:	The cafeteria ladies usually start preparing dinner around now,
context: Listen, it's really bad!\I'm listening as hard as I can!\None of the cafeteria ladies are there.\Man, I'm hungry.\Wake up already!\Hurry and come with me!\Look.\The cafeteria ladies usually start preparing dinner around now, response:	but none of them are there.
context: I'm listening as hard as I can!\None of the cafeteria ladies are there.\Man, I'm hungry.\Wake up already!\Hurry and come with me!\Look.\The cafeteria ladies usually start preparing dinner around now,\but none of them are there. response:	None of them?
context: None of the cafeteria ladies are there.\Man, I'm hungry.\Wake up already!\Hurry and come with me!\Look.\The cafeteria ladies usually start preparing dinner around now,\but none of them are there.\None of them? response:	Why?
context: Man, I'm hungry.\Wake up already!\Hurry and come with me!\Look.\The cafeteria ladies usually start preparing dinner around now,\but none of them are there.\None of them?\Why? response:	There was one until a few minutes ago.
context: Wake up already!\Hurry and come with me!\Look.\The cafeteria ladies usually start preparing dinner around now,\but none of them are there.\None of them?\Why?\There was one until a few minutes ago. response:	But she suddenly felt dizzy and went to the hospital.
context: Hurry and come with me!\Look.\The cafeteria ladies usually start preparing dinner around now,\but none of them are there.\None of them?\Why?\There was one until a few minutes ago.\But she suddenly felt dizzy and went to the hospital. response:	The other ladies had emergencies, so they left early.
context: Look.\The cafeteria ladies usually start preparing dinner around now,\but none of them are there.\None of them?\Why?\There was one until a few minutes ago.\But she suddenly felt dizzy and went to the hospital.\The other ladies had emergencies, so they left early. response:	And there were already two out sick today, too.
context: The cafeteria ladies usually start preparing dinner around now,\but none of them are there.\None of them?\Why?\There was one until a few minutes ago.\But she suddenly felt dizzy and went to the hospital.\The other ladies had emergencies, so they left early.\And there were already two out sick today, too. response:	All of them had to leave?
context: but none of them are there.\None of them?\Why?\There was one until a few minutes ago.\But she suddenly felt dizzy and went to the hospital.\The other ladies had emergencies, so they left early.\And there were already two out sick today, too.\All of them had to leave? response:	Is that even possible?
context: None of them?\Why?\There was one until a few minutes ago.\But she suddenly felt dizzy and went to the hospital.\The other ladies had emergencies, so they left early.\And there were already two out sick today, too.\All of them had to leave?\Is that even possible? response:	Either way, there isn't anyone here to make dinner!
context: Why?\There was one until a few minutes ago.\But she suddenly felt dizzy and went to the hospital.\The other ladies had emergencies, so they left early.\And there were already two out sick today, too.\All of them had to leave?\Is that even possible?\Either way, there isn't anyone here to make dinner! response:	But that means...
context: There was one until a few minutes ago.\But she suddenly felt dizzy and went to the hospital.\The other ladies had emergencies, so they left early.\And there were already two out sick today, too.\All of them had to leave?\Is that even possible?\Either way, there isn't anyone here to make dinner!\But that means... response:	Where am I gonna get dinner?!
context: But she suddenly felt dizzy and went to the hospital.\The other ladies had emergencies, so they left early.\And there were already two out sick today, too.\All of them had to leave?\Is that even possible?\Either way, there isn't anyone here to make dinner!\But that means...\Where am I gonna get dinner?! response:	My stomach's howling like a wild animal here!
context: The other ladies had emergencies, so they left early.\And there were already two out sick today, too.\All of them had to leave?\Is that even possible?\Either way, there isn't anyone here to make dinner!\But that means...\Where am I gonna get dinner?!\My stomach's howling like a wild animal here! response:	We'll make it.
context: And there were already two out sick today, too.\All of them had to leave?\Is that even possible?\Either way, there isn't anyone here to make dinner!\But that means...\Where am I gonna get dinner?!\My stomach's howling like a wild animal here!\We'll make it. response:	For the whole school!
context: All of them had to leave?\Is that even possible?\Either way, there isn't anyone here to make dinner!\But that means...\Where am I gonna get dinner?!\My stomach's howling like a wild animal here!\We'll make it.\For the whole school! response:	We're saving the cafeteria!
context: Is that even possible?\Either way, there isn't anyone here to make dinner!\But that means...\Where am I gonna get dinner?!\My stomach's howling like a wild animal here!\We'll make it.\For the whole school!\We're saving the cafeteria! response:	We're out of time!
context: Either way, there isn't anyone here to make dinner!\But that means...\Where am I gonna get dinner?!\My stomach's howling like a wild animal here!\We'll make it.\For the whole school!\We're saving the cafeteria!\We're out of time! response:	If we don't start now, we won't make it in time!
context: But that means...\Where am I gonna get dinner?!\My stomach's howling like a wild animal here!\We'll make it.\For the whole school!\We're saving the cafeteria!\We're out of time!\If we don't start now, we won't make it in time! response:	Help me!
context: Where am I gonna get dinner?!\My stomach's howling like a wild animal here!\We'll make it.\For the whole school!\We're saving the cafeteria!\We're out of time!\If we don't start now, we won't make it in time!\Help me! response:	I can't do it alone!
context: My stomach's howling like a wild animal here!\We'll make it.\For the whole school!\We're saving the cafeteria!\We're out of time!\If we don't start now, we won't make it in time!\Help me!\I can't do it alone! response:	But...
context: We'll make it.\For the whole school!\We're saving the cafeteria!\We're out of time!\If we don't start now, we won't make it in time!\Help me!\I can't do it alone!\But... response:	There's a massive number of students in this school.
context: For the whole school!\We're saving the cafeteria!\We're out of time!\If we don't start now, we won't make it in time!\Help me!\I can't do it alone!\But...\There's a massive number of students in this school. response:	It's impossible for just the three of us to handle.
context: We're saving the cafeteria!\We're out of time!\If we don't start now, we won't make it in time!\Help me!\I can't do it alone!\But...\There's a massive number of students in this school.\It's impossible for just the three of us to handle. response:	Once upon a time, there was a penguin.
context: We're out of time!\If we don't start now, we won't make it in time!\Help me!\I can't do it alone!\But...\There's a massive number of students in this school.\It's impossible for just the three of us to handle.\Once upon a time, there was a penguin. response:	It's so cute!
context: If we don't start now, we won't make it in time!\Help me!\I can't do it alone!\But...\There's a massive number of students in this school.\It's impossible for just the three of us to handle.\Once upon a time, there was a penguin.\It's so cute! response:	Komari-chan! I have a favor to ask!
context: Help me!\I can't do it alone!\But...\There's a massive number of students in this school.\It's impossible for just the three of us to handle.\Once upon a time, there was a penguin.\It's so cute!\Komari-chan! I have a favor to ask! response:	It's an emergency!
context: I can't do it alone!\But...\There's a massive number of students in this school.\It's impossible for just the three of us to handle.\Once upon a time, there was a penguin.\It's so cute!\Komari-chan! I have a favor to ask!\It's an emergency! response:	Okay?
context: But...\There's a massive number of students in this school.\It's impossible for just the three of us to handle.\Once upon a time, there was a penguin.\It's so cute!\Komari-chan! I have a favor to ask!\It's an emergency!\Okay? response:	Please!
context: There's a massive number of students in this school.\It's impossible for just the three of us to handle.\Once upon a time, there was a penguin.\It's so cute!\Komari-chan! I have a favor to ask!\It's an emergency!\Okay?\Please! response:	Oh?
context: It's impossible for just the three of us to handle.\Once upon a time, there was a penguin.\It's so cute!\Komari-chan! I have a favor to ask!\It's an emergency!\Okay?\Please!\Oh? response:	You came all the way out here to ask for my help?
context: Once upon a time, there was a penguin.\It's so cute!\Komari-chan! I have a favor to ask!\It's an emergency!\Okay?\Please!\Oh?\You came all the way out here to ask for my help? response:	It must be quite a crisis.
context: It's so cute!\Komari-chan! I have a favor to ask!\It's an emergency!\Okay?\Please!\Oh?\You came all the way out here to ask for my help?\It must be quite a crisis. response:	I see.
context: Komari-chan! I have a favor to ask!\It's an emergency!\Okay?\Please!\Oh?\You came all the way out here to ask for my help?\It must be quite a crisis.\I see. response:	I understand the situation.
context: It's an emergency!\Okay?\Please!\Oh?\You came all the way out here to ask for my help?\It must be quite a crisis.\I see.\I understand the situation. response:	Making dinner for every student in the school will be no easy feat.
context: Okay?\Please!\Oh?\You came all the way out here to ask for my help?\It must be quite a crisis.\I see.\I understand the situation.\Making dinner for every student in the school will be no easy feat. response:	But it seems you intend to do it.
context: Please!\Oh?\You came all the way out here to ask for my help?\It must be quite a crisis.\I see.\I understand the situation.\Making dinner for every student in the school will be no easy feat.\But it seems you intend to do it. response:	Yeah.
context: Oh?\You came all the way out here to ask for my help?\It must be quite a crisis.\I see.\I understand the situation.\Making dinner for every student in the school will be no easy feat.\But it seems you intend to do it.\Yeah. response:	This has to be the first time you've ever pulled everyone together.
context: You came all the way out here to ask for my help?\It must be quite a crisis.\I see.\I understand the situation.\Making dinner for every student in the school will be no easy feat.\But it seems you intend to do it.\Yeah.\This has to be the first time you've ever pulled everyone together. response:	But it's strange...
context: It must be quite a crisis.\I see.\I understand the situation.\Making dinner for every student in the school will be no easy feat.\But it seems you intend to do it.\Yeah.\This has to be the first time you've ever pulled everyone together.\But it's strange... response:	Lennon's letter predicted that the cafeteria would have a problem like this.
context: I see.\I understand the situation.\Making dinner for every student in the school will be no easy feat.\But it seems you intend to do it.\Yeah.\This has to be the first time you've ever pulled everyone together.\But it's strange...\Lennon's letter predicted that the cafeteria would have a problem like this. response:	How did the writer know that this would happen?
context: I understand the situation.\Making dinner for every student in the school will be no easy feat.\But it seems you intend to do it.\Yeah.\This has to be the first time you've ever pulled everyone together.\But it's strange...\Lennon's letter predicted that the cafeteria would have a problem like this.\How did the writer know that this would happen? response:	What's wrong, Riki?
context: Making dinner for every student in the school will be no easy feat.\But it seems you intend to do it.\Yeah.\This has to be the first time you've ever pulled everyone together.\But it's strange...\Lennon's letter predicted that the cafeteria would have a problem like this.\How did the writer know that this would happen?\What's wrong, Riki? response:	Oh. Nothing.
context: But it seems you intend to do it.\Yeah.\This has to be the first time you've ever pulled everyone together.\But it's strange...\Lennon's letter predicted that the cafeteria would have a problem like this.\How did the writer know that this would happen?\What's wrong, Riki?\Oh. Nothing. response:	What are you going to do for this mission?
context: Yeah.\This has to be the first time you've ever pulled everyone together.\But it's strange...\Lennon's letter predicted that the cafeteria would have a problem like this.\How did the writer know that this would happen?\What's wrong, Riki?\Oh. Nothing.\What are you going to do for this mission? response:	I'm going to see it through with Rin, of course.
context: This has to be the first time you've ever pulled everyone together.\But it's strange...\Lennon's letter predicted that the cafeteria would have a problem like this.\How did the writer know that this would happen?\What's wrong, Riki?\Oh. Nothing.\What are you going to do for this mission?\I'm going to see it through with Rin, of course. response:	Alright.
context: But it's strange...\Lennon's letter predicted that the cafeteria would have a problem like this.\How did the writer know that this would happen?\What's wrong, Riki?\Oh. Nothing.\What are you going to do for this mission?\I'm going to see it through with Rin, of course.\Alright. response:	Then let's put our heads together for this.
context: Lennon's letter predicted that the cafeteria would have a problem like this.\How did the writer know that this would happen?\What's wrong, Riki?\Oh. Nothing.\What are you going to do for this mission?\I'm going to see it through with Rin, of course.\Alright.\Then let's put our heads together for this. response:	Mis
context: How did the writer know that this would happen?\What's wrong, Riki?\Oh. Nothing.\What are you going to do for this mission?\I'm going to see it through with Rin, of course.\Alright.\Then let's put our heads together for this.\Mis response:	Mission, start!
context: What's wrong, Riki?\Oh. Nothing.\What are you going to do for this mission?\I'm going to see it through with Rin, of course.\Alright.\Then let's put our heads together for this.\Mis\Mission, start! response:	Let's make a lot of yummy things!
context: Oh. Nothing.\What are you going to do for this mission?\I'm going to see it through with Rin, of course.\Alright.\Then let's put our heads together for this.\Mis\Mission, start!\Let's make a lot of yummy things! response:	This is so exciting!
context: What are you going to do for this mission?\I'm going to see it through with Rin, of course.\Alright.\Then let's put our heads together for this.\Mis\Mission, start!\Let's make a lot of yummy things!\This is so exciting! response:	Now that I've seen pretty girls in aprons, I'm ready to do anything.
context: I'm going to see it through with Rin, of course.\Alright.\Then let's put our heads together for this.\Mis\Mission, start!\Let's make a lot of yummy things!\This is so exciting!\Now that I've seen pretty girls in aprons, I'm ready to do anything. response:	My, Anego, you look quite sexy as well.
context: Alright.\Then let's put our heads together for this.\Mis\Mission, start!\Let's make a lot of yummy things!\This is so exciting!\Now that I've seen pretty girls in aprons, I'm ready to do anything.\My, Anego, you look quite sexy as well. response:	I'd do anything to have a wife like you making dinner for me!
context: Then let's put our heads together for this.\Mis\Mission, start!\Let's make a lot of yummy things!\This is so exciting!\Now that I've seen pretty girls in aprons, I'm ready to do anything.\My, Anego, you look quite sexy as well.\I'd do anything to have a wife like you making dinner for me! response:	Really?
context: Mis\Mission, start!\Let's make a lot of yummy things!\This is so exciting!\Now that I've seen pretty girls in aprons, I'm ready to do anything.\My, Anego, you look quite sexy as well.\I'd do anything to have a wife like you making dinner for me!\Really? response:	So what do we do first?
context: Mission, start!\Let's make a lot of yummy things!\This is so exciting!\Now that I've seen pretty girls in aprons, I'm ready to do anything.\My, Anego, you look quite sexy as well.\I'd do anything to have a wife like you making dinner for me!\Really?\So what do we do first? response:	First...
context: Let's make a lot of yummy things!\This is so exciting!\Now that I've seen pretty girls in aprons, I'm ready to do anything.\My, Anego, you look quite sexy as well.\I'd do anything to have a wife like you making dinner for me!\Really?\So what do we do first?\First... response:	Let's see...
context: This is so exciting!\Now that I've seen pretty girls in aprons, I'm ready to do anything.\My, Anego, you look quite sexy as well.\I'd do anything to have a wife like you making dinner for me!\Really?\So what do we do first?\First...\Let's see... response:	Make some rice!
context: Now that I've seen pretty girls in aprons, I'm ready to do anything.\My, Anego, you look quite sexy as well.\I'd do anything to have a wife like you making dinner for me!\Really?\So what do we do first?\First...\Let's see...\Make some rice! response:	Shouldn't we figure out what we're serving first?
context: My, Anego, you look quite sexy as well.\I'd do anything to have a wife like you making dinner for me!\Really?\So what do we do first?\First...\Let's see...\Make some rice!\Shouldn't we figure out what we're serving first? response:	Is that how it works?
context: I'd do anything to have a wife like you making dinner for me!\Really?\So what do we do first?\First...\Let's see...\Make some rice!\Shouldn't we figure out what we're serving first?\Is that how it works? response:	I think.
context: Really?\So what do we do first?\First...\Let's see...\Make some rice!\Shouldn't we figure out what we're serving first?\Is that how it works?\I think. response:	The menu is right here!
context: So what do we do first?\First...\Let's see...\Make some rice!\Shouldn't we figure out what we're serving first?\Is that how it works?\I think.\The menu is right here! response:	Pork cutlet meal, fillet cutlet meal, cutlet and rice meal,
context: First...\Let's see...\Make some rice!\Shouldn't we figure out what we're serving first?\Is that how it works?\I think.\The menu is right here!\Pork cutlet meal, fillet cutlet meal, cutlet and rice meal, response:	combo meal, meat and vegetable cutlet meal...
context: Let's see...\Make some rice!\Shouldn't we figure out what we're serving first?\Is that how it works?\I think.\The menu is right here!\Pork cutlet meal, fillet cutlet meal, cutlet and rice meal,\combo meal, meat and vegetable cutlet meal... response:	We have to make all this?
context: Make some rice!\Shouldn't we figure out what we're serving first?\Is that how it works?\I think.\The menu is right here!\Pork cutlet meal, fillet cutlet meal, cutlet and rice meal,\combo meal, meat and vegetable cutlet meal...\We have to make all this? response:	Impossible.
context: Shouldn't we figure out what we're serving first?\Is that how it works?\I think.\The menu is right here!\Pork cutlet meal, fillet cutlet meal, cutlet and rice meal,\combo meal, meat and vegetable cutlet meal...\We have to make all this?\Impossible. response:	We can't do that...
context: Is that how it works?\I think.\The menu is right here!\Pork cutlet meal, fillet cutlet meal, cutlet and rice meal,\combo meal, meat and vegetable cutlet meal...\We have to make all this?\Impossible.\We can't do that... response:	What should we do, Rin?
context: I think.\The menu is right here!\Pork cutlet meal, fillet cutlet meal, cutlet and rice meal,\combo meal, meat and vegetable cutlet meal...\We have to make all this?\Impossible.\We can't do that...\What should we do, Rin? response:	Give me a minute!
context: The menu is right here!\Pork cutlet meal, fillet cutlet meal, cutlet and rice meal,\combo meal, meat and vegetable cutlet meal...\We have to make all this?\Impossible.\We can't do that...\What should we do, Rin?\Give me a minute! response:	Um...
context: Pork cutlet meal, fillet cutlet meal, cutlet and rice meal,\combo meal, meat and vegetable cutlet meal...\We have to make all this?\Impossible.\We can't do that...\What should we do, Rin?\Give me a minute!\Um... response:	Okay, listen!
context: combo meal, meat and vegetable cutlet meal...\We have to make all this?\Impossible.\We can't do that...\What should we do, Rin?\Give me a minute!\Um...\Okay, listen! response:	Why not just pick three things to serve?
context: We have to make all this?\Impossible.\We can't do that...\What should we do, Rin?\Give me a minute!\Um...\Okay, listen!\Why not just pick three things to serve? response:	That's a pretty normal idea to get excited about.
context: Impossible.\We can't do that...\What should we do, Rin?\Give me a minute!\Um...\Okay, listen!\Why not just pick three things to serve?\That's a pretty normal idea to get excited about. response:	It sounds like you were reading something.
context: We can't do that...\What should we do, Rin?\Give me a minute!\Um...\Okay, listen!\Why not just pick three things to serve?\That's a pretty normal idea to get excited about.\It sounds like you were reading something. response:	And why was it in the form of a question?
context: What should we do, Rin?\Give me a minute!\Um...\Okay, listen!\Why not just pick three things to serve?\That's a pretty normal idea to get excited about.\It sounds like you were reading something.\And why was it in the form of a question? response:	Well, it is an emergency.
context: Give me a minute!\Um...\Okay, listen!\Why not just pick three things to serve?\That's a pretty normal idea to get excited about.\It sounds like you were reading something.\And why was it in the form of a question?\Well, it is an emergency. response:	We'll have to make do with three dishes.
context: Um...\Okay, listen!\Why not just pick three things to serve?\That's a pretty normal idea to get excited about.\It sounds like you were reading something.\And why was it in the form of a question?\Well, it is an emergency.\We'll have to make do with three dishes. response:	Hey look!
context: Okay, listen!\Why not just pick three things to serve?\That's a pretty normal idea to get excited about.\It sounds like you were reading something.\And why was it in the form of a question?\Well, it is an emergency.\We'll have to make do with three dishes.\Hey look! response:	I found something nice!
context: Why not just pick three things to serve?\That's a pretty normal idea to get excited about.\It sounds like you were reading something.\And why was it in the form of a question?\Well, it is an emergency.\We'll have to make do with three dishes.\Hey look!\I found something nice! response:	Wow, shrimp!
context: That's a pretty normal idea to get excited about.\It sounds like you were reading something.\And why was it in the form of a question?\Well, it is an emergency.\We'll have to make do with three dishes.\Hey look!\I found something nice!\Wow, shrimp! response:	Okay, how about fried shrimp?
context: It sounds like you were reading something.\And why was it in the form of a question?\Well, it is an emergency.\We'll have to make do with three dishes.\Hey look!\I found something nice!\Wow, shrimp!\Okay, how about fried shrimp? response:	No, it's gotta be cutlet!
context: And why was it in the form of a question?\Well, it is an emergency.\We'll have to make do with three dishes.\Hey look!\I found something nice!\Wow, shrimp!\Okay, how about fried shrimp?\No, it's gotta be cutlet! response:	Then how about fried shrimp and some cutlet for a combo dish?
context: Well, it is an emergency.\We'll have to make do with three dishes.\Hey look!\I found something nice!\Wow, shrimp!\Okay, how about fried shrimp?\No, it's gotta be cutlet!\Then how about fried shrimp and some cutlet for a combo dish? response:	Add some julienned cabbage, apple slices, and a bowl of miso,
context: We'll have to make do with three dishes.\Hey look!\I found something nice!\Wow, shrimp!\Okay, how about fried shrimp?\No, it's gotta be cutlet!\Then how about fried shrimp and some cutlet for a combo dish?\Add some julienned cabbage, apple slices, and a bowl of miso, response:	and you've got a combo meal.
context: Hey look!\I found something nice!\Wow, shrimp!\Okay, how about fried shrimp?\No, it's gotta be cutlet!\Then how about fried shrimp and some cutlet for a combo dish?\Add some julienned cabbage, apple slices, and a bowl of miso,\and you've got a combo meal. response:	I see. That's a good idea.
context: I found something nice!\Wow, shrimp!\Okay, how about fried shrimp?\No, it's gotta be cutlet!\Then how about fried shrimp and some cutlet for a combo dish?\Add some julienned cabbage, apple slices, and a bowl of miso,\and you've got a combo meal.\I see. That's a good idea. response:	How about a rice ball meal, too?
context: Wow, shrimp!\Okay, how about fried shrimp?\No, it's gotta be cutlet!\Then how about fried shrimp and some cutlet for a combo dish?\Add some julienned cabbage, apple slices, and a bowl of miso,\and you've got a combo meal.\I see. That's a good idea.\How about a rice ball meal, too? response:	We can put omelette on the side!
context: Okay, how about fried shrimp?\No, it's gotta be cutlet!\Then how about fried shrimp and some cutlet for a combo dish?\Add some julienned cabbage, apple slices, and a bowl of miso,\and you've got a combo meal.\I see. That's a good idea.\How about a rice ball meal, too?\We can put omelette on the side! response:	I can make omelette!
context: No, it's gotta be cutlet!\Then how about fried shrimp and some cutlet for a combo dish?\Add some julienned cabbage, apple slices, and a bowl of miso,\and you've got a combo meal.\I see. That's a good idea.\How about a rice ball meal, too?\We can put omelette on the side!\I can make omelette! response:	Um...
context: Then how about fried shrimp and some cutlet for a combo dish?\Add some julienned cabbage, apple slices, and a bowl of miso,\and you've got a combo meal.\I see. That's a good idea.\How about a rice ball meal, too?\We can put omelette on the side!\I can make omelette!\Um... response:	Actually, omelette is my specialty.
context: Add some julienned cabbage, apple slices, and a bowl of miso,\and you've got a combo meal.\I see. That's a good idea.\How about a rice ball meal, too?\We can put omelette on the side!\I can make omelette!\Um...\Actually, omelette is my specialty. response:	My grandpa told me to learn how to make Japanese-style omelettes,
context: and you've got a combo meal.\I see. That's a good idea.\How about a rice ball meal, too?\We can put omelette on the side!\I can make omelette!\Um...\Actually, omelette is my specialty.\My grandpa told me to learn how to make Japanese-style omelettes, response:	so I learned how to make them back home.
context: I see. That's a good idea.\How about a rice ball meal, too?\We can put omelette on the side!\I can make omelette!\Um...\Actually, omelette is my specialty.\My grandpa told me to learn how to make Japanese-style omelettes,\so I learned how to make them back home. response:	Sounds good to me!
context: How about a rice ball meal, too?\We can put omelette on the side!\I can make omelette!\Um...\Actually, omelette is my specialty.\My grandpa told me to learn how to make Japanese-style omelettes,\so I learned how to make them back home.\Sounds good to me! response:	Then you're in charge of omelettes, Kud.
context: We can put omelette on the side!\I can make omelette!\Um...\Actually, omelette is my specialty.\My grandpa told me to learn how to make Japanese-style omelettes,\so I learned how to make them back home.\Sounds good to me!\Then you're in charge of omelettes, Kud. response:	Okay!
context: I can make omelette!\Um...\Actually, omelette is my specialty.\My grandpa told me to learn how to make Japanese-style omelettes,\so I learned how to make them back home.\Sounds good to me!\Then you're in charge of omelettes, Kud.\Okay! response:	We'll need curry for the third dish.
context: Um...\Actually, omelette is my specialty.\My grandpa told me to learn how to make Japanese-style omelettes,\so I learned how to make them back home.\Sounds good to me!\Then you're in charge of omelettes, Kud.\Okay!\We'll need curry for the third dish. response:	Looks like it's all settled.
context: Actually, omelette is my specialty.\My grandpa told me to learn how to make Japanese-style omelettes,\so I learned how to make them back home.\Sounds good to me!\Then you're in charge of omelettes, Kud.\Okay!\We'll need curry for the third dish.\Looks like it's all settled. response:	And jelly for dessert!
context: My grandpa told me to learn how to make Japanese-style omelettes,\so I learned how to make them back home.\Sounds good to me!\Then you're in charge of omelettes, Kud.\Okay!\We'll need curry for the third dish.\Looks like it's all settled.\And jelly for dessert! response:	Alright, we don't have much time till dinner.
context: so I learned how to make them back home.\Sounds good to me!\Then you're in charge of omelettes, Kud.\Okay!\We'll need curry for the third dish.\Looks like it's all settled.\And jelly for dessert!\Alright, we don't have much time till dinner. response:	Let's go full speed!
context: Sounds good to me!\Then you're in charge of omelettes, Kud.\Okay!\We'll need curry for the third dish.\Looks like it's all settled.\And jelly for dessert!\Alright, we don't have much time till dinner.\Let's go full speed! response:	Mission, start!
context: Then you're in charge of omelettes, Kud.\Okay!\We'll need curry for the third dish.\Looks like it's all settled.\And jelly for dessert!\Alright, we don't have much time till dinner.\Let's go full speed!\Mission, start! response:	Alright!
context: Okay!\We'll need curry for the third dish.\Looks like it's all settled.\And jelly for dessert!\Alright, we don't have much time till dinner.\Let's go full speed!\Mission, start!\Alright! response:	How do you make the shrimp and cutlet?!
context: We'll need curry for the third dish.\Looks like it's all settled.\And jelly for dessert!\Alright, we don't have much time till dinner.\Let's go full speed!\Mission, start!\Alright!\How do you make the shrimp and cutlet?! response:	You batter them with flour and bread crumbs, then fry them.
context: Looks like it's all settled.\And jelly for dessert!\Alright, we don't have much time till dinner.\Let's go full speed!\Mission, start!\Alright!\How do you make the shrimp and cutlet?!\You batter them with flour and bread crumbs, then fry them. response:	Fry...
context: And jelly for dessert!\Alright, we don't have much time till dinner.\Let's go full speed!\Mission, start!\Alright!\How do you make the shrimp and cutlet?!\You batter them with flour and bread crumbs, then fry them.\Fry... response:	With this?
context: Alright, we don't have much time till dinner.\Let's go full speed!\Mission, start!\Alright!\How do you make the shrimp and cutlet?!\You batter them with flour and bread crumbs, then fry them.\Fry...\With this? response:	You use this.
context: Let's go full speed!\Mission, start!\Alright!\How do you make the shrimp and cutlet?!\You batter them with flour and bread crumbs, then fry them.\Fry...\With this?\You use this. response:	We have stuff like this?
context: Mission, start!\Alright!\How do you make the shrimp and cutlet?!\You batter them with flour and bread crumbs, then fry them.\Fry...\With this?\You use this.\We have stuff like this? response:	I'll turn up the heat.
context: Alright!\How do you make the shrimp and cutlet?!\You batter them with flour and bread crumbs, then fry them.\Fry...\With this?\You use this.\We have stuff like this?\I'll turn up the heat. response:	Leave the frying to me!
context: How do you make the shrimp and cutlet?!\You batter them with flour and bread crumbs, then fry them.\Fry...\With this?\You use this.\We have stuff like this?\I'll turn up the heat.\Leave the frying to me! response:	Haruka-kun, hurry up and make the daikon miso soup.
context: You batter them with flour and bread crumbs, then fry them.\Fry...\With this?\You use this.\We have stuff like this?\I'll turn up the heat.\Leave the frying to me!\Haruka-kun, hurry up and make the daikon miso soup. response:	I'll supervise.
context: Fry...\With this?\You use this.\We have stuff like this?\I'll turn up the heat.\Leave the frying to me!\Haruka-kun, hurry up and make the daikon miso soup.\I'll supervise. response:	Um...
context: With this?\You use this.\We have stuff like this?\I'll turn up the heat.\Leave the frying to me!\Haruka-kun, hurry up and make the daikon miso soup.\I'll supervise.\Um... response:	Sign: Depression
context: You use this.\We have stuff like this?\I'll turn up the heat.\Leave the frying to me!\Haruka-kun, hurry up and make the daikon miso soup.\I'll supervise.\Um...\Sign: Depression response:	What on earth are you...
context: We have stuff like this?\I'll turn up the heat.\Leave the frying to me!\Haruka-kun, hurry up and make the daikon miso soup.\I'll supervise.\Um...\Sign: Depression\What on earth are you... response:	Eggs... eggs... eggs...
context: I'll turn up the heat.\Leave the frying to me!\Haruka-kun, hurry up and make the daikon miso soup.\I'll supervise.\Um...\Sign: Depression\What on earth are you...\Eggs... eggs... eggs... response:	Wafu!
context: Leave the frying to me!\Haruka-kun, hurry up and make the daikon miso soup.\I'll supervise.\Um...\Sign: Depression\What on earth are you...\Eggs... eggs... eggs...\Wafu! response:	Damn it...
context: Haruka-kun, hurry up and make the daikon miso soup.\I'll supervise.\Um...\Sign: Depression\What on earth are you...\Eggs... eggs... eggs...\Wafu!\Damn it... response:	Weak sauce, Kengo!
context: I'll supervise.\Um...\Sign: Depression\What on earth are you...\Eggs... eggs... eggs...\Wafu!\Damn it...\Weak sauce, Kengo! response:	What?!
context: Um...\Sign: Depression\What on earth are you...\Eggs... eggs... eggs...\Wafu!\Damn it...\Weak sauce, Kengo!\What?! response:	Let me show you a real move!
context: Sign: Depression\What on earth are you...\Eggs... eggs... eggs...\Wafu!\Damn it...\Weak sauce, Kengo!\What?!\Let me show you a real move! response:	We're making good time!
context: What on earth are you...\Eggs... eggs... eggs...\Wafu!\Damn it...\Weak sauce, Kengo!\What?!\Let me show you a real move!\We're making good time! response:	Here they come!
context: Eggs... eggs... eggs...\Wafu!\Damn it...\Weak sauce, Kengo!\What?!\Let me show you a real move!\We're making good time!\Here they come! response:	Man, I'm hungry!
context: Wafu!\Damn it...\Weak sauce, Kengo!\What?!\Let me show you a real move!\We're making good time!\Here they come!\Man, I'm hungry! response:	It's food time!
context: Damn it...\Weak sauce, Kengo!\What?!\Let me show you a real move!\We're making good time!\Here they come!\Man, I'm hungry!\It's food time! response:	Is everyone ready?
context: Weak sauce, Kengo!\What?!\Let me show you a real move!\We're making good time!\Here they come!\Man, I'm hungry!\It's food time!\Is everyone ready? response:	Miso soup, ready!
context: What?!\Let me show you a real move!\We're making good time!\Here they come!\Man, I'm hungry!\It's food time!\Is everyone ready?\Miso soup, ready! response:	Fried foods, ready!
context: Let me show you a real move!\We're making good time!\Here they come!\Man, I'm hungry!\It's food time!\Is everyone ready?\Miso soup, ready!\Fried foods, ready! response:	Eggs aren't ready yet!
context: We're making good time!\Here they come!\Man, I'm hungry!\It's food time!\Is everyone ready?\Miso soup, ready!\Fried foods, ready!\Eggs aren't ready yet! response:	Calm down, Kud!
context: Here they come!\Man, I'm hungry!\It's food time!\Is everyone ready?\Miso soup, ready!\Fried foods, ready!\Eggs aren't ready yet!\Calm down, Kud! response:	We'll put out the stuff we've done first.
context: Man, I'm hungry!\It's food time!\Is everyone ready?\Miso soup, ready!\Fried foods, ready!\Eggs aren't ready yet!\Calm down, Kud!\We'll put out the stuff we've done first. response:	Combo meal here!
context: It's food time!\Is everyone ready?\Miso soup, ready!\Fried foods, ready!\Eggs aren't ready yet!\Calm down, Kud!\We'll put out the stuff we've done first.\Combo meal here! response:	Curry here!
context: Is everyone ready?\Miso soup, ready!\Fried foods, ready!\Eggs aren't ready yet!\Calm down, Kud!\We'll put out the stuff we've done first.\Combo meal here!\Curry here! response:	Why are you guys cooking dinner?
context: Miso soup, ready!\Fried foods, ready!\Eggs aren't ready yet!\Calm down, Kud!\We'll put out the stuff we've done first.\Combo meal here!\Curry here!\Why are you guys cooking dinner? response:	Rice ball meal here!
context: Fried foods, ready!\Eggs aren't ready yet!\Calm down, Kud!\We'll put out the stuff we've done first.\Combo meal here!\Curry here!\Why are you guys cooking dinner?\Rice ball meal here! response:	We just need to put them on the trays!
context: Eggs aren't ready yet!\Calm down, Kud!\We'll put out the stuff we've done first.\Combo meal here!\Curry here!\Why are you guys cooking dinner?\Rice ball meal here!\We just need to put them on the trays! response:	Keep it up, everyone!
context: Calm down, Kud!\We'll put out the stuff we've done first.\Combo meal here!\Curry here!\Why are you guys cooking dinner?\Rice ball meal here!\We just need to put them on the trays!\Keep it up, everyone! response:	Add a jelly!
context: We'll put out the stuff we've done first.\Combo meal here!\Curry here!\Why are you guys cooking dinner?\Rice ball meal here!\We just need to put them on the trays!\Keep it up, everyone!\Add a jelly! response:	And a jelly!
context: Combo meal here!\Curry here!\Why are you guys cooking dinner?\Rice ball meal here!\We just need to put them on the trays!\Keep it up, everyone!\Add a jelly!\And a jelly! response:	Alright!
context: Curry here!\Why are you guys cooking dinner?\Rice ball meal here!\We just need to put them on the trays!\Keep it up, everyone!\Add a jelly!\And a jelly!\Alright! response:	Jelly! Jelly!
context: Why are you guys cooking dinner?\Rice ball meal here!\We just need to put them on the trays!\Keep it up, everyone!\Add a jelly!\And a jelly!\Alright!\Jelly! Jelly! response:	Jelly!
context: Rice ball meal here!\We just need to put them on the trays!\Keep it up, everyone!\Add a jelly!\And a jelly!\Alright!\Jelly! Jelly!\Jelly! response:	Another jelly!
context: We just need to put them on the trays!\Keep it up, everyone!\Add a jelly!\And a jelly!\Alright!\Jelly! Jelly!\Jelly!\Another jelly! response:	What the heck?
context: Keep it up, everyone!\Add a jelly!\And a jelly!\Alright!\Jelly! Jelly!\Jelly!\Another jelly!\What the heck? response:	What's with these apples?!
context: Add a jelly!\And a jelly!\Alright!\Jelly! Jelly!\Jelly!\Another jelly!\What the heck?\What's with these apples?! response:	How many jellies do I get?
context: And a jelly!\Alright!\Jelly! Jelly!\Jelly!\Another jelly!\What the heck?\What's with these apples?!\How many jellies do I get? response:	Hey, this is practically a cabbage meal!
context: Alright!\Jelly! Jelly!\Jelly!\Another jelly!\What the heck?\What's with these apples?!\How many jellies do I get?\Hey, this is practically a cabbage meal! response:	I got a combo with curry!
context: Jelly! Jelly!\Jelly!\Another jelly!\What the heck?\What's with these apples?!\How many jellies do I get?\Hey, this is practically a cabbage meal!\I got a combo with curry! response:	Why doesn't mine have a jelly?!
context: Jelly!\Another jelly!\What the heck?\What's with these apples?!\How many jellies do I get?\Hey, this is practically a cabbage meal!\I got a combo with curry!\Why doesn't mine have a jelly?! response:	Masato! Get me some plates!
context: Another jelly!\What the heck?\What's with these apples?!\How many jellies do I get?\Hey, this is practically a cabbage meal!\I got a combo with curry!\Why doesn't mine have a jelly?!\Masato! Get me some plates! response:	This is bad! We're out of trays!
context: What the heck?\What's with these apples?!\How many jellies do I get?\Hey, this is practically a cabbage meal!\I got a combo with curry!\Why doesn't mine have a jelly?!\Masato! Get me some plates!\This is bad! We're out of trays! response:	We've got more over here!
context: What's with these apples?!\How many jellies do I get?\Hey, this is practically a cabbage meal!\I got a combo with curry!\Why doesn't mine have a jelly?!\Masato! Get me some plates!\This is bad! We're out of trays!\We've got more over here! response:	Rin-chan, here too!
context: How many jellies do I get?\Hey, this is practically a cabbage meal!\I got a combo with curry!\Why doesn't mine have a jelly?!\Masato! Get me some plates!\This is bad! We're out of trays!\We've got more over here!\Rin-chan, here too! response:	Alright, more jelly!
context: Hey, this is practically a cabbage meal!\I got a combo with curry!\Why doesn't mine have a jelly?!\Masato! Get me some plates!\This is bad! We're out of trays!\We've got more over here!\Rin-chan, here too!\Alright, more jelly! response:	Jelly here!
context: I got a combo with curry!\Why doesn't mine have a jelly?!\Masato! Get me some plates!\This is bad! We're out of trays!\We've got more over here!\Rin-chan, here too!\Alright, more jelly!\Jelly here! response:	More jelly!
context: Why doesn't mine have a jelly?!\Masato! Get me some plates!\This is bad! We're out of trays!\We've got more over here!\Rin-chan, here too!\Alright, more jelly!\Jelly here!\More jelly! response:	Jelly! Jelly! Jelly!
context: Masato! Get me some plates!\This is bad! We're out of trays!\We've got more over here!\Rin-chan, here too!\Alright, more jelly!\Jelly here!\More jelly!\Jelly! Jelly! Jelly! response:	Jelly!
context: This is bad! We're out of trays!\We've got more over here!\Rin-chan, here too!\Alright, more jelly!\Jelly here!\More jelly!\Jelly! Jelly! Jelly!\Jelly! response:	Next please!
context: We've got more over here!\Rin-chan, here too!\Alright, more jelly!\Jelly here!\More jelly!\Jelly! Jelly! Jelly!\Jelly!\Next please! response:	Here!
context: Rin-chan, here too!\Alright, more jelly!\Jelly here!\More jelly!\Jelly! Jelly! Jelly!\Jelly!\Next please!\Here! response:	Alright!
context: Alright, more jelly!\Jelly here!\More jelly!\Jelly! Jelly! Jelly!\Jelly!\Next please!\Here!\Alright! response:	This is the first time I've seen Rin so lively around other people.
context: Jelly here!\More jelly!\Jelly! Jelly! Jelly!\Jelly!\Next please!\Here!\Alright!\This is the first time I've seen Rin so lively around other people. response:	But just one thing bothered me.
context: More jelly!\Jelly! Jelly! Jelly!\Jelly!\Next please!\Here!\Alright!\This is the first time I've seen Rin so lively around other people.\But just one thing bothered me. response:	How did the writer of the letter Lennon brought us predict this crisis?
context: Jelly! Jelly! Jelly!\Jelly!\Next please!\Here!\Alright!\This is the first time I've seen Rin so lively around other people.\But just one thing bothered me.\How did the writer of the letter Lennon brought us predict this crisis? response:	Who on Earth wrote that letter?
context: Jelly!\Next please!\Here!\Alright!\This is the first time I've seen Rin so lively around other people.\But just one thing bothered me.\How did the writer of the letter Lennon brought us predict this crisis?\Who on Earth wrote that letter? response:	And then, it suddenly hit me again.
context: Next please!\Here!\Alright!\This is the first time I've seen Rin so lively around other people.\But just one thing bothered me.\How did the writer of the letter Lennon brought us predict this crisis?\Who on Earth wrote that letter?\And then, it suddenly hit me again. response:	Narcolepsy.
context: Here!\Alright!\This is the first time I've seen Rin so lively around other people.\But just one thing bothered me.\How did the writer of the letter Lennon brought us predict this crisis?\Who on Earth wrote that letter?\And then, it suddenly hit me again.\Narcolepsy. response:	Just like always, it came without warning.
context: Alright!\This is the first time I've seen Rin so lively around other people.\But just one thing bothered me.\How did the writer of the letter Lennon brought us predict this crisis?\Who on Earth wrote that letter?\And then, it suddenly hit me again.\Narcolepsy.\Just like always, it came without warning. response:	I was disconnected from this world.
context: This is the first time I've seen Rin so lively around other people.\But just one thing bothered me.\How did the writer of the letter Lennon brought us predict this crisis?\Who on Earth wrote that letter?\And then, it suddenly hit me again.\Narcolepsy.\Just like always, it came without warning.\I was disconnected from this world. response:	How long did I sleep?
context: But just one thing bothered me.\How did the writer of the letter Lennon brought us predict this crisis?\Who on Earth wrote that letter?\And then, it suddenly hit me again.\Narcolepsy.\Just like always, it came without warning.\I was disconnected from this world.\How long did I sleep? response:	I was all alone, as if the world had left me behind.
context: How did the writer of the letter Lennon brought us predict this crisis?\Who on Earth wrote that letter?\And then, it suddenly hit me again.\Narcolepsy.\Just like always, it came without warning.\I was disconnected from this world.\How long did I sleep?\I was all alone, as if the world had left me behind. response:	I couldn't tell how much time had passed or what time it was.
context: Who on Earth wrote that letter?\And then, it suddenly hit me again.\Narcolepsy.\Just like always, it came without warning.\I was disconnected from this world.\How long did I sleep?\I was all alone, as if the world had left me behind.\I couldn't tell how much time had passed or what time it was. response:	Just like the first time I had a sleep attack
context: And then, it suddenly hit me again.\Narcolepsy.\Just like always, it came without warning.\I was disconnected from this world.\How long did I sleep?\I was all alone, as if the world had left me behind.\I couldn't tell how much time had passed or what time it was.\Just like the first time I had a sleep attack response:	and was hospitalized.
context: Narcolepsy.\Just like always, it came without warning.\I was disconnected from this world.\How long did I sleep?\I was all alone, as if the world had left me behind.\I couldn't tell how much time had passed or what time it was.\Just like the first time I had a sleep attack\and was hospitalized. response:	Kyousuke...
context: Just like always, it came without warning.\I was disconnected from this world.\How long did I sleep?\I was all alone, as if the world had left me behind.\I couldn't tell how much time had passed or what time it was.\Just like the first time I had a sleep attack\and was hospitalized.\Kyousuke... response:	How are you feeling?
context: I was disconnected from this world.\How long did I sleep?\I was all alone, as if the world had left me behind.\I couldn't tell how much time had passed or what time it was.\Just like the first time I had a sleep attack\and was hospitalized.\Kyousuke...\How are you feeling? response:	Nothing broken?
context: How long did I sleep?\I was all alone, as if the world had left me behind.\I couldn't tell how much time had passed or what time it was.\Just like the first time I had a sleep attack\and was hospitalized.\Kyousuke...\How are you feeling?\Nothing broken? response:	Yeah.
context: I was all alone, as if the world had left me behind.\I couldn't tell how much time had passed or what time it was.\Just like the first time I had a sleep attack\and was hospitalized.\Kyousuke...\How are you feeling?\Nothing broken?\Yeah. response:	Want to rest some more?
context: I couldn't tell how much time had passed or what time it was.\Just like the first time I had a sleep attack\and was hospitalized.\Kyousuke...\How are you feeling?\Nothing broken?\Yeah.\Want to rest some more? response:	No...
context: Just like the first time I had a sleep attack\and was hospitalized.\Kyousuke...\How are you feeling?\Nothing broken?\Yeah.\Want to rest some more?\No... response:	Then come on.
context: and was hospitalized.\Kyousuke...\How are you feeling?\Nothing broken?\Yeah.\Want to rest some more?\No...\Then come on. response:	Everyone's waiting for you.
context: Kyousuke...\How are you feeling?\Nothing broken?\Yeah.\Want to rest some more?\No...\Then come on.\Everyone's waiting for you. response:	Hey, it's Riki-kun!
context: How are you feeling?\Nothing broken?\Yeah.\Want to rest some more?\No...\Then come on.\Everyone's waiting for you.\Hey, it's Riki-kun! response:	You look better now!
context: Nothing broken?\Yeah.\Want to rest some more?\No...\Then come on.\Everyone's waiting for you.\Hey, it's Riki-kun!\You look better now! response:	Thank goodness!
context: Yeah.\Want to rest some more?\No...\Then come on.\Everyone's waiting for you.\Hey, it's Riki-kun!\You look better now!\Thank goodness! response:	Here's your fried combo meal!
context: Want to rest some more?\No...\Then come on.\Everyone's waiting for you.\Hey, it's Riki-kun!\You look better now!\Thank goodness!\Here's your fried combo meal! response:	You waited this long for me?
context: No...\Then come on.\Everyone's waiting for you.\Hey, it's Riki-kun!\You look better now!\Thank goodness!\Here's your fried combo meal!\You waited this long for me? response:	It was Rin's idea.
context: Then come on.\Everyone's waiting for you.\Hey, it's Riki-kun!\You look better now!\Thank goodness!\Here's your fried combo meal!\You waited this long for me?\It was Rin's idea. response:	We couldn't end this mission without you.
context: Everyone's waiting for you.\Hey, it's Riki-kun!\You look better now!\Thank goodness!\Here's your fried combo meal!\You waited this long for me?\It was Rin's idea.\We couldn't end this mission without you. response:	Everyone worked really hard after that.
context: Hey, it's Riki-kun!\You look better now!\Thank goodness!\Here's your fried combo meal!\You waited this long for me?\It was Rin's idea.\We couldn't end this mission without you.\Everyone worked really hard after that. response:	We managed to pull through in the end.
context: You look better now!\Thank goodness!\Here's your fried combo meal!\You waited this long for me?\It was Rin's idea.\We couldn't end this mission without you.\Everyone worked really hard after that.\We managed to pull through in the end. response:	Thanks to everyone...
context: Thank goodness!\Here's your fried combo meal!\You waited this long for me?\It was Rin's idea.\We couldn't end this mission without you.\Everyone worked really hard after that.\We managed to pull through in the end.\Thanks to everyone... response:	Mission complete, right?
context: Here's your fried combo meal!\You waited this long for me?\It was Rin's idea.\We couldn't end this mission without you.\Everyone worked really hard after that.\We managed to pull through in the end.\Thanks to everyone...\Mission complete, right? response:	Alright! Let's get this party started!
context: You waited this long for me?\It was Rin's idea.\We couldn't end this mission without you.\Everyone worked really hard after that.\We managed to pull through in the end.\Thanks to everyone...\Mission complete, right?\Alright! Let's get this party started! response:	Cheers!
context: It was Rin's idea.\We couldn't end this mission without you.\Everyone worked really hard after that.\We managed to pull through in the end.\Thanks to everyone...\Mission complete, right?\Alright! Let's get this party started!\Cheers! response:	A girl sitting quietly at lunch under a big tree.
context: We couldn't end this mission without you.\Everyone worked really hard after that.\We managed to pull through in the end.\Thanks to everyone...\Mission complete, right?\Alright! Let's get this party started!\Cheers!\A girl sitting quietly at lunch under a big tree. response:	Always reading a book under her parasol.
context: Everyone worked really hard after that.\We managed to pull through in the end.\Thanks to everyone...\Mission complete, right?\Alright! Let's get this party started!\Cheers!\A girl sitting quietly at lunch under a big tree.\Always reading a book under her parasol. response:	Find the book Miss Nishizono lost.
context: We managed to pull through in the end.\Thanks to everyone...\Mission complete, right?\Alright! Let's get this party started!\Cheers!\A girl sitting quietly at lunch under a big tree.\Always reading a book under her parasol.\Find the book Miss Nishizono lost. response:	Mission, start.
context: Thanks to everyone...\Mission complete, right?\Alright! Let's get this party started!\Cheers!\A girl sitting quietly at lunch under a big tree.\Always reading a book under her parasol.\Find the book Miss Nishizono lost.\Mission, start. response:	Episode 9
context: Mission complete, right?\Alright! Let's get this party started!\Cheers!\A girl sitting quietly at lunch under a big tree.\Always reading a book under her parasol.\Find the book Miss Nishizono lost.\Mission, start.\Episode 9 response:	Episode 9
context: Alright! Let's get this party started!\Cheers!\A girl sitting quietly at lunch under a big tree.\Always reading a book under her parasol.\Find the book Miss Nishizono lost.\Mission, start.\Episode 9\Episode 9 response:	Episode 9
context: Cheers!\A girl sitting quietly at lunch under a big tree.\Always reading a book under her parasol.\Find the book Miss Nishizono lost.\Mission, start.\Episode 9\Episode 9\Episode 9 response:	Save the Cafeteria!
context: A girl sitting quietly at lunch under a big tree.\Always reading a book under her parasol.\Find the book Miss Nishizono lost.\Mission, start.\Episode 9\Episode 9\Episode 9\Save the Cafeteria! response:	Save the Cafeteria!
context: Always reading a book under her parasol.\Find the book Miss Nishizono lost.\Mission, start.\Episode 9\Episode 9\Episode 9\Save the Cafeteria!\Save the Cafeteria! response:	Save the Cafeteria!
context: Find the book Miss Nishizono lost.\Mission, start.\Episode 9\Episode 9\Episode 9\Save the Cafeteria!\Save the Cafeteria!\Save the Cafeteria! response:	Rin
context: Mission, start.\Episode 9\Episode 9\Episode 9\Save the Cafeteria!\Save the Cafeteria!\Save the Cafeteria!\Rin response:	No Subject
context: Episode 9\Episode 9\Episode 9\Save the Cafeteria!\Save the Cafeteria!\Save the Cafeteria!\Rin\No Subject response:	What should I do?
context: Episode 9\Episode 9\Save the Cafeteria!\Save the Cafeteria!\Save the Cafeteria!\Rin\No Subject\What should I do? response:	Rin
context: Episode 9\Save the Cafeteria!\Save the Cafeteria!\Save the Cafeteria!\Rin\No Subject\What should I do?\Rin response:	None
context: Save the Cafeteria!\Save the Cafeteria!\Save the Cafeteria!\Rin\No Subject\What should I do?\Rin\None response:	Why not just pick three things to serve?
context: Save the Cafeteria!\Save the Cafeteria!\Rin\No Subject\What should I do?\Rin\None\Why not just pick three things to serve? response:	Baseball
context: Save the Cafeteria!\Rin\No Subject\What should I do?\Rin\None\Why not just pick three things to serve?\Baseball response:	Team
context: Rin\No Subject\What should I do?\Rin\None\Why not just pick three things to serve?\Baseball\Team response:	Baseball
context: No Subject\What should I do?\Rin\None\Why not just pick three things to serve?\Baseball\Team\Baseball response:	Baseball
context: What should I do?\Rin\None\Why not just pick three things to serve?\Baseball\Team\Baseball\Baseball response:	Baseball
context: Rin\None\Why not just pick three things to serve?\Baseball\Team\Baseball\Baseball\Baseball response:	Baseball
context: None\Why not just pick three things to serve?\Baseball\Team\Baseball\Baseball\Baseball\Baseball response:	Baseball
context: Why not just pick three things to serve?\Baseball\Team\Baseball\Baseball\Baseball\Baseball\Baseball response:	Baseball
context: Baseball\Team\Baseball\Baseball\Baseball\Baseball\Baseball\Baseball response:	Baseball
context: Team\Baseball\Baseball\Baseball\Baseball\Baseball\Baseball\Baseball response:	Baseball
context: Baseball\Baseball\Baseball\Baseball\Baseball\Baseball\Baseball\Baseball response:	Baseball
context: Baseball\Baseball\Baseball\Baseball\Baseball\Baseball\Baseball\Baseball response:	Baseball
context: Baseball\Baseball\Baseball\Baseball\Baseball\Baseball\Baseball\Baseball response:	Baseball
context: Baseball\Baseball\Baseball\Baseball\Baseball\Baseball\Baseball\Baseball response:	Baseball
context: Baseball\Baseball\Baseball\Baseball\Baseball\Baseball\Baseball\Baseball response:	Baseball
context: Baseball\Baseball\Baseball\Baseball\Baseball\Baseball\Baseball\Baseball response:	Baseball
context: Baseball\Baseball\Baseball\Baseball\Baseball\Baseball\Baseball\Baseball response:	Baseball
context: Baseball\Baseball\Baseball\Baseball\Baseball\Baseball\Baseball\Baseball response:	Baseball
context: Baseball\Baseball\Baseball\Baseball\Baseball\Baseball\Baseball\Baseball response:	Baseball
context: Baseball\Baseball\Baseball\Baseball\Baseball\Baseball\Baseball\Baseball response:	Baseball
context: Baseball\Baseball\Baseball\Baseball\Baseball\Baseball\Baseball\Baseball response:	Baseball
context: Baseball\Baseball\Baseball\Baseball\Baseball\Baseball\Baseball\Baseball response:	Baseball
context: Baseball\Baseball\Baseball\Baseball\Baseball\Baseball\Baseball\Baseball response:	Baseball
context: Baseball\Baseball\Baseball\Baseball\Baseball\Baseball\Baseball\Baseball response:	Baseball
context: Baseball\Baseball\Baseball\Baseball\Baseball\Baseball\Baseball\Baseball response:	Baseball
context: Baseball\Baseball\Baseball\Baseball\Baseball\Baseball\Baseball\Baseball response:	Baseball
context: Baseball\Baseball\Baseball\Baseball\Baseball\Baseball\Baseball\Baseball response:	Baseball
context: Baseball\Baseball\Baseball\Baseball\Baseball\Baseball\Baseball\Baseball response:	Baseball
context: Baseball\Baseball\Baseball\Baseball\Baseball\Baseball\Baseball\Baseball response:	Baseball
context: Baseball\Baseball\Baseball\Baseball\Baseball\Baseball\Baseball\Baseball response:	Baseball
context: Baseball\Baseball\Baseball\Baseball\Baseball\Baseball\Baseball\Baseball response:	Baseball
context: Baseball\Baseball\Baseball\Baseball\Baseball\Baseball\Baseball\Baseball response:	Baseball
context: Baseball\Baseball\Baseball\Baseball\Baseball\Baseball\Baseball\Baseball response:	Baseball
context: Baseball\Baseball\Baseball\Baseball\Baseball\Baseball\Baseball\Baseball response:	Baseball
context: Baseball\Baseball\Baseball\Baseball\Baseball\Baseball\Baseball\Baseball response:	Baseball
context: Baseball\Baseball\Baseball\Baseball\Baseball\Baseball\Baseball\Baseball response:	Baseball
context: Baseball\Baseball\Baseball\Baseball\Baseball\Baseball\Baseball\Baseball response:	Baseball
context: Baseball\Baseball\Baseball\Baseball\Baseball\Baseball\Baseball\Baseball response:	Baseball
context: Baseball\Baseball\Baseball\Baseball\Baseball\Baseball\Baseball\Baseball response:	Baseball
context: Baseball\Baseball\Baseball\Baseball\Baseball\Baseball\Baseball\Baseball response:	Baseball
context: Baseball\Baseball\Baseball\Baseball\Baseball\Baseball\Baseball\Baseball response:	Baseball
context: Baseball\Baseball\Baseball\Baseball\Baseball\Baseball\Baseball\Baseball response:	Baseball
context: Baseball\Baseball\Baseball\Baseball\Baseball\Baseball\Baseball\Baseball response:	Baseball
context: Baseball\Baseball\Baseball\Baseball\Baseball\Baseball\Baseball\Baseball response:	Baseball
context: Baseball\Baseball\Baseball\Baseball\Baseball\Baseball\Baseball\Baseball response:	Baseball
context: Baseball\Baseball\Baseball\Baseball\Baseball\Baseball\Baseball\Baseball response:	Baseball
context: Baseball\Baseball\Baseball\Baseball\Baseball\Baseball\Baseball\Baseball response:	Baseball
context: Baseball\Baseball\Baseball\Baseball\Baseball\Baseball\Baseball\Baseball response:	Baseball
context: Baseball\Baseball\Baseball\Baseball\Baseball\Baseball\Baseball\Baseball response:	Baseball
context: Baseball\Baseball\Baseball\Baseball\Baseball\Baseball\Baseball\Baseball response:	Baseball
context: Baseball\Baseball\Baseball\Baseball\Baseball\Baseball\Baseball\Baseball response:	Baseball
context: Baseball\Baseball\Baseball\Baseball\Baseball\Baseball\Baseball\Baseball response:	Baseball
context: Baseball\Baseball\Baseball\Baseball\Baseball\Baseball\Baseball\Baseball response:	Baseball
context: Baseball\Baseball\Baseball\Baseball\Baseball\Baseball\Baseball\Baseball response:	Team
context: Baseball\Baseball\Baseball\Baseball\Baseball\Baseball\Baseball\Team response:	Team
context: Baseball\Baseball\Baseball\Baseball\Baseball\Baseball\Team\Team response:	Team
context: Baseball\Baseball\Baseball\Baseball\Baseball\Team\Team\Team response:	Team
context: Baseball\Baseball\Baseball\Baseball\Team\Team\Team\Team response:	Team
context: Baseball\Baseball\Baseball\Team\Team\Team\Team\Team response:	Team
context: Baseball\Baseball\Team\Team\Team\Team\Team\Team response:	Team
context: Baseball\Team\Team\Team\Team\Team\Team\Team response:	Team
context: Team\Team\Team\Team\Team\Team\Team\Team response:	Team
context: Team\Team\Team\Team\Team\Team\Team\Team response:	Team
context: Team\Team\Team\Team\Team\Team\Team\Team response:	Team
context: Team\Team\Team\Team\Team\Team\Team\Team response:	Team
context: Team\Team\Team\Team\Team\Team\Team\Team response:	Team
context: Team\Team\Team\Team\Team\Team\Team\Team response:	Team
context: Team\Team\Team\Team\Team\Team\Team\Team response:	Team
context: Team\Team\Team\Team\Team\Team\Team\Team response:	Team
context: Team\Team\Team\Team\Team\Team\Team\Team response:	Team
context: Team\Team\Team\Team\Team\Team\Team\Team response:	Team
context: Team\Team\Team\Team\Team\Team\Team\Team response:	Team
context: Team\Team\Team\Team\Team\Team\Team\Team response:	Team
context: Team\Team\Team\Team\Team\Team\Team\Team response:	Team
context: Team\Team\Team\Team\Team\Team\Team\Team response:	Team
context: Team\Team\Team\Team\Team\Team\Team\Team response:	Team
context: Team\Team\Team\Team\Team\Team\Team\Team response:	Team
context: Team\Team\Team\Team\Team\Team\Team\Team response:	Team
context: Team\Team\Team\Team\Team\Team\Team\Team response:	Team
context: Team\Team\Team\Team\Team\Team\Team\Team response:	Team
context: Team\Team\Team\Team\Team\Team\Team\Team response:	Team
context: Team\Team\Team\Team\Team\Team\Team\Team response:	Team
context: Team\Team\Team\Team\Team\Team\Team\Team response:	Team
context: Team\Team\Team\Team\Team\Team\Team\Team response:	Team
context: Team\Team\Team\Team\Team\Team\Team\Team response:	Team
context: Team\Team\Team\Team\Team\Team\Team\Team response:	Team
context: Team\Team\Team\Team\Team\Team\Team\Team response:	Team
context: Team\Team\Team\Team\Team\Team\Team\Team response:	Team
context: Team\Team\Team\Team\Team\Team\Team\Team response:	Team
context: Team\Team\Team\Team\Team\Team\Team\Team response:	Team
context: Team\Team\Team\Team\Team\Team\Team\Team response:	Team
context: Team\Team\Team\Team\Team\Team\Team\Team response:	Team
context: Team\Team\Team\Team\Team\Team\Team\Team response:	Team
context: Team\Team\Team\Team\Team\Team\Team\Team response:	Team
context: Team\Team\Team\Team\Team\Team\Team\Team response:	Team
context: Team\Team\Team\Team\Team\Team\Team\Team response:	Team
context: Team\Team\Team\Team\Team\Team\Team\Team response:	Team
context: Team\Team\Team\Team\Team\Team\Team\Team response:	Team
context: Team\Team\Team\Team\Team\Team\Team\Team response:	Team
context: Team\Team\Team\Team\Team\Team\Team\Team response:	Team
context: Team\Team\Team\Team\Team\Team\Team\Team response:	Team
context: Team\Team\Team\Team\Team\Team\Team\Team response:	Team
context: Team\Team\Team\Team\Team\Team\Team\Team response:	Team
context: Team\Team\Team\Team\Team\Team\Team\Team response:	Baseball
context: Team\Team\Team\Team\Team\Team\Team\Baseball response:	Team
context: Team\Team\Team\Team\Team\Team\Baseball\Team response:	m -25 298 l 830 -20 1297 -4 1292 117 -28 574
context: Team\Team\Team\Team\Team\Baseball\Team\m -25 298 l 830 -20 1297 -4 1292 117 -28 574 response:	Spaghetti
context: Team\Team\Team\Team\Baseball\Team\m -25 298 l 830 -20 1297 -4 1292 117 -28 574\Spaghetti response:	Omelette
context: Team\Team\Team\Baseball\Team\m -25 298 l 830 -20 1297 -4 1292 117 -28 574\Spaghetti\Omelette response:	combo Meal
context: Team\Team\Baseball\Team\m -25 298 l 830 -20 1297 -4 1292 117 -28 574\Spaghetti\Omelette\combo Meal response:	Cutlet and Rice Meal
context: Team\Baseball\Team\m -25 298 l 830 -20 1297 -4 1292 117 -28 574\Spaghetti\Omelette\combo Meal\Cutlet and Rice Meal response:	Fillet Cutlet Meal
context: Baseball\Team\m -25 298 l 830 -20 1297 -4 1292 117 -28 574\Spaghetti\Omelette\combo Meal\Cutlet and Rice Meal\Fillet Cutlet Meal response:	Pork Cutlet Meal
context: Team\m -25 298 l 830 -20 1297 -4 1292 117 -28 574\Spaghetti\Omelette\combo Meal\Cutlet and Rice Meal\Fillet Cutlet Meal\Pork Cutlet Meal response:	Minced Cutlet Meal
context: m -25 298 l 830 -20 1297 -4 1292 117 -28 574\Spaghetti\Omelette\combo Meal\Cutlet and Rice Meal\Fillet Cutlet Meal\Pork Cutlet Meal\Minced Cutlet Meal response:	Grilled Salmon Meal
context: Spaghetti\Omelette\combo Meal\Cutlet and Rice Meal\Fillet Cutlet Meal\Pork Cutlet Meal\Minced Cutlet Meal\Grilled Salmon Meal response:	Grilled Mackerel Meal
context: Omelette\combo Meal\Cutlet and Rice Meal\Fillet Cutlet Meal\Pork Cutlet Meal\Minced Cutlet Meal\Grilled Salmon Meal\Grilled Mackerel Meal response:	Grilled Pike Meal
context: combo Meal\Cutlet and Rice Meal\Fillet Cutlet Meal\Pork Cutlet Meal\Minced Cutlet Meal\Grilled Salmon Meal\Grilled Mackerel Meal\Grilled Pike Meal response:	Utensils
context: Cutlet and Rice Meal\Fillet Cutlet Meal\Pork Cutlet Meal\Minced Cutlet Meal\Grilled Salmon Meal\Grilled Mackerel Meal\Grilled Pike Meal\Utensils response:	Return Trays Here
context: Fillet Cutlet Meal\Pork Cutlet Meal\Minced Cutlet Meal\Grilled Salmon Meal\Grilled Mackerel Meal\Grilled Pike Meal\Utensils\Return Trays Here response:	There is a secret
context: Pork Cutlet Meal\Minced Cutlet Meal\Grilled Salmon Meal\Grilled Mackerel Meal\Grilled Pike Meal\Utensils\Return Trays Here\There is a secret response:	in this world.
context: Minced Cutlet Meal\Grilled Salmon Meal\Grilled Mackerel Meal\Grilled Pike Meal\Utensils\Return Trays Here\There is a secret\in this world. response:	If you wish
context: Grilled Salmon Meal\Grilled Mackerel Meal\Grilled Pike Meal\Utensils\Return Trays Here\There is a secret\in this world.\If you wish response:	to know it,
context: Grilled Mackerel Meal\Grilled Pike Meal\Utensils\Return Trays Here\There is a secret\in this world.\If you wish\to know it, response:	then clear
context: Grilled Pike Meal\Utensils\Return Trays Here\There is a secret\in this world.\If you wish\to know it,\then clear response:	all the tasks
context: Utensils\Return Trays Here\There is a secret\in this world.\If you wish\to know it,\then clear\all the tasks response:	I give you.
context: Return Trays Here\There is a secret\in this world.\If you wish\to know it,\then clear\all the tasks\I give you. response:	hitori ga tsurai kara futatsu no te wo tsunaida
context: There is a secret\in this world.\If you wish\to know it,\then clear\all the tasks\I give you.\hitori ga tsurai kara futatsu no te wo tsunaida response:	It was too hard for one to do, so two of us held hands
context: in this world.\If you wish\to know it,\then clear\all the tasks\I give you.\hitori ga tsurai kara futatsu no te wo tsunaida\It was too hard for one to do, so two of us held hands response:	hitori ga tsurai kara futatsu no te wo tsunaida
context: If you wish\to know it,\then clear\all the tasks\I give you.\hitori ga tsurai kara futatsu no te wo tsunaida\It was too hard for one to do, so two of us held hands\hitori ga tsurai kara futatsu no te wo tsunaida response:	It was too hard for one to do, so two of us held hands
context: to know it,\then clear\all the tasks\I give you.\hitori ga tsurai kara futatsu no te wo tsunaida\It was too hard for one to do, so two of us held hands\hitori ga tsurai kara futatsu no te wo tsunaida\It was too hard for one to do, so two of us held hands response:	futari ja samishii kara wa ni natte te wo tsunaida
context: then clear\all the tasks\I give you.\hitori ga tsurai kara futatsu no te wo tsunaida\It was too hard for one to do, so two of us held hands\hitori ga tsurai kara futatsu no te wo tsunaida\It was too hard for one to do, so two of us held hands\futari ja samishii kara wa ni natte te wo tsunaida response:	But two would be too lonely, so we all came together in a circle and held hands
context: all the tasks\I give you.\hitori ga tsurai kara futatsu no te wo tsunaida\It was too hard for one to do, so two of us held hands\hitori ga tsurai kara futatsu no te wo tsunaida\It was too hard for one to do, so two of us held hands\futari ja samishii kara wa ni natte te wo tsunaida\But two would be too lonely, so we all came together in a circle and held hands response:	futari ja samishii kara wa ni natte te wo tsunaida
context: I give you.\hitori ga tsurai kara futatsu no te wo tsunaida\It was too hard for one to do, so two of us held hands\hitori ga tsurai kara futatsu no te wo tsunaida\It was too hard for one to do, so two of us held hands\futari ja samishii kara wa ni natte te wo tsunaida\But two would be too lonely, so we all came together in a circle and held hands\futari ja samishii kara wa ni natte te wo tsunaida response:	But two would be too lonely, so we all came together in a circle and held hands
context: hitori ga tsurai kara futatsu no te wo tsunaida\It was too hard for one to do, so two of us held hands\hitori ga tsurai kara futatsu no te wo tsunaida\It was too hard for one to do, so two of us held hands\futari ja samishii kara wa ni natte te wo tsunaida\But two would be too lonely, so we all came together in a circle and held hands\futari ja samishii kara wa ni natte te wo tsunaida\But two would be too lonely, so we all came together in a circle and held hands response:	kitto sore ga ikusen no chikara ni mo nari
context: It was too hard for one to do, so two of us held hands\hitori ga tsurai kara futatsu no te wo tsunaida\It was too hard for one to do, so two of us held hands\futari ja samishii kara wa ni natte te wo tsunaida\But two would be too lonely, so we all came together in a circle and held hands\futari ja samishii kara wa ni natte te wo tsunaida\But two would be too lonely, so we all came together in a circle and held hands\kitto sore ga ikusen no chikara ni mo nari response:	I'm sure that will be strength in itself,
context: hitori ga tsurai kara futatsu no te wo tsunaida\It was too hard for one to do, so two of us held hands\futari ja samishii kara wa ni natte te wo tsunaida\But two would be too lonely, so we all came together in a circle and held hands\futari ja samishii kara wa ni natte te wo tsunaida\But two would be too lonely, so we all came together in a circle and held hands\kitto sore ga ikusen no chikara ni mo nari\I'm sure that will be strength in itself, response:	kitto sore ga ikusen no chikara ni mo nari
context: It was too hard for one to do, so two of us held hands\futari ja samishii kara wa ni natte te wo tsunaida\But two would be too lonely, so we all came together in a circle and held hands\futari ja samishii kara wa ni natte te wo tsunaida\But two would be too lonely, so we all came together in a circle and held hands\kitto sore ga ikusen no chikara ni mo nari\I'm sure that will be strength in itself,\kitto sore ga ikusen no chikara ni mo nari response:	I'm sure that will be strength in itself,
context: futari ja samishii kara wa ni natte te wo tsunaida\But two would be too lonely, so we all came together in a circle and held hands\futari ja samishii kara wa ni natte te wo tsunaida\But two would be too lonely, so we all came together in a circle and held hands\kitto sore ga ikusen no chikara ni mo nari\I'm sure that will be strength in itself,\kitto sore ga ikusen no chikara ni mo nari\I'm sure that will be strength in itself, response:	donna yume mo tateru ki ga surunda
context: But two would be too lonely, so we all came together in a circle and held hands\futari ja samishii kara wa ni natte te wo tsunaida\But two would be too lonely, so we all came together in a circle and held hands\kitto sore ga ikusen no chikara ni mo nari\I'm sure that will be strength in itself,\kitto sore ga ikusen no chikara ni mo nari\I'm sure that will be strength in itself,\donna yume mo tateru ki ga surunda response:	Enough to end any dream we have
context: futari ja samishii kara wa ni natte te wo tsunaida\But two would be too lonely, so we all came together in a circle and held hands\kitto sore ga ikusen no chikara ni mo nari\I'm sure that will be strength in itself,\kitto sore ga ikusen no chikara ni mo nari\I'm sure that will be strength in itself,\donna yume mo tateru ki ga surunda\Enough to end any dream we have response:	donna yume mo tateru ki ga surunda
context: But two would be too lonely, so we all came together in a circle and held hands\kitto sore ga ikusen no chikara ni mo nari\I'm sure that will be strength in itself,\kitto sore ga ikusen no chikara ni mo nari\I'm sure that will be strength in itself,\donna yume mo tateru ki ga surunda\Enough to end any dream we have\donna yume mo tateru ki ga surunda response:	Enough to end any dream we have
context: kitto sore ga ikusen no chikara ni mo nari\I'm sure that will be strength in itself,\kitto sore ga ikusen no chikara ni mo nari\I'm sure that will be strength in itself,\donna yume mo tateru ki ga surunda\Enough to end any dream we have\donna yume mo tateru ki ga surunda\Enough to end any dream we have response:	takaku tobe takaku sora he
context: I'm sure that will be strength in itself,\kitto sore ga ikusen no chikara ni mo nari\I'm sure that will be strength in itself,\donna yume mo tateru ki ga surunda\Enough to end any dream we have\donna yume mo tateru ki ga surunda\Enough to end any dream we have\takaku tobe takaku sora he response:	Fly high, high into the sky,
context: kitto sore ga ikusen no chikara ni mo nari\I'm sure that will be strength in itself,\donna yume mo tateru ki ga surunda\Enough to end any dream we have\donna yume mo tateru ki ga surunda\Enough to end any dream we have\takaku tobe takaku sora he\Fly high, high into the sky, response:	takaku tobe takaku sora he
context: I'm sure that will be strength in itself,\donna yume mo tateru ki ga surunda\Enough to end any dream we have\donna yume mo tateru ki ga surunda\Enough to end any dream we have\takaku tobe takaku sora he\Fly high, high into the sky,\takaku tobe takaku sora he response:	Fly high, high into the sky,
context: donna yume mo tateru ki ga surunda\Enough to end any dream we have\donna yume mo tateru ki ga surunda\Enough to end any dream we have\takaku tobe takaku sora he\Fly high, high into the sky,\takaku tobe takaku sora he\Fly high, high into the sky, response:	takaku kere takaku koe wo age
context: Enough to end any dream we have\donna yume mo tateru ki ga surunda\Enough to end any dream we have\takaku tobe takaku sora he\Fly high, high into the sky,\takaku tobe takaku sora he\Fly high, high into the sky,\takaku kere takaku koe wo age response:	Jump high, and raise your voice high,
context: donna yume mo tateru ki ga surunda\Enough to end any dream we have\takaku tobe takaku sora he\Fly high, high into the sky,\takaku tobe takaku sora he\Fly high, high into the sky,\takaku kere takaku koe wo age\Jump high, and raise your voice high, response:	takaku kere takaku koe wo age
context: Enough to end any dream we have\takaku tobe takaku sora he\Fly high, high into the sky,\takaku tobe takaku sora he\Fly high, high into the sky,\takaku kere takaku koe wo age\Jump high, and raise your voice high,\takaku kere takaku koe wo age response:	Jump high, and raise your voice high,
context: takaku tobe takaku sora he\Fly high, high into the sky,\takaku tobe takaku sora he\Fly high, high into the sky,\takaku kere takaku koe wo age\Jump high, and raise your voice high,\takaku kere takaku koe wo age\Jump high, and raise your voice high, response:	itsuka kujiketa sono hi no mukou made
context: Fly high, high into the sky,\takaku tobe takaku sora he\Fly high, high into the sky,\takaku kere takaku koe wo age\Jump high, and raise your voice high,\takaku kere takaku koe wo age\Jump high, and raise your voice high,\itsuka kujiketa sono hi no mukou made response:	Until you can move on past the day we'll have died
context: takaku tobe takaku sora he\Fly high, high into the sky,\takaku kere takaku koe wo age\Jump high, and raise your voice high,\takaku kere takaku koe wo age\Jump high, and raise your voice high,\itsuka kujiketa sono hi no mukou made\Until you can move on past the day we'll have died response:	itsuka kujiketa sono hi no mukou made
context: Fly high, high into the sky,\takaku kere takaku koe wo age\Jump high, and raise your voice high,\takaku kere takaku koe wo age\Jump high, and raise your voice high,\itsuka kujiketa sono hi no mukou made\Until you can move on past the day we'll have died\itsuka kujiketa sono hi no mukou made response:	Until you can move on past the day we'll have died
context: takaku kere takaku koe wo age\Jump high, and raise your voice high,\takaku kere takaku koe wo age\Jump high, and raise your voice high,\itsuka kujiketa sono hi no mukou made\Until you can move on past the day we'll have died\itsuka kujiketa sono hi no mukou made\Until you can move on past the day we'll have died response:	kimi no koe wasurenai namida mo wasurenai
context: Jump high, and raise your voice high,\takaku kere takaku koe wo age\Jump high, and raise your voice high,\itsuka kujiketa sono hi no mukou made\Until you can move on past the day we'll have died\itsuka kujiketa sono hi no mukou made\Until you can move on past the day we'll have died\kimi no koe wasurenai namida mo wasurenai response:	I'll never forget your voice, and I'll never forget your tears
context: takaku kere takaku koe wo age\Jump high, and raise your voice high,\itsuka kujiketa sono hi no mukou made\Until you can move on past the day we'll have died\itsuka kujiketa sono hi no mukou made\Until you can move on past the day we'll have died\kimi no koe wasurenai namida mo wasurenai\I'll never forget your voice, and I'll never forget your tears response:	kimi no koe wasurenai namida mo wasurenai
context: Jump high, and raise your voice high,\itsuka kujiketa sono hi no mukou made\Until you can move on past the day we'll have died\itsuka kujiketa sono hi no mukou made\Until you can move on past the day we'll have died\kimi no koe wasurenai namida mo wasurenai\I'll never forget your voice, and I'll never forget your tears\kimi no koe wasurenai namida mo wasurenai response:	I'll never forget your voice, and I'll never forget your tears
context: itsuka kujiketa sono hi no mukou made\Until you can move on past the day we'll have died\itsuka kujiketa sono hi no mukou made\Until you can move on past the day we'll have died\kimi no koe wasurenai namida mo wasurenai\I'll never forget your voice, and I'll never forget your tears\kimi no koe wasurenai namida mo wasurenai\I'll never forget your voice, and I'll never forget your tears response:	kore kara hajimaru kibou to iu na no mirai wo
context: Until you can move on past the day we'll have died\itsuka kujiketa sono hi no mukou made\Until you can move on past the day we'll have died\kimi no koe wasurenai namida mo wasurenai\I'll never forget your voice, and I'll never forget your tears\kimi no koe wasurenai namida mo wasurenai\I'll never forget your voice, and I'll never forget your tears\kore kara hajimaru kibou to iu na no mirai wo response:	The future, what we call hope, begins now
context: itsuka kujiketa sono hi no mukou made\Until you can move on past the day we'll have died\kimi no koe wasurenai namida mo wasurenai\I'll never forget your voice, and I'll never forget your tears\kimi no koe wasurenai namida mo wasurenai\I'll never forget your voice, and I'll never forget your tears\kore kara hajimaru kibou to iu na no mirai wo\The future, what we call hope, begins now response:	kore kara hajimaru kibou to iu na no mirai wo
context: Until you can move on past the day we'll have died\kimi no koe wasurenai namida mo wasurenai\I'll never forget your voice, and I'll never forget your tears\kimi no koe wasurenai namida mo wasurenai\I'll never forget your voice, and I'll never forget your tears\kore kara hajimaru kibou to iu na no mirai wo\The future, what we call hope, begins now\kore kara hajimaru kibou to iu na no mirai wo response:	The future, what we call hope, begins now
context: kimi no koe wasurenai namida mo wasurenai\I'll never forget your voice, and I'll never forget your tears\kimi no koe wasurenai namida mo wasurenai\I'll never forget your voice, and I'll never forget your tears\kore kara hajimaru kibou to iu na no mirai wo\The future, what we call hope, begins now\kore kara hajimaru kibou to iu na no mirai wo\The future, what we call hope, begins now response:	sono ashi wa arukidasu
context: I'll never forget your voice, and I'll never forget your tears\kimi no koe wasurenai namida mo wasurenai\I'll never forget your voice, and I'll never forget your tears\kore kara hajimaru kibou to iu na no mirai wo\The future, what we call hope, begins now\kore kara hajimaru kibou to iu na no mirai wo\The future, what we call hope, begins now\sono ashi wa arukidasu response:	Those legs will keep on moving forward,
context: kimi no koe wasurenai namida mo wasurenai\I'll never forget your voice, and I'll never forget your tears\kore kara hajimaru kibou to iu na no mirai wo\The future, what we call hope, begins now\kore kara hajimaru kibou to iu na no mirai wo\The future, what we call hope, begins now\sono ashi wa arukidasu\Those legs will keep on moving forward, response:	sono ashi wa arukidasu
context: I'll never forget your voice, and I'll never forget your tears\kore kara hajimaru kibou to iu na no mirai wo\The future, what we call hope, begins now\kore kara hajimaru kibou to iu na no mirai wo\The future, what we call hope, begins now\sono ashi wa arukidasu\Those legs will keep on moving forward,\sono ashi wa arukidasu response:	Those legs will keep on moving forward,
context: kore kara hajimaru kibou to iu na no mirai wo\The future, what we call hope, begins now\kore kara hajimaru kibou to iu na no mirai wo\The future, what we call hope, begins now\sono ashi wa arukidasu\Those legs will keep on moving forward,\sono ashi wa arukidasu\Those legs will keep on moving forward, response:	yagate kuru kakoku mo
context: The future, what we call hope, begins now\kore kara hajimaru kibou to iu na no mirai wo\The future, what we call hope, begins now\sono ashi wa arukidasu\Those legs will keep on moving forward,\sono ashi wa arukidasu\Those legs will keep on moving forward,\yagate kuru kakoku mo response:	Even in the face of the oncoming grief
context: kore kara hajimaru kibou to iu na no mirai wo\The future, what we call hope, begins now\sono ashi wa arukidasu\Those legs will keep on moving forward,\sono ashi wa arukidasu\Those legs will keep on moving forward,\yagate kuru kakoku mo\Even in the face of the oncoming grief response:	yagate kuru kakoku mo
context: The future, what we call hope, begins now\sono ashi wa arukidasu\Those legs will keep on moving forward,\sono ashi wa arukidasu\Those legs will keep on moving forward,\yagate kuru kakoku mo\Even in the face of the oncoming grief\yagate kuru kakoku mo response:	Even in the face of the oncoming grief
context: sono ashi wa arukidasu\Those legs will keep on moving forward,\sono ashi wa arukidasu\Those legs will keep on moving forward,\yagate kuru kakoku mo\Even in the face of the oncoming grief\yagate kuru kakoku mo\Even in the face of the oncoming grief response:	akaneiro no kumo
context: Those legs will keep on moving forward,\sono ashi wa arukidasu\Those legs will keep on moving forward,\yagate kuru kakoku mo\Even in the face of the oncoming grief\yagate kuru kakoku mo\Even in the face of the oncoming grief\akaneiro no kumo response:	The clouds, lit bright orange,
context: sono ashi wa arukidasu\Those legs will keep on moving forward,\yagate kuru kakoku mo\Even in the face of the oncoming grief\yagate kuru kakoku mo\Even in the face of the oncoming grief\akaneiro no kumo\The clouds, lit bright orange, response:	akaneiro no kumo
context: Those legs will keep on moving forward,\yagate kuru kakoku mo\Even in the face of the oncoming grief\yagate kuru kakoku mo\Even in the face of the oncoming grief\akaneiro no kumo\The clouds, lit bright orange,\akaneiro no kumo response:	The clouds, lit bright orange,
context: yagate kuru kakoku mo\Even in the face of the oncoming grief\yagate kuru kakoku mo\Even in the face of the oncoming grief\akaneiro no kumo\The clouds, lit bright orange,\akaneiro no kumo\The clouds, lit bright orange, response:	omoide mo futatsu
context: Even in the face of the oncoming grief\yagate kuru kakoku mo\Even in the face of the oncoming grief\akaneiro no kumo\The clouds, lit bright orange,\akaneiro no kumo\The clouds, lit bright orange,\omoide mo futatsu response:	And two of our memories
context: yagate kuru kakoku mo\Even in the face of the oncoming grief\akaneiro no kumo\The clouds, lit bright orange,\akaneiro no kumo\The clouds, lit bright orange,\omoide mo futatsu\And two of our memories response:	omoide mo futatsu
context: Even in the face of the oncoming grief\akaneiro no kumo\The clouds, lit bright orange,\akaneiro no kumo\The clouds, lit bright orange,\omoide mo futatsu\And two of our memories\omoide mo futatsu response:	And two of our memories
context: akaneiro no kumo\The clouds, lit bright orange,\akaneiro no kumo\The clouds, lit bright orange,\omoide mo futatsu\And two of our memories\omoide mo futatsu\And two of our memories response:	tooku nagareteyuku yo
context: The clouds, lit bright orange,\akaneiro no kumo\The clouds, lit bright orange,\omoide mo futatsu\And two of our memories\omoide mo futatsu\And two of our memories\tooku nagareteyuku yo response:	Floating far into the distance
context: akaneiro no kumo\The clouds, lit bright orange,\omoide mo futatsu\And two of our memories\omoide mo futatsu\And two of our memories\tooku nagareteyuku yo\Floating far into the distance response:	tooku nagareteyuku yo
context: The clouds, lit bright orange,\omoide mo futatsu\And two of our memories\omoide mo futatsu\And two of our memories\tooku nagareteyuku yo\Floating far into the distance\tooku nagareteyuku yo response:	Floating far into the distance
context: omoide mo futatsu\And two of our memories\omoide mo futatsu\And two of our memories\tooku nagareteyuku yo\Floating far into the distance\tooku nagareteyuku yo\Floating far into the distance response:	hibiku kane no oto
context: And two of our memories\omoide mo futatsu\And two of our memories\tooku nagareteyuku yo\Floating far into the distance\tooku nagareteyuku yo\Floating far into the distance\hibiku kane no oto response:	The sound of the bell echoing,
context: omoide mo futatsu\And two of our memories\tooku nagareteyuku yo\Floating far into the distance\tooku nagareteyuku yo\Floating far into the distance\hibiku kane no oto\The sound of the bell echoing, response:	hibiku kane no oto
context: And two of our memories\tooku nagareteyuku yo\Floating far into the distance\tooku nagareteyuku yo\Floating far into the distance\hibiku kane no oto\The sound of the bell echoing,\hibiku kane no oto response:	The sound of the bell echoing,
context: tooku nagareteyuku yo\Floating far into the distance\tooku nagareteyuku yo\Floating far into the distance\hibiku kane no oto\The sound of the bell echoing,\hibiku kane no oto\The sound of the bell echoing, response:	kakera kimi to hitotsuzutsu
context: Floating far into the distance\tooku nagareteyuku yo\Floating far into the distance\hibiku kane no oto\The sound of the bell echoing,\hibiku kane no oto\The sound of the bell echoing,\kakera kimi to hitotsuzutsu response:	Those pieces we shared, one each
context: tooku nagareteyuku yo\Floating far into the distance\hibiku kane no oto\The sound of the bell echoing,\hibiku kane no oto\The sound of the bell echoing,\kakera kimi to hitotsuzutsu\Those pieces we shared, one each response:	kakera kimi to hitotsuzutsu
context: Floating far into the distance\hibiku kane no oto\The sound of the bell echoing,\hibiku kane no oto\The sound of the bell echoing,\kakera kimi to hitotsuzutsu\Those pieces we shared, one each\kakera kimi to hitotsuzutsu response:	Those pieces we shared, one each
context: hibiku kane no oto\The sound of the bell echoing,\hibiku kane no oto\The sound of the bell echoing,\kakera kimi to hitotsuzutsu\Those pieces we shared, one each\kakera kimi to hitotsuzutsu\Those pieces we shared, one each response:	ashita wa tenki ni nare
context: The sound of the bell echoing,\hibiku kane no oto\The sound of the bell echoing,\kakera kimi to hitotsuzutsu\Those pieces we shared, one each\kakera kimi to hitotsuzutsu\Those pieces we shared, one each\ashita wa tenki ni nare response:	I hope tomorrow will be sunny
context: hibiku kane no oto\The sound of the bell echoing,\kakera kimi to hitotsuzutsu\Those pieces we shared, one each\kakera kimi to hitotsuzutsu\Those pieces we shared, one each\ashita wa tenki ni nare\I hope tomorrow will be sunny response:	ashita wa tenki ni nare
context: The sound of the bell echoing,\kakera kimi to hitotsuzutsu\Those pieces we shared, one each\kakera kimi to hitotsuzutsu\Those pieces we shared, one each\ashita wa tenki ni nare\I hope tomorrow will be sunny\ashita wa tenki ni nare response:	I hope tomorrow will be sunny
context: kakera kimi to hitotsuzutsu\Those pieces we shared, one each\kakera kimi to hitotsuzutsu\Those pieces we shared, one each\ashita wa tenki ni nare\I hope tomorrow will be sunny\ashita wa tenki ni nare\I hope tomorrow will be sunny response:	hoshi no mukou ikeru kana
context: Those pieces we shared, one each\kakera kimi to hitotsuzutsu\Those pieces we shared, one each\ashita wa tenki ni nare\I hope tomorrow will be sunny\ashita wa tenki ni nare\I hope tomorrow will be sunny\hoshi no mukou ikeru kana response:	Can we go beyond the stars?
context: kakera kimi to hitotsuzutsu\Those pieces we shared, one each\ashita wa tenki ni nare\I hope tomorrow will be sunny\ashita wa tenki ni nare\I hope tomorrow will be sunny\hoshi no mukou ikeru kana\Can we go beyond the stars? response:	hoshi no mukou ikeru kana
context: Those pieces we shared, one each\ashita wa tenki ni nare\I hope tomorrow will be sunny\ashita wa tenki ni nare\I hope tomorrow will be sunny\hoshi no mukou ikeru kana\Can we go beyond the stars?\hoshi no mukou ikeru kana response:	Can we go beyond the stars?
context: ashita wa tenki ni nare\I hope tomorrow will be sunny\ashita wa tenki ni nare\I hope tomorrow will be sunny\hoshi no mukou ikeru kana\Can we go beyond the stars?\hoshi no mukou ikeru kana\Can we go beyond the stars? response:	sora mitsumete aruku hitohikari
context: I hope tomorrow will be sunny\ashita wa tenki ni nare\I hope tomorrow will be sunny\hoshi no mukou ikeru kana\Can we go beyond the stars?\hoshi no mukou ikeru kana\Can we go beyond the stars?\sora mitsumete aruku hitohikari response:	Walking, looking at the sky, a single light
context: ashita wa tenki ni nare\I hope tomorrow will be sunny\hoshi no mukou ikeru kana\Can we go beyond the stars?\hoshi no mukou ikeru kana\Can we go beyond the stars?\sora mitsumete aruku hitohikari\Walking, looking at the sky, a single light response:	sora mitsumete aruku hitohikari
context: I hope tomorrow will be sunny\hoshi no mukou ikeru kana\Can we go beyond the stars?\hoshi no mukou ikeru kana\Can we go beyond the stars?\sora mitsumete aruku hitohikari\Walking, looking at the sky, a single light\sora mitsumete aruku hitohikari response:	Walking, looking at the sky, a single light
context: hoshi no mukou ikeru kana\Can we go beyond the stars?\hoshi no mukou ikeru kana\Can we go beyond the stars?\sora mitsumete aruku hitohikari\Walking, looking at the sky, a single light\sora mitsumete aruku hitohikari\Walking, looking at the sky, a single light response:	tsuki no ue hitori demo
context: Can we go beyond the stars?\hoshi no mukou ikeru kana\Can we go beyond the stars?\sora mitsumete aruku hitohikari\Walking, looking at the sky, a single light\sora mitsumete aruku hitohikari\Walking, looking at the sky, a single light\tsuki no ue hitori demo response:	Even alone, on the face of the moon,
context: hoshi no mukou ikeru kana\Can we go beyond the stars?\sora mitsumete aruku hitohikari\Walking, looking at the sky, a single light\sora mitsumete aruku hitohikari\Walking, looking at the sky, a single light\tsuki no ue hitori demo\Even alone, on the face of the moon, response:	tsuki no ue hitori demo
context: Can we go beyond the stars?\sora mitsumete aruku hitohikari\Walking, looking at the sky, a single light\sora mitsumete aruku hitohikari\Walking, looking at the sky, a single light\tsuki no ue hitori demo\Even alone, on the face of the moon,\tsuki no ue hitori demo response:	Even alone, on the face of the moon,
context: sora mitsumete aruku hitohikari\Walking, looking at the sky, a single light\sora mitsumete aruku hitohikari\Walking, looking at the sky, a single light\tsuki no ue hitori demo\Even alone, on the face of the moon,\tsuki no ue hitori demo\Even alone, on the face of the moon, response:	rasen no hate he kaketeyuku yo
context: Walking, looking at the sky, a single light\sora mitsumete aruku hitohikari\Walking, looking at the sky, a single light\tsuki no ue hitori demo\Even alone, on the face of the moon,\tsuki no ue hitori demo\Even alone, on the face of the moon,\rasen no hate he kaketeyuku yo response:	Run right past the end of the circle
context: sora mitsumete aruku hitohikari\Walking, looking at the sky, a single light\tsuki no ue hitori demo\Even alone, on the face of the moon,\tsuki no ue hitori demo\Even alone, on the face of the moon,\rasen no hate he kaketeyuku yo\Run right past the end of the circle response:	rasen no hate he kaketeyuku yo
context: Walking, looking at the sky, a single light\tsuki no ue hitori demo\Even alone, on the face of the moon,\tsuki no ue hitori demo\Even alone, on the face of the moon,\rasen no hate he kaketeyuku yo\Run right past the end of the circle\rasen no hate he kaketeyuku yo response:	Run right past the end of the circle
context: tsuki no ue hitori demo\Even alone, on the face of the moon,\tsuki no ue hitori demo\Even alone, on the face of the moon,\rasen no hate he kaketeyuku yo\Run right past the end of the circle\rasen no hate he kaketeyuku yo\Run right past the end of the circle response:	kimi wa naita ato waraeru
context: Even alone, on the face of the moon,\tsuki no ue hitori demo\Even alone, on the face of the moon,\rasen no hate he kaketeyuku yo\Run right past the end of the circle\rasen no hate he kaketeyuku yo\Run right past the end of the circle\kimi wa naita ato waraeru response:	You'll be able to smile after you cry,
context: tsuki no ue hitori demo\Even alone, on the face of the moon,\rasen no hate he kaketeyuku yo\Run right past the end of the circle\rasen no hate he kaketeyuku yo\Run right past the end of the circle\kimi wa naita ato waraeru\You'll be able to smile after you cry, response:	kimi wa naita ato waraeru
context: Even alone, on the face of the moon,\rasen no hate he kaketeyuku yo\Run right past the end of the circle\rasen no hate he kaketeyuku yo\Run right past the end of the circle\kimi wa naita ato waraeru\You'll be able to smile after you cry,\kimi wa naita ato waraeru response:	You'll be able to smile after you cry,
context: rasen no hate he kaketeyuku yo\Run right past the end of the circle\rasen no hate he kaketeyuku yo\Run right past the end of the circle\kimi wa naita ato waraeru\You'll be able to smile after you cry,\kimi wa naita ato waraeru\You'll be able to smile after you cry, response:	hazu dakara tte ittan da
context: Run right past the end of the circle\rasen no hate he kaketeyuku yo\Run right past the end of the circle\kimi wa naita ato waraeru\You'll be able to smile after you cry,\kimi wa naita ato waraeru\You'll be able to smile after you cry,\hazu dakara tte ittan da response:	I said that because I know you can
context: rasen no hate he kaketeyuku yo\Run right past the end of the circle\kimi wa naita ato waraeru\You'll be able to smile after you cry,\kimi wa naita ato waraeru\You'll be able to smile after you cry,\hazu dakara tte ittan da\I said that because I know you can response:	hazu dakara tte ittan da
context: Run right past the end of the circle\kimi wa naita ato waraeru\You'll be able to smile after you cry,\kimi wa naita ato waraeru\You'll be able to smile after you cry,\hazu dakara tte ittan da\I said that because I know you can\hazu dakara tte ittan da response:	I said that because I know you can
context: kimi wa naita ato waraeru\You'll be able to smile after you cry,\kimi wa naita ato waraeru\You'll be able to smile after you cry,\hazu dakara tte ittan da\I said that because I know you can\hazu dakara tte ittan da\I said that because I know you can response:	bokura no tabi wasuretari shinai yo
context: You'll be able to smile after you cry,\kimi wa naita ato waraeru\You'll be able to smile after you cry,\hazu dakara tte ittan da\I said that because I know you can\hazu dakara tte ittan da\I said that because I know you can\bokura no tabi wasuretari shinai yo response:	You'll never forget our journey, even for a moment
context: kimi wa naita ato waraeru\You'll be able to smile after you cry,\hazu dakara tte ittan da\I said that because I know you can\hazu dakara tte ittan da\I said that because I know you can\bokura no tabi wasuretari shinai yo\You'll never forget our journey, even for a moment response:	bokura no tabi wasuretari shinai yo
context: You'll be able to smile after you cry,\hazu dakara tte ittan da\I said that because I know you can\hazu dakara tte ittan da\I said that because I know you can\bokura no tabi wasuretari shinai yo\You'll never forget our journey, even for a moment\bokura no tabi wasuretari shinai yo response:	You'll never forget our journey, even for a moment
context: hazu dakara tte ittan da\I said that because I know you can\hazu dakara tte ittan da\I said that because I know you can\bokura no tabi wasuretari shinai yo\You'll never forget our journey, even for a moment\bokura no tabi wasuretari shinai yo\You'll never forget our journey, even for a moment response:	nakusanai you ni mahou kakete
context: I said that because I know you can\hazu dakara tte ittan da\I said that because I know you can\bokura no tabi wasuretari shinai yo\You'll never forget our journey, even for a moment\bokura no tabi wasuretari shinai yo\You'll never forget our journey, even for a moment\nakusanai you ni mahou kakete response:	I'll cast a little magic so you never lose it,
context: hazu dakara tte ittan da\I said that because I know you can\bokura no tabi wasuretari shinai yo\You'll never forget our journey, even for a moment\bokura no tabi wasuretari shinai yo\You'll never forget our journey, even for a moment\nakusanai you ni mahou kakete\I'll cast a little magic so you never lose it, response:	nakusanai you ni mahou kakete
context: I said that because I know you can\bokura no tabi wasuretari shinai yo\You'll never forget our journey, even for a moment\bokura no tabi wasuretari shinai yo\You'll never forget our journey, even for a moment\nakusanai you ni mahou kakete\I'll cast a little magic so you never lose it,\nakusanai you ni mahou kakete response:	I'll cast a little magic so you never lose it,
context: bokura no tabi wasuretari shinai yo\You'll never forget our journey, even for a moment\bokura no tabi wasuretari shinai yo\You'll never forget our journey, even for a moment\nakusanai you ni mahou kakete\I'll cast a little magic so you never lose it,\nakusanai you ni mahou kakete\I'll cast a little magic so you never lose it, response:	sayonara wo tsutaenai
context: You'll never forget our journey, even for a moment\bokura no tabi wasuretari shinai yo\You'll never forget our journey, even for a moment\nakusanai you ni mahou kakete\I'll cast a little magic so you never lose it,\nakusanai you ni mahou kakete\I'll cast a little magic so you never lose it,\sayonara wo tsutaenai response:	And I won't say good-bye
context: bokura no tabi wasuretari shinai yo\You'll never forget our journey, even for a moment\nakusanai you ni mahou kakete\I'll cast a little magic so you never lose it,\nakusanai you ni mahou kakete\I'll cast a little magic so you never lose it,\sayonara wo tsutaenai\And I won't say good-bye response:	sayonara wo tsutaenai
context: You'll never forget our journey, even for a moment\nakusanai you ni mahou kakete\I'll cast a little magic so you never lose it,\nakusanai you ni mahou kakete\I'll cast a little magic so you never lose it,\sayonara wo tsutaenai\And I won't say good-bye\sayonara wo tsutaenai response:	And I won't say good-bye
context: nakusanai you ni mahou kakete\I'll cast a little magic so you never lose it,\nakusanai you ni mahou kakete\I'll cast a little magic so you never lose it,\sayonara wo tsutaenai\And I won't say good-bye\sayonara wo tsutaenai\And I won't say good-bye response:	arukidasu yo mata itsuka
context: I'll cast a little magic so you never lose it,\nakusanai you ni mahou kakete\I'll cast a little magic so you never lose it,\sayonara wo tsutaenai\And I won't say good-bye\sayonara wo tsutaenai\And I won't say good-bye\arukidasu yo mata itsuka response:	You'll start walking again one day
context: nakusanai you ni mahou kakete\I'll cast a little magic so you never lose it,\sayonara wo tsutaenai\And I won't say good-bye\sayonara wo tsutaenai\And I won't say good-bye\arukidasu yo mata itsuka\You'll start walking again one day response:	arukidasu yo mata itsuka
context: I'll cast a little magic so you never lose it,\sayonara wo tsutaenai\And I won't say good-bye\sayonara wo tsutaenai\And I won't say good-bye\arukidasu yo mata itsuka\You'll start walking again one day\arukidasu yo mata itsuka response:	You'll start walking again one day