context: I'm Kurihara Osamu, a first-year in high school. response:	The candle we both lit in our hearts on a holy night
context: I'm Kurihara Osamu, a first-year in high school.\The candle we both lit in our hearts on a holy night response:	can never be extinguished.
context: I'm Kurihara Osamu, a first-year in high school.\The candle we both lit in our hearts on a holy night\can never be extinguished. response:	You kissed Nanako-san on Christmas?!
context: I'm Kurihara Osamu, a first-year in high school.\The candle we both lit in our hearts on a holy night\can never be extinguished.\You kissed Nanako-san on Christmas?! response:	The very first day you started dating?
context: I'm Kurihara Osamu, a first-year in high school.\The candle we both lit in our hearts on a holy night\can never be extinguished.\You kissed Nanako-san on Christmas?!\The very first day you started dating? response:	Yeah.
context: I'm Kurihara Osamu, a first-year in high school.\The candle we both lit in our hearts on a holy night\can never be extinguished.\You kissed Nanako-san on Christmas?!\The very first day you started dating?\Yeah. response:	Isn't that too fast?
context: I'm Kurihara Osamu, a first-year in high school.\The candle we both lit in our hearts on a holy night\can never be extinguished.\You kissed Nanako-san on Christmas?!\The very first day you started dating?\Yeah.\Isn't that too fast? response:	There aren't any rules for that
context: I'm Kurihara Osamu, a first-year in high school.\The candle we both lit in our hearts on a holy night\can never be extinguished.\You kissed Nanako-san on Christmas?!\The very first day you started dating?\Yeah.\Isn't that too fast?\There aren't any rules for that response:	It's too fast!
context: The candle we both lit in our hearts on a holy night\can never be extinguished.\You kissed Nanako-san on Christmas?!\The very first day you started dating?\Yeah.\Isn't that too fast?\There aren't any rules for that\It's too fast! response:	Huh?
context: can never be extinguished.\You kissed Nanako-san on Christmas?!\The very first day you started dating?\Yeah.\Isn't that too fast?\There aren't any rules for that\It's too fast!\Huh? response:	Then when is it okay for you, Takeo?
context: You kissed Nanako-san on Christmas?!\The very first day you started dating?\Yeah.\Isn't that too fast?\There aren't any rules for that\It's too fast!\Huh?\Then when is it okay for you, Takeo? response:	The autumn of my third year in high school!
context: The very first day you started dating?\Yeah.\Isn't that too fast?\There aren't any rules for that\It's too fast!\Huh?\Then when is it okay for you, Takeo?\The autumn of my third year in high school! response:	Why autumn?
context: Yeah.\Isn't that too fast?\There aren't any rules for that\It's too fast!\Huh?\Then when is it okay for you, Takeo?\The autumn of my third year in high school!\Why autumn? response:	My Birthday
context: Isn't that too fast?\There aren't any rules for that\It's too fast!\Huh?\Then when is it okay for you, Takeo?\The autumn of my third year in high school!\Why autumn?\My Birthday response:	Okay, I'm off to a date with Nanako.
context: There aren't any rules for that\It's too fast!\Huh?\Then when is it okay for you, Takeo?\The autumn of my third year in high school!\Why autumn?\My Birthday\Okay, I'm off to a date with Nanako. response:	Hey, you do well by her.
context: It's too fast!\Huh?\Then when is it okay for you, Takeo?\The autumn of my third year in high school!\Why autumn?\My Birthday\Okay, I'm off to a date with Nanako.\Hey, you do well by her. response:	Of course!
context: Huh?\Then when is it okay for you, Takeo?\The autumn of my third year in high school!\Why autumn?\My Birthday\Okay, I'm off to a date with Nanako.\Hey, you do well by her.\Of course! response:	He's so easygoing...
context: Then when is it okay for you, Takeo?\The autumn of my third year in high school!\Why autumn?\My Birthday\Okay, I'm off to a date with Nanako.\Hey, you do well by her.\Of course!\He's so easygoing... response:	Why is it the autumn of your third year?
context: The autumn of my third year in high school!\Why autumn?\My Birthday\Okay, I'm off to a date with Nanako.\Hey, you do well by her.\Of course!\He's so easygoing...\Why is it the autumn of your third year? response:	Spring would be too fast.
context: Why autumn?\My Birthday\Okay, I'm off to a date with Nanako.\Hey, you do well by her.\Of course!\He's so easygoing...\Why is it the autumn of your third year?\Spring would be too fast. response:	And I thought winter would be too slow.
context: My Birthday\Okay, I'm off to a date with Nanako.\Hey, you do well by her.\Of course!\He's so easygoing...\Why is it the autumn of your third year?\Spring would be too fast.\And I thought winter would be too slow. response:	Hmm...
context: Okay, I'm off to a date with Nanako.\Hey, you do well by her.\Of course!\He's so easygoing...\Why is it the autumn of your third year?\Spring would be too fast.\And I thought winter would be too slow.\Hmm... response:	A kiss...
context: Hey, you do well by her.\Of course!\He's so easygoing...\Why is it the autumn of your third year?\Spring would be too fast.\And I thought winter would be too slow.\Hmm...\A kiss... response:	That's so far beyond holding hands.
context: Of course!\He's so easygoing...\Why is it the autumn of your third year?\Spring would be too fast.\And I thought winter would be too slow.\Hmm...\A kiss...\That's so far beyond holding hands. response:	Good thing you don't have cavities.
context: He's so easygoing...\Why is it the autumn of your third year?\Spring would be too fast.\And I thought winter would be too slow.\Hmm...\A kiss...\That's so far beyond holding hands.\Good thing you don't have cavities. response:	It's mouth to mouth.
context: Why is it the autumn of your third year?\Spring would be too fast.\And I thought winter would be too slow.\Hmm...\A kiss...\That's so far beyond holding hands.\Good thing you don't have cavities.\It's mouth to mouth. response:	It's a big deal.
context: Spring would be too fast.\And I thought winter would be too slow.\Hmm...\A kiss...\That's so far beyond holding hands.\Good thing you don't have cavities.\It's mouth to mouth.\It's a big deal. response:	I bet it's an even bigger deal for girls than for me.
context: And I thought winter would be too slow.\Hmm...\A kiss...\That's so far beyond holding hands.\Good thing you don't have cavities.\It's mouth to mouth.\It's a big deal.\I bet it's an even bigger deal for girls than for me. response:	When the time comes,
context: Hmm...\A kiss...\That's so far beyond holding hands.\Good thing you don't have cavities.\It's mouth to mouth.\It's a big deal.\I bet it's an even bigger deal for girls than for me.\When the time comes, response:	I hope I can make it a good experience.
context: A kiss...\That's so far beyond holding hands.\Good thing you don't have cavities.\It's mouth to mouth.\It's a big deal.\I bet it's an even bigger deal for girls than for me.\When the time comes,\I hope I can make it a good experience. response:	Takeo-kun, your birthday's in three days.
context: That's so far beyond holding hands.\Good thing you don't have cavities.\It's mouth to mouth.\It's a big deal.\I bet it's an even bigger deal for girls than for me.\When the time comes,\I hope I can make it a good experience.\Takeo-kun, your birthday's in three days. response:	Oh, but maybe you'll be spending it with your family because it's New Year's Day.
context: Good thing you don't have cavities.\It's mouth to mouth.\It's a big deal.\I bet it's an even bigger deal for girls than for me.\When the time comes,\I hope I can make it a good experience.\Takeo-kun, your birthday's in three days.\Oh, but maybe you'll be spending it with your family because it's New Year's Day. response:	No, it's fine.
context: It's mouth to mouth.\It's a big deal.\I bet it's an even bigger deal for girls than for me.\When the time comes,\I hope I can make it a good experience.\Takeo-kun, your birthday's in three days.\Oh, but maybe you'll be spending it with your family because it's New Year's Day.\No, it's fine. response:	Really?
context: It's a big deal.\I bet it's an even bigger deal for girls than for me.\When the time comes,\I hope I can make it a good experience.\Takeo-kun, your birthday's in three days.\Oh, but maybe you'll be spending it with your family because it's New Year's Day.\No, it's fine.\Really? response:	Then I can see you?
context: I bet it's an even bigger deal for girls than for me.\When the time comes,\I hope I can make it a good experience.\Takeo-kun, your birthday's in three days.\Oh, but maybe you'll be spending it with your family because it's New Year's Day.\No, it's fine.\Really?\Then I can see you? response:	Sure.
context: When the time comes,\I hope I can make it a good experience.\Takeo-kun, your birthday's in three days.\Oh, but maybe you'll be spending it with your family because it's New Year's Day.\No, it's fine.\Really?\Then I can see you?\Sure. response:	Want to do the holiday shrine visit together?
context: I hope I can make it a good experience.\Takeo-kun, your birthday's in three days.\Oh, but maybe you'll be spending it with your family because it's New Year's Day.\No, it's fine.\Really?\Then I can see you?\Sure.\Want to do the holiday shrine visit together? response:	Okay!
context: Takeo-kun, your birthday's in three days.\Oh, but maybe you'll be spending it with your family because it's New Year's Day.\No, it's fine.\Really?\Then I can see you?\Sure.\Want to do the holiday shrine visit together?\Okay! response:	Takeo-kun?
context: Oh, but maybe you'll be spending it with your family because it's New Year's Day.\No, it's fine.\Really?\Then I can see you?\Sure.\Want to do the holiday shrine visit together?\Okay!\Takeo-kun? response:	I can't, not yet!
context: No, it's fine.\Really?\Then I can see you?\Sure.\Want to do the holiday shrine visit together?\Okay!\Takeo-kun?\I can't, not yet! response:	Right, this year, I'll be spending my birthday with Yamato...
context: Really?\Then I can see you?\Sure.\Want to do the holiday shrine visit together?\Okay!\Takeo-kun?\I can't, not yet!\Right, this year, I'll be spending my birthday with Yamato... response:	Sunakawa
context: Then I can see you?\Sure.\Want to do the holiday shrine visit together?\Okay!\Takeo-kun?\I can't, not yet!\Right, this year, I'll be spending my birthday with Yamato...\Sunakawa response:	Thanks.
context: Sure.\Want to do the holiday shrine visit together?\Okay!\Takeo-kun?\I can't, not yet!\Right, this year, I'll be spending my birthday with Yamato...\Sunakawa\Thanks. response:	Yeah, just now.
context: Want to do the holiday shrine visit together?\Okay!\Takeo-kun?\I can't, not yet!\Right, this year, I'll be spending my birthday with Yamato...\Sunakawa\Thanks.\Yeah, just now. response:	Bullet train was supper crowded.
context: Okay!\Takeo-kun?\I can't, not yet!\Right, this year, I'll be spending my birthday with Yamato...\Sunakawa\Thanks.\Yeah, just now.\Bullet train was supper crowded. response:	Home's where the heart is.
context: Takeo-kun?\I can't, not yet!\Right, this year, I'll be spending my birthday with Yamato...\Sunakawa\Thanks.\Yeah, just now.\Bullet train was supper crowded.\Home's where the heart is. response:	The last day of the year should be spent with family, after all.
context: I can't, not yet!\Right, this year, I'll be spending my birthday with Yamato...\Sunakawa\Thanks.\Yeah, just now.\Bullet train was supper crowded.\Home's where the heart is.\The last day of the year should be spent with family, after all. response:	How's Takeo?
context: Right, this year, I'll be spending my birthday with Yamato...\Sunakawa\Thanks.\Yeah, just now.\Bullet train was supper crowded.\Home's where the heart is.\The last day of the year should be spent with family, after all.\How's Takeo? response:	Are things going well with him and his girlfriend?
context: Sunakawa\Thanks.\Yeah, just now.\Bullet train was supper crowded.\Home's where the heart is.\The last day of the year should be spent with family, after all.\How's Takeo?\Are things going well with him and his girlfriend? response:	Yeah.
context: Thanks.\Yeah, just now.\Bullet train was supper crowded.\Home's where the heart is.\The last day of the year should be spent with family, after all.\How's Takeo?\Are things going well with him and his girlfriend?\Yeah. response:	Hello?
context: Yeah, just now.\Bullet train was supper crowded.\Home's where the heart is.\The last day of the year should be spent with family, after all.\How's Takeo?\Are things going well with him and his girlfriend?\Yeah.\Hello? response:	Oh, Yamato-san... Long time, no see!
context: Bullet train was supper crowded.\Home's where the heart is.\The last day of the year should be spent with family, after all.\How's Takeo?\Are things going well with him and his girlfriend?\Yeah.\Hello?\Oh, Yamato-san... Long time, no see! response:	Oh, hello.
context: Home's where the heart is.\The last day of the year should be spent with family, after all.\How's Takeo?\Are things going well with him and his girlfriend?\Yeah.\Hello?\Oh, Yamato-san... Long time, no see!\Oh, hello. response:	It's been a while.
context: The last day of the year should be spent with family, after all.\How's Takeo?\Are things going well with him and his girlfriend?\Yeah.\Hello?\Oh, Yamato-san... Long time, no see!\Oh, hello.\It's been a while. response:	What's the matter?
context: How's Takeo?\Are things going well with him and his girlfriend?\Yeah.\Hello?\Oh, Yamato-san... Long time, no see!\Oh, hello.\It's been a while.\What's the matter? response:	Did you get mixed up, trying to see Takeo?
context: Are things going well with him and his girlfriend?\Yeah.\Hello?\Oh, Yamato-san... Long time, no see!\Oh, hello.\It's been a while.\What's the matter?\Did you get mixed up, trying to see Takeo? response:	No, that isn't it...
context: Yeah.\Hello?\Oh, Yamato-san... Long time, no see!\Oh, hello.\It's been a while.\What's the matter?\Did you get mixed up, trying to see Takeo?\No, that isn't it... response:	Tomorrow is Takeo-kun's birthday.
context: Hello?\Oh, Yamato-san... Long time, no see!\Oh, hello.\It's been a while.\What's the matter?\Did you get mixed up, trying to see Takeo?\No, that isn't it...\Tomorrow is Takeo-kun's birthday. response:	Oh, yeah.
context: Oh, Yamato-san... Long time, no see!\Oh, hello.\It's been a while.\What's the matter?\Did you get mixed up, trying to see Takeo?\No, that isn't it...\Tomorrow is Takeo-kun's birthday.\Oh, yeah. response:	I was wondering what kind of cake to make.
context: Oh, hello.\It's been a while.\What's the matter?\Did you get mixed up, trying to see Takeo?\No, that isn't it...\Tomorrow is Takeo-kun's birthday.\Oh, yeah.\I was wondering what kind of cake to make. response:	Oh, right.
context: It's been a while.\What's the matter?\Did you get mixed up, trying to see Takeo?\No, that isn't it...\Tomorrow is Takeo-kun's birthday.\Oh, yeah.\I was wondering what kind of cake to make.\Oh, right. response:	He likes everything, so that almost makes it harder to choose...
context: What's the matter?\Did you get mixed up, trying to see Takeo?\No, that isn't it...\Tomorrow is Takeo-kun's birthday.\Oh, yeah.\I was wondering what kind of cake to make.\Oh, right.\He likes everything, so that almost makes it harder to choose... response:	Why are you guys in my room?
context: Did you get mixed up, trying to see Takeo?\No, that isn't it...\Tomorrow is Takeo-kun's birthday.\Oh, yeah.\I was wondering what kind of cake to make.\Oh, right.\He likes everything, so that almost makes it harder to choose...\Why are you guys in my room? response:	How about the first cake you made for him?
context: No, that isn't it...\Tomorrow is Takeo-kun's birthday.\Oh, yeah.\I was wondering what kind of cake to make.\Oh, right.\He likes everything, so that almost makes it harder to choose...\Why are you guys in my room?\How about the first cake you made for him? response:	The cheesecake Takeo ate that first time?
context: Tomorrow is Takeo-kun's birthday.\Oh, yeah.\I was wondering what kind of cake to make.\Oh, right.\He likes everything, so that almost makes it harder to choose...\Why are you guys in my room?\How about the first cake you made for him?\The cheesecake Takeo ate that first time? response:	Oh, right!
context: Oh, yeah.\I was wondering what kind of cake to make.\Oh, right.\He likes everything, so that almost makes it harder to choose...\Why are you guys in my room?\How about the first cake you made for him?\The cheesecake Takeo ate that first time?\Oh, right! response:	I don't have to make something new.
context: I was wondering what kind of cake to make.\Oh, right.\He likes everything, so that almost makes it harder to choose...\Why are you guys in my room?\How about the first cake you made for him?\The cheesecake Takeo ate that first time?\Oh, right!\I don't have to make something new. response:	Okay, I'll try doing something with a cheesecake.
context: Oh, right.\He likes everything, so that almost makes it harder to choose...\Why are you guys in my room?\How about the first cake you made for him?\The cheesecake Takeo ate that first time?\Oh, right!\I don't have to make something new.\Okay, I'll try doing something with a cheesecake. response:	Thanks, Sunakawa-kun.
context: He likes everything, so that almost makes it harder to choose...\Why are you guys in my room?\How about the first cake you made for him?\The cheesecake Takeo ate that first time?\Oh, right!\I don't have to make something new.\Okay, I'll try doing something with a cheesecake.\Thanks, Sunakawa-kun. response:	Good... I'm glad we figured it out.
context: Why are you guys in my room?\How about the first cake you made for him?\The cheesecake Takeo ate that first time?\Oh, right!\I don't have to make something new.\Okay, I'll try doing something with a cheesecake.\Thanks, Sunakawa-kun.\Good... I'm glad we figured it out. response:	Oh... And um...
context: How about the first cake you made for him?\The cheesecake Takeo ate that first time?\Oh, right!\I don't have to make something new.\Okay, I'll try doing something with a cheesecake.\Thanks, Sunakawa-kun.\Good... I'm glad we figured it out.\Oh... And um... response:	Uh...
context: The cheesecake Takeo ate that first time?\Oh, right!\I don't have to make something new.\Okay, I'll try doing something with a cheesecake.\Thanks, Sunakawa-kun.\Good... I'm glad we figured it out.\Oh... And um...\Uh... response:	I'm wondering what Takeo-kun would think if a girl tried to kiss him.
context: Oh, right!\I don't have to make something new.\Okay, I'll try doing something with a cheesecake.\Thanks, Sunakawa-kun.\Good... I'm glad we figured it out.\Oh... And um...\Uh...\I'm wondering what Takeo-kun would think if a girl tried to kiss him. response:	Huh?
context: I don't have to make something new.\Okay, I'll try doing something with a cheesecake.\Thanks, Sunakawa-kun.\Good... I'm glad we figured it out.\Oh... And um...\Uh...\I'm wondering what Takeo-kun would think if a girl tried to kiss him.\Huh? response:	Weren't you worried before that he mistakenly thought you were naIve?
context: Okay, I'll try doing something with a cheesecake.\Thanks, Sunakawa-kun.\Good... I'm glad we figured it out.\Oh... And um...\Uh...\I'm wondering what Takeo-kun would think if a girl tried to kiss him.\Huh?\Weren't you worried before that he mistakenly thought you were naIve? response:	Oh, yes.
context: Thanks, Sunakawa-kun.\Good... I'm glad we figured it out.\Oh... And um...\Uh...\I'm wondering what Takeo-kun would think if a girl tried to kiss him.\Huh?\Weren't you worried before that he mistakenly thought you were naIve?\Oh, yes. response:	That's been cleared up.
context: Good... I'm glad we figured it out.\Oh... And um...\Uh...\I'm wondering what Takeo-kun would think if a girl tried to kiss him.\Huh?\Weren't you worried before that he mistakenly thought you were naIve?\Oh, yes.\That's been cleared up. response:	But he isn't holding back because of me.
context: Oh... And um...\Uh...\I'm wondering what Takeo-kun would think if a girl tried to kiss him.\Huh?\Weren't you worried before that he mistakenly thought you were naIve?\Oh, yes.\That's been cleared up.\But he isn't holding back because of me. response:	Takeo-kun's just very modest.
context: Uh...\I'm wondering what Takeo-kun would think if a girl tried to kiss him.\Huh?\Weren't you worried before that he mistakenly thought you were naIve?\Oh, yes.\That's been cleared up.\But he isn't holding back because of me.\Takeo-kun's just very modest. response:	Modest
context: I'm wondering what Takeo-kun would think if a girl tried to kiss him.\Huh?\Weren't you worried before that he mistakenly thought you were naIve?\Oh, yes.\That's been cleared up.\But he isn't holding back because of me.\Takeo-kun's just very modest.\Modest response:	Right...
context: Huh?\Weren't you worried before that he mistakenly thought you were naIve?\Oh, yes.\That's been cleared up.\But he isn't holding back because of me.\Takeo-kun's just very modest.\Modest\Right... response:	You might have something there...
context: Weren't you worried before that he mistakenly thought you were naIve?\Oh, yes.\That's been cleared up.\But he isn't holding back because of me.\Takeo-kun's just very modest.\Modest\Right...\You might have something there... response:	Yeah.
context: Oh, yes.\That's been cleared up.\But he isn't holding back because of me.\Takeo-kun's just very modest.\Modest\Right...\You might have something there...\Yeah. response:	He said he won't kiss until the autumn of his third year.
context: That's been cleared up.\But he isn't holding back because of me.\Takeo-kun's just very modest.\Modest\Right...\You might have something there...\Yeah.\He said he won't kiss until the autumn of his third year. response:	Huh?!
context: But he isn't holding back because of me.\Takeo-kun's just very modest.\Modest\Right...\You might have something there...\Yeah.\He said he won't kiss until the autumn of his third year.\Huh?! response:	He said spring would be too early.
context: Takeo-kun's just very modest.\Modest\Right...\You might have something there...\Yeah.\He said he won't kiss until the autumn of his third year.\Huh?!\He said spring would be too early. response:	Th-Third year... Autumn... Okay.
context: Modest\Right...\You might have something there...\Yeah.\He said he won't kiss until the autumn of his third year.\Huh?!\He said spring would be too early.\Th-Third year... Autumn... Okay. response:	Okay, Takeo-kun...
context: Right...\You might have something there...\Yeah.\He said he won't kiss until the autumn of his third year.\Huh?!\He said spring would be too early.\Th-Third year... Autumn... Okay.\Okay, Takeo-kun... response:	Then I'll wait till third year.
context: You might have something there...\Yeah.\He said he won't kiss until the autumn of his third year.\Huh?!\He said spring would be too early.\Th-Third year... Autumn... Okay.\Okay, Takeo-kun...\Then I'll wait till third year. response:	But if you wanted to,
context: Yeah.\He said he won't kiss until the autumn of his third year.\Huh?!\He said spring would be too early.\Th-Third year... Autumn... Okay.\Okay, Takeo-kun...\Then I'll wait till third year.\But if you wanted to, response:	you could just do it whenever.
context: He said he won't kiss until the autumn of his third year.\Huh?!\He said spring would be too early.\Th-Third year... Autumn... Okay.\Okay, Takeo-kun...\Then I'll wait till third year.\But if you wanted to,\you could just do it whenever. response:	Huh?
context: Huh?!\He said spring would be too early.\Th-Third year... Autumn... Okay.\Okay, Takeo-kun...\Then I'll wait till third year.\But if you wanted to,\you could just do it whenever.\Huh? response:	I think Takeo would be happy.
context: He said spring would be too early.\Th-Third year... Autumn... Okay.\Okay, Takeo-kun...\Then I'll wait till third year.\But if you wanted to,\you could just do it whenever.\Huh?\I think Takeo would be happy. response:	What?
context: Th-Third year... Autumn... Okay.\Okay, Takeo-kun...\Then I'll wait till third year.\But if you wanted to,\you could just do it whenever.\Huh?\I think Takeo would be happy.\What? response:	What should I do?!
context: Okay, Takeo-kun...\Then I'll wait till third year.\But if you wanted to,\you could just do it whenever.\Huh?\I think Takeo would be happy.\What?\What should I do?! response:	Now she doesn't know what to do.
context: Then I'll wait till third year.\But if you wanted to,\you could just do it whenever.\Huh?\I think Takeo would be happy.\What?\What should I do?!\Now she doesn't know what to do. response:	Have you ever kissed someone, Sunakawa-kun?
context: But if you wanted to,\you could just do it whenever.\Huh?\I think Takeo would be happy.\What?\What should I do?!\Now she doesn't know what to do.\Have you ever kissed someone, Sunakawa-kun? response:	Dostoevsky
context: you could just do it whenever.\Huh?\I think Takeo would be happy.\What?\What should I do?!\Now she doesn't know what to do.\Have you ever kissed someone, Sunakawa-kun?\Dostoevsky response:	Why aren't you saying anything?
context: Huh?\I think Takeo would be happy.\What?\What should I do?!\Now she doesn't know what to do.\Have you ever kissed someone, Sunakawa-kun?\Dostoevsky\Why aren't you saying anything? response:	Of course he hasn't.
context: I think Takeo would be happy.\What?\What should I do?!\Now she doesn't know what to do.\Have you ever kissed someone, Sunakawa-kun?\Dostoevsky\Why aren't you saying anything?\Of course he hasn't. response:	Are you being pretentious?
context: What?\What should I do?!\Now she doesn't know what to do.\Have you ever kissed someone, Sunakawa-kun?\Dostoevsky\Why aren't you saying anything?\Of course he hasn't.\Are you being pretentious? response:	He's never had a girlfriend.
context: What should I do?!\Now she doesn't know what to do.\Have you ever kissed someone, Sunakawa-kun?\Dostoevsky\Why aren't you saying anything?\Of course he hasn't.\Are you being pretentious?\He's never had a girlfriend. response:	Right, sorry for asking such a strange question.
context: Now she doesn't know what to do.\Have you ever kissed someone, Sunakawa-kun?\Dostoevsky\Why aren't you saying anything?\Of course he hasn't.\Are you being pretentious?\He's never had a girlfriend.\Right, sorry for asking such a strange question. response:	Thank you for helping me today by hearing me out.
context: Have you ever kissed someone, Sunakawa-kun?\Dostoevsky\Why aren't you saying anything?\Of course he hasn't.\Are you being pretentious?\He's never had a girlfriend.\Right, sorry for asking such a strange question.\Thank you for helping me today by hearing me out. response:	And thank you, too!
context: Dostoevsky\Why aren't you saying anything?\Of course he hasn't.\Are you being pretentious?\He's never had a girlfriend.\Right, sorry for asking such a strange question.\Thank you for helping me today by hearing me out.\And thank you, too! response:	Take care.
context: Why aren't you saying anything?\Of course he hasn't.\Are you being pretentious?\He's never had a girlfriend.\Right, sorry for asking such a strange question.\Thank you for helping me today by hearing me out.\And thank you, too!\Take care. response:	Have a good New Year!
context: Of course he hasn't.\Are you being pretentious?\He's never had a girlfriend.\Right, sorry for asking such a strange question.\Thank you for helping me today by hearing me out.\And thank you, too!\Take care.\Have a good New Year! response:	Okay.
context: Are you being pretentious?\He's never had a girlfriend.\Right, sorry for asking such a strange question.\Thank you for helping me today by hearing me out.\And thank you, too!\Take care.\Have a good New Year!\Okay. response:	You, too.
context: He's never had a girlfriend.\Right, sorry for asking such a strange question.\Thank you for helping me today by hearing me out.\And thank you, too!\Take care.\Have a good New Year!\Okay.\You, too. response:	Yamato-san really loves Takeo, huh?
context: Right, sorry for asking such a strange question.\Thank you for helping me today by hearing me out.\And thank you, too!\Take care.\Have a good New Year!\Okay.\You, too.\Yamato-san really loves Takeo, huh? response:	Sincere
context: Thank you for helping me today by hearing me out.\And thank you, too!\Take care.\Have a good New Year!\Okay.\You, too.\Yamato-san really loves Takeo, huh?\Sincere response:	So she's going to kiss Takeo...
context: And thank you, too!\Take care.\Have a good New Year!\Okay.\You, too.\Yamato-san really loves Takeo, huh?\Sincere\So she's going to kiss Takeo... response:	Imagining it, I feel a little down!
context: Take care.\Have a good New Year!\Okay.\You, too.\Yamato-san really loves Takeo, huh?\Sincere\So she's going to kiss Takeo...\Imagining it, I feel a little down! response:	Then maybe you shouldn't imagine it.
context: Have a good New Year!\Okay.\You, too.\Yamato-san really loves Takeo, huh?\Sincere\So she's going to kiss Takeo...\Imagining it, I feel a little down!\Then maybe you shouldn't imagine it. response:	How's Oda-san?
context: Okay.\You, too.\Yamato-san really loves Takeo, huh?\Sincere\So she's going to kiss Takeo...\Imagining it, I feel a little down!\Then maybe you shouldn't imagine it.\How's Oda-san? response:	Oh, he's fine.
context: You, too.\Yamato-san really loves Takeo, huh?\Sincere\So she's going to kiss Takeo...\Imagining it, I feel a little down!\Then maybe you shouldn't imagine it.\How's Oda-san?\Oh, he's fine. response:	Actually, ever since MM Land, he's been coming on really strong.
context: Yamato-san really loves Takeo, huh?\Sincere\So she's going to kiss Takeo...\Imagining it, I feel a little down!\Then maybe you shouldn't imagine it.\How's Oda-san?\Oh, he's fine.\Actually, ever since MM Land, he's been coming on really strong. response:	Gouda!!
context: Sincere\So she's going to kiss Takeo...\Imagining it, I feel a little down!\Then maybe you shouldn't imagine it.\How's Oda-san?\Oh, he's fine.\Actually, ever since MM Land, he's been coming on really strong.\Gouda!! response:	Singing Contest
context: So she's going to kiss Takeo...\Imagining it, I feel a little down!\Then maybe you shouldn't imagine it.\How's Oda-san?\Oh, he's fine.\Actually, ever since MM Land, he's been coming on really strong.\Gouda!!\Singing Contest response:	Have a happy New Year, everyone.
context: Imagining it, I feel a little down!\Then maybe you shouldn't imagine it.\How's Oda-san?\Oh, he's fine.\Actually, ever since MM Land, he's been coming on really strong.\Gouda!!\Singing Contest\Have a happy New Year, everyone. response:	And so ends this year.
context: Then maybe you shouldn't imagine it.\How's Oda-san?\Oh, he's fine.\Actually, ever since MM Land, he's been coming on really strong.\Gouda!!\Singing Contest\Have a happy New Year, everyone.\And so ends this year. response:	It was a good year...
context: How's Oda-san?\Oh, he's fine.\Actually, ever since MM Land, he's been coming on really strong.\Gouda!!\Singing Contest\Have a happy New Year, everyone.\And so ends this year.\It was a good year... response:	Take, if you're sleepy, go sleep in your room.
context: Oh, he's fine.\Actually, ever since MM Land, he's been coming on really strong.\Gouda!!\Singing Contest\Have a happy New Year, everyone.\And so ends this year.\It was a good year...\Take, if you're sleepy, go sleep in your room. response:	Oof...
context: Actually, ever since MM Land, he's been coming on really strong.\Gouda!!\Singing Contest\Have a happy New Year, everyone.\And so ends this year.\It was a good year...\Take, if you're sleepy, go sleep in your room.\Oof... response:	What are you up to tomorrow?
context: Gouda!!\Singing Contest\Have a happy New Year, everyone.\And so ends this year.\It was a good year...\Take, if you're sleepy, go sleep in your room.\Oof...\What are you up to tomorrow? response:	At ten, I'm going to a shrine with Yamato.
context: Singing Contest\Have a happy New Year, everyone.\And so ends this year.\It was a good year...\Take, if you're sleepy, go sleep in your room.\Oof...\What are you up to tomorrow?\At ten, I'm going to a shrine with Yamato. response:	Oh, okay.
context: Have a happy New Year, everyone.\And so ends this year.\It was a good year...\Take, if you're sleepy, go sleep in your room.\Oof...\What are you up to tomorrow?\At ten, I'm going to a shrine with Yamato.\Oh, okay. response:	Goodnight.
context: And so ends this year.\It was a good year...\Take, if you're sleepy, go sleep in your room.\Oof...\What are you up to tomorrow?\At ten, I'm going to a shrine with Yamato.\Oh, okay.\Goodnight. response:	Night.
context: It was a good year...\Take, if you're sleepy, go sleep in your room.\Oof...\What are you up to tomorrow?\At ten, I'm going to a shrine with Yamato.\Oh, okay.\Goodnight.\Night. response:	Happy Birthday, Takeo-kun!
context: Take, if you're sleepy, go sleep in your room.\Oof...\What are you up to tomorrow?\At ten, I'm going to a shrine with Yamato.\Oh, okay.\Goodnight.\Night.\Happy Birthday, Takeo-kun! response:	Oh, thanks.
context: Oof...\What are you up to tomorrow?\At ten, I'm going to a shrine with Yamato.\Oh, okay.\Goodnight.\Night.\Happy Birthday, Takeo-kun!\Oh, thanks. response:	Were you sleeping, Takeo-kun?
context: What are you up to tomorrow?\At ten, I'm going to a shrine with Yamato.\Oh, okay.\Goodnight.\Night.\Happy Birthday, Takeo-kun!\Oh, thanks.\Were you sleeping, Takeo-kun? response:	Oh, don't worry about it.
context: At ten, I'm going to a shrine with Yamato.\Oh, okay.\Goodnight.\Night.\Happy Birthday, Takeo-kun!\Oh, thanks.\Were you sleeping, Takeo-kun?\Oh, don't worry about it. response:	Sorry about that.
context: Oh, okay.\Goodnight.\Night.\Happy Birthday, Takeo-kun!\Oh, thanks.\Were you sleeping, Takeo-kun?\Oh, don't worry about it.\Sorry about that. response:	See you tomorrow... Oh, it's already today!
context: Goodnight.\Night.\Happy Birthday, Takeo-kun!\Oh, thanks.\Were you sleeping, Takeo-kun?\Oh, don't worry about it.\Sorry about that.\See you tomorrow... Oh, it's already today! response:	Yeah.
context: Night.\Happy Birthday, Takeo-kun!\Oh, thanks.\Were you sleeping, Takeo-kun?\Oh, don't worry about it.\Sorry about that.\See you tomorrow... Oh, it's already today!\Yeah. response:	Goodnight.
context: Happy Birthday, Takeo-kun!\Oh, thanks.\Were you sleeping, Takeo-kun?\Oh, don't worry about it.\Sorry about that.\See you tomorrow... Oh, it's already today!\Yeah.\Goodnight. response:	Night.
context: Oh, thanks.\Were you sleeping, Takeo-kun?\Oh, don't worry about it.\Sorry about that.\See you tomorrow... Oh, it's already today!\Yeah.\Goodnight.\Night. response:	This year will be a good year, too.
context: Were you sleeping, Takeo-kun?\Oh, don't worry about it.\Sorry about that.\See you tomorrow... Oh, it's already today!\Yeah.\Goodnight.\Night.\This year will be a good year, too. response:	Ram HNY Gouda Takeo
context: Oh, don't worry about it.\Sorry about that.\See you tomorrow... Oh, it's already today!\Yeah.\Goodnight.\Night.\This year will be a good year, too.\Ram HNY Gouda Takeo response:	first laugh of the year
context: Sorry about that.\See you tomorrow... Oh, it's already today!\Yeah.\Goodnight.\Night.\This year will be a good year, too.\Ram HNY Gouda Takeo\first laugh of the year response:	Happy New Year!
context: See you tomorrow... Oh, it's already today!\Yeah.\Goodnight.\Night.\This year will be a good year, too.\Ram HNY Gouda Takeo\first laugh of the year\Happy New Year! response:	Happy New Year.
context: Yeah.\Goodnight.\Night.\This year will be a good year, too.\Ram HNY Gouda Takeo\first laugh of the year\Happy New Year!\Happy New Year. response:	Happy New Year.
context: Goodnight.\Night.\This year will be a good year, too.\Ram HNY Gouda Takeo\first laugh of the year\Happy New Year!\Happy New Year.\Happy New Year. response:	Here, your New Year's gift.
context: Night.\This year will be a good year, too.\Ram HNY Gouda Takeo\first laugh of the year\Happy New Year!\Happy New Year.\Happy New Year.\Here, your New Year's gift. response:	New Year's Gift
context: This year will be a good year, too.\Ram HNY Gouda Takeo\first laugh of the year\Happy New Year!\Happy New Year.\Happy New Year.\Here, your New Year's gift.\New Year's Gift response:	Oh, thanks!
context: Ram HNY Gouda Takeo\first laugh of the year\Happy New Year!\Happy New Year.\Happy New Year.\Here, your New Year's gift.\New Year's Gift\Oh, thanks! response:	I'm off.
context: first laugh of the year\Happy New Year!\Happy New Year.\Happy New Year.\Here, your New Year's gift.\New Year's Gift\Oh, thanks!\I'm off. response:	Okay.
context: Happy New Year!\Happy New Year.\Happy New Year.\Here, your New Year's gift.\New Year's Gift\Oh, thanks!\I'm off.\Okay. response:	Yamato!
context: Happy New Year.\Happy New Year.\Here, your New Year's gift.\New Year's Gift\Oh, thanks!\I'm off.\Okay.\Yamato! response:	Takeo-kun!
context: Happy New Year.\Here, your New Year's gift.\New Year's Gift\Oh, thanks!\I'm off.\Okay.\Yamato!\Takeo-kun! response:	I love her this year, too.
context: Here, your New Year's gift.\New Year's Gift\Oh, thanks!\I'm off.\Okay.\Yamato!\Takeo-kun!\I love her this year, too. response:	Happy birthday.
context: New Year's Gift\Oh, thanks!\I'm off.\Okay.\Yamato!\Takeo-kun!\I love her this year, too.\Happy birthday. response:	Thanks.
context: Oh, thanks!\I'm off.\Okay.\Yamato!\Takeo-kun!\I love her this year, too.\Happy birthday.\Thanks. response:	It's her second time saying it.
context: I'm off.\Okay.\Yamato!\Takeo-kun!\I love her this year, too.\Happy birthday.\Thanks.\It's her second time saying it. response:	It's my second time saying it.
context: Okay.\Yamato!\Takeo-kun!\I love her this year, too.\Happy birthday.\Thanks.\It's her second time saying it.\It's my second time saying it. response:	Yeah.
context: Yamato!\Takeo-kun!\I love her this year, too.\Happy birthday.\Thanks.\It's her second time saying it.\It's my second time saying it.\Yeah. response:	I was really happy I could be there for your birthday this year.
context: Takeo-kun!\I love her this year, too.\Happy birthday.\Thanks.\It's her second time saying it.\It's my second time saying it.\Yeah.\I was really happy I could be there for your birthday this year. response:	Oh, I guess it's last year now.
context: I love her this year, too.\Happy birthday.\Thanks.\It's her second time saying it.\It's my second time saying it.\Yeah.\I was really happy I could be there for your birthday this year.\Oh, I guess it's last year now. response:	Yeah.
context: Happy birthday.\Thanks.\It's her second time saying it.\It's my second time saying it.\Yeah.\I was really happy I could be there for your birthday this year.\Oh, I guess it's last year now.\Yeah. response:	So I'd like to make your birthday something you'll never forget.
context: Thanks.\It's her second time saying it.\It's my second time saying it.\Yeah.\I was really happy I could be there for your birthday this year.\Oh, I guess it's last year now.\Yeah.\So I'd like to make your birthday something you'll never forget. response:	Okay.
context: It's her second time saying it.\It's my second time saying it.\Yeah.\I was really happy I could be there for your birthday this year.\Oh, I guess it's last year now.\Yeah.\So I'd like to make your birthday something you'll never forget.\Okay. response:	I'll never forget, not ever.
context: It's my second time saying it.\Yeah.\I was really happy I could be there for your birthday this year.\Oh, I guess it's last year now.\Yeah.\So I'd like to make your birthday something you'll never forget.\Okay.\I'll never forget, not ever. response:	Aren't your hands cold, Takeo-kun?
context: Yeah.\I was really happy I could be there for your birthday this year.\Oh, I guess it's last year now.\Yeah.\So I'd like to make your birthday something you'll never forget.\Okay.\I'll never forget, not ever.\Aren't your hands cold, Takeo-kun? response:	Not at all.
context: I was really happy I could be there for your birthday this year.\Oh, I guess it's last year now.\Yeah.\So I'd like to make your birthday something you'll never forget.\Okay.\I'll never forget, not ever.\Aren't your hands cold, Takeo-kun?\Not at all. response:	I need gloves!
context: Oh, I guess it's last year now.\Yeah.\So I'd like to make your birthday something you'll never forget.\Okay.\I'll never forget, not ever.\Aren't your hands cold, Takeo-kun?\Not at all.\I need gloves! response:	I see.
context: Yeah.\So I'd like to make your birthday something you'll never forget.\Okay.\I'll never forget, not ever.\Aren't your hands cold, Takeo-kun?\Not at all.\I need gloves!\I see. response:	I love her!
context: So I'd like to make your birthday something you'll never forget.\Okay.\I'll never forget, not ever.\Aren't your hands cold, Takeo-kun?\Not at all.\I need gloves!\I see.\I love her! response:	Do you always come here, Takeo-kun?
context: Okay.\I'll never forget, not ever.\Aren't your hands cold, Takeo-kun?\Not at all.\I need gloves!\I see.\I love her!\Do you always come here, Takeo-kun? response:	Not always...
context: I'll never forget, not ever.\Aren't your hands cold, Takeo-kun?\Not at all.\I need gloves!\I see.\I love her!\Do you always come here, Takeo-kun?\Not always... response:	But last year, I was going to take entrance exams, so I came with Suna.
context: Aren't your hands cold, Takeo-kun?\Not at all.\I need gloves!\I see.\I love her!\Do you always come here, Takeo-kun?\Not always...\But last year, I was going to take entrance exams, so I came with Suna. response:	I came last year, too.
context: Not at all.\I need gloves!\I see.\I love her!\Do you always come here, Takeo-kun?\Not always...\But last year, I was going to take entrance exams, so I came with Suna.\I came last year, too. response:	This year, your family will be having a new baby.
context: I need gloves!\I see.\I love her!\Do you always come here, Takeo-kun?\Not always...\But last year, I was going to take entrance exams, so I came with Suna.\I came last year, too.\This year, your family will be having a new baby. response:	Yeah.
context: I see.\I love her!\Do you always come here, Takeo-kun?\Not always...\But last year, I was going to take entrance exams, so I came with Suna.\I came last year, too.\This year, your family will be having a new baby.\Yeah. response:	It'll be fun.
context: I love her!\Do you always come here, Takeo-kun?\Not always...\But last year, I was going to take entrance exams, so I came with Suna.\I came last year, too.\This year, your family will be having a new baby.\Yeah.\It'll be fun. response:	Yeah, I'm looking forward to it.
context: Do you always come here, Takeo-kun?\Not always...\But last year, I was going to take entrance exams, so I came with Suna.\I came last year, too.\This year, your family will be having a new baby.\Yeah.\It'll be fun.\Yeah, I'm looking forward to it. response:	Wow, look!
context: Not always...\But last year, I was going to take entrance exams, so I came with Suna.\I came last year, too.\This year, your family will be having a new baby.\Yeah.\It'll be fun.\Yeah, I'm looking forward to it.\Wow, look! response:	Fortune Great Luck
context: But last year, I was going to take entrance exams, so I came with Suna.\I came last year, too.\This year, your family will be having a new baby.\Yeah.\It'll be fun.\Yeah, I'm looking forward to it.\Wow, look!\Fortune Great Luck response:	You got great luck on your fortune!
context: I came last year, too.\This year, your family will be having a new baby.\Yeah.\It'll be fun.\Yeah, I'm looking forward to it.\Wow, look!\Fortune Great Luck\You got great luck on your fortune! response:	What did you get?
context: This year, your family will be having a new baby.\Yeah.\It'll be fun.\Yeah, I'm looking forward to it.\Wow, look!\Fortune Great Luck\You got great luck on your fortune!\What did you get? response:	I got small luck.
context: Yeah.\It'll be fun.\Yeah, I'm looking forward to it.\Wow, look!\Fortune Great Luck\You got great luck on your fortune!\What did you get?\I got small luck. response:	But if you got great luck, that's what I'll have, too.
context: It'll be fun.\Yeah, I'm looking forward to it.\Wow, look!\Fortune Great Luck\You got great luck on your fortune!\What did you get?\I got small luck.\But if you got great luck, that's what I'll have, too. response:	If you got small luck, I'll have small luck, too.
context: Yeah, I'm looking forward to it.\Wow, look!\Fortune Great Luck\You got great luck on your fortune!\What did you get?\I got small luck.\But if you got great luck, that's what I'll have, too.\If you got small luck, I'll have small luck, too. response:	Oh, right!
context: Wow, look!\Fortune Great Luck\You got great luck on your fortune!\What did you get?\I got small luck.\But if you got great luck, that's what I'll have, too.\If you got small luck, I'll have small luck, too.\Oh, right! response:	Fortune Small Luck Romance: Women will do well to take the initiative
context: Fortune Great Luck\You got great luck on your fortune!\What did you get?\I got small luck.\But if you got great luck, that's what I'll have, too.\If you got small luck, I'll have small luck, too.\Oh, right!\Fortune Small Luck Romance: Women will do well to take the initiative response:	I don't care if I have small luck...
context: You got great luck on your fortune!\What did you get?\I got small luck.\But if you got great luck, that's what I'll have, too.\If you got small luck, I'll have small luck, too.\Oh, right!\Fortune Small Luck Romance: Women will do well to take the initiative\I don't care if I have small luck... response:	I've never been lucky with fortunes.
context: What did you get?\I got small luck.\But if you got great luck, that's what I'll have, too.\If you got small luck, I'll have small luck, too.\Oh, right!\Fortune Small Luck Romance: Women will do well to take the initiative\I don't care if I have small luck...\I've never been lucky with fortunes. response:	Romance: Sleep on it, and wait for good news
context: I got small luck.\But if you got great luck, that's what I'll have, too.\If you got small luck, I'll have small luck, too.\Oh, right!\Fortune Small Luck Romance: Women will do well to take the initiative\I don't care if I have small luck...\I've never been lucky with fortunes.\Romance: Sleep on it, and wait for good news response:	I hope everyone will have a good year.
context: But if you got great luck, that's what I'll have, too.\If you got small luck, I'll have small luck, too.\Oh, right!\Fortune Small Luck Romance: Women will do well to take the initiative\I don't care if I have small luck...\I've never been lucky with fortunes.\Romance: Sleep on it, and wait for good news\I hope everyone will have a good year. response:	I hope that my little brother or sister will be born healthy.
context: If you got small luck, I'll have small luck, too.\Oh, right!\Fortune Small Luck Romance: Women will do well to take the initiative\I don't care if I have small luck...\I've never been lucky with fortunes.\Romance: Sleep on it, and wait for good news\I hope everyone will have a good year.\I hope that my little brother or sister will be born healthy. response:	I hope that Yamato and I can...
context: Oh, right!\Fortune Small Luck Romance: Women will do well to take the initiative\I don't care if I have small luck...\I've never been lucky with fortunes.\Romance: Sleep on it, and wait for good news\I hope everyone will have a good year.\I hope that my little brother or sister will be born healthy.\I hope that Yamato and I can... response:	I hope that we'll stay together.
context: Fortune Small Luck Romance: Women will do well to take the initiative\I don't care if I have small luck...\I've never been lucky with fortunes.\Romance: Sleep on it, and wait for good news\I hope everyone will have a good year.\I hope that my little brother or sister will be born healthy.\I hope that Yamato and I can...\I hope that we'll stay together. response:	Hey, Takeo-kun... I made a cake.
context: I don't care if I have small luck...\I've never been lucky with fortunes.\Romance: Sleep on it, and wait for good news\I hope everyone will have a good year.\I hope that my little brother or sister will be born healthy.\I hope that Yamato and I can...\I hope that we'll stay together.\Hey, Takeo-kun... I made a cake. response:	Can I come to your place?
context: I've never been lucky with fortunes.\Romance: Sleep on it, and wait for good news\I hope everyone will have a good year.\I hope that my little brother or sister will be born healthy.\I hope that Yamato and I can...\I hope that we'll stay together.\Hey, Takeo-kun... I made a cake.\Can I come to your place? response:	Sure!
context: Romance: Sleep on it, and wait for good news\I hope everyone will have a good year.\I hope that my little brother or sister will be born healthy.\I hope that Yamato and I can...\I hope that we'll stay together.\Hey, Takeo-kun... I made a cake.\Can I come to your place?\Sure! response:	I haven't really cleaned up, though... Is that okay?
context: I hope everyone will have a good year.\I hope that my little brother or sister will be born healthy.\I hope that Yamato and I can...\I hope that we'll stay together.\Hey, Takeo-kun... I made a cake.\Can I come to your place?\Sure!\I haven't really cleaned up, though... Is that okay? response:	Fortune
context: I hope that my little brother or sister will be born healthy.\I hope that Yamato and I can...\I hope that we'll stay together.\Hey, Takeo-kun... I made a cake.\Can I come to your place?\Sure!\I haven't really cleaned up, though... Is that okay?\Fortune response:	Yeah.
context: I hope that Yamato and I can...\I hope that we'll stay together.\Hey, Takeo-kun... I made a cake.\Can I come to your place?\Sure!\I haven't really cleaned up, though... Is that okay?\Fortune\Yeah. response:	Good
context: I hope that we'll stay together.\Hey, Takeo-kun... I made a cake.\Can I come to your place?\Sure!\I haven't really cleaned up, though... Is that okay?\Fortune\Yeah.\Good response:	I'm home!
context: Hey, Takeo-kun... I made a cake.\Can I come to your place?\Sure!\I haven't really cleaned up, though... Is that okay?\Fortune\Yeah.\Good\I'm home! response:	That was quick.
context: Can I come to your place?\Sure!\I haven't really cleaned up, though... Is that okay?\Fortune\Yeah.\Good\I'm home!\That was quick. response:	Yeah.
context: Sure!\I haven't really cleaned up, though... Is that okay?\Fortune\Yeah.\Good\I'm home!\That was quick.\Yeah. response:	Yamato's with me.
context: I haven't really cleaned up, though... Is that okay?\Fortune\Yeah.\Good\I'm home!\That was quick.\Yeah.\Yamato's with me. response:	Oh, hello, Yamato-san.
context: Fortune\Yeah.\Good\I'm home!\That was quick.\Yeah.\Yamato's with me.\Oh, hello, Yamato-san. response:	Happy New Year.
context: Yeah.\Good\I'm home!\That was quick.\Yeah.\Yamato's with me.\Oh, hello, Yamato-san.\Happy New Year. response:	Happy New Year.
context: Good\I'm home!\That was quick.\Yeah.\Yamato's with me.\Oh, hello, Yamato-san.\Happy New Year.\Happy New Year. response:	I hope we have a good year ahead!
context: I'm home!\That was quick.\Yeah.\Yamato's with me.\Oh, hello, Yamato-san.\Happy New Year.\Happy New Year.\I hope we have a good year ahead! response:	Crap... It's messier than I thought.
context: That was quick.\Yeah.\Yamato's with me.\Oh, hello, Yamato-san.\Happy New Year.\Happy New Year.\I hope we have a good year ahead!\Crap... It's messier than I thought. response:	Oh, I'll help, too.
context: Yeah.\Yamato's with me.\Oh, hello, Yamato-san.\Happy New Year.\Happy New Year.\I hope we have a good year ahead!\Crap... It's messier than I thought.\Oh, I'll help, too. response:	Take!
context: Yamato's with me.\Oh, hello, Yamato-san.\Happy New Year.\Happy New Year.\I hope we have a good year ahead!\Crap... It's messier than I thought.\Oh, I'll help, too.\Take! response:	Mom's going with Dad to the shrine and the New Year's sales.
context: Oh, hello, Yamato-san.\Happy New Year.\Happy New Year.\I hope we have a good year ahead!\Crap... It's messier than I thought.\Oh, I'll help, too.\Take!\Mom's going with Dad to the shrine and the New Year's sales. response:	We'll stop on our way home to buy food,
context: Happy New Year.\Happy New Year.\I hope we have a good year ahead!\Crap... It's messier than I thought.\Oh, I'll help, too.\Take!\Mom's going with Dad to the shrine and the New Year's sales.\We'll stop on our way home to buy food, response:	so we won't be back for about five hours.
context: Happy New Year.\I hope we have a good year ahead!\Crap... It's messier than I thought.\Oh, I'll help, too.\Take!\Mom's going with Dad to the shrine and the New Year's sales.\We'll stop on our way home to buy food,\so we won't be back for about five hours. response:	Okay, that's a long time.
context: I hope we have a good year ahead!\Crap... It's messier than I thought.\Oh, I'll help, too.\Take!\Mom's going with Dad to the shrine and the New Year's sales.\We'll stop on our way home to buy food,\so we won't be back for about five hours.\Okay, that's a long time. response:	Make yourself at home, Yamato-san.
context: Crap... It's messier than I thought.\Oh, I'll help, too.\Take!\Mom's going with Dad to the shrine and the New Year's sales.\We'll stop on our way home to buy food,\so we won't be back for about five hours.\Okay, that's a long time.\Make yourself at home, Yamato-san. response:	Would you like something to drink?
context: Oh, I'll help, too.\Take!\Mom's going with Dad to the shrine and the New Year's sales.\We'll stop on our way home to buy food,\so we won't be back for about five hours.\Okay, that's a long time.\Make yourself at home, Yamato-san.\Would you like something to drink? response:	No, I'm fine...
context: Take!\Mom's going with Dad to the shrine and the New Year's sales.\We'll stop on our way home to buy food,\so we won't be back for about five hours.\Okay, that's a long time.\Make yourself at home, Yamato-san.\Would you like something to drink?\No, I'm fine... response:	Happy New Year!
context: Mom's going with Dad to the shrine and the New Year's sales.\We'll stop on our way home to buy food,\so we won't be back for about five hours.\Okay, that's a long time.\Make yourself at home, Yamato-san.\Would you like something to drink?\No, I'm fine...\Happy New Year! response:	We're here, Takeo!
context: We'll stop on our way home to buy food,\so we won't be back for about five hours.\Okay, that's a long time.\Make yourself at home, Yamato-san.\Would you like something to drink?\No, I'm fine...\Happy New Year!\We're here, Takeo! response:	Here's your present!
context: so we won't be back for about five hours.\Okay, that's a long time.\Make yourself at home, Yamato-san.\Would you like something to drink?\No, I'm fine...\Happy New Year!\We're here, Takeo!\Here's your present! response:	I just got it at the arcade!
context: Okay, that's a long time.\Make yourself at home, Yamato-san.\Would you like something to drink?\No, I'm fine...\Happy New Year!\We're here, Takeo!\Here's your present!\I just got it at the arcade! response:	Thanks!
context: Make yourself at home, Yamato-san.\Would you like something to drink?\No, I'm fine...\Happy New Year!\We're here, Takeo!\Here's your present!\I just got it at the arcade!\Thanks! response:	Whoa, your girlfriend is here?
context: Would you like something to drink?\No, I'm fine...\Happy New Year!\We're here, Takeo!\Here's your present!\I just got it at the arcade!\Thanks!\Whoa, your girlfriend is here? response:	Seriously?
context: No, I'm fine...\Happy New Year!\We're here, Takeo!\Here's your present!\I just got it at the arcade!\Thanks!\Whoa, your girlfriend is here?\Seriously? response:	Can we come in for a bit?
context: Happy New Year!\We're here, Takeo!\Here's your present!\I just got it at the arcade!\Thanks!\Whoa, your girlfriend is here?\Seriously?\Can we come in for a bit? response:	Sure.
context: We're here, Takeo!\Here's your present!\I just got it at the arcade!\Thanks!\Whoa, your girlfriend is here?\Seriously?\Can we come in for a bit?\Sure. response:	Nice to meet you.
context: Here's your present!\I just got it at the arcade!\Thanks!\Whoa, your girlfriend is here?\Seriously?\Can we come in for a bit?\Sure.\Nice to meet you. response:	Sorry to interrupt...
context: I just got it at the arcade!\Thanks!\Whoa, your girlfriend is here?\Seriously?\Can we come in for a bit?\Sure.\Nice to meet you.\Sorry to interrupt... response:	I'm Yamato. It's nice to meet you.
context: Thanks!\Whoa, your girlfriend is here?\Seriously?\Can we come in for a bit?\Sure.\Nice to meet you.\Sorry to interrupt...\I'm Yamato. It's nice to meet you. response:	We went to elementary school with Takeo.
context: Whoa, your girlfriend is here?\Seriously?\Can we come in for a bit?\Sure.\Nice to meet you.\Sorry to interrupt...\I'm Yamato. It's nice to meet you.\We went to elementary school with Takeo. response:	Oh, I see.
context: Seriously?\Can we come in for a bit?\Sure.\Nice to meet you.\Sorry to interrupt...\I'm Yamato. It's nice to meet you.\We went to elementary school with Takeo.\Oh, I see. response:	Yep.
context: Can we come in for a bit?\Sure.\Nice to meet you.\Sorry to interrupt...\I'm Yamato. It's nice to meet you.\We went to elementary school with Takeo.\Oh, I see.\Yep. response:	Hey, is Takeo here?
context: Sure.\Nice to meet you.\Sorry to interrupt...\I'm Yamato. It's nice to meet you.\We went to elementary school with Takeo.\Oh, I see.\Yep.\Hey, is Takeo here? response:	Oh, cut it out.
context: Nice to meet you.\Sorry to interrupt...\I'm Yamato. It's nice to meet you.\We went to elementary school with Takeo.\Oh, I see.\Yep.\Hey, is Takeo here?\Oh, cut it out. response:	Congrats! Happy Birthday!
context: Sorry to interrupt...\I'm Yamato. It's nice to meet you.\We went to elementary school with Takeo.\Oh, I see.\Yep.\Hey, is Takeo here?\Oh, cut it out.\Congrats! Happy Birthday! response:	Can we come in?
context: I'm Yamato. It's nice to meet you.\We went to elementary school with Takeo.\Oh, I see.\Yep.\Hey, is Takeo here?\Oh, cut it out.\Congrats! Happy Birthday!\Can we come in? response:	Sure.
context: We went to elementary school with Takeo.\Oh, I see.\Yep.\Hey, is Takeo here?\Oh, cut it out.\Congrats! Happy Birthday!\Can we come in?\Sure. response:	I just can't start the new year without seeing Takeo first.
context: Oh, I see.\Yep.\Hey, is Takeo here?\Oh, cut it out.\Congrats! Happy Birthday!\Can we come in?\Sure.\I just can't start the new year without seeing Takeo first. response:	No kidding!
context: Yep.\Hey, is Takeo here?\Oh, cut it out.\Congrats! Happy Birthday!\Can we come in?\Sure.\I just can't start the new year without seeing Takeo first.\No kidding! response:	But, Takeo, it's so funny that you were born on New Year's Day.
context: Hey, is Takeo here?\Oh, cut it out.\Congrats! Happy Birthday!\Can we come in?\Sure.\I just can't start the new year without seeing Takeo first.\No kidding!\But, Takeo, it's so funny that you were born on New Year's Day. response:	It's funny every time.
context: Oh, cut it out.\Congrats! Happy Birthday!\Can we come in?\Sure.\I just can't start the new year without seeing Takeo first.\No kidding!\But, Takeo, it's so funny that you were born on New Year's Day.\It's funny every time. response:	Did Takeo ask you out?
context: Congrats! Happy Birthday!\Can we come in?\Sure.\I just can't start the new year without seeing Takeo first.\No kidding!\But, Takeo, it's so funny that you were born on New Year's Day.\It's funny every time.\Did Takeo ask you out? response:	I know the story!
context: Can we come in?\Sure.\I just can't start the new year without seeing Takeo first.\No kidding!\But, Takeo, it's so funny that you were born on New Year's Day.\It's funny every time.\Did Takeo ask you out?\I know the story! response:	Takeo saved her from a groper.
context: Sure.\I just can't start the new year without seeing Takeo first.\No kidding!\But, Takeo, it's so funny that you were born on New Year's Day.\It's funny every time.\Did Takeo ask you out?\I know the story!\Takeo saved her from a groper. response:	Yes.
context: I just can't start the new year without seeing Takeo first.\No kidding!\But, Takeo, it's so funny that you were born on New Year's Day.\It's funny every time.\Did Takeo ask you out?\I know the story!\Takeo saved her from a groper.\Yes. response:	I asked him out.
context: No kidding!\But, Takeo, it's so funny that you were born on New Year's Day.\It's funny every time.\Did Takeo ask you out?\I know the story!\Takeo saved her from a groper.\Yes.\I asked him out. response:	For me, it was love at first sight.
context: But, Takeo, it's so funny that you were born on New Year's Day.\It's funny every time.\Did Takeo ask you out?\I know the story!\Takeo saved her from a groper.\Yes.\I asked him out.\For me, it was love at first sight. response:	Yamato-san, you have good taste.
context: It's funny every time.\Did Takeo ask you out?\I know the story!\Takeo saved her from a groper.\Yes.\I asked him out.\For me, it was love at first sight.\Yamato-san, you have good taste. response:	Please take good care of Takeo.
context: Did Takeo ask you out?\I know the story!\Takeo saved her from a groper.\Yes.\I asked him out.\For me, it was love at first sight.\Yamato-san, you have good taste.\Please take good care of Takeo. response:	See you, Takeo!
context: I know the story!\Takeo saved her from a groper.\Yes.\I asked him out.\For me, it was love at first sight.\Yamato-san, you have good taste.\Please take good care of Takeo.\See you, Takeo! response:	Sorry about that.
context: Takeo saved her from a groper.\Yes.\I asked him out.\For me, it was love at first sight.\Yamato-san, you have good taste.\Please take good care of Takeo.\See you, Takeo!\Sorry about that. response:	They come every year.
context: Yes.\I asked him out.\For me, it was love at first sight.\Yamato-san, you have good taste.\Please take good care of Takeo.\See you, Takeo!\Sorry about that.\They come every year. response:	No problem.
context: I asked him out.\For me, it was love at first sight.\Yamato-san, you have good taste.\Please take good care of Takeo.\See you, Takeo!\Sorry about that.\They come every year.\No problem. response:	Oh, Takeo-kun...
context: For me, it was love at first sight.\Yamato-san, you have good taste.\Please take good care of Takeo.\See you, Takeo!\Sorry about that.\They come every year.\No problem.\Oh, Takeo-kun... response:	This is my present to you.
context: Yamato-san, you have good taste.\Please take good care of Takeo.\See you, Takeo!\Sorry about that.\They come every year.\No problem.\Oh, Takeo-kun...\This is my present to you. response:	Oh, thanks.
context: Please take good care of Takeo.\See you, Takeo!\Sorry about that.\They come every year.\No problem.\Oh, Takeo-kun...\This is my present to you.\Oh, thanks. response:	Can I open it?
context: See you, Takeo!\Sorry about that.\They come every year.\No problem.\Oh, Takeo-kun...\This is my present to you.\Oh, thanks.\Can I open it? response:	Sure.
context: Sorry about that.\They come every year.\No problem.\Oh, Takeo-kun...\This is my present to you.\Oh, thanks.\Can I open it?\Sure. response:	It's the first time I've gotten a stuffed animal as a present.
context: They come every year.\No problem.\Oh, Takeo-kun...\This is my present to you.\Oh, thanks.\Can I open it?\Sure.\It's the first time I've gotten a stuffed animal as a present. response:	If you press the stomach, it squeaks.
context: No problem.\Oh, Takeo-kun...\This is my present to you.\Oh, thanks.\Can I open it?\Sure.\It's the first time I've gotten a stuffed animal as a present.\If you press the stomach, it squeaks. response:	What a shocker!
context: Oh, Takeo-kun...\This is my present to you.\Oh, thanks.\Can I open it?\Sure.\It's the first time I've gotten a stuffed animal as a present.\If you press the stomach, it squeaks.\What a shocker! response:	Squeak
context: This is my present to you.\Oh, thanks.\Can I open it?\Sure.\It's the first time I've gotten a stuffed animal as a present.\If you press the stomach, it squeaks.\What a shocker!\Squeak response:	Why did Yamato think to give me a stuffed animal?
context: Oh, thanks.\Can I open it?\Sure.\It's the first time I've gotten a stuffed animal as a present.\If you press the stomach, it squeaks.\What a shocker!\Squeak\Why did Yamato think to give me a stuffed animal? response:	How cute!
context: Can I open it?\Sure.\It's the first time I've gotten a stuffed animal as a present.\If you press the stomach, it squeaks.\What a shocker!\Squeak\Why did Yamato think to give me a stuffed animal?\How cute! response:	A-ha ha
context: Sure.\It's the first time I've gotten a stuffed animal as a present.\If you press the stomach, it squeaks.\What a shocker!\Squeak\Why did Yamato think to give me a stuffed animal?\How cute!\A-ha ha response:	I wasn't really sure what to get you,
context: It's the first time I've gotten a stuffed animal as a present.\If you press the stomach, it squeaks.\What a shocker!\Squeak\Why did Yamato think to give me a stuffed animal?\How cute!\A-ha ha\I wasn't really sure what to get you, response:	but she was so cute, I couldn't turn away.
context: If you press the stomach, it squeaks.\What a shocker!\Squeak\Why did Yamato think to give me a stuffed animal?\How cute!\A-ha ha\I wasn't really sure what to get you,\but she was so cute, I couldn't turn away. response:	I see, so it was cute...
context: What a shocker!\Squeak\Why did Yamato think to give me a stuffed animal?\How cute!\A-ha ha\I wasn't really sure what to get you,\but she was so cute, I couldn't turn away.\I see, so it was cute... response:	She gave me something she liked.
context: Squeak\Why did Yamato think to give me a stuffed animal?\How cute!\A-ha ha\I wasn't really sure what to get you,\but she was so cute, I couldn't turn away.\I see, so it was cute...\She gave me something she liked. response:	I also baked a cake.
context: Why did Yamato think to give me a stuffed animal?\How cute!\A-ha ha\I wasn't really sure what to get you,\but she was so cute, I couldn't turn away.\I see, so it was cute...\She gave me something she liked.\I also baked a cake. response:	I consulted Sunakawa-kun,
context: How cute!\A-ha ha\I wasn't really sure what to get you,\but she was so cute, I couldn't turn away.\I see, so it was cute...\She gave me something she liked.\I also baked a cake.\I consulted Sunakawa-kun, response:	and decided to bake the first cake you had from me, a cheesecake.
context: A-ha ha\I wasn't really sure what to get you,\but she was so cute, I couldn't turn away.\I see, so it was cute...\She gave me something she liked.\I also baked a cake.\I consulted Sunakawa-kun,\and decided to bake the first cake you had from me, a cheesecake. response:	Happy Birthday, Takeo-kun
context: I wasn't really sure what to get you,\but she was so cute, I couldn't turn away.\I see, so it was cute...\She gave me something she liked.\I also baked a cake.\I consulted Sunakawa-kun,\and decided to bake the first cake you had from me, a cheesecake.\Happy Birthday, Takeo-kun response:	I thought about serving it when everyone was here,
context: but she was so cute, I couldn't turn away.\I see, so it was cute...\She gave me something she liked.\I also baked a cake.\I consulted Sunakawa-kun,\and decided to bake the first cake you had from me, a cheesecake.\Happy Birthday, Takeo-kun\I thought about serving it when everyone was here, response:	but I wanted you to see it before it got all cut up.
context: I see, so it was cute...\She gave me something she liked.\I also baked a cake.\I consulted Sunakawa-kun,\and decided to bake the first cake you had from me, a cheesecake.\Happy Birthday, Takeo-kun\I thought about serving it when everyone was here,\but I wanted you to see it before it got all cut up. response:	Yeah, I can't let anyone else have this.
context: She gave me something she liked.\I also baked a cake.\I consulted Sunakawa-kun,\and decided to bake the first cake you had from me, a cheesecake.\Happy Birthday, Takeo-kun\I thought about serving it when everyone was here,\but I wanted you to see it before it got all cut up.\Yeah, I can't let anyone else have this. response:	Oh, I brought candles! Sixteen!
context: I also baked a cake.\I consulted Sunakawa-kun,\and decided to bake the first cake you had from me, a cheesecake.\Happy Birthday, Takeo-kun\I thought about serving it when everyone was here,\but I wanted you to see it before it got all cut up.\Yeah, I can't let anyone else have this.\Oh, I brought candles! Sixteen! response:	I think there's a lighter in the kitchen.
context: I consulted Sunakawa-kun,\and decided to bake the first cake you had from me, a cheesecake.\Happy Birthday, Takeo-kun\I thought about serving it when everyone was here,\but I wanted you to see it before it got all cut up.\Yeah, I can't let anyone else have this.\Oh, I brought candles! Sixteen!\I think there's a lighter in the kitchen. response:	I'll go get it.
context: and decided to bake the first cake you had from me, a cheesecake.\Happy Birthday, Takeo-kun\I thought about serving it when everyone was here,\but I wanted you to see it before it got all cut up.\Yeah, I can't let anyone else have this.\Oh, I brought candles! Sixteen!\I think there's a lighter in the kitchen.\I'll go get it. response:	Okay.
context: Happy Birthday, Takeo-kun\I thought about serving it when everyone was here,\but I wanted you to see it before it got all cut up.\Yeah, I can't let anyone else have this.\Oh, I brought candles! Sixteen!\I think there's a lighter in the kitchen.\I'll go get it.\Okay. response:	Okay...
context: I thought about serving it when everyone was here,\but I wanted you to see it before it got all cut up.\Yeah, I can't let anyone else have this.\Oh, I brought candles! Sixteen!\I think there's a lighter in the kitchen.\I'll go get it.\Okay.\Okay... response:	Happy Birthday, Takeo-kun.
context: but I wanted you to see it before it got all cut up.\Yeah, I can't let anyone else have this.\Oh, I brought candles! Sixteen!\I think there's a lighter in the kitchen.\I'll go get it.\Okay.\Okay...\Happy Birthday, Takeo-kun. response:	Yep, thanks.
context: Yeah, I can't let anyone else have this.\Oh, I brought candles! Sixteen!\I think there's a lighter in the kitchen.\I'll go get it.\Okay.\Okay...\Happy Birthday, Takeo-kun.\Yep, thanks. response:	It's beautiful.
context: Oh, I brought candles! Sixteen!\I think there's a lighter in the kitchen.\I'll go get it.\Okay.\Okay...\Happy Birthday, Takeo-kun.\Yep, thanks.\It's beautiful. response:	Thank you, Yamato.
context: I think there's a lighter in the kitchen.\I'll go get it.\Okay.\Okay...\Happy Birthday, Takeo-kun.\Yep, thanks.\It's beautiful.\Thank you, Yamato. response:	Takeo-kun,
context: I'll go get it.\Okay.\Okay...\Happy Birthday, Takeo-kun.\Yep, thanks.\It's beautiful.\Thank you, Yamato.\Takeo-kun, response:	you have to close your eyes and make a wish before you blow out the candles.
context: Okay.\Okay...\Happy Birthday, Takeo-kun.\Yep, thanks.\It's beautiful.\Thank you, Yamato.\Takeo-kun,\you have to close your eyes and make a wish before you blow out the candles. response:	Oh, okay.
context: Okay...\Happy Birthday, Takeo-kun.\Yep, thanks.\It's beautiful.\Thank you, Yamato.\Takeo-kun,\you have to close your eyes and make a wish before you blow out the candles.\Oh, okay. response:	Slowly, okay?
context: Happy Birthday, Takeo-kun.\Yep, thanks.\It's beautiful.\Thank you, Yamato.\Takeo-kun,\you have to close your eyes and make a wish before you blow out the candles.\Oh, okay.\Slowly, okay? response:	Got it, make a wish.
context: Yep, thanks.\It's beautiful.\Thank you, Yamato.\Takeo-kun,\you have to close your eyes and make a wish before you blow out the candles.\Oh, okay.\Slowly, okay?\Got it, make a wish. response:	I'll never forget this.
context: It's beautiful.\Thank you, Yamato.\Takeo-kun,\you have to close your eyes and make a wish before you blow out the candles.\Oh, okay.\Slowly, okay?\Got it, make a wish.\I'll never forget this. response:	Not the phone call right at the stroke of midnight,
context: Thank you, Yamato.\Takeo-kun,\you have to close your eyes and make a wish before you blow out the candles.\Oh, okay.\Slowly, okay?\Got it, make a wish.\I'll never forget this.\Not the phone call right at the stroke of midnight, response:	not the stuffed animal or the cake.
context: Takeo-kun,\you have to close your eyes and make a wish before you blow out the candles.\Oh, okay.\Slowly, okay?\Got it, make a wish.\I'll never forget this.\Not the phone call right at the stroke of midnight,\not the stuffed animal or the cake. response:	I'll never forget.
context: you have to close your eyes and make a wish before you blow out the candles.\Oh, okay.\Slowly, okay?\Got it, make a wish.\I'll never forget this.\Not the phone call right at the stroke of midnight,\not the stuffed animal or the cake.\I'll never forget. response:	I hope Yamato will stay happy all year...
context: Oh, okay.\Slowly, okay?\Got it, make a wish.\I'll never forget this.\Not the phone call right at the stroke of midnight,\not the stuffed animal or the cake.\I'll never forget.\I hope Yamato will stay happy all year... response:	Yamato...
context: Slowly, okay?\Got it, make a wish.\I'll never forget this.\Not the phone call right at the stroke of midnight,\not the stuffed animal or the cake.\I'll never forget.\I hope Yamato will stay happy all year...\Yamato... response:	Thank you!
context: Got it, make a wish.\I'll never forget this.\Not the phone call right at the stroke of midnight,\not the stuffed animal or the cake.\I'll never forget.\I hope Yamato will stay happy all year...\Yamato...\Thank you! response:	Can I blow them out now?
context: I'll never forget this.\Not the phone call right at the stroke of midnight,\not the stuffed animal or the cake.\I'll never forget.\I hope Yamato will stay happy all year...\Yamato...\Thank you!\Can I blow them out now? response:	the candles
context: Not the phone call right at the stroke of midnight,\not the stuffed animal or the cake.\I'll never forget.\I hope Yamato will stay happy all year...\Yamato...\Thank you!\Can I blow them out now?\the candles response:	Huh?
context: not the stuffed animal or the cake.\I'll never forget.\I hope Yamato will stay happy all year...\Yamato...\Thank you!\Can I blow them out now?\the candles\Huh? response:	Y-Yeah!
context: I'll never forget.\I hope Yamato will stay happy all year...\Yamato...\Thank you!\Can I blow them out now?\the candles\Huh?\Y-Yeah! response:	Could it be...
context: I hope Yamato will stay happy all year...\Yamato...\Thank you!\Can I blow them out now?\the candles\Huh?\Y-Yeah!\Could it be... response:	Good.
context: Yamato...\Thank you!\Can I blow them out now?\the candles\Huh?\Y-Yeah!\Could it be...\Good. response:	Oh, I forgot to bring a knife and plates.
context: Thank you!\Can I blow them out now?\the candles\Huh?\Y-Yeah!\Could it be...\Good.\Oh, I forgot to bring a knife and plates. response:	he didn't...
context: Can I blow them out now?\the candles\Huh?\Y-Yeah!\Could it be...\Good.\Oh, I forgot to bring a knife and plates.\he didn't... response:	I'll get some!
context: the candles\Huh?\Y-Yeah!\Could it be...\Good.\Oh, I forgot to bring a knife and plates.\he didn't...\I'll get some! response:	I don't think he noticed at all!
context: Huh?\Y-Yeah!\Could it be...\Good.\Oh, I forgot to bring a knife and plates.\he didn't...\I'll get some!\I don't think he noticed at all! response:	orz
context: Y-Yeah!\Could it be...\Good.\Oh, I forgot to bring a knife and plates.\he didn't...\I'll get some!\I don't think he noticed at all!\orz response:	We're back.
context: Could it be...\Good.\Oh, I forgot to bring a knife and plates.\he didn't...\I'll get some!\I don't think he noticed at all!\orz\We're back. response:	Oh, hey, Mom.
context: Good.\Oh, I forgot to bring a knife and plates.\he didn't...\I'll get some!\I don't think he noticed at all!\orz\We're back.\Oh, hey, Mom. response:	Are you going to fillet fish or something?
context: Oh, I forgot to bring a knife and plates.\he didn't...\I'll get some!\I don't think he noticed at all!\orz\We're back.\Oh, hey, Mom.\Are you going to fillet fish or something? response:	I need to slice a cake.
context: he didn't...\I'll get some!\I don't think he noticed at all!\orz\We're back.\Oh, hey, Mom.\Are you going to fillet fish or something?\I need to slice a cake. response:	Here's a knife.
context: I'll get some!\I don't think he noticed at all!\orz\We're back.\Oh, hey, Mom.\Are you going to fillet fish or something?\I need to slice a cake.\Here's a knife. response:	Found a knife.
context: I don't think he noticed at all!\orz\We're back.\Oh, hey, Mom.\Are you going to fillet fish or something?\I need to slice a cake.\Here's a knife.\Found a knife. response:	Don't want to mess up the cake...
context: orz\We're back.\Oh, hey, Mom.\Are you going to fillet fish or something?\I need to slice a cake.\Here's a knife.\Found a knife.\Don't want to mess up the cake... response:	Digging in!
context: We're back.\Oh, hey, Mom.\Are you going to fillet fish or something?\I need to slice a cake.\Here's a knife.\Found a knife.\Don't want to mess up the cake...\Digging in! response:	It's delicious!
context: Oh, hey, Mom.\Are you going to fillet fish or something?\I need to slice a cake.\Here's a knife.\Found a knife.\Don't want to mess up the cake...\Digging in!\It's delicious! response:	I don't remember cakes being this delicious.
context: Are you going to fillet fish or something?\I need to slice a cake.\Here's a knife.\Found a knife.\Don't want to mess up the cake...\Digging in!\It's delicious!\I don't remember cakes being this delicious. response:	Thank you, Yamato.
context: I need to slice a cake.\Here's a knife.\Found a knife.\Don't want to mess up the cake...\Digging in!\It's delicious!\I don't remember cakes being this delicious.\Thank you, Yamato. response:	It's been a great birthday for me.
context: Here's a knife.\Found a knife.\Don't want to mess up the cake...\Digging in!\It's delicious!\I don't remember cakes being this delicious.\Thank you, Yamato.\It's been a great birthday for me. response:	I'm glad.
context: Found a knife.\Don't want to mess up the cake...\Digging in!\It's delicious!\I don't remember cakes being this delicious.\Thank you, Yamato.\It's been a great birthday for me.\I'm glad. response:	I'm happy...
context: Don't want to mess up the cake...\Digging in!\It's delicious!\I don't remember cakes being this delicious.\Thank you, Yamato.\It's been a great birthday for me.\I'm glad.\I'm happy... response:	From: Yamato
context: Digging in!\It's delicious!\I don't remember cakes being this delicious.\Thank you, Yamato.\It's been a great birthday for me.\I'm glad.\I'm happy...\From: Yamato response:	Takeo-kun, I'm glad I could celebrate your birthday with you.
context: It's delicious!\I don't remember cakes being this delicious.\Thank you, Yamato.\It's been a great birthday for me.\I'm glad.\I'm happy...\From: Yamato\Takeo-kun, I'm glad I could celebrate your birthday with you. response:	Congratulations!
context: I don't remember cakes being this delicious.\Thank you, Yamato.\It's been a great birthday for me.\I'm glad.\I'm happy...\From: Yamato\Takeo-kun, I'm glad I could celebrate your birthday with you.\Congratulations! response:	Oh, and I forgot to say it earlier,
context: Thank you, Yamato.\It's been a great birthday for me.\I'm glad.\I'm happy...\From: Yamato\Takeo-kun, I'm glad I could celebrate your birthday with you.\Congratulations!\Oh, and I forgot to say it earlier, response:	but Happy New Year.
context: It's been a great birthday for me.\I'm glad.\I'm happy...\From: Yamato\Takeo-kun, I'm glad I could celebrate your birthday with you.\Congratulations!\Oh, and I forgot to say it earlier,\but Happy New Year. response:	I'm looking forward to our time together.
context: I'm glad.\I'm happy...\From: Yamato\Takeo-kun, I'm glad I could celebrate your birthday with you.\Congratulations!\Oh, and I forgot to say it earlier,\but Happy New Year.\I'm looking forward to our time together. response:	I love you, Takeo-kun.
context: I'm happy...\From: Yamato\Takeo-kun, I'm glad I could celebrate your birthday with you.\Congratulations!\Oh, and I forgot to say it earlier,\but Happy New Year.\I'm looking forward to our time together.\I love you, Takeo-kun. response:	For Yamato, January first isn't New Year's Day.
context: From: Yamato\Takeo-kun, I'm glad I could celebrate your birthday with you.\Congratulations!\Oh, and I forgot to say it earlier,\but Happy New Year.\I'm looking forward to our time together.\I love you, Takeo-kun.\For Yamato, January first isn't New Year's Day. response:	It's my birthday...
context: Takeo-kun, I'm glad I could celebrate your birthday with you.\Congratulations!\Oh, and I forgot to say it earlier,\but Happy New Year.\I'm looking forward to our time together.\I love you, Takeo-kun.\For Yamato, January first isn't New Year's Day.\It's my birthday... response:	She almost forgot it was New Year's Day.
context: Congratulations!\Oh, and I forgot to say it earlier,\but Happy New Year.\I'm looking forward to our time together.\I love you, Takeo-kun.\For Yamato, January first isn't New Year's Day.\It's my birthday...\She almost forgot it was New Year's Day. response:	Suna!
context: Oh, and I forgot to say it earlier,\but Happy New Year.\I'm looking forward to our time together.\I love you, Takeo-kun.\For Yamato, January first isn't New Year's Day.\It's my birthday...\She almost forgot it was New Year's Day.\Suna! response:	Happy New Year!
context: but Happy New Year.\I'm looking forward to our time together.\I love you, Takeo-kun.\For Yamato, January first isn't New Year's Day.\It's my birthday...\She almost forgot it was New Year's Day.\Suna!\Happy New Year! response:	Yeah, Happy New Year.
context: I'm looking forward to our time together.\I love you, Takeo-kun.\For Yamato, January first isn't New Year's Day.\It's my birthday...\She almost forgot it was New Year's Day.\Suna!\Happy New Year!\Yeah, Happy New Year. response:	Takeo, here's your birthday present.
context: I love you, Takeo-kun.\For Yamato, January first isn't New Year's Day.\It's my birthday...\She almost forgot it was New Year's Day.\Suna!\Happy New Year!\Yeah, Happy New Year.\Takeo, here's your birthday present. response:	Notebook
context: For Yamato, January first isn't New Year's Day.\It's my birthday...\She almost forgot it was New Year's Day.\Suna!\Happy New Year!\Yeah, Happy New Year.\Takeo, here's your birthday present.\Notebook response:	Oh, thanks.
context: It's my birthday...\She almost forgot it was New Year's Day.\Suna!\Happy New Year!\Yeah, Happy New Year.\Takeo, here's your birthday present.\Notebook\Oh, thanks. response:	Good luck on your studies.
context: She almost forgot it was New Year's Day.\Suna!\Happy New Year!\Yeah, Happy New Year.\Takeo, here's your birthday present.\Notebook\Oh, thanks.\Good luck on your studies. response:	Where's Yamato-san?
context: Suna!\Happy New Year!\Yeah, Happy New Year.\Takeo, here's your birthday present.\Notebook\Oh, thanks.\Good luck on your studies.\Where's Yamato-san? response:	I just saw her home.
context: Happy New Year!\Yeah, Happy New Year.\Takeo, here's your birthday present.\Notebook\Oh, thanks.\Good luck on your studies.\Where's Yamato-san?\I just saw her home. response:	I got a stuffed animal from her...
context: Yeah, Happy New Year.\Takeo, here's your birthday present.\Notebook\Oh, thanks.\Good luck on your studies.\Where's Yamato-san?\I just saw her home.\I got a stuffed animal from her... response:	Huh, a stuffed animal.
context: Takeo, here's your birthday present.\Notebook\Oh, thanks.\Good luck on your studies.\Where's Yamato-san?\I just saw her home.\I got a stuffed animal from her...\Huh, a stuffed animal. response:	That sounds like her, all right.
context: Notebook\Oh, thanks.\Good luck on your studies.\Where's Yamato-san?\I just saw her home.\I got a stuffed animal from her...\Huh, a stuffed animal.\That sounds like her, all right. response:	I'd never think of giving you a stuffed animal.
context: Oh, thanks.\Good luck on your studies.\Where's Yamato-san?\I just saw her home.\I got a stuffed animal from her...\Huh, a stuffed animal.\That sounds like her, all right.\I'd never think of giving you a stuffed animal. response:	I think so, too.
context: Good luck on your studies.\Where's Yamato-san?\I just saw her home.\I got a stuffed animal from her...\Huh, a stuffed animal.\That sounds like her, all right.\I'd never think of giving you a stuffed animal.\I think so, too. response:	She baked me a cheesecake.
context: Where's Yamato-san?\I just saw her home.\I got a stuffed animal from her...\Huh, a stuffed animal.\That sounds like her, all right.\I'd never think of giving you a stuffed animal.\I think so, too.\She baked me a cheesecake. response:	It was a cute, round one.
context: I just saw her home.\I got a stuffed animal from her...\Huh, a stuffed animal.\That sounds like her, all right.\I'd never think of giving you a stuffed animal.\I think so, too.\She baked me a cheesecake.\It was a cute, round one. response:	It was a great birthday.
context: I got a stuffed animal from her...\Huh, a stuffed animal.\That sounds like her, all right.\I'd never think of giving you a stuffed animal.\I think so, too.\She baked me a cheesecake.\It was a cute, round one.\It was a great birthday. response:	Congrats, I'm happy for you.
context: Huh, a stuffed animal.\That sounds like her, all right.\I'd never think of giving you a stuffed animal.\I think so, too.\She baked me a cheesecake.\It was a cute, round one.\It was a great birthday.\Congrats, I'm happy for you. response:	She asked me to close my eyes and make a wish, before blowing out the candles.
context: That sounds like her, all right.\I'd never think of giving you a stuffed animal.\I think so, too.\She baked me a cheesecake.\It was a cute, round one.\It was a great birthday.\Congrats, I'm happy for you.\She asked me to close my eyes and make a wish, before blowing out the candles. response:	While my eyes were closed, a bug landed on my mouth.
context: I'd never think of giving you a stuffed animal.\I think so, too.\She baked me a cheesecake.\It was a cute, round one.\It was a great birthday.\Congrats, I'm happy for you.\She asked me to close my eyes and make a wish, before blowing out the candles.\While my eyes were closed, a bug landed on my mouth. response:	I was making a wish, so I almost opened my mouth.
context: I think so, too.\She baked me a cheesecake.\It was a cute, round one.\It was a great birthday.\Congrats, I'm happy for you.\She asked me to close my eyes and make a wish, before blowing out the candles.\While my eyes were closed, a bug landed on my mouth.\I was making a wish, so I almost opened my mouth. response:	A bug?
context: She baked me a cheesecake.\It was a cute, round one.\It was a great birthday.\Congrats, I'm happy for you.\She asked me to close my eyes and make a wish, before blowing out the candles.\While my eyes were closed, a bug landed on my mouth.\I was making a wish, so I almost opened my mouth.\A bug? response:	I didn't hear one flying around, so I didn't notice it at all.
context: It was a cute, round one.\It was a great birthday.\Congrats, I'm happy for you.\She asked me to close my eyes and make a wish, before blowing out the candles.\While my eyes were closed, a bug landed on my mouth.\I was making a wish, so I almost opened my mouth.\A bug?\I didn't hear one flying around, so I didn't notice it at all. response:	It was pretty big.
context: It was a great birthday.\Congrats, I'm happy for you.\She asked me to close my eyes and make a wish, before blowing out the candles.\While my eyes were closed, a bug landed on my mouth.\I was making a wish, so I almost opened my mouth.\A bug?\I didn't hear one flying around, so I didn't notice it at all.\It was pretty big. response:	It was kind of soft.
context: Congrats, I'm happy for you.\She asked me to close my eyes and make a wish, before blowing out the candles.\While my eyes were closed, a bug landed on my mouth.\I was making a wish, so I almost opened my mouth.\A bug?\I didn't hear one flying around, so I didn't notice it at all.\It was pretty big.\It was kind of soft. response:	It stayed for a while...
context: She asked me to close my eyes and make a wish, before blowing out the candles.\While my eyes were closed, a bug landed on my mouth.\I was making a wish, so I almost opened my mouth.\A bug?\I didn't hear one flying around, so I didn't notice it at all.\It was pretty big.\It was kind of soft.\It stayed for a while... response:	I wonder what kind of bug it was.
context: While my eyes were closed, a bug landed on my mouth.\I was making a wish, so I almost opened my mouth.\A bug?\I didn't hear one flying around, so I didn't notice it at all.\It was pretty big.\It was kind of soft.\It stayed for a while...\I wonder what kind of bug it was. response:	Doesn't that mean
context: I was making a wish, so I almost opened my mouth.\A bug?\I didn't hear one flying around, so I didn't notice it at all.\It was pretty big.\It was kind of soft.\It stayed for a while...\I wonder what kind of bug it was.\Doesn't that mean response:	you were kissed?
context: A bug?\I didn't hear one flying around, so I didn't notice it at all.\It was pretty big.\It was kind of soft.\It stayed for a while...\I wonder what kind of bug it was.\Doesn't that mean\you were kissed? response:	A kiss?
context: I didn't hear one flying around, so I didn't notice it at all.\It was pretty big.\It was kind of soft.\It stayed for a while...\I wonder what kind of bug it was.\Doesn't that mean\you were kissed?\A kiss? response:	A kiss...
context: It was pretty big.\It was kind of soft.\It stayed for a while...\I wonder what kind of bug it was.\Doesn't that mean\you were kissed?\A kiss?\A kiss... response:	A kiss!
context: It was kind of soft.\It stayed for a while...\I wonder what kind of bug it was.\Doesn't that mean\you were kissed?\A kiss?\A kiss...\A kiss! response:	A kiss!
context: It stayed for a while...\I wonder what kind of bug it was.\Doesn't that mean\you were kissed?\A kiss?\A kiss...\A kiss!\A kiss! response:	It wasn't a bug!
context: I wonder what kind of bug it was.\Doesn't that mean\you were kissed?\A kiss?\A kiss...\A kiss!\A kiss!\It wasn't a bug! response:	It wasn't a bug?!
context: Doesn't that mean\you were kissed?\A kiss?\A kiss...\A kiss!\A kiss!\It wasn't a bug!\It wasn't a bug?! response:	Yamato!
context: you were kissed?\A kiss?\A kiss...\A kiss!\A kiss!\It wasn't a bug!\It wasn't a bug?!\Yamato! response:	So I'd like to make your birthday something you'll never forget.
context: A kiss?\A kiss...\A kiss!\A kiss!\It wasn't a bug!\It wasn't a bug?!\Yamato!\So I'd like to make your birthday something you'll never forget. response:	Yamato!
context: A kiss...\A kiss!\A kiss!\It wasn't a bug!\It wasn't a bug?!\Yamato!\So I'd like to make your birthday something you'll never forget.\Yamato! response:	Happy Birthday, Takeo-kun.
context: A kiss!\A kiss!\It wasn't a bug!\It wasn't a bug?!\Yamato!\So I'd like to make your birthday something you'll never forget.\Yamato!\Happy Birthday, Takeo-kun. response:	Yamato...
context: A kiss!\It wasn't a bug!\It wasn't a bug?!\Yamato!\So I'd like to make your birthday something you'll never forget.\Yamato!\Happy Birthday, Takeo-kun.\Yamato... response:	I'm glad.
context: It wasn't a bug!\It wasn't a bug?!\Yamato!\So I'd like to make your birthday something you'll never forget.\Yamato!\Happy Birthday, Takeo-kun.\Yamato...\I'm glad. response:	Yamato...
context: It wasn't a bug?!\Yamato!\So I'd like to make your birthday something you'll never forget.\Yamato!\Happy Birthday, Takeo-kun.\Yamato...\I'm glad.\Yamato... response:	Hi, Takeo-kun, what's wrong?
context: Yamato!\So I'd like to make your birthday something you'll never forget.\Yamato!\Happy Birthday, Takeo-kun.\Yamato...\I'm glad.\Yamato...\Hi, Takeo-kun, what's wrong? response:	Yeah, I'm home.
context: So I'd like to make your birthday something you'll never forget.\Yamato!\Happy Birthday, Takeo-kun.\Yamato...\I'm glad.\Yamato...\Hi, Takeo-kun, what's wrong?\Yeah, I'm home. response:	Huh? Look outside?
context: Yamato!\Happy Birthday, Takeo-kun.\Yamato...\I'm glad.\Yamato...\Hi, Takeo-kun, what's wrong?\Yeah, I'm home.\Huh? Look outside? response:	Yamato
context: Happy Birthday, Takeo-kun.\Yamato...\I'm glad.\Yamato...\Hi, Takeo-kun, what's wrong?\Yeah, I'm home.\Huh? Look outside?\Yamato response:	What's wrong, Takeo-kun?
context: Yamato...\I'm glad.\Yamato...\Hi, Takeo-kun, what's wrong?\Yeah, I'm home.\Huh? Look outside?\Yamato\What's wrong, Takeo-kun? response:	Yamato...
context: I'm glad.\Yamato...\Hi, Takeo-kun, what's wrong?\Yeah, I'm home.\Huh? Look outside?\Yamato\What's wrong, Takeo-kun?\Yamato... response:	Did you
context: Yamato...\Hi, Takeo-kun, what's wrong?\Yeah, I'm home.\Huh? Look outside?\Yamato\What's wrong, Takeo-kun?\Yamato...\Did you response:	kiss me?
context: Hi, Takeo-kun, what's wrong?\Yeah, I'm home.\Huh? Look outside?\Yamato\What's wrong, Takeo-kun?\Yamato...\Did you\kiss me? response:	Huh?
context: Yeah, I'm home.\Huh? Look outside?\Yamato\What's wrong, Takeo-kun?\Yamato...\Did you\kiss me?\Huh? response:	Let me do it over!
context: Huh? Look outside?\Yamato\What's wrong, Takeo-kun?\Yamato...\Did you\kiss me?\Huh?\Let me do it over! response:	Eh?
context: Yamato\What's wrong, Takeo-kun?\Yamato...\Did you\kiss me?\Huh?\Let me do it over!\Eh? response:	One more time... Properly, this time...
context: What's wrong, Takeo-kun?\Yamato...\Did you\kiss me?\Huh?\Let me do it over!\Eh?\One more time... Properly, this time... response:	I love you.
context: Yamato...\Did you\kiss me?\Huh?\Let me do it over!\Eh?\One more time... Properly, this time...\I love you. response:	I'll be good to you! I will!
context: Did you\kiss me?\Huh?\Let me do it over!\Eh?\One more time... Properly, this time...\I love you.\I'll be good to you! I will! response:	Yeah! I will, too!
context: kiss me?\Huh?\Let me do it over!\Eh?\One more time... Properly, this time...\I love you.\I'll be good to you! I will!\Yeah! I will, too! response:	Yeah, thanks.
context: Huh?\Let me do it over!\Eh?\One more time... Properly, this time...\I love you.\I'll be good to you! I will!\Yeah! I will, too!\Yeah, thanks. response:	I'll be good to you.
context: Let me do it over!\Eh?\One more time... Properly, this time...\I love you.\I'll be good to you! I will!\Yeah! I will, too!\Yeah, thanks.\I'll be good to you. response:	Thank you, Takeo-kun.
context: Eh?\One more time... Properly, this time...\I love you.\I'll be good to you! I will!\Yeah! I will, too!\Yeah, thanks.\I'll be good to you.\Thank you, Takeo-kun. response:	I'll be good to you, too.
context: One more time... Properly, this time...\I love you.\I'll be good to you! I will!\Yeah! I will, too!\Yeah, thanks.\I'll be good to you.\Thank you, Takeo-kun.\I'll be good to you, too. response:	Yeah, me, too.
context: I love you.\I'll be good to you! I will!\Yeah! I will, too!\Yeah, thanks.\I'll be good to you.\Thank you, Takeo-kun.\I'll be good to you, too.\Yeah, me, too. response:	My sixteenth birthday...
context: I'll be good to you! I will!\Yeah! I will, too!\Yeah, thanks.\I'll be good to you.\Thank you, Takeo-kun.\I'll be good to you, too.\Yeah, me, too.\My sixteenth birthday... response:	I'll remember this day for the rest of my life.
context: Yeah! I will, too!\Yeah, thanks.\I'll be good to you.\Thank you, Takeo-kun.\I'll be good to you, too.\Yeah, me, too.\My sixteenth birthday...\I'll remember this day for the rest of my life. response:	Suna, it's thanks to you!
context: Yeah, thanks.\I'll be good to you.\Thank you, Takeo-kun.\I'll be good to you, too.\Yeah, me, too.\My sixteenth birthday...\I'll remember this day for the rest of my life.\Suna, it's thanks to you! response:	Thank you!
context: I'll be good to you.\Thank you, Takeo-kun.\I'll be good to you, too.\Yeah, me, too.\My sixteenth birthday...\I'll remember this day for the rest of my life.\Suna, it's thanks to you!\Thank you! response:	Don't mention it.
context: Thank you, Takeo-kun.\I'll be good to you, too.\Yeah, me, too.\My sixteenth birthday...\I'll remember this day for the rest of my life.\Suna, it's thanks to you!\Thank you!\Don't mention it. response:	Thank you.
context: I'll be good to you, too.\Yeah, me, too.\My sixteenth birthday...\I'll remember this day for the rest of my life.\Suna, it's thanks to you!\Thank you!\Don't mention it.\Thank you. response:	It's really all thanks to you!
context: Yeah, me, too.\My sixteenth birthday...\I'll remember this day for the rest of my life.\Suna, it's thanks to you!\Thank you!\Don't mention it.\Thank you.\It's really all thanks to you! response:	No, not really.
context: My sixteenth birthday...\I'll remember this day for the rest of my life.\Suna, it's thanks to you!\Thank you!\Don't mention it.\Thank you.\It's really all thanks to you!\No, not really. response:	I don't really want to think about it.
context: I'll remember this day for the rest of my life.\Suna, it's thanks to you!\Thank you!\Don't mention it.\Thank you.\It's really all thanks to you!\No, not really.\I don't really want to think about it. response:	I didn't do anything.
context: Suna, it's thanks to you!\Thank you!\Don't mention it.\Thank you.\It's really all thanks to you!\No, not really.\I don't really want to think about it.\I didn't do anything. response:	It's because you put yourself out there!
context: Thank you!\Don't mention it.\Thank you.\It's really all thanks to you!\No, not really.\I don't really want to think about it.\I didn't do anything.\It's because you put yourself out there! response:	Thank you!
context: Don't mention it.\Thank you.\It's really all thanks to you!\No, not really.\I don't really want to think about it.\I didn't do anything.\It's because you put yourself out there!\Thank you! response:	You're being loud.
context: Thank you.\It's really all thanks to you!\No, not really.\I don't really want to think about it.\I didn't do anything.\It's because you put yourself out there!\Thank you!\You're being loud. response:	Well, I'm glad to see you looking so happy.
context: It's really all thanks to you!\No, not really.\I don't really want to think about it.\I didn't do anything.\It's because you put yourself out there!\Thank you!\You're being loud.\Well, I'm glad to see you looking so happy. response:	By the way...
context: No, not really.\I don't really want to think about it.\I didn't do anything.\It's because you put yourself out there!\Thank you!\You're being loud.\Well, I'm glad to see you looking so happy.\By the way... response:	In this kind of situation,
context: I don't really want to think about it.\I didn't do anything.\It's because you put yourself out there!\Thank you!\You're being loud.\Well, I'm glad to see you looking so happy.\By the way...\In this kind of situation, response:	when does one have a second kiss?
context: I didn't do anything.\It's because you put yourself out there!\Thank you!\You're being loud.\Well, I'm glad to see you looking so happy.\By the way...\In this kind of situation,\when does one have a second kiss? response:	I think whenever you feel like it.
context: It's because you put yourself out there!\Thank you!\You're being loud.\Well, I'm glad to see you looking so happy.\By the way...\In this kind of situation,\when does one have a second kiss?\I think whenever you feel like it. response:	I see!
context: Thank you!\You're being loud.\Well, I'm glad to see you looking so happy.\By the way...\In this kind of situation,\when does one have a second kiss?\I think whenever you feel like it.\I see! response:	But sometimes, Yamato may not feel like it!
context: You're being loud.\Well, I'm glad to see you looking so happy.\By the way...\In this kind of situation,\when does one have a second kiss?\I think whenever you feel like it.\I see!\But sometimes, Yamato may not feel like it! response:	Then you shouldn't do it.
context: Well, I'm glad to see you looking so happy.\By the way...\In this kind of situation,\when does one have a second kiss?\I think whenever you feel like it.\I see!\But sometimes, Yamato may not feel like it!\Then you shouldn't do it. response:	Like I'd know.
context: By the way...\In this kind of situation,\when does one have a second kiss?\I think whenever you feel like it.\I see!\But sometimes, Yamato may not feel like it!\Then you shouldn't do it.\Like I'd know. response:	I'd like to practice reading people!
context: In this kind of situation,\when does one have a second kiss?\I think whenever you feel like it.\I see!\But sometimes, Yamato may not feel like it!\Then you shouldn't do it.\Like I'd know.\I'd like to practice reading people! response:	Think yes or no, and let me feel it.
context: when does one have a second kiss?\I think whenever you feel like it.\I see!\But sometimes, Yamato may not feel like it!\Then you shouldn't do it.\Like I'd know.\I'd like to practice reading people!\Think yes or no, and let me feel it. response:	There's never gonna be a yes.
context: I think whenever you feel like it.\I see!\But sometimes, Yamato may not feel like it!\Then you shouldn't do it.\Like I'd know.\I'd like to practice reading people!\Think yes or no, and let me feel it.\There's never gonna be a yes. response:	Why not just do it on anniversaries or something?
context: I see!\But sometimes, Yamato may not feel like it!\Then you shouldn't do it.\Like I'd know.\I'd like to practice reading people!\Think yes or no, and let me feel it.\There's never gonna be a yes.\Why not just do it on anniversaries or something? response:	Anniversaries!
context: But sometimes, Yamato may not feel like it!\Then you shouldn't do it.\Like I'd know.\I'd like to practice reading people!\Think yes or no, and let me feel it.\There's never gonna be a yes.\Why not just do it on anniversaries or something?\Anniversaries! response:	I see.
context: Then you shouldn't do it.\Like I'd know.\I'd like to practice reading people!\Think yes or no, and let me feel it.\There's never gonna be a yes.\Why not just do it on anniversaries or something?\Anniversaries!\I see. response:	You're the best, Suna.
context: Like I'd know.\I'd like to practice reading people!\Think yes or no, and let me feel it.\There's never gonna be a yes.\Why not just do it on anniversaries or something?\Anniversaries!\I see.\You're the best, Suna. response:	The next one's Valentine's Day...
context: I'd like to practice reading people!\Think yes or no, and let me feel it.\There's never gonna be a yes.\Why not just do it on anniversaries or something?\Anniversaries!\I see.\You're the best, Suna.\The next one's Valentine's Day... response:	That's nerve-wracking to think about!
context: Think yes or no, and let me feel it.\There's never gonna be a yes.\Why not just do it on anniversaries or something?\Anniversaries!\I see.\You're the best, Suna.\The next one's Valentine's Day...\That's nerve-wracking to think about! response:	It's getting hot.
context: There's never gonna be a yes.\Why not just do it on anniversaries or something?\Anniversaries!\I see.\You're the best, Suna.\The next one's Valentine's Day...\That's nerve-wracking to think about!\It's getting hot. response:	My Mom
context: Why not just do it on anniversaries or something?\Anniversaries!\I see.\You're the best, Suna.\The next one's Valentine's Day...\That's nerve-wracking to think about!\It's getting hot.\My Mom response:	Next time: My Mom.