context: It appeared as though humanity would be destroyed by the demons. response:	But a single mage saved them all.
context: It appeared as though humanity would be destroyed by the demons.\But a single mage saved them all. response:	He was called the Wizard King, and he became a legend.
context: It appeared as though humanity would be destroyed by the demons.\But a single mage saved them all.\He was called the Wizard King, and he became a legend. response:	The mysterious enemy,
context: It appeared as though humanity would be destroyed by the demons.\But a single mage saved them all.\He was called the Wizard King, and he became a legend.\The mysterious enemy, response:	controlling an army of the dead to attack the royal capital,
context: It appeared as though humanity would be destroyed by the demons.\But a single mage saved them all.\He was called the Wizard King, and he became a legend.\The mysterious enemy,\controlling an army of the dead to attack the royal capital, response:	was restrained by Fuegoleon, along with Asta's help.
context: It appeared as though humanity would be destroyed by the demons.\But a single mage saved them all.\He was called the Wizard King, and he became a legend.\The mysterious enemy,\controlling an army of the dead to attack the royal capital,\was restrained by Fuegoleon, along with Asta's help. response:	Couldn't you think of any other way to get people to acknowledge your power?
context: It appeared as though humanity would be destroyed by the demons.\But a single mage saved them all.\He was called the Wizard King, and he became a legend.\The mysterious enemy,\controlling an army of the dead to attack the royal capital,\was restrained by Fuegoleon, along with Asta's help.\Couldn't you think of any other way to get people to acknowledge your power? response:	What?
context: It appeared as though humanity would be destroyed by the demons.\But a single mage saved them all.\He was called the Wizard King, and he became a legend.\The mysterious enemy,\controlling an army of the dead to attack the royal capital,\was restrained by Fuegoleon, along with Asta's help.\Couldn't you think of any other way to get people to acknowledge your power?\What? response:	Well done, Magic Knights.
context: But a single mage saved them all.\He was called the Wizard King, and he became a legend.\The mysterious enemy,\controlling an army of the dead to attack the royal capital,\was restrained by Fuegoleon, along with Asta's help.\Couldn't you think of any other way to get people to acknowledge your power?\What?\Well done, Magic Knights. response:	No
context: He was called the Wizard King, and he became a legend.\The mysterious enemy,\controlling an army of the dead to attack the royal capital,\was restrained by Fuegoleon, along with Asta's help.\Couldn't you think of any other way to get people to acknowledge your power?\What?\Well done, Magic Knights.\No response:	Most of the Magic Knights were sent
context: The mysterious enemy,\controlling an army of the dead to attack the royal capital,\was restrained by Fuegoleon, along with Asta's help.\Couldn't you think of any other way to get people to acknowledge your power?\What?\Well done, Magic Knights.\No\Most of the Magic Knights were sent response:	far away from the royal capital with spatial magic.
context: controlling an army of the dead to attack the royal capital,\was restrained by Fuegoleon, along with Asta's help.\Couldn't you think of any other way to get people to acknowledge your power?\What?\Well done, Magic Knights.\No\Most of the Magic Knights were sent\far away from the royal capital with spatial magic. response:	I figured they must've had a rather skilled spatial magic user, but...
context: was restrained by Fuegoleon, along with Asta's help.\Couldn't you think of any other way to get people to acknowledge your power?\What?\Well done, Magic Knights.\No\Most of the Magic Knights were sent\far away from the royal capital with spatial magic.\I figured they must've had a rather skilled spatial magic user, but... response:	To think they were able to send us all this far.
context: Couldn't you think of any other way to get people to acknowledge your power?\What?\Well done, Magic Knights.\No\Most of the Magic Knights were sent\far away from the royal capital with spatial magic.\I figured they must've had a rather skilled spatial magic user, but...\To think they were able to send us all this far. response:	This is spatial magic.
context: What?\Well done, Magic Knights.\No\Most of the Magic Knights were sent\far away from the royal capital with spatial magic.\I figured they must've had a rather skilled spatial magic user, but...\To think they were able to send us all this far.\This is spatial magic. response:	Very well. Nothing ventured, nothing gained.
context: Well done, Magic Knights.\No\Most of the Magic Knights were sent\far away from the royal capital with spatial magic.\I figured they must've had a rather skilled spatial magic user, but...\To think they were able to send us all this far.\This is spatial magic.\Very well. Nothing ventured, nothing gained. response:	The captain of the Crimson Lion Kings,
context: No\Most of the Magic Knights were sent\far away from the royal capital with spatial magic.\I figured they must've had a rather skilled spatial magic user, but...\To think they were able to send us all this far.\This is spatial magic.\Very well. Nothing ventured, nothing gained.\The captain of the Crimson Lion Kings, response:	Fuegoleon Vermillion, was also sent away somewhere.
context: Most of the Magic Knights were sent\far away from the royal capital with spatial magic.\I figured they must've had a rather skilled spatial magic user, but...\To think they were able to send us all this far.\This is spatial magic.\Very well. Nothing ventured, nothing gained.\The captain of the Crimson Lion Kings,\Fuegoleon Vermillion, was also sent away somewhere. response:	You're...
context: far away from the royal capital with spatial magic.\I figured they must've had a rather skilled spatial magic user, but...\To think they were able to send us all this far.\This is spatial magic.\Very well. Nothing ventured, nothing gained.\The captain of the Crimson Lion Kings,\Fuegoleon Vermillion, was also sent away somewhere.\You're... response:	Meanwhile, Yuno was able to escape the spatial magic attack,
context: I figured they must've had a rather skilled spatial magic user, but...\To think they were able to send us all this far.\This is spatial magic.\Very well. Nothing ventured, nothing gained.\The captain of the Crimson Lion Kings,\Fuegoleon Vermillion, was also sent away somewhere.\You're...\Meanwhile, Yuno was able to escape the spatial magic attack, response:	but while battling a witch who used ash curse magic,
context: To think they were able to send us all this far.\This is spatial magic.\Very well. Nothing ventured, nothing gained.\The captain of the Crimson Lion Kings,\Fuegoleon Vermillion, was also sent away somewhere.\You're...\Meanwhile, Yuno was able to escape the spatial magic attack,\but while battling a witch who used ash curse magic, response:	he ended up losing his sight, hearing, and other senses.
context: This is spatial magic.\Very well. Nothing ventured, nothing gained.\The captain of the Crimson Lion Kings,\Fuegoleon Vermillion, was also sent away somewhere.\You're...\Meanwhile, Yuno was able to escape the spatial magic attack,\but while battling a witch who used ash curse magic,\he ended up losing his sight, hearing, and other senses. response:	But...
context: Very well. Nothing ventured, nothing gained.\The captain of the Crimson Lion Kings,\Fuegoleon Vermillion, was also sent away somewhere.\You're...\Meanwhile, Yuno was able to escape the spatial magic attack,\but while battling a witch who used ash curse magic,\he ended up losing his sight, hearing, and other senses.\But... response:	Not yet!
context: The captain of the Crimson Lion Kings,\Fuegoleon Vermillion, was also sent away somewhere.\You're...\Meanwhile, Yuno was able to escape the spatial magic attack,\but while battling a witch who used ash curse magic,\he ended up losing his sight, hearing, and other senses.\But...\Not yet! response:	Let me just tell you one thing about me.
context: Fuegoleon Vermillion, was also sent away somewhere.\You're...\Meanwhile, Yuno was able to escape the spatial magic attack,\but while battling a witch who used ash curse magic,\he ended up losing his sight, hearing, and other senses.\But...\Not yet!\Let me just tell you one thing about me. response:	hate losing more than anything else!
context: You're...\Meanwhile, Yuno was able to escape the spatial magic attack,\but while battling a witch who used ash curse magic,\he ended up losing his sight, hearing, and other senses.\But...\Not yet!\Let me just tell you one thing about me.\hate losing more than anything else! response:	Wind Spirit Magic: Sylph's Breath!
context: Meanwhile, Yuno was able to escape the spatial magic attack,\but while battling a witch who used ash curse magic,\he ended up losing his sight, hearing, and other senses.\But...\Not yet!\Let me just tell you one thing about me.\hate losing more than anything else!\Wind Spirit Magic: Sylph's Breath! response:	I would always close my eyes
context: but while battling a witch who used ash curse magic,\he ended up losing his sight, hearing, and other senses.\But...\Not yet!\Let me just tell you one thing about me.\hate losing more than anything else!\Wind Spirit Magic: Sylph's Breath!\I would always close my eyes response:	And cower at reality
context: he ended up losing his sight, hearing, and other senses.\But...\Not yet!\Let me just tell you one thing about me.\hate losing more than anything else!\Wind Spirit Magic: Sylph's Breath!\I would always close my eyes\And cower at reality response:	I can't stand the idea
context: But...\Not yet!\Let me just tell you one thing about me.\hate losing more than anything else!\Wind Spirit Magic: Sylph's Breath!\I would always close my eyes\And cower at reality\I can't stand the idea response:	Of just making excuses to give up
context: Not yet!\Let me just tell you one thing about me.\hate losing more than anything else!\Wind Spirit Magic: Sylph's Breath!\I would always close my eyes\And cower at reality\I can't stand the idea\Of just making excuses to give up response:	Stand right there
context: Let me just tell you one thing about me.\hate losing more than anything else!\Wind Spirit Magic: Sylph's Breath!\I would always close my eyes\And cower at reality\I can't stand the idea\Of just making excuses to give up\Stand right there response:	I don't want to be near you
context: hate losing more than anything else!\Wind Spirit Magic: Sylph's Breath!\I would always close my eyes\And cower at reality\I can't stand the idea\Of just making excuses to give up\Stand right there\I don't want to be near you response:	Any minute now
context: Wind Spirit Magic: Sylph's Breath!\I would always close my eyes\And cower at reality\I can't stand the idea\Of just making excuses to give up\Stand right there\I don't want to be near you\Any minute now response:	Just wait right there
context: I would always close my eyes\And cower at reality\I can't stand the idea\Of just making excuses to give up\Stand right there\I don't want to be near you\Any minute now\Just wait right there response:	(The decisive battle is still a long way off)
context: And cower at reality\I can't stand the idea\Of just making excuses to give up\Stand right there\I don't want to be near you\Any minute now\Just wait right there\(The decisive battle is still a long way off) response:	Black and blue
context: I can't stand the idea\Of just making excuses to give up\Stand right there\I don't want to be near you\Any minute now\Just wait right there\(The decisive battle is still a long way off)\Black and blue response:	I'll give up on giving up
context: Of just making excuses to give up\Stand right there\I don't want to be near you\Any minute now\Just wait right there\(The decisive battle is still a long way off)\Black and blue\I'll give up on giving up response:	And get the world on my side
context: Stand right there\I don't want to be near you\Any minute now\Just wait right there\(The decisive battle is still a long way off)\Black and blue\I'll give up on giving up\And get the world on my side response:	I'm looking for the reason I'm alive
context: I don't want to be near you\Any minute now\Just wait right there\(The decisive battle is still a long way off)\Black and blue\I'll give up on giving up\And get the world on my side\I'm looking for the reason I'm alive response:	Every time somewhere under this sky
context: Any minute now\Just wait right there\(The decisive battle is still a long way off)\Black and blue\I'll give up on giving up\And get the world on my side\I'm looking for the reason I'm alive\Every time somewhere under this sky response:	Break through the tearful nights
context: Just wait right there\(The decisive battle is still a long way off)\Black and blue\I'll give up on giving up\And get the world on my side\I'm looking for the reason I'm alive\Every time somewhere under this sky\Break through the tearful nights response:	And head where the light shines
context: (The decisive battle is still a long way off)\Black and blue\I'll give up on giving up\And get the world on my side\I'm looking for the reason I'm alive\Every time somewhere under this sky\Break through the tearful nights\And head where the light shines response:	I want to keep my promise
context: Black and blue\I'll give up on giving up\And get the world on my side\I'm looking for the reason I'm alive\Every time somewhere under this sky\Break through the tearful nights\And head where the light shines\I want to keep my promise response:	I'll deliver it to you
context: I'll give up on giving up\And get the world on my side\I'm looking for the reason I'm alive\Every time somewhere under this sky\Break through the tearful nights\And head where the light shines\I want to keep my promise\I'll deliver it to you response:	shape of love
context: And get the world on my side\I'm looking for the reason I'm alive\Every time somewhere under this sky\Break through the tearful nights\And head where the light shines\I want to keep my promise\I'll deliver it to you\shape of love response:	Adversity
context: I'm looking for the reason I'm alive\Every time somewhere under this sky\Break through the tearful nights\And head where the light shines\I want to keep my promise\I'll deliver it to you\shape of love\Adversity response:	Castle Town Kikka
context: Every time somewhere under this sky\Break through the tearful nights\And head where the light shines\I want to keep my promise\I'll deliver it to you\shape of love\Adversity\Castle Town Kikka response:	Munchy, munchy, munchy, munchy...
context: Break through the tearful nights\And head where the light shines\I want to keep my promise\I'll deliver it to you\shape of love\Adversity\Castle Town Kikka\Munchy, munchy, munchy, munchy... response:	Munchy, munchy, munchy, munchy...
context: And head where the light shines\I want to keep my promise\I'll deliver it to you\shape of love\Adversity\Castle Town Kikka\Munchy, munchy, munchy, munchy...\Munchy, munchy, munchy, munchy... response:	Munchy, munchy, munchy, munchy...
context: I want to keep my promise\I'll deliver it to you\shape of love\Adversity\Castle Town Kikka\Munchy, munchy, munchy, munchy...\Munchy, munchy, munchy, munchy...\Munchy, munchy, munchy, munchy... response:	So good!
context: I'll deliver it to you\shape of love\Adversity\Castle Town Kikka\Munchy, munchy, munchy, munchy...\Munchy, munchy, munchy, munchy...\Munchy, munchy, munchy, munchy...\So good! response:	The way you eat is fantastic,
context: shape of love\Adversity\Castle Town Kikka\Munchy, munchy, munchy, munchy...\Munchy, munchy, munchy, munchy...\Munchy, munchy, munchy, munchy...\So good!\The way you eat is fantastic, response:	you shrimp!
context: Adversity\Castle Town Kikka\Munchy, munchy, munchy, munchy...\Munchy, munchy, munchy, munchy...\Munchy, munchy, munchy, munchy...\So good!\The way you eat is fantastic,\you shrimp! response:	All right! Eat, eat, and eat some more!
context: Castle Town Kikka\Munchy, munchy, munchy, munchy...\Munchy, munchy, munchy, munchy...\Munchy, munchy, munchy, munchy...\So good!\The way you eat is fantastic,\you shrimp!\All right! Eat, eat, and eat some more! response:	'Kay...
context: Munchy, munchy, munchy, munchy...\Munchy, munchy, munchy, munchy...\Munchy, munchy, munchy, munchy...\So good!\The way you eat is fantastic,\you shrimp!\All right! Eat, eat, and eat some more!\'Kay... response:	The country's in danger! What the heck are these two doing?
context: Munchy, munchy, munchy, munchy...\Munchy, munchy, munchy, munchy...\So good!\The way you eat is fantastic,\you shrimp!\All right! Eat, eat, and eat some more!\'Kay...\The country's in danger! What the heck are these two doing? response:	If it's not enough, I'll make as much as you want!
context: Munchy, munchy, munchy, munchy...\So good!\The way you eat is fantastic,\you shrimp!\All right! Eat, eat, and eat some more!\'Kay...\The country's in danger! What the heck are these two doing?\If it's not enough, I'll make as much as you want! response:	'Kay!
context: So good!\The way you eat is fantastic,\you shrimp!\All right! Eat, eat, and eat some more!\'Kay...\The country's in danger! What the heck are these two doing?\If it's not enough, I'll make as much as you want!\'Kay! response:	La?
context: The way you eat is fantastic,\you shrimp!\All right! Eat, eat, and eat some more!\'Kay...\The country's in danger! What the heck are these two doing?\If it's not enough, I'll make as much as you want!\'Kay!\La? response:	A witch?
context: you shrimp!\All right! Eat, eat, and eat some more!\'Kay...\The country's in danger! What the heck are these two doing?\If it's not enough, I'll make as much as you want!\'Kay!\La?\A witch? response:	We're being attacked!
context: All right! Eat, eat, and eat some more!\'Kay...\The country's in danger! What the heck are these two doing?\If it's not enough, I'll make as much as you want!\'Kay!\La?\A witch?\We're being attacked! response:	That's why we told you we should run!
context: 'Kay...\The country's in danger! What the heck are these two doing?\If it's not enough, I'll make as much as you want!\'Kay!\La?\A witch?\We're being attacked!\That's why we told you we should run! response:	Sir, hurry!
context: The country's in danger! What the heck are these two doing?\If it's not enough, I'll make as much as you want!\'Kay!\La?\A witch?\We're being attacked!\That's why we told you we should run!\Sir, hurry! response:	Come on, shrimp, we gotta go!
context: If it's not enough, I'll make as much as you want!\'Kay!\La?\A witch?\We're being attacked!\That's why we told you we should run!\Sir, hurry!\Come on, shrimp, we gotta go! response:	I need... mana.
context: 'Kay!\La?\A witch?\We're being attacked!\That's why we told you we should run!\Sir, hurry!\Come on, shrimp, we gotta go!\I need... mana. response:	I need to steal some!
context: La?\A witch?\We're being attacked!\That's why we told you we should run!\Sir, hurry!\Come on, shrimp, we gotta go!\I need... mana.\I need to steal some! response:	She's overflowing with mana...
context: A witch?\We're being attacked!\That's why we told you we should run!\Sir, hurry!\Come on, shrimp, we gotta go!\I need... mana.\I need to steal some!\She's overflowing with mana... response:	It's glistening on her skin!
context: We're being attacked!\That's why we told you we should run!\Sir, hurry!\Come on, shrimp, we gotta go!\I need... mana.\I need to steal some!\She's overflowing with mana...\It's glistening on her skin! response:	I need to steal it!
context: That's why we told you we should run!\Sir, hurry!\Come on, shrimp, we gotta go!\I need... mana.\I need to steal some!\She's overflowing with mana...\It's glistening on her skin!\I need to steal it! response:	Give it to me!
context: Sir, hurry!\Come on, shrimp, we gotta go!\I need... mana.\I need to steal some!\She's overflowing with mana...\It's glistening on her skin!\I need to steal it!\Give it to me! response:	Give it to me!
context: Come on, shrimp, we gotta go!\I need... mana.\I need to steal some!\She's overflowing with mana...\It's glistening on her skin!\I need to steal it!\Give it to me!\Give it to me! response:	Give it to you? You can't mean...
context: I need... mana.\I need to steal some!\She's overflowing with mana...\It's glistening on her skin!\I need to steal it!\Give it to me!\Give it to me!\Give it to you? You can't mean... response:	My food?!
context: I need to steal some!\She's overflowing with mana...\It's glistening on her skin!\I need to steal it!\Give it to me!\Give it to me!\Give it to you? You can't mean...\My food?! response:	N-No!
context: She's overflowing with mana...\It's glistening on her skin!\I need to steal it!\Give it to me!\Give it to me!\Give it to you? You can't mean...\My food?!\N-No! response:	Give it to me!
context: It's glistening on her skin!\I need to steal it!\Give it to me!\Give it to me!\Give it to you? You can't mean...\My food?!\N-No!\Give it to me! response:	No!
context: I need to steal it!\Give it to me!\Give it to me!\Give it to you? You can't mean...\My food?!\N-No!\Give it to me!\No! response:	This mana... That woman must still be alive.
context: Give it to me!\Give it to me!\Give it to you? You can't mean...\My food?!\N-No!\Give it to me!\No!\This mana... That woman must still be alive. response:	I'm reaching my limit.
context: Give it to me!\Give it to you? You can't mean...\My food?!\N-No!\Give it to me!\No!\This mana... That woman must still be alive.\I'm reaching my limit. response:	What is this overflowing magic?
context: Give it to you? You can't mean...\My food?!\N-No!\Give it to me!\No!\This mana... That woman must still be alive.\I'm reaching my limit.\What is this overflowing magic? response:	Give it to me!
context: My food?!\N-No!\Give it to me!\No!\This mana... That woman must still be alive.\I'm reaching my limit.\What is this overflowing magic?\Give it to me! response:	La...
context: N-No!\Give it to me!\No!\This mana... That woman must still be alive.\I'm reaching my limit.\What is this overflowing magic?\Give it to me!\La... response:	I told you...
context: Give it to me!\No!\This mana... That woman must still be alive.\I'm reaching my limit.\What is this overflowing magic?\Give it to me!\La...\I told you... response:	I told you no.
context: No!\This mana... That woman must still be alive.\I'm reaching my limit.\What is this overflowing magic?\Give it to me!\La...\I told you...\I told you no. response:	I-Impossible!
context: This mana... That woman must still be alive.\I'm reaching my limit.\What is this overflowing magic?\Give it to me!\La...\I told you...\I told you no.\I-Impossible! response:	Cotton Creation Magic: Strike of the Sleeping Sheep.
context: I'm reaching my limit.\What is this overflowing magic?\Give it to me!\La...\I told you...\I told you no.\I-Impossible!\Cotton Creation Magic: Strike of the Sleeping Sheep. response:	Th-That's amazing!
context: What is this overflowing magic?\Give it to me!\La...\I told you...\I told you no.\I-Impossible!\Cotton Creation Magic: Strike of the Sleeping Sheep.\Th-That's amazing! response:	How'd you like that?!
context: Give it to me!\La...\I told you...\I told you no.\I-Impossible!\Cotton Creation Magic: Strike of the Sleeping Sheep.\Th-That's amazing!\How'd you like that?! response:	The food that I cooked with all my soul powered up the shrimp's magic!
context: La...\I told you...\I told you no.\I-Impossible!\Cotton Creation Magic: Strike of the Sleeping Sheep.\Th-That's amazing!\How'd you like that?!\The food that I cooked with all my soul powered up the shrimp's magic! response:	Seriously?! We'll follow you forever, sir!
context: I told you...\I told you no.\I-Impossible!\Cotton Creation Magic: Strike of the Sleeping Sheep.\Th-That's amazing!\How'd you like that?!\The food that I cooked with all my soul powered up the shrimp's magic!\Seriously?! We'll follow you forever, sir! response:	Thank you so much!
context: I told you no.\I-Impossible!\Cotton Creation Magic: Strike of the Sleeping Sheep.\Th-That's amazing!\How'd you like that?!\The food that I cooked with all my soul powered up the shrimp's magic!\Seriously?! We'll follow you forever, sir!\Thank you so much! response:	Glad ya liked it!
context: I-Impossible!\Cotton Creation Magic: Strike of the Sleeping Sheep.\Th-That's amazing!\How'd you like that?!\The food that I cooked with all my soul powered up the shrimp's magic!\Seriously?! We'll follow you forever, sir!\Thank you so much!\Glad ya liked it! response:	None shall ever lay a finger on my food.
context: Cotton Creation Magic: Strike of the Sleeping Sheep.\Th-That's amazing!\How'd you like that?!\The food that I cooked with all my soul powered up the shrimp's magic!\Seriously?! We'll follow you forever, sir!\Thank you so much!\Glad ya liked it!\None shall ever lay a finger on my food. response:	And don't you ever come back!
context: Th-That's amazing!\How'd you like that?!\The food that I cooked with all my soul powered up the shrimp's magic!\Seriously?! We'll follow you forever, sir!\Thank you so much!\Glad ya liked it!\None shall ever lay a finger on my food.\And don't you ever come back! response:	Am I pretty?
context: How'd you like that?!\The food that I cooked with all my soul powered up the shrimp's magic!\Seriously?! We'll follow you forever, sir!\Thank you so much!\Glad ya liked it!\None shall ever lay a finger on my food.\And don't you ever come back!\Am I pretty? response:	Eliza...
context: The food that I cooked with all my soul powered up the shrimp's magic!\Seriously?! We'll follow you forever, sir!\Thank you so much!\Glad ya liked it!\None shall ever lay a finger on my food.\And don't you ever come back!\Am I pretty?\Eliza... response:	I'll love you no matter how you look.
context: Seriously?! We'll follow you forever, sir!\Thank you so much!\Glad ya liked it!\None shall ever lay a finger on my food.\And don't you ever come back!\Am I pretty?\Eliza...\I'll love you no matter how you look. response:	I love you, too.
context: Thank you so much!\Glad ya liked it!\None shall ever lay a finger on my food.\And don't you ever come back!\Am I pretty?\Eliza...\I'll love you no matter how you look.\I love you, too. response:	Eliza!
context: Glad ya liked it!\None shall ever lay a finger on my food.\And don't you ever come back!\Am I pretty?\Eliza...\I'll love you no matter how you look.\I love you, too.\Eliza! response:	My love!
context: None shall ever lay a finger on my food.\And don't you ever come back!\Am I pretty?\Eliza...\I'll love you no matter how you look.\I love you, too.\Eliza!\My love! response:	My food!
context: And don't you ever come back!\Am I pretty?\Eliza...\I'll love you no matter how you look.\I love you, too.\Eliza!\My love!\My food! response:	My noms!
context: Am I pretty?\Eliza...\I'll love you no matter how you look.\I love you, too.\Eliza!\My love!\My food!\My noms! response:	A kid?
context: Eliza...\I'll love you no matter how you look.\I love you, too.\Eliza!\My love!\My food!\My noms!\A kid? response:	That tremendous magical power I felt earlier... was from her?
context: I'll love you no matter how you look.\I love you, too.\Eliza!\My love!\My food!\My noms!\A kid?\That tremendous magical power I felt earlier... was from her? response:	A Black Bulls robe... So it was her.
context: I love you, too.\Eliza!\My love!\My food!\My noms!\A kid?\That tremendous magical power I felt earlier... was from her?\A Black Bulls robe... So it was her. response:	M-My noms?
context: Eliza!\My love!\My food!\My noms!\A kid?\That tremendous magical power I felt earlier... was from her?\A Black Bulls robe... So it was her.\M-My noms? response:	Noms? Oh, here. I'm not sure what's going on, but...
context: My love!\My food!\My noms!\A kid?\That tremendous magical power I felt earlier... was from her?\A Black Bulls robe... So it was her.\M-My noms?\Noms? Oh, here. I'm not sure what's going on, but... response:	Thank y
context: My food!\My noms!\A kid?\That tremendous magical power I felt earlier... was from her?\A Black Bulls robe... So it was her.\M-My noms?\Noms? Oh, here. I'm not sure what's going on, but...\Thank y response:	My meal-saving prince has arrived!
context: My noms!\A kid?\That tremendous magical power I felt earlier... was from her?\A Black Bulls robe... So it was her.\M-My noms?\Noms? Oh, here. I'm not sure what's going on, but...\Thank y\My meal-saving prince has arrived! response:	Meal-Saving Prince
context: A kid?\That tremendous magical power I felt earlier... was from her?\A Black Bulls robe... So it was her.\M-My noms?\Noms? Oh, here. I'm not sure what's going on, but...\Thank y\My meal-saving prince has arrived!\Meal-Saving Prince response:	Th-Thank you...
context: That tremendous magical power I felt earlier... was from her?\A Black Bulls robe... So it was her.\M-My noms?\Noms? Oh, here. I'm not sure what's going on, but...\Thank y\My meal-saving prince has arrived!\Meal-Saving Prince\Th-Thank you... response:	Sure...
context: A Black Bulls robe... So it was her.\M-My noms?\Noms? Oh, here. I'm not sure what's going on, but...\Thank y\My meal-saving prince has arrived!\Meal-Saving Prince\Th-Thank you...\Sure... response:	U-Um...
context: M-My noms?\Noms? Oh, here. I'm not sure what's going on, but...\Thank y\My meal-saving prince has arrived!\Meal-Saving Prince\Th-Thank you...\Sure...\U-Um... response:	N-Name...
context: Noms? Oh, here. I'm not sure what's going on, but...\Thank y\My meal-saving prince has arrived!\Meal-Saving Prince\Th-Thank you...\Sure...\U-Um...\N-Name... response:	Short ribs?
context: Thank y\My meal-saving prince has arrived!\Meal-Saving Prince\Th-Thank you...\Sure...\U-Um...\N-Name...\Short ribs? response:	Oh, yeah. They're delicious! Try some!
context: My meal-saving prince has arrived!\Meal-Saving Prince\Th-Thank you...\Sure...\U-Um...\N-Name...\Short ribs?\Oh, yeah. They're delicious! Try some! response:	No, I mean... Wh-What is your name?
context: Meal-Saving Prince\Th-Thank you...\Sure...\U-Um...\N-Name...\Short ribs?\Oh, yeah. They're delicious! Try some!\No, I mean... Wh-What is your name? response:	Um, I mean, I like meat, too, but...
context: Th-Thank you...\Sure...\U-Um...\N-Name...\Short ribs?\Oh, yeah. They're delicious! Try some!\No, I mean... Wh-What is your name?\Um, I mean, I like meat, too, but... response:	As you'd expect...
context: Sure...\U-Um...\N-Name...\Short ribs?\Oh, yeah. They're delicious! Try some!\No, I mean... Wh-What is your name?\Um, I mean, I like meat, too, but...\As you'd expect... response:	That spell wears out my body and uses a ton of mana...
context: U-Um...\N-Name...\Short ribs?\Oh, yeah. They're delicious! Try some!\No, I mean... Wh-What is your name?\Um, I mean, I like meat, too, but...\As you'd expect...\That spell wears out my body and uses a ton of mana... response:	But what I was wondering about is your name...
context: N-Name...\Short ribs?\Oh, yeah. They're delicious! Try some!\No, I mean... Wh-What is your name?\Um, I mean, I like meat, too, but...\As you'd expect...\That spell wears out my body and uses a ton of mana...\But what I was wondering about is your name... response:	I need to learn how to use it better.
context: Short ribs?\Oh, yeah. They're delicious! Try some!\No, I mean... Wh-What is your name?\Um, I mean, I like meat, too, but...\As you'd expect...\That spell wears out my body and uses a ton of mana...\But what I was wondering about is your name...\I need to learn how to use it better. response:	Look out!
context: Oh, yeah. They're delicious! Try some!\No, I mean... Wh-What is your name?\Um, I mean, I like meat, too, but...\As you'd expect...\That spell wears out my body and uses a ton of mana...\But what I was wondering about is your name...\I need to learn how to use it better.\Look out! response:	La... La! Got it!
context: No, I mean... Wh-What is your name?\Um, I mean, I like meat, too, but...\As you'd expect...\That spell wears out my body and uses a ton of mana...\But what I was wondering about is your name...\I need to learn how to use it better.\Look out!\La... La! Got it! response:	La la la...
context: Um, I mean, I like meat, too, but...\As you'd expect...\That spell wears out my body and uses a ton of mana...\But what I was wondering about is your name...\I need to learn how to use it better.\Look out!\La... La! Got it!\La la la... response:	Well, I guess I might as well eat...
context: As you'd expect...\That spell wears out my body and uses a ton of mana...\But what I was wondering about is your name...\I need to learn how to use it better.\Look out!\La... La! Got it!\La la la...\Well, I guess I might as well eat... response:	Munchy, munchy, munchy...
context: That spell wears out my body and uses a ton of mana...\But what I was wondering about is your name...\I need to learn how to use it better.\Look out!\La... La! Got it!\La la la...\Well, I guess I might as well eat...\Munchy, munchy, munchy... response:	It's rather noisy out there.
context: But what I was wondering about is your name...\I need to learn how to use it better.\Look out!\La... La! Got it!\La la la...\Well, I guess I might as well eat...\Munchy, munchy, munchy...\It's rather noisy out there. response:	King's Quarters
context: I need to learn how to use it better.\Look out!\La... La! Got it!\La la la...\Well, I guess I might as well eat...\Munchy, munchy, munchy...\It's rather noisy out there.\King's Quarters response:	Could you shut them up?
context: Look out!\La... La! Got it!\La la la...\Well, I guess I might as well eat...\Munchy, munchy, munchy...\It's rather noisy out there.\King's Quarters\Could you shut them up? response:	It's time for my royal nap.
context: La... La! Got it!\La la la...\Well, I guess I might as well eat...\Munchy, munchy, munchy...\It's rather noisy out there.\King's Quarters\Could you shut them up?\It's time for my royal nap. response:	I'll look into it.
context: La la la...\Well, I guess I might as well eat...\Munchy, munchy, munchy...\It's rather noisy out there.\King's Quarters\Could you shut them up?\It's time for my royal nap.\I'll look into it. response:	He should be back any moment now.
context: Well, I guess I might as well eat...\Munchy, munchy, munchy...\It's rather noisy out there.\King's Quarters\Could you shut them up?\It's time for my royal nap.\I'll look into it.\He should be back any moment now. response:	The He in Question
context: Munchy, munchy, munchy...\It's rather noisy out there.\King's Quarters\Could you shut them up?\It's time for my royal nap.\I'll look into it.\He should be back any moment now.\The He in Question response:	You're the best shrimp ever!
context: It's rather noisy out there.\King's Quarters\Could you shut them up?\It's time for my royal nap.\I'll look into it.\He should be back any moment now.\The He in Question\You're the best shrimp ever! response:	Uh-huh!
context: King's Quarters\Could you shut them up?\It's time for my royal nap.\I'll look into it.\He should be back any moment now.\The He in Question\You're the best shrimp ever!\Uh-huh! response:	Come see me whenever you're hungry. I'll let you eat all you want.
context: Could you shut them up?\It's time for my royal nap.\I'll look into it.\He should be back any moment now.\The He in Question\You're the best shrimp ever!\Uh-huh!\Come see me whenever you're hungry. I'll let you eat all you want. response:	Yay!
context: It's time for my royal nap.\I'll look into it.\He should be back any moment now.\The He in Question\You're the best shrimp ever!\Uh-huh!\Come see me whenever you're hungry. I'll let you eat all you want.\Yay! response:	North District
context: I'll look into it.\He should be back any moment now.\The He in Question\You're the best shrimp ever!\Uh-huh!\Come see me whenever you're hungry. I'll let you eat all you want.\Yay!\North District response:	You bastard! What have you done with my brother?!
context: He should be back any moment now.\The He in Question\You're the best shrimp ever!\Uh-huh!\Come see me whenever you're hungry. I'll let you eat all you want.\Yay!\North District\You bastard! What have you done with my brother?! response:	Leopold! He's not the spatial magic user.
context: The He in Question\You're the best shrimp ever!\Uh-huh!\Come see me whenever you're hungry. I'll let you eat all you want.\Yay!\North District\You bastard! What have you done with my brother?!\Leopold! He's not the spatial magic user. response:	That spell pinpointed him,
context: You're the best shrimp ever!\Uh-huh!\Come see me whenever you're hungry. I'll let you eat all you want.\Yay!\North District\You bastard! What have you done with my brother?!\Leopold! He's not the spatial magic user.\That spell pinpointed him, response:	so there's no way the spellcaster could've cast it from far away.
context: Uh-huh!\Come see me whenever you're hungry. I'll let you eat all you want.\Yay!\North District\You bastard! What have you done with my brother?!\Leopold! He's not the spatial magic user.\That spell pinpointed him,\so there's no way the spellcaster could've cast it from far away. response:	Where could they be?
context: Come see me whenever you're hungry. I'll let you eat all you want.\Yay!\North District\You bastard! What have you done with my brother?!\Leopold! He's not the spatial magic user.\That spell pinpointed him,\so there's no way the spellcaster could've cast it from far away.\Where could they be? response:	Huh? Asta?
context: Yay!\North District\You bastard! What have you done with my brother?!\Leopold! He's not the spatial magic user.\That spell pinpointed him,\so there's no way the spellcaster could've cast it from far away.\Where could they be?\Huh? Asta? response:	You're right there!
context: North District\You bastard! What have you done with my brother?!\Leopold! He's not the spatial magic user.\That spell pinpointed him,\so there's no way the spellcaster could've cast it from far away.\Where could they be?\Huh? Asta?\You're right there! response:	He was hiding among the corpses?!
context: You bastard! What have you done with my brother?!\Leopold! He's not the spatial magic user.\That spell pinpointed him,\so there's no way the spellcaster could've cast it from far away.\Where could they be?\Huh? Asta?\You're right there!\He was hiding among the corpses?! response:	I'm impressed you found me.
context: Leopold! He's not the spatial magic user.\That spell pinpointed him,\so there's no way the spellcaster could've cast it from far away.\Where could they be?\Huh? Asta?\You're right there!\He was hiding among the corpses?!\I'm impressed you found me. response:	I figured I'd be found if I used magic to transform,
context: That spell pinpointed him,\so there's no way the spellcaster could've cast it from far away.\Where could they be?\Huh? Asta?\You're right there!\He was hiding among the corpses?!\I'm impressed you found me.\I figured I'd be found if I used magic to transform, response:	so I went to the trouble of making this filthy disguise.
context: so there's no way the spellcaster could've cast it from far away.\Where could they be?\Huh? Asta?\You're right there!\He was hiding among the corpses?!\I'm impressed you found me.\I figured I'd be found if I used magic to transform,\so I went to the trouble of making this filthy disguise. response:	What are you, an animal?
context: Where could they be?\Huh? Asta?\You're right there!\He was hiding among the corpses?!\I'm impressed you found me.\I figured I'd be found if I used magic to transform,\so I went to the trouble of making this filthy disguise.\What are you, an animal? response:	But it appears that it's over now.
context: Huh? Asta?\You're right there!\He was hiding among the corpses?!\I'm impressed you found me.\I figured I'd be found if I used magic to transform,\so I went to the trouble of making this filthy disguise.\What are you, an animal?\But it appears that it's over now. response:	Over?
context: You're right there!\He was hiding among the corpses?!\I'm impressed you found me.\I figured I'd be found if I used magic to transform,\so I went to the trouble of making this filthy disguise.\What are you, an animal?\But it appears that it's over now.\Over? response:	What's over?
context: He was hiding among the corpses?!\I'm impressed you found me.\I figured I'd be found if I used magic to transform,\so I went to the trouble of making this filthy disguise.\What are you, an animal?\But it appears that it's over now.\Over?\What's over? response:	Fuegoleon!
context: I'm impressed you found me.\I figured I'd be found if I used magic to transform,\so I went to the trouble of making this filthy disguise.\What are you, an animal?\But it appears that it's over now.\Over?\What's over?\Fuegoleon! response:	But...
context: I figured I'd be found if I used magic to transform,\so I went to the trouble of making this filthy disguise.\What are you, an animal?\But it appears that it's over now.\Over?\What's over?\Fuegoleon!\But... response:	But he's so strong.
context: so I went to the trouble of making this filthy disguise.\What are you, an animal?\But it appears that it's over now.\Over?\What's over?\Fuegoleon!\But...\But he's so strong. response:	That's... impossible...
context: What are you, an animal?\But it appears that it's over now.\Over?\What's over?\Fuegoleon!\But...\But he's so strong.\That's... impossible... response:	H-His arm...
context: But it appears that it's over now.\Over?\What's over?\Fuegoleon!\But...\But he's so strong.\That's... impossible...\H-His arm... response:	Fuegoleon...
context: Over?\What's over?\Fuegoleon!\But...\But he's so strong.\That's... impossible...\H-His arm...\Fuegoleon... response:	Fuegoleon... Fuegoleon!
context: What's over?\Fuegoleon!\But...\But he's so strong.\That's... impossible...\H-His arm...\Fuegoleon...\Fuegoleon... Fuegoleon! response:	That's impossible... There's no way Fuegoleon would lose.
context: Fuegoleon!\But...\But he's so strong.\That's... impossible...\H-His arm...\Fuegoleon...\Fuegoleon... Fuegoleon!\That's impossible... There's no way Fuegoleon would lose. response:	My brother wouldn't...
context: But...\But he's so strong.\That's... impossible...\H-His arm...\Fuegoleon...\Fuegoleon... Fuegoleon!\That's impossible... There's no way Fuegoleon would lose.\My brother wouldn't... response:	Captain Fuegoleon's grimoire...
context: But he's so strong.\That's... impossible...\H-His arm...\Fuegoleon...\Fuegoleon... Fuegoleon!\That's impossible... There's no way Fuegoleon would lose.\My brother wouldn't...\Captain Fuegoleon's grimoire... response:	It's still intact, which means... he's still alive!
context: That's... impossible...\H-His arm...\Fuegoleon...\Fuegoleon... Fuegoleon!\That's impossible... There's no way Fuegoleon would lose.\My brother wouldn't...\Captain Fuegoleon's grimoire...\It's still intact, which means... he's still alive! response:	We have to stop the bleeding!
context: H-His arm...\Fuegoleon...\Fuegoleon... Fuegoleon!\That's impossible... There's no way Fuegoleon would lose.\My brother wouldn't...\Captain Fuegoleon's grimoire...\It's still intact, which means... he's still alive!\We have to stop the bleeding! response:	Impossible... That's impossible...
context: Fuegoleon...\Fuegoleon... Fuegoleon!\That's impossible... There's no way Fuegoleon would lose.\My brother wouldn't...\Captain Fuegoleon's grimoire...\It's still intact, which means... he's still alive!\We have to stop the bleeding!\Impossible... That's impossible... response:	If only Mimosa were here...
context: Fuegoleon... Fuegoleon!\That's impossible... There's no way Fuegoleon would lose.\My brother wouldn't...\Captain Fuegoleon's grimoire...\It's still intact, which means... he's still alive!\We have to stop the bleeding!\Impossible... That's impossible...\If only Mimosa were here... response:	Oh, no... His grimoire is breaking apart!
context: That's impossible... There's no way Fuegoleon would lose.\My brother wouldn't...\Captain Fuegoleon's grimoire...\It's still intact, which means... he's still alive!\We have to stop the bleeding!\Impossible... That's impossible...\If only Mimosa were here...\Oh, no... His grimoire is breaking apart! response:	Leopold, help me!
context: My brother wouldn't...\Captain Fuegoleon's grimoire...\It's still intact, which means... he's still alive!\We have to stop the bleeding!\Impossible... That's impossible...\If only Mimosa were here...\Oh, no... His grimoire is breaking apart!\Leopold, help me! response:	Fuegoleon...
context: Captain Fuegoleon's grimoire...\It's still intact, which means... he's still alive!\We have to stop the bleeding!\Impossible... That's impossible...\If only Mimosa were here...\Oh, no... His grimoire is breaking apart!\Leopold, help me!\Fuegoleon... response:	Leopold! Your captain is...
context: It's still intact, which means... he's still alive!\We have to stop the bleeding!\Impossible... That's impossible...\If only Mimosa were here...\Oh, no... His grimoire is breaking apart!\Leopold, help me!\Fuegoleon...\Leopold! Your captain is... response:	That's what you get for talking down to me earlier!
context: We have to stop the bleeding!\Impossible... That's impossible...\If only Mimosa were here...\Oh, no... His grimoire is breaking apart!\Leopold, help me!\Fuegoleon...\Leopold! Your captain is...\That's what you get for talking down to me earlier! response:	Leopold!
context: Impossible... That's impossible...\If only Mimosa were here...\Oh, no... His grimoire is breaking apart!\Leopold, help me!\Fuegoleon...\Leopold! Your captain is...\That's what you get for talking down to me earlier!\Leopold! response:	A magic blast...
context: If only Mimosa were here...\Oh, no... His grimoire is breaking apart!\Leopold, help me!\Fuegoleon...\Leopold! Your captain is...\That's what you get for talking down to me earlier!\Leopold!\A magic blast... response:	What you lacked to overcome adversity...
context: Oh, no... His grimoire is breaking apart!\Leopold, help me!\Fuegoleon...\Leopold! Your captain is...\That's what you get for talking down to me earlier!\Leopold!\A magic blast...\What you lacked to overcome adversity... response:	was a righteous heart.
context: Leopold, help me!\Fuegoleon...\Leopold! Your captain is...\That's what you get for talking down to me earlier!\Leopold!\A magic blast...\What you lacked to overcome adversity...\was a righteous heart. response:	A righteous heart?! I've always been true to myself!
context: Fuegoleon...\Leopold! Your captain is...\That's what you get for talking down to me earlier!\Leopold!\A magic blast...\What you lacked to overcome adversity...\was a righteous heart.\A righteous heart?! I've always been true to myself! response:	Keep yappin' in the next world, Fuegoleon Vermillion!
context: Leopold! Your captain is...\That's what you get for talking down to me earlier!\Leopold!\A magic blast...\What you lacked to overcome adversity...\was a righteous heart.\A righteous heart?! I've always been true to myself!\Keep yappin' in the next world, Fuegoleon Vermillion! response:	We've completed our mission.
context: That's what you get for talking down to me earlier!\Leopold!\A magic blast...\What you lacked to overcome adversity...\was a righteous heart.\A righteous heart?! I've always been true to myself!\Keep yappin' in the next world, Fuegoleon Vermillion!\We've completed our mission. response:	We're leaving before the other Magic Knights come back, Rades.
context: Leopold!\A magic blast...\What you lacked to overcome adversity...\was a righteous heart.\A righteous heart?! I've always been true to myself!\Keep yappin' in the next world, Fuegoleon Vermillion!\We've completed our mission.\We're leaving before the other Magic Knights come back, Rades. response:	Hold it... right there.
context: A magic blast...\What you lacked to overcome adversity...\was a righteous heart.\A righteous heart?! I've always been true to myself!\Keep yappin' in the next world, Fuegoleon Vermillion!\We've completed our mission.\We're leaving before the other Magic Knights come back, Rades.\Hold it... right there. response:	Asta, wasn't it?
context: What you lacked to overcome adversity...\was a righteous heart.\A righteous heart?! I've always been true to myself!\Keep yappin' in the next world, Fuegoleon Vermillion!\We've completed our mission.\We're leaving before the other Magic Knights come back, Rades.\Hold it... right there.\Asta, wasn't it? response:	I'll eventually kill you and make you into one of my toys.
context: was a righteous heart.\A righteous heart?! I've always been true to myself!\Keep yappin' in the next world, Fuegoleon Vermillion!\We've completed our mission.\We're leaving before the other Magic Knights come back, Rades.\Hold it... right there.\Asta, wasn't it?\I'll eventually kill you and make you into one of my toys. response:	Look forward to that, you little brat!
context: A righteous heart?! I've always been true to myself!\Keep yappin' in the next world, Fuegoleon Vermillion!\We've completed our mission.\We're leaving before the other Magic Knights come back, Rades.\Hold it... right there.\Asta, wasn't it?\I'll eventually kill you and make you into one of my toys.\Look forward to that, you little brat! response:	Asta!
context: Keep yappin' in the next world, Fuegoleon Vermillion!\We've completed our mission.\We're leaving before the other Magic Knights come back, Rades.\Hold it... right there.\Asta, wasn't it?\I'll eventually kill you and make you into one of my toys.\Look forward to that, you little brat!\Asta! response:	This distance... I'm not gonna make it.
context: We've completed our mission.\We're leaving before the other Magic Knights come back, Rades.\Hold it... right there.\Asta, wasn't it?\I'll eventually kill you and make you into one of my toys.\Look forward to that, you little brat!\Asta!\This distance... I'm not gonna make it. response:	Don't!
context: We're leaving before the other Magic Knights come back, Rades.\Hold it... right there.\Asta, wasn't it?\I'll eventually kill you and make you into one of my toys.\Look forward to that, you little brat!\Asta!\This distance... I'm not gonna make it.\Don't! response:	If you move any more while you're bleeding that much...
context: Hold it... right there.\Asta, wasn't it?\I'll eventually kill you and make you into one of my toys.\Look forward to that, you little brat!\Asta!\This distance... I'm not gonna make it.\Don't!\If you move any more while you're bleeding that much... response:	Not yet!
context: Asta, wasn't it?\I'll eventually kill you and make you into one of my toys.\Look forward to that, you little brat!\Asta!\This distance... I'm not gonna make it.\Don't!\If you move any more while you're bleeding that much...\Not yet! response:	The captain of the Crimson Lion Kings just taught me...
context: I'll eventually kill you and make you into one of my toys.\Look forward to that, you little brat!\Asta!\This distance... I'm not gonna make it.\Don't!\If you move any more while you're bleeding that much...\Not yet!\The captain of the Crimson Lion Kings just taught me... response:	I need to think calmly.
context: Look forward to that, you little brat!\Asta!\This distance... I'm not gonna make it.\Don't!\If you move any more while you're bleeding that much...\Not yet!\The captain of the Crimson Lion Kings just taught me...\I need to think calmly. response:	How can I stop him?
context: Asta!\This distance... I'm not gonna make it.\Don't!\If you move any more while you're bleeding that much...\Not yet!\The captain of the Crimson Lion Kings just taught me...\I need to think calmly.\How can I stop him? response:	That spatial magic...
context: This distance... I'm not gonna make it.\Don't!\If you move any more while you're bleeding that much...\Not yet!\The captain of the Crimson Lion Kings just taught me...\I need to think calmly.\How can I stop him?\That spatial magic... response:	Not giving up is my magic!
context: Don't!\If you move any more while you're bleeding that much...\Not yet!\The captain of the Crimson Lion Kings just taught me...\I need to think calmly.\How can I stop him?\That spatial magic...\Not giving up is my magic! response:	And my sword can...
context: If you move any more while you're bleeding that much...\Not yet!\The captain of the Crimson Lion Kings just taught me...\I need to think calmly.\How can I stop him?\That spatial magic...\Not giving up is my magic!\And my sword can... response:	Cut through magic!
context: Not yet!\The captain of the Crimson Lion Kings just taught me...\I need to think calmly.\How can I stop him?\That spatial magic...\Not giving up is my magic!\And my sword can...\Cut through magic! response:	What?!
context: The captain of the Crimson Lion Kings just taught me...\I need to think calmly.\How can I stop him?\That spatial magic...\Not giving up is my magic!\And my sword can...\Cut through magic!\What?! response:	Ow! What the hell are you doing, you little shit?!
context: I need to think calmly.\How can I stop him?\That spatial magic...\Not giving up is my magic!\And my sword can...\Cut through magic!\What?!\Ow! What the hell are you doing, you little shit?! response:	Not good...
context: How can I stop him?\That spatial magic...\Not giving up is my magic!\And my sword can...\Cut through magic!\What?!\Ow! What the hell are you doing, you little shit?!\Not good... response:	You have the nerve to say that after hurting all those people?!
context: That spatial magic...\Not giving up is my magic!\And my sword can...\Cut through magic!\What?!\Ow! What the hell are you doing, you little shit?!\Not good...\You have the nerve to say that after hurting all those people?! response:	This...
context: Not giving up is my magic!\And my sword can...\Cut through magic!\What?!\Ow! What the hell are you doing, you little shit?!\Not good...\You have the nerve to say that after hurting all those people?!\This... response:	is pain!
context: And my sword can...\Cut through magic!\What?!\Ow! What the hell are you doing, you little shit?!\Not good...\You have the nerve to say that after hurting all those people?!\This...\is pain! response:	This is what you did to innocent people as you laughed about it!
context: Cut through magic!\What?!\Ow! What the hell are you doing, you little shit?!\Not good...\You have the nerve to say that after hurting all those people?!\This...\is pain!\This is what you did to innocent people as you laughed about it! response:	Stop!
context: What?!\Ow! What the hell are you doing, you little shit?!\Not good...\You have the nerve to say that after hurting all those people?!\This...\is pain!\This is what you did to innocent people as you laughed about it!\Stop! response:	Getting hurt and bleeding are signs of being weak!
context: Ow! What the hell are you doing, you little shit?!\Not good...\You have the nerve to say that after hurting all those people?!\This...\is pain!\This is what you did to innocent people as you laughed about it!\Stop!\Getting hurt and bleeding are signs of being weak! response:	Those who lack magic should just get their asses beat by those
context: Not good...\You have the nerve to say that after hurting all those people?!\This...\is pain!\This is what you did to innocent people as you laughed about it!\Stop!\Getting hurt and bleeding are signs of being weak!\Those who lack magic should just get their asses beat by those response:	who are more powerful!
context: You have the nerve to say that after hurting all those people?!\This...\is pain!\This is what you did to innocent people as you laughed about it!\Stop!\Getting hurt and bleeding are signs of being weak!\Those who lack magic should just get their asses beat by those\who are more powerful! response:	Especially... pieces of trash like you who don't have any magic!
context: This...\is pain!\This is what you did to innocent people as you laughed about it!\Stop!\Getting hurt and bleeding are signs of being weak!\Those who lack magic should just get their asses beat by those\who are more powerful!\Especially... pieces of trash like you who don't have any magic! response:	I'm here to make sure...
context: is pain!\This is what you did to innocent people as you laughed about it!\Stop!\Getting hurt and bleeding are signs of being weak!\Those who lack magic should just get their asses beat by those\who are more powerful!\Especially... pieces of trash like you who don't have any magic!\I'm here to make sure... response:	that doesn't happen!
context: This is what you did to innocent people as you laughed about it!\Stop!\Getting hurt and bleeding are signs of being weak!\Those who lack magic should just get their asses beat by those\who are more powerful!\Especially... pieces of trash like you who don't have any magic!\I'm here to make sure...\that doesn't happen! response:	And...
context: Stop!\Getting hurt and bleeding are signs of being weak!\Those who lack magic should just get their asses beat by those\who are more powerful!\Especially... pieces of trash like you who don't have any magic!\I'm here to make sure...\that doesn't happen!\And... response:	Even those without magic can become the best!
context: Getting hurt and bleeding are signs of being weak!\Those who lack magic should just get their asses beat by those\who are more powerful!\Especially... pieces of trash like you who don't have any magic!\I'm here to make sure...\that doesn't happen!\And...\Even those without magic can become the best! response:	I'm going to prove that by becoming the Wizard King!
context: Those who lack magic should just get their asses beat by those\who are more powerful!\Especially... pieces of trash like you who don't have any magic!\I'm here to make sure...\that doesn't happen!\And...\Even those without magic can become the best!\I'm going to prove that by becoming the Wizard King! response:	Valtos! Do something!
context: who are more powerful!\Especially... pieces of trash like you who don't have any magic!\I'm here to make sure...\that doesn't happen!\And...\Even those without magic can become the best!\I'm going to prove that by becoming the Wizard King!\Valtos! Do something! response:	If I could, I would've by now.
context: Especially... pieces of trash like you who don't have any magic!\I'm here to make sure...\that doesn't happen!\And...\Even those without magic can become the best!\I'm going to prove that by becoming the Wizard King!\Valtos! Do something!\If I could, I would've by now. response:	That anti-magic is more troublesome than I'd imagined.
context: I'm here to make sure...\that doesn't happen!\And...\Even those without magic can become the best!\I'm going to prove that by becoming the Wizard King!\Valtos! Do something!\If I could, I would've by now.\That anti-magic is more troublesome than I'd imagined. response:	Looks like we're going to have to take care of him first.
context: that doesn't happen!\And...\Even those without magic can become the best!\I'm going to prove that by becoming the Wizard King!\Valtos! Do something!\If I could, I would've by now.\That anti-magic is more troublesome than I'd imagined.\Looks like we're going to have to take care of him first. response:	He's gathering magic? What's he
context: And...\Even those without magic can become the best!\I'm going to prove that by becoming the Wizard King!\Valtos! Do something!\If I could, I would've by now.\That anti-magic is more troublesome than I'd imagined.\Looks like we're going to have to take care of him first.\He's gathering magic? What's he response:	Is he going to attack using spatial magic?
context: Even those without magic can become the best!\I'm going to prove that by becoming the Wizard King!\Valtos! Do something!\If I could, I would've by now.\That anti-magic is more troublesome than I'd imagined.\Looks like we're going to have to take care of him first.\He's gathering magic? What's he\Is he going to attack using spatial magic? response:	Asta, look out!
context: I'm going to prove that by becoming the Wizard King!\Valtos! Do something!\If I could, I would've by now.\That anti-magic is more troublesome than I'd imagined.\Looks like we're going to have to take care of him first.\He's gathering magic? What's he\Is he going to attack using spatial magic?\Asta, look out! response:	Too late!
context: Valtos! Do something!\If I could, I would've by now.\That anti-magic is more troublesome than I'd imagined.\Looks like we're going to have to take care of him first.\He's gathering magic? What's he\Is he going to attack using spatial magic?\Asta, look out!\Too late! response:	How can I be panicking?
context: If I could, I would've by now.\That anti-magic is more troublesome than I'd imagined.\Looks like we're going to have to take care of him first.\He's gathering magic? What's he\Is he going to attack using spatial magic?\Asta, look out!\Too late!\How can I be panicking? response:	I always need to remain calm...
context: That anti-magic is more troublesome than I'd imagined.\Looks like we're going to have to take care of him first.\He's gathering magic? What's he\Is he going to attack using spatial magic?\Asta, look out!\Too late!\How can I be panicking?\I always need to remain calm... response:	Right, Fuegoleon?!
context: Looks like we're going to have to take care of him first.\He's gathering magic? What's he\Is he going to attack using spatial magic?\Asta, look out!\Too late!\How can I be panicking?\I always need to remain calm...\Right, Fuegoleon?! response:	Leopold!
context: He's gathering magic? What's he\Is he going to attack using spatial magic?\Asta, look out!\Too late!\How can I be panicking?\I always need to remain calm...\Right, Fuegoleon?!\Leopold! response:	This isn't good... We can't afford to lose Rades, too.
context: Is he going to attack using spatial magic?\Asta, look out!\Too late!\How can I be panicking?\I always need to remain calm...\Right, Fuegoleon?!\Leopold!\This isn't good... We can't afford to lose Rades, too. response:	D-Damn you all! Get away! Stay back!
context: Asta, look out!\Too late!\How can I be panicking?\I always need to remain calm...\Right, Fuegoleon?!\Leopold!\This isn't good... We can't afford to lose Rades, too.\D-Damn you all! Get away! Stay back! response:	Pathetic.
context: Too late!\How can I be panicking?\I always need to remain calm...\Right, Fuegoleon?!\Leopold!\This isn't good... We can't afford to lose Rades, too.\D-Damn you all! Get away! Stay back!\Pathetic. response:	We received orders from Master to come here, and look at you...
context: How can I be panicking?\I always need to remain calm...\Right, Fuegoleon?!\Leopold!\This isn't good... We can't afford to lose Rades, too.\D-Damn you all! Get away! Stay back!\Pathetic.\We received orders from Master to come here, and look at you... response:	You're struggling against this lot. How pathetic.
context: I always need to remain calm...\Right, Fuegoleon?!\Leopold!\This isn't good... We can't afford to lose Rades, too.\D-Damn you all! Get away! Stay back!\Pathetic.\We received orders from Master to come here, and look at you...\You're struggling against this lot. How pathetic. response:	Such piercingly cold magic...
context: Right, Fuegoleon?!\Leopold!\This isn't good... We can't afford to lose Rades, too.\D-Damn you all! Get away! Stay back!\Pathetic.\We received orders from Master to come here, and look at you...\You're struggling against this lot. How pathetic.\Such piercingly cold magic... response:	There are five new enemies!
context: Leopold!\This isn't good... We can't afford to lose Rades, too.\D-Damn you all! Get away! Stay back!\Pathetic.\We received orders from Master to come here, and look at you...\You're struggling against this lot. How pathetic.\Such piercingly cold magic...\There are five new enemies! response:	I was only scratched... but thanks to that curse, the bleeding won't stop.
context: This isn't good... We can't afford to lose Rades, too.\D-Damn you all! Get away! Stay back!\Pathetic.\We received orders from Master to come here, and look at you...\You're struggling against this lot. How pathetic.\Such piercingly cold magic...\There are five new enemies!\I was only scratched... but thanks to that curse, the bleeding won't stop. response:	If I lose any more blood, I'm in trouble.
context: D-Damn you all! Get away! Stay back!\Pathetic.\We received orders from Master to come here, and look at you...\You're struggling against this lot. How pathetic.\Such piercingly cold magic...\There are five new enemies!\I was only scratched... but thanks to that curse, the bleeding won't stop.\If I lose any more blood, I'm in trouble. response:	No one asked for your help!
context: Pathetic.\We received orders from Master to come here, and look at you...\You're struggling against this lot. How pathetic.\Such piercingly cold magic...\There are five new enemies!\I was only scratched... but thanks to that curse, the bleeding won't stop.\If I lose any more blood, I'm in trouble.\No one asked for your help! response:	Aw, you should be thanking us.
context: We received orders from Master to come here, and look at you...\You're struggling against this lot. How pathetic.\Such piercingly cold magic...\There are five new enemies!\I was only scratched... but thanks to that curse, the bleeding won't stop.\If I lose any more blood, I'm in trouble.\No one asked for your help!\Aw, you should be thanking us. response:	If we hadn't arrived,
context: You're struggling against this lot. How pathetic.\Such piercingly cold magic...\There are five new enemies!\I was only scratched... but thanks to that curse, the bleeding won't stop.\If I lose any more blood, I'm in trouble.\No one asked for your help!\Aw, you should be thanking us.\If we hadn't arrived, response:	you definitely would've been captured and dissected alive.
context: Such piercingly cold magic...\There are five new enemies!\I was only scratched... but thanks to that curse, the bleeding won't stop.\If I lose any more blood, I'm in trouble.\No one asked for your help!\Aw, you should be thanking us.\If we hadn't arrived,\you definitely would've been captured and dissected alive. response:	And if you're gonna be dissected, I want to be the one to do it.
context: There are five new enemies!\I was only scratched... but thanks to that curse, the bleeding won't stop.\If I lose any more blood, I'm in trouble.\No one asked for your help!\Aw, you should be thanking us.\If we hadn't arrived,\you definitely would've been captured and dissected alive.\And if you're gonna be dissected, I want to be the one to do it. response:	Shut up!
context: I was only scratched... but thanks to that curse, the bleeding won't stop.\If I lose any more blood, I'm in trouble.\No one asked for your help!\Aw, you should be thanking us.\If we hadn't arrived,\you definitely would've been captured and dissected alive.\And if you're gonna be dissected, I want to be the one to do it.\Shut up! response:	Anyway, it looks like the tables have turned!
context: If I lose any more blood, I'm in trouble.\No one asked for your help!\Aw, you should be thanking us.\If we hadn't arrived,\you definitely would've been captured and dissected alive.\And if you're gonna be dissected, I want to be the one to do it.\Shut up!\Anyway, it looks like the tables have turned! response:	Asta!
context: No one asked for your help!\Aw, you should be thanking us.\If we hadn't arrived,\you definitely would've been captured and dissected alive.\And if you're gonna be dissected, I want to be the one to do it.\Shut up!\Anyway, it looks like the tables have turned!\Asta! response:	You...
context: Aw, you should be thanking us.\If we hadn't arrived,\you definitely would've been captured and dissected alive.\And if you're gonna be dissected, I want to be the one to do it.\Shut up!\Anyway, it looks like the tables have turned!\Asta!\You... response:	Now I can keep fighting!
context: If we hadn't arrived,\you definitely would've been captured and dissected alive.\And if you're gonna be dissected, I want to be the one to do it.\Shut up!\Anyway, it looks like the tables have turned!\Asta!\You...\Now I can keep fighting! response:	Please watch me, sir!
context: you definitely would've been captured and dissected alive.\And if you're gonna be dissected, I want to be the one to do it.\Shut up!\Anyway, it looks like the tables have turned!\Asta!\You...\Now I can keep fighting!\Please watch me, sir! response:	This brat... He struck himself with his own swords to get rid of the curse?
context: And if you're gonna be dissected, I want to be the one to do it.\Shut up!\Anyway, it looks like the tables have turned!\Asta!\You...\Now I can keep fighting!\Please watch me, sir!\This brat... He struck himself with his own swords to get rid of the curse? response:	Unbelievable... He's so stupid!
context: Shut up!\Anyway, it looks like the tables have turned!\Asta!\You...\Now I can keep fighting!\Please watch me, sir!\This brat... He struck himself with his own swords to get rid of the curse?\Unbelievable... He's so stupid! response:	Wow, he's fun. Can I dissect him later?
context: Anyway, it looks like the tables have turned!\Asta!\You...\Now I can keep fighting!\Please watch me, sir!\This brat... He struck himself with his own swords to get rid of the curse?\Unbelievable... He's so stupid!\Wow, he's fun. Can I dissect him later? response:	Quiet.
context: Asta!\You...\Now I can keep fighting!\Please watch me, sir!\This brat... He struck himself with his own swords to get rid of the curse?\Unbelievable... He's so stupid!\Wow, he's fun. Can I dissect him later?\Quiet. response:	Boo. You're such a spoilsport.
context: You...\Now I can keep fighting!\Please watch me, sir!\This brat... He struck himself with his own swords to get rid of the curse?\Unbelievable... He's so stupid!\Wow, he's fun. Can I dissect him later?\Quiet.\Boo. You're such a spoilsport. response:	All I've ever faced since I was born... was adversity.
context: Now I can keep fighting!\Please watch me, sir!\This brat... He struck himself with his own swords to get rid of the curse?\Unbelievable... He's so stupid!\Wow, he's fun. Can I dissect him later?\Quiet.\Boo. You're such a spoilsport.\All I've ever faced since I was born... was adversity. response:	No matter how many come at me, no matter what happens,
context: Please watch me, sir!\This brat... He struck himself with his own swords to get rid of the curse?\Unbelievable... He's so stupid!\Wow, he's fun. Can I dissect him later?\Quiet.\Boo. You're such a spoilsport.\All I've ever faced since I was born... was adversity.\No matter how many come at me, no matter what happens, response:	I'll blast them all away!
context: This brat... He struck himself with his own swords to get rid of the curse?\Unbelievable... He's so stupid!\Wow, he's fun. Can I dissect him later?\Quiet.\Boo. You're such a spoilsport.\All I've ever faced since I was born... was adversity.\No matter how many come at me, no matter what happens,\I'll blast them all away! response:	All right! Come at me!
context: Unbelievable... He's so stupid!\Wow, he's fun. Can I dissect him later?\Quiet.\Boo. You're such a spoilsport.\All I've ever faced since I was born... was adversity.\No matter how many come at me, no matter what happens,\I'll blast them all away!\All right! Come at me! response:	My dry emotions gaze at the me from that day
context: Wow, he's fun. Can I dissect him later?\Quiet.\Boo. You're such a spoilsport.\All I've ever faced since I was born... was adversity.\No matter how many come at me, no matter what happens,\I'll blast them all away!\All right! Come at me!\My dry emotions gaze at the me from that day response:	And push me forward
context: Quiet.\Boo. You're such a spoilsport.\All I've ever faced since I was born... was adversity.\No matter how many come at me, no matter what happens,\I'll blast them all away!\All right! Come at me!\My dry emotions gaze at the me from that day\And push me forward response:	(I can't find a place to go)
context: Boo. You're such a spoilsport.\All I've ever faced since I was born... was adversity.\No matter how many come at me, no matter what happens,\I'll blast them all away!\All right! Come at me!\My dry emotions gaze at the me from that day\And push me forward\(I can't find a place to go) response:	Even the faintest light can still break through the darkness
context: All I've ever faced since I was born... was adversity.\No matter how many come at me, no matter what happens,\I'll blast them all away!\All right! Come at me!\My dry emotions gaze at the me from that day\And push me forward\(I can't find a place to go)\Even the faintest light can still break through the darkness response:	And change the flow of time
context: No matter how many come at me, no matter what happens,\I'll blast them all away!\All right! Come at me!\My dry emotions gaze at the me from that day\And push me forward\(I can't find a place to go)\Even the faintest light can still break through the darkness\And change the flow of time response:	(I will keep believing in you)
context: I'll blast them all away!\All right! Come at me!\My dry emotions gaze at the me from that day\And push me forward\(I can't find a place to go)\Even the faintest light can still break through the darkness\And change the flow of time\(I will keep believing in you) response:	In this ever-vivid place
context: All right! Come at me!\My dry emotions gaze at the me from that day\And push me forward\(I can't find a place to go)\Even the faintest light can still break through the darkness\And change the flow of time\(I will keep believing in you)\In this ever-vivid place response:	(Break free yourself)
context: My dry emotions gaze at the me from that day\And push me forward\(I can't find a place to go)\Even the faintest light can still break through the darkness\And change the flow of time\(I will keep believing in you)\In this ever-vivid place\(Break free yourself) response:	In order to grasp my endless dream
context: And push me forward\(I can't find a place to go)\Even the faintest light can still break through the darkness\And change the flow of time\(I will keep believing in you)\In this ever-vivid place\(Break free yourself)\In order to grasp my endless dream response:	If there is a path that I should choose
context: (I can't find a place to go)\Even the faintest light can still break through the darkness\And change the flow of time\(I will keep believing in you)\In this ever-vivid place\(Break free yourself)\In order to grasp my endless dream\If there is a path that I should choose response:	(Do you wanna try? Do you wanna try?)
context: Even the faintest light can still break through the darkness\And change the flow of time\(I will keep believing in you)\In this ever-vivid place\(Break free yourself)\In order to grasp my endless dream\If there is a path that I should choose\(Do you wanna try? Do you wanna try?) response:	Wherever it may lead us
context: And change the flow of time\(I will keep believing in you)\In this ever-vivid place\(Break free yourself)\In order to grasp my endless dream\If there is a path that I should choose\(Do you wanna try? Do you wanna try?)\Wherever it may lead us response:	Until my life comes to an end
context: (I will keep believing in you)\In this ever-vivid place\(Break free yourself)\In order to grasp my endless dream\If there is a path that I should choose\(Do you wanna try? Do you wanna try?)\Wherever it may lead us\Until my life comes to an end response:	I will accept any pain that comes my way
context: In this ever-vivid place\(Break free yourself)\In order to grasp my endless dream\If there is a path that I should choose\(Do you wanna try? Do you wanna try?)\Wherever it may lead us\Until my life comes to an end\I will accept any pain that comes my way response:	(We can try again, we can try again)
context: (Break free yourself)\In order to grasp my endless dream\If there is a path that I should choose\(Do you wanna try? Do you wanna try?)\Wherever it may lead us\Until my life comes to an end\I will accept any pain that comes my way\(We can try again, we can try again) response:	Even if we can't see tomorrow
context: In order to grasp my endless dream\If there is a path that I should choose\(Do you wanna try? Do you wanna try?)\Wherever it may lead us\Until my life comes to an end\I will accept any pain that comes my way\(We can try again, we can try again)\Even if we can't see tomorrow response:	Holding onto feelings too intense to voice
context: If there is a path that I should choose\(Do you wanna try? Do you wanna try?)\Wherever it may lead us\Until my life comes to an end\I will accept any pain that comes my way\(We can try again, we can try again)\Even if we can't see tomorrow\Holding onto feelings too intense to voice response:	I'll keep screaming them in my heart
context: (Do you wanna try? Do you wanna try?)\Wherever it may lead us\Until my life comes to an end\I will accept any pain that comes my way\(We can try again, we can try again)\Even if we can't see tomorrow\Holding onto feelings too intense to voice\I'll keep screaming them in my heart response:	Petit Clover!
context: Wherever it may lead us\Until my life comes to an end\I will accept any pain that comes my way\(We can try again, we can try again)\Even if we can't see tomorrow\Holding onto feelings too intense to voice\I'll keep screaming them in my heart\Petit Clover! response:	They Won't Find Me
context: Until my life comes to an end\I will accept any pain that comes my way\(We can try again, we can try again)\Even if we can't see tomorrow\Holding onto feelings too intense to voice\I'll keep screaming them in my heart\Petit Clover!\They Won't Find Me response:	They Won't Find Me.
context: I will accept any pain that comes my way\(We can try again, we can try again)\Even if we can't see tomorrow\Holding onto feelings too intense to voice\I'll keep screaming them in my heart\Petit Clover!\They Won't Find Me\They Won't Find Me. response:	Leopold! He's not the spatial magic user.
context: (We can try again, we can try again)\Even if we can't see tomorrow\Holding onto feelings too intense to voice\I'll keep screaming them in my heart\Petit Clover!\They Won't Find Me\They Won't Find Me.\Leopold! He's not the spatial magic user. response:	That spell pinpointed him,
context: Even if we can't see tomorrow\Holding onto feelings too intense to voice\I'll keep screaming them in my heart\Petit Clover!\They Won't Find Me\They Won't Find Me.\Leopold! He's not the spatial magic user.\That spell pinpointed him, response:	so there's no way the spellcaster could've cast it from far away.
context: Holding onto feelings too intense to voice\I'll keep screaming them in my heart\Petit Clover!\They Won't Find Me\They Won't Find Me.\Leopold! He's not the spatial magic user.\That spell pinpointed him,\so there's no way the spellcaster could've cast it from far away. response:	Where could they be?
context: I'll keep screaming them in my heart\Petit Clover!\They Won't Find Me\They Won't Find Me.\Leopold! He's not the spatial magic user.\That spell pinpointed him,\so there's no way the spellcaster could've cast it from far away.\Where could they be? response:	They won't find me.
context: Petit Clover!\They Won't Find Me\They Won't Find Me.\Leopold! He's not the spatial magic user.\That spell pinpointed him,\so there's no way the spellcaster could've cast it from far away.\Where could they be?\They won't find me. response:	I can't find him!
context: They Won't Find Me\They Won't Find Me.\Leopold! He's not the spatial magic user.\That spell pinpointed him,\so there's no way the spellcaster could've cast it from far away.\Where could they be?\They won't find me.\I can't find him! response:	Nope!
context: They Won't Find Me.\Leopold! He's not the spatial magic user.\That spell pinpointed him,\so there's no way the spellcaster could've cast it from far away.\Where could they be?\They won't find me.\I can't find him!\Nope! response:	I'll kill you.
context: Leopold! He's not the spatial magic user.\That spell pinpointed him,\so there's no way the spellcaster could've cast it from far away.\Where could they be?\They won't find me.\I can't find him!\Nope!\I'll kill you. response:	Nowhere to be found!
context: That spell pinpointed him,\so there's no way the spellcaster could've cast it from far away.\Where could they be?\They won't find me.\I can't find him!\Nope!\I'll kill you.\Nowhere to be found! response:	It's about time...
context: so there's no way the spellcaster could've cast it from far away.\Where could they be?\They won't find me.\I can't find him!\Nope!\I'll kill you.\Nowhere to be found!\It's about time... response:	I'll make my grand entrance and surprise them!
context: Where could they be?\They won't find me.\I can't find him!\Nope!\I'll kill you.\Nowhere to be found!\It's about time...\I'll make my grand entrance and surprise them! response:	I'm pretty sure they're not here. Let's go look over there.
context: They won't find me.\I can't find him!\Nope!\I'll kill you.\Nowhere to be found!\It's about time...\I'll make my grand entrance and surprise them!\I'm pretty sure they're not here. Let's go look over there. response:	Yeah.
context: I can't find him!\Nope!\I'll kill you.\Nowhere to be found!\It's about time...\I'll make my grand entrance and surprise them!\I'm pretty sure they're not here. Let's go look over there.\Yeah. response:	Let's see who can find them first!
context: Nope!\I'll kill you.\Nowhere to be found!\It's about time...\I'll make my grand entrance and surprise them!\I'm pretty sure they're not here. Let's go look over there.\Yeah.\Let's see who can find them first! response:	What?
context: I'll kill you.\Nowhere to be found!\It's about time...\I'll make my grand entrance and surprise them!\I'm pretty sure they're not here. Let's go look over there.\Yeah.\Let's see who can find them first!\What? response:	What...?
context: Nowhere to be found!\It's about time...\I'll make my grand entrance and surprise them!\I'm pretty sure they're not here. Let's go look over there.\Yeah.\Let's see who can find them first!\What?\What...? response:	Magic Knights, eat my cooking and fight!
context: It's about time...\I'll make my grand entrance and surprise them!\I'm pretty sure they're not here. Let's go look over there.\Yeah.\Let's see who can find them first!\What?\What...?\Magic Knights, eat my cooking and fight! response:	I'm going to fight my battle in the kitchen!
context: I'll make my grand entrance and surprise them!\I'm pretty sure they're not here. Let's go look over there.\Yeah.\Let's see who can find them first!\What?\What...?\Magic Knights, eat my cooking and fight!\I'm going to fight my battle in the kitchen! response:	Black Clover, Page 26: Wounded Beasts.
context: I'm pretty sure they're not here. Let's go look over there.\Yeah.\Let's see who can find them first!\What?\What...?\Magic Knights, eat my cooking and fight!\I'm going to fight my battle in the kitchen!\Black Clover, Page 26: Wounded Beasts. response:	Page 26 Wounded Beasts
context: Yeah.\Let's see who can find them first!\What?\What...?\Magic Knights, eat my cooking and fight!\I'm going to fight my battle in the kitchen!\Black Clover, Page 26: Wounded Beasts.\Page 26 Wounded Beasts response:	Cooking food with magic is my job!