context: And it's been really dry lately, right? response:	So Yumiko brought this little humidifier to school,
context: And it's been really dry lately, right?\So Yumiko brought this little humidifier to school, response:	and it was spitting out a ton of steam all through class!
context: And it's been really dry lately, right?\So Yumiko brought this little humidifier to school,\and it was spitting out a ton of steam all through class! response:	You know, those new ones powered by... USJ? USA? That kind!
context: And it's been really dry lately, right?\So Yumiko brought this little humidifier to school,\and it was spitting out a ton of steam all through class!\You know, those new ones powered by... USJ? USA? That kind! response:	That slight smile hasn't changed since that day.
context: And it's been really dry lately, right?\So Yumiko brought this little humidifier to school,\and it was spitting out a ton of steam all through class!\You know, those new ones powered by... USJ? USA? That kind!\That slight smile hasn't changed since that day. response:	Our days haven't changed.
context: And it's been really dry lately, right?\So Yumiko brought this little humidifier to school,\and it was spitting out a ton of steam all through class!\You know, those new ones powered by... USJ? USA? That kind!\That slight smile hasn't changed since that day.\Our days haven't changed. response:	I'd love to have one of those in my room.
context: And it's been really dry lately, right?\So Yumiko brought this little humidifier to school,\and it was spitting out a ton of steam all through class!\You know, those new ones powered by... USJ? USA? That kind!\That slight smile hasn't changed since that day.\Our days haven't changed.\I'd love to have one of those in my room. response:	Right, Hikki?
context: And it's been really dry lately, right?\So Yumiko brought this little humidifier to school,\and it was spitting out a ton of steam all through class!\You know, those new ones powered by... USJ? USA? That kind!\That slight smile hasn't changed since that day.\Our days haven't changed.\I'd love to have one of those in my room.\Right, Hikki? response:	Days spent just trying not to run away...
context: So Yumiko brought this little humidifier to school,\and it was spitting out a ton of steam all through class!\You know, those new ones powered by... USJ? USA? That kind!\That slight smile hasn't changed since that day.\Our days haven't changed.\I'd love to have one of those in my room.\Right, Hikki?\Days spent just trying not to run away... response:	Earth to Hikki!
context: and it was spitting out a ton of steam all through class!\You know, those new ones powered by... USJ? USA? That kind!\That slight smile hasn't changed since that day.\Our days haven't changed.\I'd love to have one of those in my room.\Right, Hikki?\Days spent just trying not to run away...\Earth to Hikki! response:	I'm listening. And it's USB.
context: You know, those new ones powered by... USJ? USA? That kind!\That slight smile hasn't changed since that day.\Our days haven't changed.\I'd love to have one of those in my room.\Right, Hikki?\Days spent just trying not to run away...\Earth to Hikki!\I'm listening. And it's USB. response:	Why should humidifiers have to get their power from America?
context: That slight smile hasn't changed since that day.\Our days haven't changed.\I'd love to have one of those in my room.\Right, Hikki?\Days spent just trying not to run away...\Earth to Hikki!\I'm listening. And it's USB.\Why should humidifiers have to get their power from America? response:	Yeah, that's it! USB!
context: Our days haven't changed.\I'd love to have one of those in my room.\Right, Hikki?\Days spent just trying not to run away...\Earth to Hikki!\I'm listening. And it's USB.\Why should humidifiers have to get their power from America?\Yeah, that's it! USB! response:	Cell phones these days can be charged with that USB thing, too.
context: I'd love to have one of those in my room.\Right, Hikki?\Days spent just trying not to run away...\Earth to Hikki!\I'm listening. And it's USB.\Why should humidifiers have to get their power from America?\Yeah, that's it! USB!\Cell phones these days can be charged with that USB thing, too. response:	Anyway, what should we do for Christmas?
context: Right, Hikki?\Days spent just trying not to run away...\Earth to Hikki!\I'm listening. And it's USB.\Why should humidifiers have to get their power from America?\Yeah, that's it! USB!\Cell phones these days can be charged with that USB thing, too.\Anyway, what should we do for Christmas? response:	I'll be busy getting ready for the new year.
context: Days spent just trying not to run away...\Earth to Hikki!\I'm listening. And it's USB.\Why should humidifiers have to get their power from America?\Yeah, that's it! USB!\Cell phones these days can be charged with that USB thing, too.\Anyway, what should we do for Christmas?\I'll be busy getting ready for the new year. response:	To keep from making the things we've lost into excuses,
context: Earth to Hikki!\I'm listening. And it's USB.\Why should humidifiers have to get their power from America?\Yeah, that's it! USB!\Cell phones these days can be charged with that USB thing, too.\Anyway, what should we do for Christmas?\I'll be busy getting ready for the new year.\To keep from making the things we've lost into excuses, response:	Yeah, but...
context: I'm listening. And it's USB.\Why should humidifiers have to get their power from America?\Yeah, that's it! USB!\Cell phones these days can be charged with that USB thing, too.\Anyway, what should we do for Christmas?\I'll be busy getting ready for the new year.\To keep from making the things we've lost into excuses,\Yeah, but... response:	we steel ourselves more than usual,
context: Why should humidifiers have to get their power from America?\Yeah, that's it! USB!\Cell phones these days can be charged with that USB thing, too.\Anyway, what should we do for Christmas?\I'll be busy getting ready for the new year.\To keep from making the things we've lost into excuses,\Yeah, but...\we steel ourselves more than usual, response:	trying harder than usual to act the same as usual.
context: Yeah, that's it! USB!\Cell phones these days can be charged with that USB thing, too.\Anyway, what should we do for Christmas?\I'll be busy getting ready for the new year.\To keep from making the things we've lost into excuses,\Yeah, but...\we steel ourselves more than usual,\trying harder than usual to act the same as usual. response:	Christmas, huh? I know about Ebina, but...
context: Cell phones these days can be charged with that USB thing, too.\Anyway, what should we do for Christmas?\I'll be busy getting ready for the new year.\To keep from making the things we've lost into excuses,\Yeah, but...\we steel ourselves more than usual,\trying harder than usual to act the same as usual.\Christmas, huh? I know about Ebina, but... response:	What about you guys?
context: Anyway, what should we do for Christmas?\I'll be busy getting ready for the new year.\To keep from making the things we've lost into excuses,\Yeah, but...\we steel ourselves more than usual,\trying harder than usual to act the same as usual.\Christmas, huh? I know about Ebina, but...\What about you guys? response:	I'll have to pass, too.
context: I'll be busy getting ready for the new year.\To keep from making the things we've lost into excuses,\Yeah, but...\we steel ourselves more than usual,\trying harder than usual to act the same as usual.\Christmas, huh? I know about Ebina, but...\What about you guys?\I'll have to pass, too. response:	H-Hayato...
context: To keep from making the things we've lost into excuses,\Yeah, but...\we steel ourselves more than usual,\trying harder than usual to act the same as usual.\Christmas, huh? I know about Ebina, but...\What about you guys?\I'll have to pass, too.\H-Hayato... response:	You have plans or something?
context: Yeah, but...\we steel ourselves more than usual,\trying harder than usual to act the same as usual.\Christmas, huh? I know about Ebina, but...\What about you guys?\I'll have to pass, too.\H-Hayato...\You have plans or something? response:	Huh...
context: we steel ourselves more than usual,\trying harder than usual to act the same as usual.\Christmas, huh? I know about Ebina, but...\What about you guys?\I'll have to pass, too.\H-Hayato...\You have plans or something?\Huh... response:	Hikki...
context: trying harder than usual to act the same as usual.\Christmas, huh? I know about Ebina, but...\What about you guys?\I'll have to pass, too.\H-Hayato...\You have plans or something?\Huh...\Hikki... response:	You're looking at us too much.
context: Christmas, huh? I know about Ebina, but...\What about you guys?\I'll have to pass, too.\H-Hayato...\You have plans or something?\Huh...\Hikki...\You're looking at us too much. response:	My Teen Romantic Comedy SNAFU TOO!
context: What about you guys?\I'll have to pass, too.\H-Hayato...\You have plans or something?\Huh...\Hikki...\You're looking at us too much.\My Teen Romantic Comedy SNAFU TOO! response:	Huh? Er, I wasn't really looking...
context: I'll have to pass, too.\H-Hayato...\You have plans or something?\Huh...\Hikki...\You're looking at us too much.\My Teen Romantic Comedy SNAFU TOO!\Huh? Er, I wasn't really looking... response:	No, you were totally looking.
context: H-Hayato...\You have plans or something?\Huh...\Hikki...\You're looking at us too much.\My Teen Romantic Comedy SNAFU TOO!\Huh? Er, I wasn't really looking...\No, you were totally looking. response:	I was kinda freaked out, honestly.
context: You have plans or something?\Huh...\Hikki...\You're looking at us too much.\My Teen Romantic Comedy SNAFU TOO!\Huh? Er, I wasn't really looking...\No, you were totally looking.\I was kinda freaked out, honestly. response:	You're the one who should stop looking at me.
context: Huh...\Hikki...\You're looking at us too much.\My Teen Romantic Comedy SNAFU TOO!\Huh? Er, I wasn't really looking...\No, you were totally looking.\I was kinda freaked out, honestly.\You're the one who should stop looking at me. response:	Huh?! Oh, that was...
context: Hikki...\You're looking at us too much.\My Teen Romantic Comedy SNAFU TOO!\Huh? Er, I wasn't really looking...\No, you were totally looking.\I was kinda freaked out, honestly.\You're the one who should stop looking at me.\Huh?! Oh, that was... response:	I just sensed something, that's all.
context: You're looking at us too much.\My Teen Romantic Comedy SNAFU TOO!\Huh? Er, I wasn't really looking...\No, you were totally looking.\I was kinda freaked out, honestly.\You're the one who should stop looking at me.\Huh?! Oh, that was...\I just sensed something, that's all. response:	Some kind of pressure, or chill...
context: My Teen Romantic Comedy SNAFU TOO!\Huh? Er, I wasn't really looking...\No, you were totally looking.\I was kinda freaked out, honestly.\You're the one who should stop looking at me.\Huh?! Oh, that was...\I just sensed something, that's all.\Some kind of pressure, or chill... response:	Those two don't feel anything alike.
context: Huh? Er, I wasn't really looking...\No, you were totally looking.\I was kinda freaked out, honestly.\You're the one who should stop looking at me.\Huh?! Oh, that was...\I just sensed something, that's all.\Some kind of pressure, or chill...\Those two don't feel anything alike. response:	Is that what you meant?
context: No, you were totally looking.\I was kinda freaked out, honestly.\You're the one who should stop looking at me.\Huh?! Oh, that was...\I just sensed something, that's all.\Some kind of pressure, or chill...\Those two don't feel anything alike.\Is that what you meant? response:	Anyway, did you need something?
context: I was kinda freaked out, honestly.\You're the one who should stop looking at me.\Huh?! Oh, that was...\I just sensed something, that's all.\Some kind of pressure, or chill...\Those two don't feel anything alike.\Is that what you meant?\Anyway, did you need something? response:	No, it's just...
context: You're the one who should stop looking at me.\Huh?! Oh, that was...\I just sensed something, that's all.\Some kind of pressure, or chill...\Those two don't feel anything alike.\Is that what you meant?\Anyway, did you need something?\No, it's just... response:	you guys were drawing attention to yourselves.
context: Huh?! Oh, that was...\I just sensed something, that's all.\Some kind of pressure, or chill...\Those two don't feel anything alike.\Is that what you meant?\Anyway, did you need something?\No, it's just...\you guys were drawing attention to yourselves. response:	Just then, somewhere inside, something hit me.
context: I just sensed something, that's all.\Some kind of pressure, or chill...\Those two don't feel anything alike.\Is that what you meant?\Anyway, did you need something?\No, it's just...\you guys were drawing attention to yourselves.\Just then, somewhere inside, something hit me. response:	Why was I watching them?
context: Some kind of pressure, or chill...\Those two don't feel anything alike.\Is that what you meant?\Anyway, did you need something?\No, it's just...\you guys were drawing attention to yourselves.\Just then, somewhere inside, something hit me.\Why was I watching them? response:	Morning!
context: Those two don't feel anything alike.\Is that what you meant?\Anyway, did you need something?\No, it's just...\you guys were drawing attention to yourselves.\Just then, somewhere inside, something hit me.\Why was I watching them?\Morning! response:	Morning, Sai-chan!
context: Is that what you meant?\Anyway, did you need something?\No, it's just...\you guys were drawing attention to yourselves.\Just then, somewhere inside, something hit me.\Why was I watching them?\Morning!\Morning, Sai-chan! response:	Morning.
context: Anyway, did you need something?\No, it's just...\you guys were drawing attention to yourselves.\Just then, somewhere inside, something hit me.\Why was I watching them?\Morning!\Morning, Sai-chan!\Morning. response:	Something wrong?
context: No, it's just...\you guys were drawing attention to yourselves.\Just then, somewhere inside, something hit me.\Why was I watching them?\Morning!\Morning, Sai-chan!\Morning.\Something wrong? response:	I just thought it was unusual to see you two talking in the classroom.
context: you guys were drawing attention to yourselves.\Just then, somewhere inside, something hit me.\Why was I watching them?\Morning!\Morning, Sai-chan!\Morning.\Something wrong?\I just thought it was unusual to see you two talking in the classroom. response:	Y-You think so?
context: Just then, somewhere inside, something hit me.\Why was I watching them?\Morning!\Morning, Sai-chan!\Morning.\Something wrong?\I just thought it was unusual to see you two talking in the classroom.\Y-You think so? response:	Did something happen?
context: Why was I watching them?\Morning!\Morning, Sai-chan!\Morning.\Something wrong?\I just thought it was unusual to see you two talking in the classroom.\Y-You think so?\Did something happen? response:	No, nothing!
context: Morning!\Morning, Sai-chan!\Morning.\Something wrong?\I just thought it was unusual to see you two talking in the classroom.\Y-You think so?\Did something happen?\No, nothing! response:	Well, we were kind of talking about club stuff, I guess...
context: Morning, Sai-chan!\Morning.\Something wrong?\I just thought it was unusual to see you two talking in the classroom.\Y-You think so?\Did something happen?\No, nothing!\Well, we were kind of talking about club stuff, I guess... response:	Oh, your club, huh?
context: Morning.\Something wrong?\I just thought it was unusual to see you two talking in the classroom.\Y-You think so?\Did something happen?\No, nothing!\Well, we were kind of talking about club stuff, I guess...\Oh, your club, huh? response:	Well, if you guys are back to doing club work like before, that's good.
context: Something wrong?\I just thought it was unusual to see you two talking in the classroom.\Y-You think so?\Did something happen?\No, nothing!\Well, we were kind of talking about club stuff, I guess...\Oh, your club, huh?\Well, if you guys are back to doing club work like before, that's good. response:	Y-Yeah...
context: I just thought it was unusual to see you two talking in the classroom.\Y-You think so?\Did something happen?\No, nothing!\Well, we were kind of talking about club stuff, I guess...\Oh, your club, huh?\Well, if you guys are back to doing club work like before, that's good.\Y-Yeah... response:	Oh, hey, you can come to us if you ever need help again.
context: Y-You think so?\Did something happen?\No, nothing!\Well, we were kind of talking about club stuff, I guess...\Oh, your club, huh?\Well, if you guys are back to doing club work like before, that's good.\Y-Yeah...\Oh, hey, you can come to us if you ever need help again. response:	Nah, you know what?
context: Did something happen?\No, nothing!\Well, we were kind of talking about club stuff, I guess...\Oh, your club, huh?\Well, if you guys are back to doing club work like before, that's good.\Y-Yeah...\Oh, hey, you can come to us if you ever need help again.\Nah, you know what? response:	You can come, even if you don't need anything.
context: No, nothing!\Well, we were kind of talking about club stuff, I guess...\Oh, your club, huh?\Well, if you guys are back to doing club work like before, that's good.\Y-Yeah...\Oh, hey, you can come to us if you ever need help again.\Nah, you know what?\You can come, even if you don't need anything. response:	You're motivated for once!
context: Well, we were kind of talking about club stuff, I guess...\Oh, your club, huh?\Well, if you guys are back to doing club work like before, that's good.\Y-Yeah...\Oh, hey, you can come to us if you ever need help again.\Nah, you know what?\You can come, even if you don't need anything.\You're motivated for once! response:	Well, later.
context: Oh, your club, huh?\Well, if you guys are back to doing club work like before, that's good.\Y-Yeah...\Oh, hey, you can come to us if you ever need help again.\Nah, you know what?\You can come, even if you don't need anything.\You're motivated for once!\Well, later. response:	By the way, Hikki...
context: Well, if you guys are back to doing club work like before, that's good.\Y-Yeah...\Oh, hey, you can come to us if you ever need help again.\Nah, you know what?\You can come, even if you don't need anything.\You're motivated for once!\Well, later.\By the way, Hikki... response:	Let's go to club together.
context: Y-Yeah...\Oh, hey, you can come to us if you ever need help again.\Nah, you know what?\You can come, even if you don't need anything.\You're motivated for once!\Well, later.\By the way, Hikki...\Let's go to club together. response:	See ya!
context: Oh, hey, you can come to us if you ever need help again.\Nah, you know what?\You can come, even if you don't need anything.\You're motivated for once!\Well, later.\By the way, Hikki...\Let's go to club together.\See ya! response:	Yep.
context: Nah, you know what?\You can come, even if you don't need anything.\You're motivated for once!\Well, later.\By the way, Hikki...\Let's go to club together.\See ya!\Yep. response:	Why'd you leave first?
context: You can come, even if you don't need anything.\You're motivated for once!\Well, later.\By the way, Hikki...\Let's go to club together.\See ya!\Yep.\Why'd you leave first? response:	I didn't. I'm waiting here.
context: You're motivated for once!\Well, later.\By the way, Hikki...\Let's go to club together.\See ya!\Yep.\Why'd you leave first?\I didn't. I'm waiting here. response:	Yeah, but...
context: Well, later.\By the way, Hikki...\Let's go to club together.\See ya!\Yep.\Why'd you leave first?\I didn't. I'm waiting here.\Yeah, but... response:	Wait, so you don't mind?
context: By the way, Hikki...\Let's go to club together.\See ya!\Yep.\Why'd you leave first?\I didn't. I'm waiting here.\Yeah, but...\Wait, so you don't mind? response:	Let's go.
context: Let's go to club together.\See ya!\Yep.\Why'd you leave first?\I didn't. I'm waiting here.\Yeah, but...\Wait, so you don't mind?\Let's go. response:	By the way, what do you do at lunch?
context: See ya!\Yep.\Why'd you leave first?\I didn't. I'm waiting here.\Yeah, but...\Wait, so you don't mind?\Let's go.\By the way, what do you do at lunch? response:	Huh? Oh... Same as always.
context: Yep.\Why'd you leave first?\I didn't. I'm waiting here.\Yeah, but...\Wait, so you don't mind?\Let's go.\By the way, what do you do at lunch?\Huh? Oh... Same as always. response:	I see.
context: Why'd you leave first?\I didn't. I'm waiting here.\Yeah, but...\Wait, so you don't mind?\Let's go.\By the way, what do you do at lunch?\Huh? Oh... Same as always.\I see. response:	Hey...
context: I didn't. I'm waiting here.\Yeah, but...\Wait, so you don't mind?\Let's go.\By the way, what do you do at lunch?\Huh? Oh... Same as always.\I see.\Hey... response:	Never mind.
context: Yeah, but...\Wait, so you don't mind?\Let's go.\By the way, what do you do at lunch?\Huh? Oh... Same as always.\I see.\Hey...\Never mind. response:	I see.
context: Wait, so you don't mind?\Let's go.\By the way, what do you do at lunch?\Huh? Oh... Same as always.\I see.\Hey...\Never mind.\I see. response:	Yahello, Yukinon!
context: Let's go.\By the way, what do you do at lunch?\Huh? Oh... Same as always.\I see.\Hey...\Never mind.\I see.\Yahello, Yukinon! response:	And he said it's unusual for me and Hikki to talk in the classroom.
context: By the way, what do you do at lunch?\Huh? Oh... Same as always.\I see.\Hey...\Never mind.\I see.\Yahello, Yukinon!\And he said it's unusual for me and Hikki to talk in the classroom. response:	How long will this continue?
context: Huh? Oh... Same as always.\I see.\Hey...\Never mind.\I see.\Yahello, Yukinon!\And he said it's unusual for me and Hikki to talk in the classroom.\How long will this continue? response:	Did he? I suppose it might be unusual.
context: I see.\Hey...\Never mind.\I see.\Yahello, Yukinon!\And he said it's unusual for me and Hikki to talk in the classroom.\How long will this continue?\Did he? I suppose it might be unusual. response:	How long will we be able to keep this up?
context: Hey...\Never mind.\I see.\Yahello, Yukinon!\And he said it's unusual for me and Hikki to talk in the classroom.\How long will this continue?\Did he? I suppose it might be unusual.\How long will we be able to keep this up? response:	Not really. Right, Hikki?
context: Never mind.\I see.\Yahello, Yukinon!\And he said it's unusual for me and Hikki to talk in the classroom.\How long will this continue?\Did he? I suppose it might be unusual.\How long will we be able to keep this up?\Not really. Right, Hikki? response:	What will happen when we can't keep it up anymore?
context: I see.\Yahello, Yukinon!\And he said it's unusual for me and Hikki to talk in the classroom.\How long will this continue?\Did he? I suppose it might be unusual.\How long will we be able to keep this up?\Not really. Right, Hikki?\What will happen when we can't keep it up anymore? response:	No, that was probably the first time we talked that much.
context: Yahello, Yukinon!\And he said it's unusual for me and Hikki to talk in the classroom.\How long will this continue?\Did he? I suppose it might be unusual.\How long will we be able to keep this up?\Not really. Right, Hikki?\What will happen when we can't keep it up anymore?\No, that was probably the first time we talked that much. response:	It kinda tired me out.
context: And he said it's unusual for me and Hikki to talk in the classroom.\How long will this continue?\Did he? I suppose it might be unusual.\How long will we be able to keep this up?\Not really. Right, Hikki?\What will happen when we can't keep it up anymore?\No, that was probably the first time we talked that much.\It kinda tired me out. response:	It tired you out?!
context: How long will this continue?\Did he? I suppose it might be unusual.\How long will we be able to keep this up?\Not really. Right, Hikki?\What will happen when we can't keep it up anymore?\No, that was probably the first time we talked that much.\It kinda tired me out.\It tired you out?! response:	I was probably watching Hayama and his buddies
context: Did he? I suppose it might be unusual.\How long will we be able to keep this up?\Not really. Right, Hikki?\What will happen when we can't keep it up anymore?\No, that was probably the first time we talked that much.\It kinda tired me out.\It tired you out?!\I was probably watching Hayama and his buddies response:	because I felt like they'd teach me
context: How long will we be able to keep this up?\Not really. Right, Hikki?\What will happen when we can't keep it up anymore?\No, that was probably the first time we talked that much.\It kinda tired me out.\It tired you out?!\I was probably watching Hayama and his buddies\because I felt like they'd teach me response:	how to mend something that's fallen apart.
context: Not really. Right, Hikki?\What will happen when we can't keep it up anymore?\No, that was probably the first time we talked that much.\It kinda tired me out.\It tired you out?!\I was probably watching Hayama and his buddies\because I felt like they'd teach me\how to mend something that's fallen apart. response:	Come in.
context: What will happen when we can't keep it up anymore?\No, that was probably the first time we talked that much.\It kinda tired me out.\It tired you out?!\I was probably watching Hayama and his buddies\because I felt like they'd teach me\how to mend something that's fallen apart.\Come in. response:	Senpai!
context: No, that was probably the first time we talked that much.\It kinda tired me out.\It tired you out?!\I was probably watching Hayama and his buddies\because I felt like they'd teach me\how to mend something that's fallen apart.\Come in.\Senpai! response:	I'm in trouble!
context: It kinda tired me out.\It tired you out?!\I was probably watching Hayama and his buddies\because I felt like they'd teach me\how to mend something that's fallen apart.\Come in.\Senpai!\I'm in trouble! response:	I'm in trouble! I'm in trouble!
context: It tired you out?!\I was probably watching Hayama and his buddies\because I felt like they'd teach me\how to mend something that's fallen apart.\Come in.\Senpai!\I'm in trouble!\I'm in trouble! I'm in trouble! response:	I'm in serious trouble!
context: I was probably watching Hayama and his buddies\because I felt like they'd teach me\how to mend something that's fallen apart.\Come in.\Senpai!\I'm in trouble!\I'm in trouble! I'm in trouble!\I'm in serious trouble! response:	A Christmas event?
context: because I felt like they'd teach me\how to mend something that's fallen apart.\Come in.\Senpai!\I'm in trouble!\I'm in trouble! I'm in trouble!\I'm in serious trouble!\A Christmas event? response:	Yeah.
context: how to mend something that's fallen apart.\Come in.\Senpai!\I'm in trouble!\I'm in trouble! I'm in trouble!\I'm in serious trouble!\A Christmas event?\Yeah. response:	So that's your first student council job...
context: Come in.\Senpai!\I'm in trouble!\I'm in trouble! I'm in trouble!\I'm in serious trouble!\A Christmas event?\Yeah.\So that's your first student council job... response:	It's a joint thing with Kaihin General High School,
context: Senpai!\I'm in trouble!\I'm in trouble! I'm in trouble!\I'm in serious trouble!\A Christmas event?\Yeah.\So that's your first student council job...\It's a joint thing with Kaihin General High School, response:	and I guess we're supposed to entertain old folks and preschool kids.
context: I'm in trouble!\I'm in trouble! I'm in trouble!\I'm in serious trouble!\A Christmas event?\Yeah.\So that's your first student council job...\It's a joint thing with Kaihin General High School,\and I guess we're supposed to entertain old folks and preschool kids. response:	Who came up with that idea?
context: I'm in trouble! I'm in trouble!\I'm in serious trouble!\A Christmas event?\Yeah.\So that's your first student council job...\It's a joint thing with Kaihin General High School,\and I guess we're supposed to entertain old folks and preschool kids.\Who came up with that idea? response:	It was the other school!
context: I'm in serious trouble!\A Christmas event?\Yeah.\So that's your first student council job...\It's a joint thing with Kaihin General High School,\and I guess we're supposed to entertain old folks and preschool kids.\Who came up with that idea?\It was the other school! response:	As if I'd ever suggest something like that!
context: A Christmas event?\Yeah.\So that's your first student council job...\It's a joint thing with Kaihin General High School,\and I guess we're supposed to entertain old folks and preschool kids.\Who came up with that idea?\It was the other school!\As if I'd ever suggest something like that! response:	I figured.
context: Yeah.\So that's your first student council job...\It's a joint thing with Kaihin General High School,\and I guess we're supposed to entertain old folks and preschool kids.\Who came up with that idea?\It was the other school!\As if I'd ever suggest something like that!\I figured. response:	So of course, I'd normally turn them down, you know?
context: So that's your first student council job...\It's a joint thing with Kaihin General High School,\and I guess we're supposed to entertain old folks and preschool kids.\Who came up with that idea?\It was the other school!\As if I'd ever suggest something like that!\I figured.\So of course, I'd normally turn them down, you know? response:	I have plans for Christmas, anyway.
context: It's a joint thing with Kaihin General High School,\and I guess we're supposed to entertain old folks and preschool kids.\Who came up with that idea?\It was the other school!\As if I'd ever suggest something like that!\I figured.\So of course, I'd normally turn them down, you know?\I have plans for Christmas, anyway. response:	You'd turn them down?
context: and I guess we're supposed to entertain old folks and preschool kids.\Who came up with that idea?\It was the other school!\As if I'd ever suggest something like that!\I figured.\So of course, I'd normally turn them down, you know?\I have plans for Christmas, anyway.\You'd turn them down? response:	You're handling your freedom too personally.
context: Who came up with that idea?\It was the other school!\As if I'd ever suggest something like that!\I figured.\So of course, I'd normally turn them down, you know?\I have plans for Christmas, anyway.\You'd turn them down?\You're handling your freedom too personally. response:	But Hiratsuka-sensei is telling us to do it.
context: It was the other school!\As if I'd ever suggest something like that!\I figured.\So of course, I'd normally turn them down, you know?\I have plans for Christmas, anyway.\You'd turn them down?\You're handling your freedom too personally.\But Hiratsuka-sensei is telling us to do it. response:	I should've known she had a hand in this...
context: As if I'd ever suggest something like that!\I figured.\So of course, I'd normally turn them down, you know?\I have plans for Christmas, anyway.\You'd turn them down?\You're handling your freedom too personally.\But Hiratsuka-sensei is telling us to do it.\I should've known she had a hand in this... response:	So I got started with things, but it's just not coming together.
context: I figured.\So of course, I'd normally turn them down, you know?\I have plans for Christmas, anyway.\You'd turn them down?\You're handling your freedom too personally.\But Hiratsuka-sensei is telling us to do it.\I should've known she had a hand in this...\So I got started with things, but it's just not coming together. response:	That's how it goes when you deal with other schools.
context: So of course, I'd normally turn them down, you know?\I have plans for Christmas, anyway.\You'd turn them down?\You're handling your freedom too personally.\But Hiratsuka-sensei is telling us to do it.\I should've known she had a hand in this...\So I got started with things, but it's just not coming together.\That's how it goes when you deal with other schools. response:	Don't feel bad.
context: I have plans for Christmas, anyway.\You'd turn them down?\You're handling your freedom too personally.\But Hiratsuka-sensei is telling us to do it.\I should've known she had a hand in this...\So I got started with things, but it's just not coming together.\That's how it goes when you deal with other schools.\Don't feel bad. response:	Actually, you should've talked to Shiromeguri-senpai before coming here.
context: You'd turn them down?\You're handling your freedom too personally.\But Hiratsuka-sensei is telling us to do it.\I should've known she had a hand in this...\So I got started with things, but it's just not coming together.\That's how it goes when you deal with other schools.\Don't feel bad.\Actually, you should've talked to Shiromeguri-senpai before coming here. response:	Oh... w-well... I mean, uh...
context: You're handling your freedom too personally.\But Hiratsuka-sensei is telling us to do it.\I should've known she had a hand in this...\So I got started with things, but it's just not coming together.\That's how it goes when you deal with other schools.\Don't feel bad.\Actually, you should've talked to Shiromeguri-senpai before coming here.\Oh... w-well... I mean, uh... response:	Oh, yeah!
context: But Hiratsuka-sensei is telling us to do it.\I should've known she had a hand in this...\So I got started with things, but it's just not coming together.\That's how it goes when you deal with other schools.\Don't feel bad.\Actually, you should've talked to Shiromeguri-senpai before coming here.\Oh... w-well... I mean, uh...\Oh, yeah! response:	I can't bother her when she's studying for entrance exams, right?
context: I should've known she had a hand in this...\So I got started with things, but it's just not coming together.\That's how it goes when you deal with other schools.\Don't feel bad.\Actually, you should've talked to Shiromeguri-senpai before coming here.\Oh... w-well... I mean, uh...\Oh, yeah!\I can't bother her when she's studying for entrance exams, right? response:	Um, you just don't like Meguri-senpai, right?
context: So I got started with things, but it's just not coming together.\That's how it goes when you deal with other schools.\Don't feel bad.\Actually, you should've talked to Shiromeguri-senpai before coming here.\Oh... w-well... I mean, uh...\Oh, yeah!\I can't bother her when she's studying for entrance exams, right?\Um, you just don't like Meguri-senpai, right? response:	You're the only ones I can turn to!
context: That's how it goes when you deal with other schools.\Don't feel bad.\Actually, you should've talked to Shiromeguri-senpai before coming here.\Oh... w-well... I mean, uh...\Oh, yeah!\I can't bother her when she's studying for entrance exams, right?\Um, you just don't like Meguri-senpai, right?\You're the only ones I can turn to! response:	Okay... I have an idea of what's going on, but...
context: Don't feel bad.\Actually, you should've talked to Shiromeguri-senpai before coming here.\Oh... w-well... I mean, uh...\Oh, yeah!\I can't bother her when she's studying for entrance exams, right?\Um, you just don't like Meguri-senpai, right?\You're the only ones I can turn to!\Okay... I have an idea of what's going on, but... response:	What do you think?
context: Actually, you should've talked to Shiromeguri-senpai before coming here.\Oh... w-well... I mean, uh...\Oh, yeah!\I can't bother her when she's studying for entrance exams, right?\Um, you just don't like Meguri-senpai, right?\You're the only ones I can turn to!\Okay... I have an idea of what's going on, but...\What do you think? response:	Sounds good! Let's do it!
context: Oh... w-well... I mean, uh...\Oh, yeah!\I can't bother her when she's studying for entrance exams, right?\Um, you just don't like Meguri-senpai, right?\You're the only ones I can turn to!\Okay... I have an idea of what's going on, but...\What do you think?\Sounds good! Let's do it! response:	It's been a while since anyone's asked for our help, you know?
context: Oh, yeah!\I can't bother her when she's studying for entrance exams, right?\Um, you just don't like Meguri-senpai, right?\You're the only ones I can turn to!\Okay... I have an idea of what's going on, but...\What do you think?\Sounds good! Let's do it!\It's been a while since anyone's asked for our help, you know? response:	We haven't done anything like this lately.
context: I can't bother her when she's studying for entrance exams, right?\Um, you just don't like Meguri-senpai, right?\You're the only ones I can turn to!\Okay... I have an idea of what's going on, but...\What do you think?\Sounds good! Let's do it!\It's been a while since anyone's asked for our help, you know?\We haven't done anything like this lately. response:	So, just like before...
context: Um, you just don't like Meguri-senpai, right?\You're the only ones I can turn to!\Okay... I have an idea of what's going on, but...\What do you think?\Sounds good! Let's do it!\It's been a while since anyone's asked for our help, you know?\We haven't done anything like this lately.\So, just like before... response:	I mean... it couldn't hurt to try... I think...
context: You're the only ones I can turn to!\Okay... I have an idea of what's going on, but...\What do you think?\Sounds good! Let's do it!\It's been a while since anyone's asked for our help, you know?\We haven't done anything like this lately.\So, just like before...\I mean... it couldn't hurt to try... I think... response:	Really?
context: Okay... I have an idea of what's going on, but...\What do you think?\Sounds good! Let's do it!\It's been a while since anyone's asked for our help, you know?\We haven't done anything like this lately.\So, just like before...\I mean... it couldn't hurt to try... I think...\Really? response:	I think it's fine, then.
context: What do you think?\Sounds good! Let's do it!\It's been a while since anyone's asked for our help, you know?\We haven't done anything like this lately.\So, just like before...\I mean... it couldn't hurt to try... I think...\Really?\I think it's fine, then. response:	No, I don't think we should mess with this.
context: Sounds good! Let's do it!\It's been a while since anyone's asked for our help, you know?\We haven't done anything like this lately.\So, just like before...\I mean... it couldn't hurt to try... I think...\Really?\I think it's fine, then.\No, I don't think we should mess with this. response:	It's the student council's problem.
context: It's been a while since anyone's asked for our help, you know?\We haven't done anything like this lately.\So, just like before...\I mean... it couldn't hurt to try... I think...\Really?\I think it's fine, then.\No, I don't think we should mess with this.\It's the student council's problem. response:	Plus, I don't think it's a good thing to rely on other people right
context: We haven't done anything like this lately.\So, just like before...\I mean... it couldn't hurt to try... I think...\Really?\I think it's fine, then.\No, I don't think we should mess with this.\It's the student council's problem.\Plus, I don't think it's a good thing to rely on other people right response:	after you take over as president.
context: So, just like before...\I mean... it couldn't hurt to try... I think...\Really?\I think it's fine, then.\No, I don't think we should mess with this.\It's the student council's problem.\Plus, I don't think it's a good thing to rely on other people right\after you take over as president. response:	Huh?! What does that mean?
context: I mean... it couldn't hurt to try... I think...\Really?\I think it's fine, then.\No, I don't think we should mess with this.\It's the student council's problem.\Plus, I don't think it's a good thing to rely on other people right\after you take over as president.\Huh?! What does that mean? response:	We're not a jack-of-all-trades service.
context: Really?\I think it's fine, then.\No, I don't think we should mess with this.\It's the student council's problem.\Plus, I don't think it's a good thing to rely on other people right\after you take over as president.\Huh?! What does that mean?\We're not a jack-of-all-trades service. response:	We only help people out.
context: I think it's fine, then.\No, I don't think we should mess with this.\It's the student council's problem.\Plus, I don't think it's a good thing to rely on other people right\after you take over as president.\Huh?! What does that mean?\We're not a jack-of-all-trades service.\We only help people out. response:	Anyway, this is your job. Got it? Go on.
context: No, I don't think we should mess with this.\It's the student council's problem.\Plus, I don't think it's a good thing to rely on other people right\after you take over as president.\Huh?! What does that mean?\We're not a jack-of-all-trades service.\We only help people out.\Anyway, this is your job. Got it? Go on. response:	I took over as president because you said I should!
context: It's the student council's problem.\Plus, I don't think it's a good thing to rely on other people right\after you take over as president.\Huh?! What does that mean?\We're not a jack-of-all-trades service.\We only help people out.\Anyway, this is your job. Got it? Go on.\I took over as president because you said I should! response:	I want you to do something about this!
context: Plus, I don't think it's a good thing to rely on other people right\after you take over as president.\Huh?! What does that mean?\We're not a jack-of-all-trades service.\We only help people out.\Anyway, this is your job. Got it? Go on.\I took over as president because you said I should!\I want you to do something about this! response:	Being told that weakens me.
context: after you take over as president.\Huh?! What does that mean?\We're not a jack-of-all-trades service.\We only help people out.\Anyway, this is your job. Got it? Go on.\I took over as president because you said I should!\I want you to do something about this!\Being told that weakens me. response:	It only makes sense that I should take responsibility for Isshiki Iroha.
context: Huh?! What does that mean?\We're not a jack-of-all-trades service.\We only help people out.\Anyway, this is your job. Got it? Go on.\I took over as president because you said I should!\I want you to do something about this!\Being told that weakens me.\It only makes sense that I should take responsibility for Isshiki Iroha. response:	Which means there's one other person
context: We're not a jack-of-all-trades service.\We only help people out.\Anyway, this is your job. Got it? Go on.\I took over as president because you said I should!\I want you to do something about this!\Being told that weakens me.\It only makes sense that I should take responsibility for Isshiki Iroha.\Which means there's one other person response:	I need to take responsibility for.
context: We only help people out.\Anyway, this is your job. Got it? Go on.\I took over as president because you said I should!\I want you to do something about this!\Being told that weakens me.\It only makes sense that I should take responsibility for Isshiki Iroha.\Which means there's one other person\I need to take responsibility for. response:	Would you object to me helping you
context: Anyway, this is your job. Got it? Go on.\I took over as president because you said I should!\I want you to do something about this!\Being told that weakens me.\It only makes sense that I should take responsibility for Isshiki Iroha.\Which means there's one other person\I need to take responsibility for.\Would you object to me helping you response:	on a personal level, not for the club?
context: I took over as president because you said I should!\I want you to do something about this!\Being told that weakens me.\It only makes sense that I should take responsibility for Isshiki Iroha.\Which means there's one other person\I need to take responsibility for.\Would you object to me helping you\on a personal level, not for the club? response:	Huh? Well, yeah, I'm fine with that...
context: I want you to do something about this!\Being told that weakens me.\It only makes sense that I should take responsibility for Isshiki Iroha.\Which means there's one other person\I need to take responsibility for.\Would you object to me helping you\on a personal level, not for the club?\Huh? Well, yeah, I'm fine with that... response:	If it's just you alone, I can use
context: Being told that weakens me.\It only makes sense that I should take responsibility for Isshiki Iroha.\Which means there's one other person\I need to take responsibility for.\Would you object to me helping you\on a personal level, not for the club?\Huh? Well, yeah, I'm fine with that...\If it's just you alone, I can use response:	I can rest easy. I mean, I can rely on you.
context: It only makes sense that I should take responsibility for Isshiki Iroha.\Which means there's one other person\I need to take responsibility for.\Would you object to me helping you\on a personal level, not for the club?\Huh? Well, yeah, I'm fine with that...\If it's just you alone, I can use\I can rest easy. I mean, I can rely on you. response:	You don't have to correct yourself.
context: Which means there's one other person\I need to take responsibility for.\Would you object to me helping you\on a personal level, not for the club?\Huh? Well, yeah, I'm fine with that...\If it's just you alone, I can use\I can rest easy. I mean, I can rely on you.\You don't have to correct yourself. response:	What about Hayama, anyway?
context: I need to take responsibility for.\Would you object to me helping you\on a personal level, not for the club?\Huh? Well, yeah, I'm fine with that...\If it's just you alone, I can use\I can rest easy. I mean, I can rely on you.\You don't have to correct yourself.\What about Hayama, anyway? response:	Aren't times like these when you should get him to help you?
context: Would you object to me helping you\on a personal level, not for the club?\Huh? Well, yeah, I'm fine with that...\If it's just you alone, I can use\I can rest easy. I mean, I can rely on you.\You don't have to correct yourself.\What about Hayama, anyway?\Aren't times like these when you should get him to help you? response:	This is a tough job, so I didn't want to bother him with it...
context: on a personal level, not for the club?\Huh? Well, yeah, I'm fine with that...\If it's just you alone, I can use\I can rest easy. I mean, I can rely on you.\You don't have to correct yourself.\What about Hayama, anyway?\Aren't times like these when you should get him to help you?\This is a tough job, so I didn't want to bother him with it... response:	But you don't mind bothering me? I mean, not that I care...
context: Huh? Well, yeah, I'm fine with that...\If it's just you alone, I can use\I can rest easy. I mean, I can rely on you.\You don't have to correct yourself.\What about Hayama, anyway?\Aren't times like these when you should get him to help you?\This is a tough job, so I didn't want to bother him with it...\But you don't mind bothering me? I mean, not that I care... response:	Still, who knew she'd say something noble like she didn't want to bother him?
context: If it's just you alone, I can use\I can rest easy. I mean, I can rely on you.\You don't have to correct yourself.\What about Hayama, anyway?\Aren't times like these when you should get him to help you?\This is a tough job, so I didn't want to bother him with it...\But you don't mind bothering me? I mean, not that I care...\Still, who knew she'd say something noble like she didn't want to bother him? response:	I guess even Isshiki can act like a girl in love.
context: I can rest easy. I mean, I can rely on you.\You don't have to correct yourself.\What about Hayama, anyway?\Aren't times like these when you should get him to help you?\This is a tough job, so I didn't want to bother him with it...\But you don't mind bothering me? I mean, not that I care...\Still, who knew she'd say something noble like she didn't want to bother him?\I guess even Isshiki can act like a girl in love. response:	I've gotta admire that.
context: You don't have to correct yourself.\What about Hayama, anyway?\Aren't times like these when you should get him to help you?\This is a tough job, so I didn't want to bother him with it...\But you don't mind bothering me? I mean, not that I care...\Still, who knew she'd say something noble like she didn't want to bother him?\I guess even Isshiki can act like a girl in love.\I've gotta admire that. response:	Besides, with stuff like this,
context: What about Hayama, anyway?\Aren't times like these when you should get him to help you?\This is a tough job, so I didn't want to bother him with it...\But you don't mind bothering me? I mean, not that I care...\Still, who knew she'd say something noble like she didn't want to bother him?\I guess even Isshiki can act like a girl in love.\I've gotta admire that.\Besides, with stuff like this, response:	it's cute how he can't handle simple things.
context: Aren't times like these when you should get him to help you?\This is a tough job, so I didn't want to bother him with it...\But you don't mind bothering me? I mean, not that I care...\Still, who knew she'd say something noble like she didn't want to bother him?\I guess even Isshiki can act like a girl in love.\I've gotta admire that.\Besides, with stuff like this,\it's cute how he can't handle simple things. response:	It's his mistakes that I like about him.
context: This is a tough job, so I didn't want to bother him with it...\But you don't mind bothering me? I mean, not that I care...\Still, who knew she'd say something noble like she didn't want to bother him?\I guess even Isshiki can act like a girl in love.\I've gotta admire that.\Besides, with stuff like this,\it's cute how he can't handle simple things.\It's his mistakes that I like about him. response:	Asking him to do something that's actually hard would just scare him off.
context: But you don't mind bothering me? I mean, not that I care...\Still, who knew she'd say something noble like she didn't want to bother him?\I guess even Isshiki can act like a girl in love.\I've gotta admire that.\Besides, with stuff like this,\it's cute how he can't handle simple things.\It's his mistakes that I like about him.\Asking him to do something that's actually hard would just scare him off. response:	Oh... I see.
context: Still, who knew she'd say something noble like she didn't want to bother him?\I guess even Isshiki can act like a girl in love.\I've gotta admire that.\Besides, with stuff like this,\it's cute how he can't handle simple things.\It's his mistakes that I like about him.\Asking him to do something that's actually hard would just scare him off.\Oh... I see. response:	Some winning personality she's got.
context: I guess even Isshiki can act like a girl in love.\I've gotta admire that.\Besides, with stuff like this,\it's cute how he can't handle simple things.\It's his mistakes that I like about him.\Asking him to do something that's actually hard would just scare him off.\Oh... I see.\Some winning personality she's got. response:	Give it back! Return to me my admiration!
context: I've gotta admire that.\Besides, with stuff like this,\it's cute how he can't handle simple things.\It's his mistakes that I like about him.\Asking him to do something that's actually hard would just scare him off.\Oh... I see.\Some winning personality she's got.\Give it back! Return to me my admiration! response:	Okay, let's meet at the school gate afterward.
context: Besides, with stuff like this,\it's cute how he can't handle simple things.\It's his mistakes that I like about him.\Asking him to do something that's actually hard would just scare him off.\Oh... I see.\Some winning personality she's got.\Give it back! Return to me my admiration!\Okay, let's meet at the school gate afterward. response:	What? We're starting today?
context: it's cute how he can't handle simple things.\It's his mistakes that I like about him.\Asking him to do something that's actually hard would just scare him off.\Oh... I see.\Some winning personality she's got.\Give it back! Return to me my admiration!\Okay, let's meet at the school gate afterward.\What? We're starting today? response:	We don't have much time.
context: It's his mistakes that I like about him.\Asking him to do something that's actually hard would just scare him off.\Oh... I see.\Some winning personality she's got.\Give it back! Return to me my admiration!\Okay, let's meet at the school gate afterward.\What? We're starting today?\We don't have much time. response:	Okay, then change the meeting location.
context: Asking him to do something that's actually hard would just scare him off.\Oh... I see.\Some winning personality she's got.\Give it back! Return to me my admiration!\Okay, let's meet at the school gate afterward.\What? We're starting today?\We don't have much time.\Okay, then change the meeting location. response:	It'd be embarrassing if my friends saw us leaving together and started rumors.
context: Oh... I see.\Some winning personality she's got.\Give it back! Return to me my admiration!\Okay, let's meet at the school gate afterward.\What? We're starting today?\We don't have much time.\Okay, then change the meeting location.\It'd be embarrassing if my friends saw us leaving together and started rumors. response:	Huh?
context: Some winning personality she's got.\Give it back! Return to me my admiration!\Okay, let's meet at the school gate afterward.\What? We're starting today?\We don't have much time.\Okay, then change the meeting location.\It'd be embarrassing if my friends saw us leaving together and started rumors.\Huh? response:	Hm, is she in the wrong generation to get the humor of that?
context: Give it back! Return to me my admiration!\Okay, let's meet at the school gate afterward.\What? We're starting today?\We don't have much time.\Okay, then change the meeting location.\It'd be embarrassing if my friends saw us leaving together and started rumors.\Huh?\Hm, is she in the wrong generation to get the humor of that? response:	She's not even responding with But you don't have any friends.
context: Okay, let's meet at the school gate afterward.\What? We're starting today?\We don't have much time.\Okay, then change the meeting location.\It'd be embarrassing if my friends saw us leaving together and started rumors.\Huh?\Hm, is she in the wrong generation to get the humor of that?\She's not even responding with But you don't have any friends. response:	Total poker face.
context: What? We're starting today?\We don't have much time.\Okay, then change the meeting location.\It'd be embarrassing if my friends saw us leaving together and started rumors.\Huh?\Hm, is she in the wrong generation to get the humor of that?\She's not even responding with But you don't have any friends.\Total poker face. response:	Okay, then...
context: We don't have much time.\Okay, then change the meeting location.\It'd be embarrassing if my friends saw us leaving together and started rumors.\Huh?\Hm, is she in the wrong generation to get the humor of that?\She's not even responding with But you don't have any friends.\Total poker face.\Okay, then... response:	You know where the community center is?
context: Okay, then change the meeting location.\It'd be embarrassing if my friends saw us leaving together and started rumors.\Huh?\Hm, is she in the wrong generation to get the humor of that?\She's not even responding with But you don't have any friends.\Total poker face.\Okay, then...\You know where the community center is? response:	We'll meet there.
context: It'd be embarrassing if my friends saw us leaving together and started rumors.\Huh?\Hm, is she in the wrong generation to get the humor of that?\She's not even responding with But you don't have any friends.\Total poker face.\Okay, then...\You know where the community center is?\We'll meet there. response:	Fine. I'll head there after I get ready.
context: Huh?\Hm, is she in the wrong generation to get the humor of that?\She's not even responding with But you don't have any friends.\Total poker face.\Okay, then...\You know where the community center is?\We'll meet there.\Fine. I'll head there after I get ready. response:	Okay, see you there, then!
context: Hm, is she in the wrong generation to get the humor of that?\She's not even responding with But you don't have any friends.\Total poker face.\Okay, then...\You know where the community center is?\We'll meet there.\Fine. I'll head there after I get ready.\Okay, see you there, then! response:	You really are sneaky...
context: She's not even responding with But you don't have any friends.\Total poker face.\Okay, then...\You know where the community center is?\We'll meet there.\Fine. I'll head there after I get ready.\Okay, see you there, then!\You really are sneaky... response:	What did Iroha-chan say?
context: Total poker face.\Okay, then...\You know where the community center is?\We'll meet there.\Fine. I'll head there after I get ready.\Okay, see you there, then!\You really are sneaky...\What did Iroha-chan say? response:	She whined a lot, but she seemed to understand.
context: Okay, then...\You know where the community center is?\We'll meet there.\Fine. I'll head there after I get ready.\Okay, see you there, then!\You really are sneaky...\What did Iroha-chan say?\She whined a lot, but she seemed to understand. response:	I see...
context: You know where the community center is?\We'll meet there.\Fine. I'll head there after I get ready.\Okay, see you there, then!\You really are sneaky...\What did Iroha-chan say?\She whined a lot, but she seemed to understand.\I see... response:	And that was the first time in a while that I hoped we could do something...
context: We'll meet there.\Fine. I'll head there after I get ready.\Okay, see you there, then!\You really are sneaky...\What did Iroha-chan say?\She whined a lot, but she seemed to understand.\I see...\And that was the first time in a while that I hoped we could do something... response:	Something else will come up soon enough.
context: Fine. I'll head there after I get ready.\Okay, see you there, then!\You really are sneaky...\What did Iroha-chan say?\She whined a lot, but she seemed to understand.\I see...\And that was the first time in a while that I hoped we could do something...\Something else will come up soon enough. response:	Maybe it's actually better if we don't get any requests.
context: Okay, see you there, then!\You really are sneaky...\What did Iroha-chan say?\She whined a lot, but she seemed to understand.\I see...\And that was the first time in a while that I hoped we could do something...\Something else will come up soon enough.\Maybe it's actually better if we don't get any requests. response:	If we just don't do anything.
context: You really are sneaky...\What did Iroha-chan say?\She whined a lot, but she seemed to understand.\I see...\And that was the first time in a while that I hoped we could do something...\Something else will come up soon enough.\Maybe it's actually better if we don't get any requests.\If we just don't do anything. response:	Maybe.
context: What did Iroha-chan say?\She whined a lot, but she seemed to understand.\I see...\And that was the first time in a while that I hoped we could do something...\Something else will come up soon enough.\Maybe it's actually better if we don't get any requests.\If we just don't do anything.\Maybe. response:	Then what have I...
context: She whined a lot, but she seemed to understand.\I see...\And that was the first time in a while that I hoped we could do something...\Something else will come up soon enough.\Maybe it's actually better if we don't get any requests.\If we just don't do anything.\Maybe.\Then what have I... response:	What have we...
context: I see...\And that was the first time in a while that I hoped we could do something...\Something else will come up soon enough.\Maybe it's actually better if we don't get any requests.\If we just don't do anything.\Maybe.\Then what have I...\What have we... response:	been doing all this time?
context: And that was the first time in a while that I hoped we could do something...\Something else will come up soon enough.\Maybe it's actually better if we don't get any requests.\If we just don't do anything.\Maybe.\Then what have I...\What have we...\been doing all this time? response:	Sorry I made you wait.
context: Something else will come up soon enough.\Maybe it's actually better if we don't get any requests.\If we just don't do anything.\Maybe.\Then what have I...\What have we...\been doing all this time?\Sorry I made you wait. response:	I had a little shopping to do.
context: Maybe it's actually better if we don't get any requests.\If we just don't do anything.\Maybe.\Then what have I...\What have we...\been doing all this time?\Sorry I made you wait.\I had a little shopping to do. response:	It's fine...
context: If we just don't do anything.\Maybe.\Then what have I...\What have we...\been doing all this time?\Sorry I made you wait.\I had a little shopping to do.\It's fine... response:	What's that irritating face for?
context: Maybe.\Then what have I...\What have we...\been doing all this time?\Sorry I made you wait.\I had a little shopping to do.\It's fine...\What's that irritating face for? response:	You weren't trying to call attention to how heavy your bags are so I'd carry them?
context: Then what have I...\What have we...\been doing all this time?\Sorry I made you wait.\I had a little shopping to do.\It's fine...\What's that irritating face for?\You weren't trying to call attention to how heavy your bags are so I'd carry them? response:	Uh, no, that was just a natural reaction.
context: What have we...\been doing all this time?\Sorry I made you wait.\I had a little shopping to do.\It's fine...\What's that irritating face for?\You weren't trying to call attention to how heavy your bags are so I'd carry them?\Uh, no, that was just a natural reaction. response:	You weren't trying to hit on me, were you?
context: been doing all this time?\Sorry I made you wait.\I had a little shopping to do.\It's fine...\What's that irritating face for?\You weren't trying to call attention to how heavy your bags are so I'd carry them?\Uh, no, that was just a natural reaction.\You weren't trying to hit on me, were you? response:	I'm sorry. My heart fluttered for a moment, but after calming down, I still can't.
context: Sorry I made you wait.\I had a little shopping to do.\It's fine...\What's that irritating face for?\You weren't trying to call attention to how heavy your bags are so I'd carry them?\Uh, no, that was just a natural reaction.\You weren't trying to hit on me, were you?\I'm sorry. My heart fluttered for a moment, but after calming down, I still can't. response:	Huh? I see...
context: I had a little shopping to do.\It's fine...\What's that irritating face for?\You weren't trying to call attention to how heavy your bags are so I'd carry them?\Uh, no, that was just a natural reaction.\You weren't trying to hit on me, were you?\I'm sorry. My heart fluttered for a moment, but after calming down, I still can't.\Huh? I see... response:	How many times do I have to get rejected by this girl?
context: It's fine...\What's that irritating face for?\You weren't trying to call attention to how heavy your bags are so I'd carry them?\Uh, no, that was just a natural reaction.\You weren't trying to hit on me, were you?\I'm sorry. My heart fluttered for a moment, but after calming down, I still can't.\Huh? I see...\How many times do I have to get rejected by this girl? response:	Th-Thank you...
context: What's that irritating face for?\You weren't trying to call attention to how heavy your bags are so I'd carry them?\Uh, no, that was just a natural reaction.\You weren't trying to hit on me, were you?\I'm sorry. My heart fluttered for a moment, but after calming down, I still can't.\Huh? I see...\How many times do I have to get rejected by this girl?\Th-Thank you... response:	No big deal. It's part of my job.
context: You weren't trying to call attention to how heavy your bags are so I'd carry them?\Uh, no, that was just a natural reaction.\You weren't trying to hit on me, were you?\I'm sorry. My heart fluttered for a moment, but after calming down, I still can't.\Huh? I see...\How many times do I have to get rejected by this girl?\Th-Thank you...\No big deal. It's part of my job. response:	Wow, you're so dependable!
context: Uh, no, that was just a natural reaction.\You weren't trying to hit on me, were you?\I'm sorry. My heart fluttered for a moment, but after calming down, I still can't.\Huh? I see...\How many times do I have to get rejected by this girl?\Th-Thank you...\No big deal. It's part of my job.\Wow, you're so dependable! response:	In that case, take care of the next part, too, okay?
context: You weren't trying to hit on me, were you?\I'm sorry. My heart fluttered for a moment, but after calming down, I still can't.\Huh? I see...\How many times do I have to get rejected by this girl?\Th-Thank you...\No big deal. It's part of my job.\Wow, you're so dependable!\In that case, take care of the next part, too, okay? response:	Lecture Room 1
context: I'm sorry. My heart fluttered for a moment, but after calming down, I still can't.\Huh? I see...\How many times do I have to get rejected by this girl?\Th-Thank you...\No big deal. It's part of my job.\Wow, you're so dependable!\In that case, take care of the next part, too, okay?\Lecture Room 1 response:	Hi, everyone.
context: Huh? I see...\How many times do I have to get rejected by this girl?\Th-Thank you...\No big deal. It's part of my job.\Wow, you're so dependable!\In that case, take care of the next part, too, okay?\Lecture Room 1\Hi, everyone. response:	Chiba City Mihama Ward Takasu Community Center
context: How many times do I have to get rejected by this girl?\Th-Thank you...\No big deal. It's part of my job.\Wow, you're so dependable!\In that case, take care of the next part, too, okay?\Lecture Room 1\Hi, everyone.\Chiba City Mihama Ward Takasu Community Center response:	I'm Tamanawa, student council president of Kaihin General High School.
context: Th-Thank you...\No big deal. It's part of my job.\Wow, you're so dependable!\In that case, take care of the next part, too, okay?\Lecture Room 1\Hi, everyone.\Chiba City Mihama Ward Takasu Community Center\I'm Tamanawa, student council president of Kaihin General High School. response:	Nice to meet you.
context: No big deal. It's part of my job.\Wow, you're so dependable!\In that case, take care of the next part, too, okay?\Lecture Room 1\Hi, everyone.\Chiba City Mihama Ward Takasu Community Center\I'm Tamanawa, student council president of Kaihin General High School.\Nice to meet you. response:	Yeah... hello.
context: Wow, you're so dependable!\In that case, take care of the next part, too, okay?\Lecture Room 1\Hi, everyone.\Chiba City Mihama Ward Takasu Community Center\I'm Tamanawa, student council president of Kaihin General High School.\Nice to meet you.\Yeah... hello. response:	I'm really glad
context: In that case, take care of the next part, too, okay?\Lecture Room 1\Hi, everyone.\Chiba City Mihama Ward Takasu Community Center\I'm Tamanawa, student council president of Kaihin General High School.\Nice to meet you.\Yeah... hello.\I'm really glad response:	we had the chance to plan this together, as two fresh, rookie presidents.
context: Lecture Room 1\Hi, everyone.\Chiba City Mihama Ward Takasu Community Center\I'm Tamanawa, student council president of Kaihin General High School.\Nice to meet you.\Yeah... hello.\I'm really glad\we had the chance to plan this together, as two fresh, rookie presidents. response:	I'm hoping we can forge a partnership of mutual respect
context: Hi, everyone.\Chiba City Mihama Ward Takasu Community Center\I'm Tamanawa, student council president of Kaihin General High School.\Nice to meet you.\Yeah... hello.\I'm really glad\we had the chance to plan this together, as two fresh, rookie presidents.\I'm hoping we can forge a partnership of mutual respect response:	and bring about a synergetic effect.
context: Chiba City Mihama Ward Takasu Community Center\I'm Tamanawa, student council president of Kaihin General High School.\Nice to meet you.\Yeah... hello.\I'm really glad\we had the chance to plan this together, as two fresh, rookie presidents.\I'm hoping we can forge a partnership of mutual respect\and bring about a synergetic effect. response:	He throws a good punch right from the get-go...
context: I'm Tamanawa, student council president of Kaihin General High School.\Nice to meet you.\Yeah... hello.\I'm really glad\we had the chance to plan this together, as two fresh, rookie presidents.\I'm hoping we can forge a partnership of mutual respect\and bring about a synergetic effect.\He throws a good punch right from the get-go... response:	Iroha-chan, got a minute?
context: Nice to meet you.\Yeah... hello.\I'm really glad\we had the chance to plan this together, as two fresh, rookie presidents.\I'm hoping we can forge a partnership of mutual respect\and bring about a synergetic effect.\He throws a good punch right from the get-go...\Iroha-chan, got a minute? response:	Sure!
context: Yeah... hello.\I'm really glad\we had the chance to plan this together, as two fresh, rookie presidents.\I'm hoping we can forge a partnership of mutual respect\and bring about a synergetic effect.\He throws a good punch right from the get-go...\Iroha-chan, got a minute?\Sure! response:	Huh? Hikigaya?
context: I'm really glad\we had the chance to plan this together, as two fresh, rookie presidents.\I'm hoping we can forge a partnership of mutual respect\and bring about a synergetic effect.\He throws a good punch right from the get-go...\Iroha-chan, got a minute?\Sure!\Huh? Hikigaya? response:	Hey...
context: we had the chance to plan this together, as two fresh, rookie presidents.\I'm hoping we can forge a partnership of mutual respect\and bring about a synergetic effect.\He throws a good punch right from the get-go...\Iroha-chan, got a minute?\Sure!\Huh? Hikigaya?\Hey... response:	You're on the student council?
context: I'm hoping we can forge a partnership of mutual respect\and bring about a synergetic effect.\He throws a good punch right from the get-go...\Iroha-chan, got a minute?\Sure!\Huh? Hikigaya?\Hey...\You're on the student council? response:	No.
context: and bring about a synergetic effect.\He throws a good punch right from the get-go...\Iroha-chan, got a minute?\Sure!\Huh? Hikigaya?\Hey...\You're on the student council?\No. response:	Same as me, then!
context: He throws a good punch right from the get-go...\Iroha-chan, got a minute?\Sure!\Huh? Hikigaya?\Hey...\You're on the student council?\No.\Same as me, then! response:	I'm here because my friend asked me to come...
context: Iroha-chan, got a minute?\Sure!\Huh? Hikigaya?\Hey...\You're on the student council?\No.\Same as me, then!\I'm here because my friend asked me to come... response:	Huh? Wait, you're alone?
context: Sure!\Huh? Hikigaya?\Hey...\You're on the student council?\No.\Same as me, then!\I'm here because my friend asked me to come...\Huh? Wait, you're alone? response:	All the time, pretty much.
context: Huh? Hikigaya?\Hey...\You're on the student council?\No.\Same as me, then!\I'm here because my friend asked me to come...\Huh? Wait, you're alone?\All the time, pretty much. response:	What the heck? That's hilarious!
context: Hey...\You're on the student council?\No.\Same as me, then!\I'm here because my friend asked me to come...\Huh? Wait, you're alone?\All the time, pretty much.\What the heck? That's hilarious! response:	No it's not...
context: You're on the student council?\No.\Same as me, then!\I'm here because my friend asked me to come...\Huh? Wait, you're alone?\All the time, pretty much.\What the heck? That's hilarious!\No it's not... response:	Well, see ya!
context: No.\Same as me, then!\I'm here because my friend asked me to come...\Huh? Wait, you're alone?\All the time, pretty much.\What the heck? That's hilarious!\No it's not...\Well, see ya! response:	Senpai, there's someone here you know?
context: Same as me, then!\I'm here because my friend asked me to come...\Huh? Wait, you're alone?\All the time, pretty much.\What the heck? That's hilarious!\No it's not...\Well, see ya!\Senpai, there's someone here you know? response:	The way you said that sounded like
context: I'm here because my friend asked me to come...\Huh? Wait, you're alone?\All the time, pretty much.\What the heck? That's hilarious!\No it's not...\Well, see ya!\Senpai, there's someone here you know?\The way you said that sounded like response:	Someone exists that you know? Don't do that.
context: Huh? Wait, you're alone?\All the time, pretty much.\What the heck? That's hilarious!\No it's not...\Well, see ya!\Senpai, there's someone here you know?\The way you said that sounded like\Someone exists that you know? Don't do that. response:	Besides, you've seen her before.
context: All the time, pretty much.\What the heck? That's hilarious!\No it's not...\Well, see ya!\Senpai, there's someone here you know?\The way you said that sounded like\Someone exists that you know? Don't do that.\Besides, you've seen her before. response:	Who's the girl, anyway?
context: What the heck? That's hilarious!\No it's not...\Well, see ya!\Senpai, there's someone here you know?\The way you said that sounded like\Someone exists that you know? Don't do that.\Besides, you've seen her before.\Who's the girl, anyway? response:	Yeah, she was my classmate in middle school.
context: No it's not...\Well, see ya!\Senpai, there's someone here you know?\The way you said that sounded like\Someone exists that you know? Don't do that.\Besides, you've seen her before.\Who's the girl, anyway?\Yeah, she was my classmate in middle school. response:	Yeah?
context: Well, see ya!\Senpai, there's someone here you know?\The way you said that sounded like\Someone exists that you know? Don't do that.\Besides, you've seen her before.\Who's the girl, anyway?\Yeah, she was my classmate in middle school.\Yeah? response:	Oh, the meeting's starting.
context: Senpai, there's someone here you know?\The way you said that sounded like\Someone exists that you know? Don't do that.\Besides, you've seen her before.\Who's the girl, anyway?\Yeah, she was my classmate in middle school.\Yeah?\Oh, the meeting's starting. response:	This way, Senpai.
context: The way you said that sounded like\Someone exists that you know? Don't do that.\Besides, you've seen her before.\Who's the girl, anyway?\Yeah, she was my classmate in middle school.\Yeah?\Oh, the meeting's starting.\This way, Senpai. response:	Uh, I'd rather stay on the sidelines...
context: Someone exists that you know? Don't do that.\Besides, you've seen her before.\Who's the girl, anyway?\Yeah, she was my classmate in middle school.\Yeah?\Oh, the meeting's starting.\This way, Senpai.\Uh, I'd rather stay on the sidelines... response:	About the Christmas Event Plan
context: Besides, you've seen her before.\Who's the girl, anyway?\Yeah, she was my classmate in middle school.\Yeah?\Oh, the meeting's starting.\This way, Senpai.\Uh, I'd rather stay on the sidelines...\About the Christmas Event Plan response:	Okay, so just like last time,
context: Who's the girl, anyway?\Yeah, she was my classmate in middle school.\Yeah?\Oh, the meeting's starting.\This way, Senpai.\Uh, I'd rather stay on the sidelines...\About the Christmas Event Plan\Okay, so just like last time, response:	let's start by brainstorming.
context: Yeah, she was my classmate in middle school.\Yeah?\Oh, the meeting's starting.\This way, Senpai.\Uh, I'd rather stay on the sidelines...\About the Christmas Event Plan\Okay, so just like last time,\let's start by brainstorming. response:	First on the agenda is the event concept
context: Yeah?\Oh, the meeting's starting.\This way, Senpai.\Uh, I'd rather stay on the sidelines...\About the Christmas Event Plan\Okay, so just like last time,\let's start by brainstorming.\First on the agenda is the event concept response:	and sharing of ideas for activities.
context: Oh, the meeting's starting.\This way, Senpai.\Uh, I'd rather stay on the sidelines...\About the Christmas Event Plan\Okay, so just like last time,\let's start by brainstorming.\First on the agenda is the event concept\and sharing of ideas for activities. response:	Considering the demands that fall on us as high school students,
context: This way, Senpai.\Uh, I'd rather stay on the sidelines...\About the Christmas Event Plan\Okay, so just like last time,\let's start by brainstorming.\First on the agenda is the event concept\and sharing of ideas for activities.\Considering the demands that fall on us as high school students, response:	I believe we need to come up with some
context: Uh, I'd rather stay on the sidelines...\About the Christmas Event Plan\Okay, so just like last time,\let's start by brainstorming.\First on the agenda is the event concept\and sharing of ideas for activities.\Considering the demands that fall on us as high school students,\I believe we need to come up with some response:	innovation befitting of young minds.
context: About the Christmas Event Plan\Okay, so just like last time,\let's start by brainstorming.\First on the agenda is the event concept\and sharing of ideas for activities.\Considering the demands that fall on us as high school students,\I believe we need to come up with some\innovation befitting of young minds. response:	In that case, naturally, we need to ponder on the premise of
context: Okay, so just like last time,\let's start by brainstorming.\First on the agenda is the event concept\and sharing of ideas for activities.\Considering the demands that fall on us as high school students,\I believe we need to come up with some\innovation befitting of young minds.\In that case, naturally, we need to ponder on the premise of response:	a win-win relationship with the community.
context: let's start by brainstorming.\First on the agenda is the event concept\and sharing of ideas for activities.\Considering the demands that fall on us as high school students,\I believe we need to come up with some\innovation befitting of young minds.\In that case, naturally, we need to ponder on the premise of\a win-win relationship with the community. response:	Then we'll probably have to think strategically in terms of cost-effectiveness.
context: First on the agenda is the event concept\and sharing of ideas for activities.\Considering the demands that fall on us as high school students,\I believe we need to come up with some\innovation befitting of young minds.\In that case, naturally, we need to ponder on the premise of\a win-win relationship with the community.\Then we'll probably have to think strategically in terms of cost-effectiveness. response:	What is going on right now?
context: and sharing of ideas for activities.\Considering the demands that fall on us as high school students,\I believe we need to come up with some\innovation befitting of young minds.\In that case, naturally, we need to ponder on the premise of\a win-win relationship with the community.\Then we'll probably have to think strategically in terms of cost-effectiveness.\What is going on right now? response:	Huh? No idea.
context: Considering the demands that fall on us as high school students,\I believe we need to come up with some\innovation befitting of young minds.\In that case, naturally, we need to ponder on the premise of\a win-win relationship with the community.\Then we'll probably have to think strategically in terms of cost-effectiveness.\What is going on right now?\Huh? No idea. response:	The other school is making suggestions for us, I guess.
context: I believe we need to come up with some\innovation befitting of young minds.\In that case, naturally, we need to ponder on the premise of\a win-win relationship with the community.\Then we'll probably have to think strategically in terms of cost-effectiveness.\What is going on right now?\Huh? No idea.\The other school is making suggestions for us, I guess. response:	Huh...
context: innovation befitting of young minds.\In that case, naturally, we need to ponder on the premise of\a win-win relationship with the community.\Then we'll probably have to think strategically in terms of cost-effectiveness.\What is going on right now?\Huh? No idea.\The other school is making suggestions for us, I guess.\Huh... response:	Everyone, isn't there something more important to consider?
context: In that case, naturally, we need to ponder on the premise of\a win-win relationship with the community.\Then we'll probably have to think strategically in terms of cost-effectiveness.\What is going on right now?\Huh? No idea.\The other school is making suggestions for us, I guess.\Huh...\Everyone, isn't there something more important to consider? response:	We should use logical thinking to think logically.
context: a win-win relationship with the community.\Then we'll probably have to think strategically in terms of cost-effectiveness.\What is going on right now?\Huh? No idea.\The other school is making suggestions for us, I guess.\Huh...\Everyone, isn't there something more important to consider?\We should use logical thinking to think logically. response:	Aren't those the same thing?
context: Then we'll probably have to think strategically in terms of cost-effectiveness.\What is going on right now?\Huh? No idea.\The other school is making suggestions for us, I guess.\Huh...\Everyone, isn't there something more important to consider?\We should use logical thinking to think logically.\Aren't those the same thing? response:	How many times are we supposed to think?
context: What is going on right now?\Huh? No idea.\The other school is making suggestions for us, I guess.\Huh...\Everyone, isn't there something more important to consider?\We should use logical thinking to think logically.\Aren't those the same thing?\How many times are we supposed to think? response:	We should put ourselves in the customer's place to see from the customers' perspective.
context: Huh? No idea.\The other school is making suggestions for us, I guess.\Huh...\Everyone, isn't there something more important to consider?\We should use logical thinking to think logically.\Aren't those the same thing?\How many times are we supposed to think?\We should put ourselves in the customer's place to see from the customers' perspective. response:	Again, aren't those the same thing?
context: The other school is making suggestions for us, I guess.\Huh...\Everyone, isn't there something more important to consider?\We should use logical thinking to think logically.\Aren't those the same thing?\How many times are we supposed to think?\We should put ourselves in the customer's place to see from the customers' perspective.\Again, aren't those the same thing? response:	How many times do we have to become the customer?
context: Huh...\Everyone, isn't there something more important to consider?\We should use logical thinking to think logically.\Aren't those the same thing?\How many times are we supposed to think?\We should put ourselves in the customer's place to see from the customers' perspective.\Again, aren't those the same thing?\How many times do we have to become the customer? response:	Then we could give some thought to outsourcing.
context: Everyone, isn't there something more important to consider?\We should use logical thinking to think logically.\Aren't those the same thing?\How many times are we supposed to think?\We should put ourselves in the customer's place to see from the customers' perspective.\Again, aren't those the same thing?\How many times do we have to become the customer?\Then we could give some thought to outsourcing. response:	With our current method, that might be tough to fit in the scheme.
context: We should use logical thinking to think logically.\Aren't those the same thing?\How many times are we supposed to think?\We should put ourselves in the customer's place to see from the customers' perspective.\Again, aren't those the same thing?\How many times do we have to become the customer?\Then we could give some thought to outsourcing.\With our current method, that might be tough to fit in the scheme. response:	What do you think?
context: Aren't those the same thing?\How many times are we supposed to think?\We should put ourselves in the customer's place to see from the customers' perspective.\Again, aren't those the same thing?\How many times do we have to become the customer?\Then we could give some thought to outsourcing.\With our current method, that might be tough to fit in the scheme.\What do you think? response:	There's a chance it could be rescheduled, too.
context: How many times are we supposed to think?\We should put ourselves in the customer's place to see from the customers' perspective.\Again, aren't those the same thing?\How many times do we have to become the customer?\Then we could give some thought to outsourcing.\With our current method, that might be tough to fit in the scheme.\What do you think?\There's a chance it could be rescheduled, too. response:	Shouldn't we give ourselves more of a buffer?
context: We should put ourselves in the customer's place to see from the customers' perspective.\Again, aren't those the same thing?\How many times do we have to become the customer?\Then we could give some thought to outsourcing.\With our current method, that might be tough to fit in the scheme.\What do you think?\There's a chance it could be rescheduled, too.\Shouldn't we give ourselves more of a buffer? response:	Oh, that's true. We should look at the whole picture.
context: Again, aren't those the same thing?\How many times do we have to become the customer?\Then we could give some thought to outsourcing.\With our current method, that might be tough to fit in the scheme.\What do you think?\There's a chance it could be rescheduled, too.\Shouldn't we give ourselves more of a buffer?\Oh, that's true. We should look at the whole picture. response:	Are you getting an idea of how it all works?
context: How many times do we have to become the customer?\Then we could give some thought to outsourcing.\With our current method, that might be tough to fit in the scheme.\What do you think?\There's a chance it could be rescheduled, too.\Shouldn't we give ourselves more of a buffer?\Oh, that's true. We should look at the whole picture.\Are you getting an idea of how it all works? response:	No, I didn't understand a thing.
context: Then we could give some thought to outsourcing.\With our current method, that might be tough to fit in the scheme.\What do you think?\There's a chance it could be rescheduled, too.\Shouldn't we give ourselves more of a buffer?\Oh, that's true. We should look at the whole picture.\Are you getting an idea of how it all works?\No, I didn't understand a thing. response:	Yeah, they were saying some difficult stuff, huh?
context: With our current method, that might be tough to fit in the scheme.\What do you think?\There's a chance it could be rescheduled, too.\Shouldn't we give ourselves more of a buffer?\Oh, that's true. We should look at the whole picture.\Are you getting an idea of how it all works?\No, I didn't understand a thing.\Yeah, they were saying some difficult stuff, huh? response:	But when I say stuff like Wow, I need to work hard, too,
context: What do you think?\There's a chance it could be rescheduled, too.\Shouldn't we give ourselves more of a buffer?\Oh, that's true. We should look at the whole picture.\Are you getting an idea of how it all works?\No, I didn't understand a thing.\Yeah, they were saying some difficult stuff, huh?\But when I say stuff like Wow, I need to work hard, too, response:	that goes over really well.
context: There's a chance it could be rescheduled, too.\Shouldn't we give ourselves more of a buffer?\Oh, that's true. We should look at the whole picture.\Are you getting an idea of how it all works?\No, I didn't understand a thing.\Yeah, they were saying some difficult stuff, huh?\But when I say stuff like Wow, I need to work hard, too,\that goes over really well. response:	Otherwise, all I really have to do is email back and forth with them.
context: Shouldn't we give ourselves more of a buffer?\Oh, that's true. We should look at the whole picture.\Are you getting an idea of how it all works?\No, I didn't understand a thing.\Yeah, they were saying some difficult stuff, huh?\But when I say stuff like Wow, I need to work hard, too,\that goes over really well.\Otherwise, all I really have to do is email back and forth with them. response:	You're gonna get stabbed someday.
context: Oh, that's true. We should look at the whole picture.\Are you getting an idea of how it all works?\No, I didn't understand a thing.\Yeah, they were saying some difficult stuff, huh?\But when I say stuff like Wow, I need to work hard, too,\that goes over really well.\Otherwise, all I really have to do is email back and forth with them.\You're gonna get stabbed someday. response:	But you're like that sometimes, too, Senpai.
context: Are you getting an idea of how it all works?\No, I didn't understand a thing.\Yeah, they were saying some difficult stuff, huh?\But when I say stuff like Wow, I need to work hard, too,\that goes over really well.\Otherwise, all I really have to do is email back and forth with them.\You're gonna get stabbed someday.\But you're like that sometimes, too, Senpai. response:	Like you're trying to look smart or interesting...
context: No, I didn't understand a thing.\Yeah, they were saying some difficult stuff, huh?\But when I say stuff like Wow, I need to work hard, too,\that goes over really well.\Otherwise, all I really have to do is email back and forth with them.\You're gonna get stabbed someday.\But you're like that sometimes, too, Senpai.\Like you're trying to look smart or interesting... response:	Don't put me on their level.
context: Yeah, they were saying some difficult stuff, huh?\But when I say stuff like Wow, I need to work hard, too,\that goes over really well.\Otherwise, all I really have to do is email back and forth with them.\You're gonna get stabbed someday.\But you're like that sometimes, too, Senpai.\Like you're trying to look smart or interesting...\Don't put me on their level. response:	I don't care about looking interesting.
context: But when I say stuff like Wow, I need to work hard, too,\that goes over really well.\Otherwise, all I really have to do is email back and forth with them.\You're gonna get stabbed someday.\But you're like that sometimes, too, Senpai.\Like you're trying to look smart or interesting...\Don't put me on their level.\I don't care about looking interesting. response:	I'm just self-conscious.
context: that goes over really well.\Otherwise, all I really have to do is email back and forth with them.\You're gonna get stabbed someday.\But you're like that sometimes, too, Senpai.\Like you're trying to look smart or interesting...\Don't put me on their level.\I don't care about looking interesting.\I'm just self-conscious. response:	Huh... I don't get it.
context: Otherwise, all I really have to do is email back and forth with them.\You're gonna get stabbed someday.\But you're like that sometimes, too, Senpai.\Like you're trying to look smart or interesting...\Don't put me on their level.\I don't care about looking interesting.\I'm just self-conscious.\Huh... I don't get it. response:	Anyway, I've worked out what we need to do, so let's start tackling it.
context: You're gonna get stabbed someday.\But you're like that sometimes, too, Senpai.\Like you're trying to look smart or interesting...\Don't put me on their level.\I don't care about looking interesting.\I'm just self-conscious.\Huh... I don't get it.\Anyway, I've worked out what we need to do, so let's start tackling it. response:	What?
context: But you're like that sometimes, too, Senpai.\Like you're trying to look smart or interesting...\Don't put me on their level.\I don't care about looking interesting.\I'm just self-conscious.\Huh... I don't get it.\Anyway, I've worked out what we need to do, so let's start tackling it.\What? response:	You seem to be getting on well enough with them.
context: Like you're trying to look smart or interesting...\Don't put me on their level.\I don't care about looking interesting.\I'm just self-conscious.\Huh... I don't get it.\Anyway, I've worked out what we need to do, so let's start tackling it.\What?\You seem to be getting on well enough with them. response:	Yeah, I guess so.
context: Don't put me on their level.\I don't care about looking interesting.\I'm just self-conscious.\Huh... I don't get it.\Anyway, I've worked out what we need to do, so let's start tackling it.\What?\You seem to be getting on well enough with them.\Yeah, I guess so. response:	But you're the one who taught me
context: I don't care about looking interesting.\I'm just self-conscious.\Huh... I don't get it.\Anyway, I've worked out what we need to do, so let's start tackling it.\What?\You seem to be getting on well enough with them.\Yeah, I guess so.\But you're the one who taught me response:	that younger girls trying to learn something are cute, right?
context: I'm just self-conscious.\Huh... I don't get it.\Anyway, I've worked out what we need to do, so let's start tackling it.\What?\You seem to be getting on well enough with them.\Yeah, I guess so.\But you're the one who taught me\that younger girls trying to learn something are cute, right? response:	I didn't teach you that.
context: Huh... I don't get it.\Anyway, I've worked out what we need to do, so let's start tackling it.\What?\You seem to be getting on well enough with them.\Yeah, I guess so.\But you're the one who taught me\that younger girls trying to learn something are cute, right?\I didn't teach you that. response:	But now you don't need me, do you?
context: Anyway, I've worked out what we need to do, so let's start tackling it.\What?\You seem to be getting on well enough with them.\Yeah, I guess so.\But you're the one who taught me\that younger girls trying to learn something are cute, right?\I didn't teach you that.\But now you don't need me, do you? response:	Ah... Well...
context: What?\You seem to be getting on well enough with them.\Yeah, I guess so.\But you're the one who taught me\that younger girls trying to learn something are cute, right?\I didn't teach you that.\But now you don't need me, do you?\Ah... Well... response:	Iroha-chan, can you take care of these, too?
context: You seem to be getting on well enough with them.\Yeah, I guess so.\But you're the one who taught me\that younger girls trying to learn something are cute, right?\I didn't teach you that.\But now you don't need me, do you?\Ah... Well...\Iroha-chan, can you take care of these, too? response:	Also this, and this, and this, too.
context: Yeah, I guess so.\But you're the one who taught me\that younger girls trying to learn something are cute, right?\I didn't teach you that.\But now you don't need me, do you?\Ah... Well...\Iroha-chan, can you take care of these, too?\Also this, and this, and this, too. response:	Ah, okay.
context: But you're the one who taught me\that younger girls trying to learn something are cute, right?\I didn't teach you that.\But now you don't need me, do you?\Ah... Well...\Iroha-chan, can you take care of these, too?\Also this, and this, and this, too.\Ah, okay. response:	If there's anything you don't understand, let me know.
context: that younger girls trying to learn something are cute, right?\I didn't teach you that.\But now you don't need me, do you?\Ah... Well...\Iroha-chan, can you take care of these, too?\Also this, and this, and this, too.\Ah, okay.\If there's anything you don't understand, let me know. response:	I'll explain it so you can understand.
context: I didn't teach you that.\But now you don't need me, do you?\Ah... Well...\Iroha-chan, can you take care of these, too?\Also this, and this, and this, too.\Ah, okay.\If there's anything you don't understand, let me know.\I'll explain it so you can understand. response:	So as you heard, getting the minutes together will be our job, too.
context: But now you don't need me, do you?\Ah... Well...\Iroha-chan, can you take care of these, too?\Also this, and this, and this, too.\Ah, okay.\If there's anything you don't understand, let me know.\I'll explain it so you can understand.\So as you heard, getting the minutes together will be our job, too. response:	I'm counting on all of you.
context: Ah... Well...\Iroha-chan, can you take care of these, too?\Also this, and this, and this, too.\Ah, okay.\If there's anything you don't understand, let me know.\I'll explain it so you can understand.\So as you heard, getting the minutes together will be our job, too.\I'm counting on all of you. response:	Doesn't look like we can say the student council is functioning well.
context: Iroha-chan, can you take care of these, too?\Also this, and this, and this, too.\Ah, okay.\If there's anything you don't understand, let me know.\I'll explain it so you can understand.\So as you heard, getting the minutes together will be our job, too.\I'm counting on all of you.\Doesn't look like we can say the student council is functioning well. response:	I'm sure there's some reservation between them,
context: Also this, and this, and this, too.\Ah, okay.\If there's anything you don't understand, let me know.\I'll explain it so you can understand.\So as you heard, getting the minutes together will be our job, too.\I'm counting on all of you.\Doesn't look like we can say the student council is functioning well.\I'm sure there's some reservation between them, response:	but it looks like that's hindering their communication.
context: Ah, okay.\If there's anything you don't understand, let me know.\I'll explain it so you can understand.\So as you heard, getting the minutes together will be our job, too.\I'm counting on all of you.\Doesn't look like we can say the student council is functioning well.\I'm sure there's some reservation between them,\but it looks like that's hindering their communication. response:	President, is this okay?
context: If there's anything you don't understand, let me know.\I'll explain it so you can understand.\So as you heard, getting the minutes together will be our job, too.\I'm counting on all of you.\Doesn't look like we can say the student council is functioning well.\I'm sure there's some reservation between them,\but it looks like that's hindering their communication.\President, is this okay? response:	Oh... I'll check.
context: I'll explain it so you can understand.\So as you heard, getting the minutes together will be our job, too.\I'm counting on all of you.\Doesn't look like we can say the student council is functioning well.\I'm sure there's some reservation between them,\but it looks like that's hindering their communication.\President, is this okay?\Oh... I'll check. response:	Also, about the way this work is progressing...
context: So as you heard, getting the minutes together will be our job, too.\I'm counting on all of you.\Doesn't look like we can say the student council is functioning well.\I'm sure there's some reservation between them,\but it looks like that's hindering their communication.\President, is this okay?\Oh... I'll check.\Also, about the way this work is progressing... response:	Yes?
context: I'm counting on all of you.\Doesn't look like we can say the student council is functioning well.\I'm sure there's some reservation between them,\but it looks like that's hindering their communication.\President, is this okay?\Oh... I'll check.\Also, about the way this work is progressing...\Yes? response:	Actually, never mind.
context: Doesn't look like we can say the student council is functioning well.\I'm sure there's some reservation between them,\but it looks like that's hindering their communication.\President, is this okay?\Oh... I'll check.\Also, about the way this work is progressing...\Yes?\Actually, never mind. response:	He's the vice president.
context: I'm sure there's some reservation between them,\but it looks like that's hindering their communication.\President, is this okay?\Oh... I'll check.\Also, about the way this work is progressing...\Yes?\Actually, never mind.\He's the vice president. response:	Looks like you've got it rough.
context: but it looks like that's hindering their communication.\President, is this okay?\Oh... I'll check.\Also, about the way this work is progressing...\Yes?\Actually, never mind.\He's the vice president.\Looks like you've got it rough. response:	I don't think he likes me much...
context: President, is this okay?\Oh... I'll check.\Also, about the way this work is progressing...\Yes?\Actually, never mind.\He's the vice president.\Looks like you've got it rough.\I don't think he likes me much... response:	But that's how it always goes at first.
context: Oh... I'll check.\Also, about the way this work is progressing...\Yes?\Actually, never mind.\He's the vice president.\Looks like you've got it rough.\I don't think he likes me much...\But that's how it always goes at first. response:	He'll get used to me eventually.
context: Also, about the way this work is progressing...\Yes?\Actually, never mind.\He's the vice president.\Looks like you've got it rough.\I don't think he likes me much...\But that's how it always goes at first.\He'll get used to me eventually. response:	Mihama Library
context: Yes?\Actually, never mind.\He's the vice president.\Looks like you've got it rough.\I don't think he likes me much...\But that's how it always goes at first.\He'll get used to me eventually.\Mihama Library response:	Takasu Community Festival
context: Actually, never mind.\He's the vice president.\Looks like you've got it rough.\I don't think he likes me much...\But that's how it always goes at first.\He'll get used to me eventually.\Mihama Library\Takasu Community Festival response:	Senpai!
context: He's the vice president.\Looks like you've got it rough.\I don't think he likes me much...\But that's how it always goes at first.\He'll get used to me eventually.\Mihama Library\Takasu Community Festival\Senpai! response:	Your reactions are too weak.
context: Looks like you've got it rough.\I don't think he likes me much...\But that's how it always goes at first.\He'll get used to me eventually.\Mihama Library\Takasu Community Festival\Senpai!\Your reactions are too weak. response:	Because you're just being sneaky with that.
context: I don't think he likes me much...\But that's how it always goes at first.\He'll get used to me eventually.\Mihama Library\Takasu Community Festival\Senpai!\Your reactions are too weak.\Because you're just being sneaky with that. response:	Oh, come on. I'm just being natural.
context: But that's how it always goes at first.\He'll get used to me eventually.\Mihama Library\Takasu Community Festival\Senpai!\Your reactions are too weak.\Because you're just being sneaky with that.\Oh, come on. I'm just being natural. response:	But you know, I think that's pretty sneaky of you, too.
context: He'll get used to me eventually.\Mihama Library\Takasu Community Festival\Senpai!\Your reactions are too weak.\Because you're just being sneaky with that.\Oh, come on. I'm just being natural.\But you know, I think that's pretty sneaky of you, too. response:	Oh, come on. I'm just being natural.
context: Mihama Library\Takasu Community Festival\Senpai!\Your reactions are too weak.\Because you're just being sneaky with that.\Oh, come on. I'm just being natural.\But you know, I think that's pretty sneaky of you, too.\Oh, come on. I'm just being natural. response:	Hey, wait up!
context: Takasu Community Festival\Senpai!\Your reactions are too weak.\Because you're just being sneaky with that.\Oh, come on. I'm just being natural.\But you know, I think that's pretty sneaky of you, too.\Oh, come on. I'm just being natural.\Hey, wait up! response:	Lecture Room 1
context: Senpai!\Your reactions are too weak.\Because you're just being sneaky with that.\Oh, come on. I'm just being natural.\But you know, I think that's pretty sneaky of you, too.\Oh, come on. I'm just being natural.\Hey, wait up!\Lecture Room 1 response:	Our outline of the plan hasn't completely solidified yet,
context: Your reactions are too weak.\Because you're just being sneaky with that.\Oh, come on. I'm just being natural.\But you know, I think that's pretty sneaky of you, too.\Oh, come on. I'm just being natural.\Hey, wait up!\Lecture Room 1\Our outline of the plan hasn't completely solidified yet, response:	so let's continue our brainstorming from yesterday.
context: Because you're just being sneaky with that.\Oh, come on. I'm just being natural.\But you know, I think that's pretty sneaky of you, too.\Oh, come on. I'm just being natural.\Hey, wait up!\Lecture Room 1\Our outline of the plan hasn't completely solidified yet,\so let's continue our brainstorming from yesterday. response:	As long as we're doing this, I'd like to make it more flashy.
context: Oh, come on. I'm just being natural.\But you know, I think that's pretty sneaky of you, too.\Oh, come on. I'm just being natural.\Hey, wait up!\Lecture Room 1\Our outline of the plan hasn't completely solidified yet,\so let's continue our brainstorming from yesterday.\As long as we're doing this, I'd like to make it more flashy. response:	Yeah! That's the thing!
context: But you know, I think that's pretty sneaky of you, too.\Oh, come on. I'm just being natural.\Hey, wait up!\Lecture Room 1\Our outline of the plan hasn't completely solidified yet,\so let's continue our brainstorming from yesterday.\As long as we're doing this, I'd like to make it more flashy.\Yeah! That's the thing! response:	We should do something big, something with a real bang!
context: Oh, come on. I'm just being natural.\Hey, wait up!\Lecture Room 1\Our outline of the plan hasn't completely solidified yet,\so let's continue our brainstorming from yesterday.\As long as we're doing this, I'd like to make it more flashy.\Yeah! That's the thing!\We should do something big, something with a real bang! response:	Yes, we may have been pulling everything together too closely.
context: Hey, wait up!\Lecture Room 1\Our outline of the plan hasn't completely solidified yet,\so let's continue our brainstorming from yesterday.\As long as we're doing this, I'd like to make it more flashy.\Yeah! That's the thing!\We should do something big, something with a real bang!\Yes, we may have been pulling everything together too closely. response:	Huh? Really? Something was pulled together?
context: Lecture Room 1\Our outline of the plan hasn't completely solidified yet,\so let's continue our brainstorming from yesterday.\As long as we're doing this, I'd like to make it more flashy.\Yeah! That's the thing!\We should do something big, something with a real bang!\Yes, we may have been pulling everything together too closely.\Huh? Really? Something was pulled together? response:	The minutes don't have anything in them but logical thinking blah blah blah.
context: Our outline of the plan hasn't completely solidified yet,\so let's continue our brainstorming from yesterday.\As long as we're doing this, I'd like to make it more flashy.\Yeah! That's the thing!\We should do something big, something with a real bang!\Yes, we may have been pulling everything together too closely.\Huh? Really? Something was pulled together?\The minutes don't have anything in them but logical thinking blah blah blah. response:	I don't know what I'm supposed to do.
context: so let's continue our brainstorming from yesterday.\As long as we're doing this, I'd like to make it more flashy.\Yeah! That's the thing!\We should do something big, something with a real bang!\Yes, we may have been pulling everything together too closely.\Huh? Really? Something was pulled together?\The minutes don't have anything in them but logical thinking blah blah blah.\I don't know what I'm supposed to do. response:	Well, that's because nothing specific has been settled on yet.
context: As long as we're doing this, I'd like to make it more flashy.\Yeah! That's the thing!\We should do something big, something with a real bang!\Yes, we may have been pulling everything together too closely.\Huh? Really? Something was pulled together?\The minutes don't have anything in them but logical thinking blah blah blah.\I don't know what I'm supposed to do.\Well, that's because nothing specific has been settled on yet. response:	I think we should increase the scale.
context: Yeah! That's the thing!\We should do something big, something with a real bang!\Yes, we may have been pulling everything together too closely.\Huh? Really? Something was pulled together?\The minutes don't have anything in them but logical thinking blah blah blah.\I don't know what I'm supposed to do.\Well, that's because nothing specific has been settled on yet.\I think we should increase the scale. response:	What do you think?
context: We should do something big, something with a real bang!\Yes, we may have been pulling everything together too closely.\Huh? Really? Something was pulled together?\The minutes don't have anything in them but logical thinking blah blah blah.\I don't know what I'm supposed to do.\Well, that's because nothing specific has been settled on yet.\I think we should increase the scale.\What do you think? response:	Ah...
context: Yes, we may have been pulling everything together too closely.\Huh? Really? Something was pulled together?\The minutes don't have anything in them but logical thinking blah blah blah.\I don't know what I'm supposed to do.\Well, that's because nothing specific has been settled on yet.\I think we should increase the scale.\What do you think?\Ah... response:	You might be right.
context: Huh? Really? Something was pulled together?\The minutes don't have anything in them but logical thinking blah blah blah.\I don't know what I'm supposed to do.\Well, that's because nothing specific has been settled on yet.\I think we should increase the scale.\What do you think?\Ah...\You might be right. response:	We don't have the time or the personnel to increase the scale.
context: The minutes don't have anything in them but logical thinking blah blah blah.\I don't know what I'm supposed to do.\Well, that's because nothing specific has been settled on yet.\I think we should increase the scale.\What do you think?\Ah...\You might be right.\We don't have the time or the personnel to increase the scale. response:	No, no, not like that.
context: I don't know what I'm supposed to do.\Well, that's because nothing specific has been settled on yet.\I think we should increase the scale.\What do you think?\Ah...\You might be right.\We don't have the time or the personnel to increase the scale.\No, no, not like that. response:	When brainstorming, you don't reject another's opinion.
context: Well, that's because nothing specific has been settled on yet.\I think we should increase the scale.\What do you think?\Ah...\You might be right.\We don't have the time or the personnel to increase the scale.\No, no, not like that.\When brainstorming, you don't reject another's opinion. response:	We can't make this any bigger because we lack the time and personnel.
context: I think we should increase the scale.\What do you think?\Ah...\You might be right.\We don't have the time or the personnel to increase the scale.\No, no, not like that.\When brainstorming, you don't reject another's opinion.\We can't make this any bigger because we lack the time and personnel. response:	So how should we deal with that?
context: What do you think?\Ah...\You might be right.\We don't have the time or the personnel to increase the scale.\No, no, not like that.\When brainstorming, you don't reject another's opinion.\We can't make this any bigger because we lack the time and personnel.\So how should we deal with that? response:	We expand the discussion in that way.
context: Ah...\You might be right.\We don't have the time or the personnel to increase the scale.\No, no, not like that.\When brainstorming, you don't reject another's opinion.\We can't make this any bigger because we lack the time and personnel.\So how should we deal with that?\We expand the discussion in that way. response:	We mustn't come to a conclusion right away.
context: You might be right.\We don't have the time or the personnel to increase the scale.\No, no, not like that.\When brainstorming, you don't reject another's opinion.\We can't make this any bigger because we lack the time and personnel.\So how should we deal with that?\We expand the discussion in that way.\We mustn't come to a conclusion right away. response:	So your opinion doesn't work.
context: We don't have the time or the personnel to increase the scale.\No, no, not like that.\When brainstorming, you don't reject another's opinion.\We can't make this any bigger because we lack the time and personnel.\So how should we deal with that?\We expand the discussion in that way.\We mustn't come to a conclusion right away.\So your opinion doesn't work. response:	O-Okay...
context: No, no, not like that.\When brainstorming, you don't reject another's opinion.\We can't make this any bigger because we lack the time and personnel.\So how should we deal with that?\We expand the discussion in that way.\We mustn't come to a conclusion right away.\So your opinion doesn't work.\O-Okay... response:	For all you said, you wasted no time rejecting my opinion...
context: When brainstorming, you don't reject another's opinion.\We can't make this any bigger because we lack the time and personnel.\So how should we deal with that?\We expand the discussion in that way.\We mustn't come to a conclusion right away.\So your opinion doesn't work.\O-Okay...\For all you said, you wasted no time rejecting my opinion... response:	Let's discuss how to make it possible.
context: We can't make this any bigger because we lack the time and personnel.\So how should we deal with that?\We expand the discussion in that way.\We mustn't come to a conclusion right away.\So your opinion doesn't work.\O-Okay...\For all you said, you wasted no time rejecting my opinion...\Let's discuss how to make it possible. response:	Why don't we bring in more local high schools?
context: So how should we deal with that?\We expand the discussion in that way.\We mustn't come to a conclusion right away.\So your opinion doesn't work.\O-Okay...\For all you said, you wasted no time rejecting my opinion...\Let's discuss how to make it possible.\Why don't we bring in more local high schools? response:	Whoa, whoa. Why do people who want to look interesting
context: We expand the discussion in that way.\We mustn't come to a conclusion right away.\So your opinion doesn't work.\O-Okay...\For all you said, you wasted no time rejecting my opinion...\Let's discuss how to make it possible.\Why don't we bring in more local high schools?\Whoa, whoa. Why do people who want to look interesting response:	love working with others so much?
context: We mustn't come to a conclusion right away.\So your opinion doesn't work.\O-Okay...\For all you said, you wasted no time rejecting my opinion...\Let's discuss how to make it possible.\Why don't we bring in more local high schools?\Whoa, whoa. Why do people who want to look interesting\love working with others so much? response:	There's no merit in bringing in more schools.
context: So your opinion doesn't work.\O-Okay...\For all you said, you wasted no time rejecting my opinion...\Let's discuss how to make it possible.\Why don't we bring in more local high schools?\Whoa, whoa. Why do people who want to look interesting\love working with others so much?\There's no merit in bringing in more schools. response:	Sounds good. We'd be involving the community.
context: O-Okay...\For all you said, you wasted no time rejecting my opinion...\Let's discuss how to make it possible.\Why don't we bring in more local high schools?\Whoa, whoa. Why do people who want to look interesting\love working with others so much?\There's no merit in bringing in more schools.\Sounds good. We'd be involving the community. response:	But a simple objection like that would be crushed.
context: For all you said, you wasted no time rejecting my opinion...\Let's discuss how to make it possible.\Why don't we bring in more local high schools?\Whoa, whoa. Why do people who want to look interesting\love working with others so much?\There's no merit in bringing in more schools.\Sounds good. We'd be involving the community.\But a simple objection like that would be crushed. response:	In that case, we could work toward closing generation gaps.
context: Let's discuss how to make it possible.\Why don't we bring in more local high schools?\Whoa, whoa. Why do people who want to look interesting\love working with others so much?\There's no merit in bringing in more schools.\Sounds good. We'd be involving the community.\But a simple objection like that would be crushed.\In that case, we could work toward closing generation gaps. response:	That'll work!
context: Why don't we bring in more local high schools?\Whoa, whoa. Why do people who want to look interesting\love working with others so much?\There's no merit in bringing in more schools.\Sounds good. We'd be involving the community.\But a simple objection like that would be crushed.\In that case, we could work toward closing generation gaps.\That'll work! response:	I'll have to say this in a way that fits their rules.
context: Whoa, whoa. Why do people who want to look interesting\love working with others so much?\There's no merit in bringing in more schools.\Sounds good. We'd be involving the community.\But a simple objection like that would be crushed.\In that case, we could work toward closing generation gaps.\That'll work!\I'll have to say this in a way that fits their rules. response:	This is just a fresh idea.
context: love working with others so much?\There's no merit in bringing in more schools.\Sounds good. We'd be involving the community.\But a simple objection like that would be crushed.\In that case, we could work toward closing generation gaps.\That'll work!\I'll have to say this in a way that fits their rules.\This is just a fresh idea. response:	As a counter to your previous suggestion,
context: There's no merit in bringing in more schools.\Sounds good. We'd be involving the community.\But a simple objection like that would be crushed.\In that case, we could work toward closing generation gaps.\That'll work!\I'll have to say this in a way that fits their rules.\This is just a fresh idea.\As a counter to your previous suggestion, response:	I feel it would be better to strive for the maximum synergetic effect
context: Sounds good. We'd be involving the community.\But a simple objection like that would be crushed.\In that case, we could work toward closing generation gaps.\That'll work!\I'll have to say this in a way that fits their rules.\This is just a fresh idea.\As a counter to your previous suggestion,\I feel it would be better to strive for the maximum synergetic effect response:	by having our two schools cooperate to build a closer relationship.
context: But a simple objection like that would be crushed.\In that case, we could work toward closing generation gaps.\That'll work!\I'll have to say this in a way that fits their rules.\This is just a fresh idea.\As a counter to your previous suggestion,\I feel it would be better to strive for the maximum synergetic effect\by having our two schools cooperate to build a closer relationship. response:	What do you think?
context: In that case, we could work toward closing generation gaps.\That'll work!\I'll have to say this in a way that fits their rules.\This is just a fresh idea.\As a counter to your previous suggestion,\I feel it would be better to strive for the maximum synergetic effect\by having our two schools cooperate to build a closer relationship.\What do you think? response:	I see...
context: That'll work!\I'll have to say this in a way that fits their rules.\This is just a fresh idea.\As a counter to your previous suggestion,\I feel it would be better to strive for the maximum synergetic effect\by having our two schools cooperate to build a closer relationship.\What do you think?\I see... response:	So it shouldn't be a high school. Perhaps college students...
context: I'll have to say this in a way that fits their rules.\This is just a fresh idea.\As a counter to your previous suggestion,\I feel it would be better to strive for the maximum synergetic effect\by having our two schools cooperate to build a closer relationship.\What do you think?\I see...\So it shouldn't be a high school. Perhaps college students... response:	It didn't work!
context: This is just a fresh idea.\As a counter to your previous suggestion,\I feel it would be better to strive for the maximum synergetic effect\by having our two schools cooperate to build a closer relationship.\What do you think?\I see...\So it shouldn't be a high school. Perhaps college students...\It didn't work! response:	No, wait. Then we can't take initiative.
context: As a counter to your previous suggestion,\I feel it would be better to strive for the maximum synergetic effect\by having our two schools cooperate to build a closer relationship.\What do you think?\I see...\So it shouldn't be a high school. Perhaps college students...\It didn't work!\No, wait. Then we can't take initiative. response:	Even if we're to reach a consensus with our stakeholders,
context: I feel it would be better to strive for the maximum synergetic effect\by having our two schools cooperate to build a closer relationship.\What do you think?\I see...\So it shouldn't be a high school. Perhaps college students...\It didn't work!\No, wait. Then we can't take initiative.\Even if we're to reach a consensus with our stakeholders, response:	we need a partnership in which we can offer clear suggestions of a solid manifesto...
context: by having our two schools cooperate to build a closer relationship.\What do you think?\I see...\So it shouldn't be a high school. Perhaps college students...\It didn't work!\No, wait. Then we can't take initiative.\Even if we're to reach a consensus with our stakeholders,\we need a partnership in which we can offer clear suggestions of a solid manifesto... response:	Senpai, what are you talking about?
context: What do you think?\I see...\So it shouldn't be a high school. Perhaps college students...\It didn't work!\No, wait. Then we can't take initiative.\Even if we're to reach a consensus with our stakeholders,\we need a partnership in which we can offer clear suggestions of a solid manifesto...\Senpai, what are you talking about? response:	I'm the one saying it, and I don't know myself.
context: I see...\So it shouldn't be a high school. Perhaps college students...\It didn't work!\No, wait. Then we can't take initiative.\Even if we're to reach a consensus with our stakeholders,\we need a partnership in which we can offer clear suggestions of a solid manifesto...\Senpai, what are you talking about?\I'm the one saying it, and I don't know myself. response:	That's true.
context: So it shouldn't be a high school. Perhaps college students...\It didn't work!\No, wait. Then we can't take initiative.\Even if we're to reach a consensus with our stakeholders,\we need a partnership in which we can offer clear suggestions of a solid manifesto...\Senpai, what are you talking about?\I'm the one saying it, and I don't know myself.\That's true. response:	He understood that?!
context: It didn't work!\No, wait. Then we can't take initiative.\Even if we're to reach a consensus with our stakeholders,\we need a partnership in which we can offer clear suggestions of a solid manifesto...\Senpai, what are you talking about?\I'm the one saying it, and I don't know myself.\That's true.\He understood that?! response:	Then how about a local elementary school?
context: No, wait. Then we can't take initiative.\Even if we're to reach a consensus with our stakeholders,\we need a partnership in which we can offer clear suggestions of a solid manifesto...\Senpai, what are you talking about?\I'm the one saying it, and I don't know myself.\That's true.\He understood that?!\Then how about a local elementary school? response:	What do you call it? Gameducation?
context: Even if we're to reach a consensus with our stakeholders,\we need a partnership in which we can offer clear suggestions of a solid manifesto...\Senpai, what are you talking about?\I'm the one saying it, and I don't know myself.\That's true.\He understood that?!\Then how about a local elementary school?\What do you call it? Gameducation? response:	If we can make the work enjoyable,
context: we need a partnership in which we can offer clear suggestions of a solid manifesto...\Senpai, what are you talking about?\I'm the one saying it, and I don't know myself.\That's true.\He understood that?!\Then how about a local elementary school?\What do you call it? Gameducation?\If we can make the work enjoyable, response:	maybe we could get a local elementary school to help.
context: Senpai, what are you talking about?\I'm the one saying it, and I don't know myself.\That's true.\He understood that?!\Then how about a local elementary school?\What do you call it? Gameducation?\If we can make the work enjoyable,\maybe we could get a local elementary school to help. response:	That'd be win-win.
context: I'm the one saying it, and I don't know myself.\That's true.\He understood that?!\Then how about a local elementary school?\What do you call it? Gameducation?\If we can make the work enjoyable,\maybe we could get a local elementary school to help.\That'd be win-win. response:	Win-win!
context: That's true.\He understood that?!\Then how about a local elementary school?\What do you call it? Gameducation?\If we can make the work enjoyable,\maybe we could get a local elementary school to help.\That'd be win-win.\Win-win! response:	Yeah! That's the thing!
context: He understood that?!\Then how about a local elementary school?\What do you call it? Gameducation?\If we can make the work enjoyable,\maybe we could get a local elementary school to help.\That'd be win-win.\Win-win!\Yeah! That's the thing! response:	What's the thing?
context: Then how about a local elementary school?\What do you call it? Gameducation?\If we can make the work enjoyable,\maybe we could get a local elementary school to help.\That'd be win-win.\Win-win!\Yeah! That's the thing!\What's the thing? response:	If we handle the appointment and negotiation of an elementary school...
context: What do you call it? Gameducation?\If we can make the work enjoyable,\maybe we could get a local elementary school to help.\That'd be win-win.\Win-win!\Yeah! That's the thing!\What's the thing?\If we handle the appointment and negotiation of an elementary school... response:	If you could handle them after that, I'd appreciate it.
context: If we can make the work enjoyable,\maybe we could get a local elementary school to help.\That'd be win-win.\Win-win!\Yeah! That's the thing!\What's the thing?\If we handle the appointment and negotiation of an elementary school...\If you could handle them after that, I'd appreciate it. response:	Good idea.
context: maybe we could get a local elementary school to help.\That'd be win-win.\Win-win!\Yeah! That's the thing!\What's the thing?\If we handle the appointment and negotiation of an elementary school...\If you could handle them after that, I'd appreciate it.\Good idea. response:	What do you think?
context: That'd be win-win.\Win-win!\Yeah! That's the thing!\What's the thing?\If we handle the appointment and negotiation of an elementary school...\If you could handle them after that, I'd appreciate it.\Good idea.\What do you think? response:	Okay, got it.
context: Win-win!\Yeah! That's the thing!\What's the thing?\If we handle the appointment and negotiation of an elementary school...\If you could handle them after that, I'd appreciate it.\Good idea.\What do you think?\Okay, got it. response:	Yo!
context: Yeah! That's the thing!\What's the thing?\If we handle the appointment and negotiation of an elementary school...\If you could handle them after that, I'd appreciate it.\Good idea.\What do you think?\Okay, got it.\Yo! response:	Were you on the student council or anything in middle school?
context: What's the thing?\If we handle the appointment and negotiation of an elementary school...\If you could handle them after that, I'd appreciate it.\Good idea.\What do you think?\Okay, got it.\Yo!\Were you on the student council or anything in middle school? response:	You seem used to it.
context: If we handle the appointment and negotiation of an elementary school...\If you could handle them after that, I'd appreciate it.\Good idea.\What do you think?\Okay, got it.\Yo!\Were you on the student council or anything in middle school?\You seem used to it. response:	I'm not.
context: If you could handle them after that, I'd appreciate it.\Good idea.\What do you think?\Okay, got it.\Yo!\Were you on the student council or anything in middle school?\You seem used to it.\I'm not. response:	Did you break up with your girlfriend?
context: Good idea.\What do you think?\Okay, got it.\Yo!\Were you on the student council or anything in middle school?\You seem used to it.\I'm not.\Did you break up with your girlfriend? response:	What?
context: What do you think?\Okay, got it.\Yo!\Were you on the student council or anything in middle school?\You seem used to it.\I'm not.\Did you break up with your girlfriend?\What? response:	I mean, it just seemed like you had your sights on Isshiki-chan.
context: Okay, got it.\Yo!\Were you on the student council or anything in middle school?\You seem used to it.\I'm not.\Did you break up with your girlfriend?\What?\I mean, it just seemed like you had your sights on Isshiki-chan. response:	I couldn't have broken up. I've never had a girlfriend.
context: Yo!\Were you on the student council or anything in middle school?\You seem used to it.\I'm not.\Did you break up with your girlfriend?\What?\I mean, it just seemed like you had your sights on Isshiki-chan.\I couldn't have broken up. I've never had a girlfriend. response:	Really? I thought you were going out with one of those two girls.
context: Were you on the student council or anything in middle school?\You seem used to it.\I'm not.\Did you break up with your girlfriend?\What?\I mean, it just seemed like you had your sights on Isshiki-chan.\I couldn't have broken up. I've never had a girlfriend.\Really? I thought you were going out with one of those two girls. response:	Which two girls?
context: You seem used to it.\I'm not.\Did you break up with your girlfriend?\What?\I mean, it just seemed like you had your sights on Isshiki-chan.\I couldn't have broken up. I've never had a girlfriend.\Really? I thought you were going out with one of those two girls.\Which two girls? response:	You know, the ones who showed up on that date.
context: I'm not.\Did you break up with your girlfriend?\What?\I mean, it just seemed like you had your sights on Isshiki-chan.\I couldn't have broken up. I've never had a girlfriend.\Really? I thought you were going out with one of those two girls.\Which two girls?\You know, the ones who showed up on that date. response:	They're just... in the same club as me.
context: Did you break up with your girlfriend?\What?\I mean, it just seemed like you had your sights on Isshiki-chan.\I couldn't have broken up. I've never had a girlfriend.\Really? I thought you were going out with one of those two girls.\Which two girls?\You know, the ones who showed up on that date.\They're just... in the same club as me. response:	You're in a club? Which one?
context: What?\I mean, it just seemed like you had your sights on Isshiki-chan.\I couldn't have broken up. I've never had a girlfriend.\Really? I thought you were going out with one of those two girls.\Which two girls?\You know, the ones who showed up on that date.\They're just... in the same club as me.\You're in a club? Which one? response:	The Service Club.
context: I mean, it just seemed like you had your sights on Isshiki-chan.\I couldn't have broken up. I've never had a girlfriend.\Really? I thought you were going out with one of those two girls.\Which two girls?\You know, the ones who showed up on that date.\They're just... in the same club as me.\You're in a club? Which one?\The Service Club. response:	What is that? I don't get it!
context: I couldn't have broken up. I've never had a girlfriend.\Really? I thought you were going out with one of those two girls.\Which two girls?\You know, the ones who showed up on that date.\They're just... in the same club as me.\You're in a club? Which one?\The Service Club.\What is that? I don't get it! response:	That's hilarious!
context: Really? I thought you were going out with one of those two girls.\Which two girls?\You know, the ones who showed up on that date.\They're just... in the same club as me.\You're in a club? Which one?\The Service Club.\What is that? I don't get it!\That's hilarious! response:	No, it's not.
context: Which two girls?\You know, the ones who showed up on that date.\They're just... in the same club as me.\You're in a club? Which one?\The Service Club.\What is that? I don't get it!\That's hilarious!\No, it's not. response:	Seriously, what does that club do?
context: You know, the ones who showed up on that date.\They're just... in the same club as me.\You're in a club? Which one?\The Service Club.\What is that? I don't get it!\That's hilarious!\No, it's not.\Seriously, what does that club do? response:	That's my first seriously of the day!
context: They're just... in the same club as me.\You're in a club? Which one?\The Service Club.\What is that? I don't get it!\That's hilarious!\No, it's not.\Seriously, what does that club do?\That's my first seriously of the day! response:	Yeah, it is a club that doesn't make much sense.
context: You're in a club? Which one?\The Service Club.\What is that? I don't get it!\That's hilarious!\No, it's not.\Seriously, what does that club do?\That's my first seriously of the day!\Yeah, it is a club that doesn't make much sense. response:	I've never heard of a Service Club before!
context: The Service Club.\What is that? I don't get it!\That's hilarious!\No, it's not.\Seriously, what does that club do?\That's my first seriously of the day!\Yeah, it is a club that doesn't make much sense.\I've never heard of a Service Club before! response:	But it's not funny.
context: What is that? I don't get it!\That's hilarious!\No, it's not.\Seriously, what does that club do?\That's my first seriously of the day!\Yeah, it is a club that doesn't make much sense.\I've never heard of a Service Club before!\But it's not funny. response:	Without Incident, The Congress Dances, But Does Not Progress.
context: That's hilarious!\No, it's not.\Seriously, what does that club do?\That's my first seriously of the day!\Yeah, it is a club that doesn't make much sense.\I've never heard of a Service Club before!\But it's not funny.\Without Incident, The Congress Dances, But Does Not Progress. response:	There's really nothing to laugh about.
context: No, it's not.\Seriously, what does that club do?\That's my first seriously of the day!\Yeah, it is a club that doesn't make much sense.\I've never heard of a Service Club before!\But it's not funny.\Without Incident, The Congress Dances, But Does Not Progress.\There's really nothing to laugh about. response:	07 Yet, That Room Continues to Play Out the Endless Days.
context: Seriously, what does that club do?\That's my first seriously of the day!\Yeah, it is a club that doesn't make much sense.\I've never heard of a Service Club before!\But it's not funny.\Without Incident, The Congress Dances, But Does Not Progress.\There's really nothing to laugh about.\07 Yet, That Room Continues to Play Out the Endless Days. response:	We should consider the priority of each task
context: That's my first seriously of the day!\Yeah, it is a club that doesn't make much sense.\I've never heard of a Service Club before!\But it's not funny.\Without Incident, The Congress Dances, But Does Not Progress.\There's really nothing to laugh about.\07 Yet, That Room Continues to Play Out the Endless Days.\We should consider the priority of each task response:	and come up with an order of priority.
context: Yeah, it is a club that doesn't make much sense.\I've never heard of a Service Club before!\But it's not funny.\Without Incident, The Congress Dances, But Does Not Progress.\There's really nothing to laugh about.\07 Yet, That Room Continues to Play Out the Endless Days.\We should consider the priority of each task\and come up with an order of priority. response:	That'll work!
context: I've never heard of a Service Club before!\But it's not funny.\Without Incident, The Congress Dances, But Does Not Progress.\There's really nothing to laugh about.\07 Yet, That Room Continues to Play Out the Endless Days.\We should consider the priority of each task\and come up with an order of priority.\That'll work! response:	Those mean the same thing.
context: But it's not funny.\Without Incident, The Congress Dances, But Does Not Progress.\There's really nothing to laugh about.\07 Yet, That Room Continues to Play Out the Endless Days.\We should consider the priority of each task\and come up with an order of priority.\That'll work!\Those mean the same thing. response:	How many times do you want to prioritize?
context: Without Incident, The Congress Dances, But Does Not Progress.\There's really nothing to laugh about.\07 Yet, That Room Continues to Play Out the Endless Days.\We should consider the priority of each task\and come up with an order of priority.\That'll work!\Those mean the same thing.\How many times do you want to prioritize? response:	What's being demanded of us now
context: There's really nothing to laugh about.\07 Yet, That Room Continues to Play Out the Endless Days.\We should consider the priority of each task\and come up with an order of priority.\That'll work!\Those mean the same thing.\How many times do you want to prioritize?\What's being demanded of us now response:	is the flexibility of flexible ideas that only young minds can invent!
context: 07 Yet, That Room Continues to Play Out the Endless Days.\We should consider the priority of each task\and come up with an order of priority.\That'll work!\Those mean the same thing.\How many times do you want to prioritize?\What's being demanded of us now\is the flexibility of flexible ideas that only young minds can invent! response:	That's the thing!
context: We should consider the priority of each task\and come up with an order of priority.\That'll work!\Those mean the same thing.\How many times do you want to prioritize?\What's being demanded of us now\is the flexibility of flexible ideas that only young minds can invent!\That's the thing! response:	Those mean the same thing.
context: and come up with an order of priority.\That'll work!\Those mean the same thing.\How many times do you want to prioritize?\What's being demanded of us now\is the flexibility of flexible ideas that only young minds can invent!\That's the thing!\Those mean the same thing. response:	How flexible are we supposed to get?
context: That'll work!\Those mean the same thing.\How many times do you want to prioritize?\What's being demanded of us now\is the flexibility of flexible ideas that only young minds can invent!\That's the thing!\Those mean the same thing.\How flexible are we supposed to get? response:	All right. Now our scheme to drop all of our resources into this event is ready.
context: Those mean the same thing.\How many times do you want to prioritize?\What's being demanded of us now\is the flexibility of flexible ideas that only young minds can invent!\That's the thing!\Those mean the same thing.\How flexible are we supposed to get?\All right. Now our scheme to drop all of our resources into this event is ready. response:	I look forward to our next brainstorm!
context: How many times do you want to prioritize?\What's being demanded of us now\is the flexibility of flexible ideas that only young minds can invent!\That's the thing!\Those mean the same thing.\How flexible are we supposed to get?\All right. Now our scheme to drop all of our resources into this event is ready.\I look forward to our next brainstorm! response:	Getting ready is all we've done...