context: Say, Nana Komatsu. response:	Do you remember the first time we met?
context: Say, Nana Komatsu.\Do you remember the first time we met? response:	I'm the type who doesn't believe in fate one bit.
context: Say, Nana Komatsu.\Do you remember the first time we met?\I'm the type who doesn't believe in fate one bit. response:	I think this was all a coincidence.
context: Say, Nana Komatsu.\Do you remember the first time we met?\I'm the type who doesn't believe in fate one bit.\I think this was all a coincidence. response:	When I was darkness at that time
context: Say, Nana Komatsu.\Do you remember the first time we met?\I'm the type who doesn't believe in fate one bit.\I think this was all a coincidence.\When I was darkness at that time response:	With trembling lips
context: Say, Nana Komatsu.\Do you remember the first time we met?\I'm the type who doesn't believe in fate one bit.\I think this was all a coincidence.\When I was darkness at that time\With trembling lips response:	The more I struggle
context: Say, Nana Komatsu.\Do you remember the first time we met?\I'm the type who doesn't believe in fate one bit.\I think this was all a coincidence.\When I was darkness at that time\With trembling lips\The more I struggle response:	The more this wound deepens
context: Say, Nana Komatsu.\Do you remember the first time we met?\I'm the type who doesn't believe in fate one bit.\I think this was all a coincidence.\When I was darkness at that time\With trembling lips\The more I struggle\The more this wound deepens response:	The broken promise hurt me
context: Do you remember the first time we met?\I'm the type who doesn't believe in fate one bit.\I think this was all a coincidence.\When I was darkness at that time\With trembling lips\The more I struggle\The more this wound deepens\The broken promise hurt me response:	Nobody can save me
context: I'm the type who doesn't believe in fate one bit.\I think this was all a coincidence.\When I was darkness at that time\With trembling lips\The more I struggle\The more this wound deepens\The broken promise hurt me\Nobody can save me response:	God, I have only one request
context: I think this was all a coincidence.\When I was darkness at that time\With trembling lips\The more I struggle\The more this wound deepens\The broken promise hurt me\Nobody can save me\God, I have only one request response:	Stop tearing apart my love
context: When I was darkness at that time\With trembling lips\The more I struggle\The more this wound deepens\The broken promise hurt me\Nobody can save me\God, I have only one request\Stop tearing apart my love response:	I need your love
context: With trembling lips\The more I struggle\The more this wound deepens\The broken promise hurt me\Nobody can save me\God, I have only one request\Stop tearing apart my love\I need your love response:	I'm a broken rose
context: The more I struggle\The more this wound deepens\The broken promise hurt me\Nobody can save me\God, I have only one request\Stop tearing apart my love\I need your love\I'm a broken rose response:	Sorrow tumbling down is your song
context: The more this wound deepens\The broken promise hurt me\Nobody can save me\God, I have only one request\Stop tearing apart my love\I need your love\I'm a broken rose\Sorrow tumbling down is your song response:	All alone with nowhere to go in my life
context: The broken promise hurt me\Nobody can save me\God, I have only one request\Stop tearing apart my love\I need your love\I'm a broken rose\Sorrow tumbling down is your song\All alone with nowhere to go in my life response:	I need your love
context: Nobody can save me\God, I have only one request\Stop tearing apart my love\I need your love\I'm a broken rose\Sorrow tumbling down is your song\All alone with nowhere to go in my life\I need your love response:	I'm a broken rose
context: God, I have only one request\Stop tearing apart my love\I need your love\I'm a broken rose\Sorrow tumbling down is your song\All alone with nowhere to go in my life\I need your love\I'm a broken rose response:	Oh baby, help me from frozen pain
context: Stop tearing apart my love\I need your love\I'm a broken rose\Sorrow tumbling down is your song\All alone with nowhere to go in my life\I need your love\I'm a broken rose\Oh baby, help me from frozen pain response:	With your smile, your eyes, and sing me, just for me
context: I need your love\I'm a broken rose\Sorrow tumbling down is your song\All alone with nowhere to go in my life\I need your love\I'm a broken rose\Oh baby, help me from frozen pain\With your smile, your eyes, and sing me, just for me response:	I wanna need your love
context: I'm a broken rose\Sorrow tumbling down is your song\All alone with nowhere to go in my life\I need your love\I'm a broken rose\Oh baby, help me from frozen pain\With your smile, your eyes, and sing me, just for me\I wanna need your love response:	I'm a broken rose
context: Sorrow tumbling down is your song\All alone with nowhere to go in my life\I need your love\I'm a broken rose\Oh baby, help me from frozen pain\With your smile, your eyes, and sing me, just for me\I wanna need your love\I'm a broken rose response:	I wanna need your love
context: All alone with nowhere to go in my life\I need your love\I'm a broken rose\Oh baby, help me from frozen pain\With your smile, your eyes, and sing me, just for me\I wanna need your love\I'm a broken rose\I wanna need your love response:	I thought it was Nana's room?
context: I need your love\I'm a broken rose\Oh baby, help me from frozen pain\With your smile, your eyes, and sing me, just for me\I wanna need your love\I'm a broken rose\I wanna need your love\I thought it was Nana's room? response:	No, this is my room. I'm the master here, you know.
context: I'm a broken rose\Oh baby, help me from frozen pain\With your smile, your eyes, and sing me, just for me\I wanna need your love\I'm a broken rose\I wanna need your love\I thought it was Nana's room?\No, this is my room. I'm the master here, you know. response:	You are?
context: Oh baby, help me from frozen pain\With your smile, your eyes, and sing me, just for me\I wanna need your love\I'm a broken rose\I wanna need your love\I thought it was Nana's room?\No, this is my room. I'm the master here, you know.\You are? response:	You know what?
context: With your smile, your eyes, and sing me, just for me\I wanna need your love\I'm a broken rose\I wanna need your love\I thought it was Nana's room?\No, this is my room. I'm the master here, you know.\You are?\You know what? response:	I've been really exhausted as of late.
context: I wanna need your love\I'm a broken rose\I wanna need your love\I thought it was Nana's room?\No, this is my room. I'm the master here, you know.\You are?\You know what?\I've been really exhausted as of late. response:	Even though you play a small role?
context: I'm a broken rose\I wanna need your love\I thought it was Nana's room?\No, this is my room. I'm the master here, you know.\You are?\You know what?\I've been really exhausted as of late.\Even though you play a small role? response:	Hey, you're no different.
context: I wanna need your love\I thought it was Nana's room?\No, this is my room. I'm the master here, you know.\You are?\You know what?\I've been really exhausted as of late.\Even though you play a small role?\Hey, you're no different. response:	I'm exhausted because of Nana. Ah, the Nana also known as Hachi.
context: I thought it was Nana's room?\No, this is my room. I'm the master here, you know.\You are?\You know what?\I've been really exhausted as of late.\Even though you play a small role?\Hey, you're no different.\I'm exhausted because of Nana. Ah, the Nana also known as Hachi. response:	I see.
context: No, this is my room. I'm the master here, you know.\You are?\You know what?\I've been really exhausted as of late.\Even though you play a small role?\Hey, you're no different.\I'm exhausted because of Nana. Ah, the Nana also known as Hachi.\I see. response:	Why won't Nana get it into her head?
context: You are?\You know what?\I've been really exhausted as of late.\Even though you play a small role?\Hey, you're no different.\I'm exhausted because of Nana. Ah, the Nana also known as Hachi.\I see.\Why won't Nana get it into her head? response:	It's been one headache after another ever since she moved to Tokyo.
context: You know what?\I've been really exhausted as of late.\Even though you play a small role?\Hey, you're no different.\I'm exhausted because of Nana. Ah, the Nana also known as Hachi.\I see.\Why won't Nana get it into her head?\It's been one headache after another ever since she moved to Tokyo. response:	It's spring! Spring has finally come!
context: I've been really exhausted as of late.\Even though you play a small role?\Hey, you're no different.\I'm exhausted because of Nana. Ah, the Nana also known as Hachi.\I see.\Why won't Nana get it into her head?\It's been one headache after another ever since she moved to Tokyo.\It's spring! Spring has finally come! response:	After the long wait, spring has arrived!
context: Even though you play a small role?\Hey, you're no different.\I'm exhausted because of Nana. Ah, the Nana also known as Hachi.\I see.\Why won't Nana get it into her head?\It's been one headache after another ever since she moved to Tokyo.\It's spring! Spring has finally come!\After the long wait, spring has arrived! response:	Nana says she's on her way to Tokyo.
context: Hey, you're no different.\I'm exhausted because of Nana. Ah, the Nana also known as Hachi.\I see.\Why won't Nana get it into her head?\It's been one headache after another ever since she moved to Tokyo.\It's spring! Spring has finally come!\After the long wait, spring has arrived!\Nana says she's on her way to Tokyo. response:	- Y-Yes?! - Y-Yes?!
context: I'm exhausted because of Nana. Ah, the Nana also known as Hachi.\I see.\Why won't Nana get it into her head?\It's been one headache after another ever since she moved to Tokyo.\It's spring! Spring has finally come!\After the long wait, spring has arrived!\Nana says she's on her way to Tokyo.\- Y-Yes?! - Y-Yes?! response:	One ticket to Tokyo. One way.
context: I see.\Why won't Nana get it into her head?\It's been one headache after another ever since she moved to Tokyo.\It's spring! Spring has finally come!\After the long wait, spring has arrived!\Nana says she's on her way to Tokyo.\- Y-Yes?! - Y-Yes?!\One ticket to Tokyo. One way. response:	Okay, then. Let's make a toast.
context: Why won't Nana get it into her head?\It's been one headache after another ever since she moved to Tokyo.\It's spring! Spring has finally come!\After the long wait, spring has arrived!\Nana says she's on her way to Tokyo.\- Y-Yes?! - Y-Yes?!\One ticket to Tokyo. One way.\Okay, then. Let's make a toast. response:	A toast to what?
context: It's been one headache after another ever since she moved to Tokyo.\It's spring! Spring has finally come!\After the long wait, spring has arrived!\Nana says she's on her way to Tokyo.\- Y-Yes?! - Y-Yes?!\One ticket to Tokyo. One way.\Okay, then. Let's make a toast.\A toast to what? response:	Well...
context: It's spring! Spring has finally come!\After the long wait, spring has arrived!\Nana says she's on her way to Tokyo.\- Y-Yes?! - Y-Yes?!\One ticket to Tokyo. One way.\Okay, then. Let's make a toast.\A toast to what?\Well... response:	To Shoji passing the University exams!
context: After the long wait, spring has arrived!\Nana says she's on her way to Tokyo.\- Y-Yes?! - Y-Yes?!\One ticket to Tokyo. One way.\Okay, then. Let's make a toast.\A toast to what?\Well...\To Shoji passing the University exams! response:	No, that has nothing to do with me.
context: Nana says she's on her way to Tokyo.\- Y-Yes?! - Y-Yes?!\One ticket to Tokyo. One way.\Okay, then. Let's make a toast.\A toast to what?\Well...\To Shoji passing the University exams!\No, that has nothing to do with me. response:	Then, can we at least drink to this unique moment?
context: - Y-Yes?! - Y-Yes?!\One ticket to Tokyo. One way.\Okay, then. Let's make a toast.\A toast to what?\Well...\To Shoji passing the University exams!\No, that has nothing to do with me.\Then, can we at least drink to this unique moment? response:	Hey, I like that.
context: One ticket to Tokyo. One way.\Okay, then. Let's make a toast.\A toast to what?\Well...\To Shoji passing the University exams!\No, that has nothing to do with me.\Then, can we at least drink to this unique moment?\Hey, I like that. response:	To two girls, the same age,
context: Okay, then. Let's make a toast.\A toast to what?\Well...\To Shoji passing the University exams!\No, that has nothing to do with me.\Then, can we at least drink to this unique moment?\Hey, I like that.\To two girls, the same age, response:	arriving in Tokyo at the same time on the same train.
context: A toast to what?\Well...\To Shoji passing the University exams!\No, that has nothing to do with me.\Then, can we at least drink to this unique moment?\Hey, I like that.\To two girls, the same age,\arriving in Tokyo at the same time on the same train. response:	That's quite a coincidence, don't you think?
context: Well...\To Shoji passing the University exams!\No, that has nothing to do with me.\Then, can we at least drink to this unique moment?\Hey, I like that.\To two girls, the same age,\arriving in Tokyo at the same time on the same train.\That's quite a coincidence, don't you think? response:	And to one more thing.
context: To Shoji passing the University exams!\No, that has nothing to do with me.\Then, can we at least drink to this unique moment?\Hey, I like that.\To two girls, the same age,\arriving in Tokyo at the same time on the same train.\That's quite a coincidence, don't you think?\And to one more thing. response:	My name is Nana too, Nana.
context: No, that has nothing to do with me.\Then, can we at least drink to this unique moment?\Hey, I like that.\To two girls, the same age,\arriving in Tokyo at the same time on the same train.\That's quite a coincidence, don't you think?\And to one more thing.\My name is Nana too, Nana. response:	Nana!
context: Then, can we at least drink to this unique moment?\Hey, I like that.\To two girls, the same age,\arriving in Tokyo at the same time on the same train.\That's quite a coincidence, don't you think?\And to one more thing.\My name is Nana too, Nana.\Nana! response:	That's you, right, Nana?! No way!
context: Hey, I like that.\To two girls, the same age,\arriving in Tokyo at the same time on the same train.\That's quite a coincidence, don't you think?\And to one more thing.\My name is Nana too, Nana.\Nana!\That's you, right, Nana?! No way! response:	What a coincidence!
context: To two girls, the same age,\arriving in Tokyo at the same time on the same train.\That's quite a coincidence, don't you think?\And to one more thing.\My name is Nana too, Nana.\Nana!\That's you, right, Nana?! No way!\What a coincidence! response:	Who are you?
context: arriving in Tokyo at the same time on the same train.\That's quite a coincidence, don't you think?\And to one more thing.\My name is Nana too, Nana.\Nana!\That's you, right, Nana?! No way!\What a coincidence!\Who are you? response:	Am I such a forgettable person?
context: That's quite a coincidence, don't you think?\And to one more thing.\My name is Nana too, Nana.\Nana!\That's you, right, Nana?! No way!\What a coincidence!\Who are you?\Am I such a forgettable person? response:	Sorry, sorry.
context: And to one more thing.\My name is Nana too, Nana.\Nana!\That's you, right, Nana?! No way!\What a coincidence!\Who are you?\Am I such a forgettable person?\Sorry, sorry. response:	Are you all right, Nana-chan?
context: My name is Nana too, Nana.\Nana!\That's you, right, Nana?! No way!\What a coincidence!\Who are you?\Am I such a forgettable person?\Sorry, sorry.\Are you all right, Nana-chan? response:	So you do remember.
context: Nana!\That's you, right, Nana?! No way!\What a coincidence!\Who are you?\Am I such a forgettable person?\Sorry, sorry.\Are you all right, Nana-chan?\So you do remember. response:	Then starting tomorrow, we're roommates, Nana-chan.
context: That's you, right, Nana?! No way!\What a coincidence!\Who are you?\Am I such a forgettable person?\Sorry, sorry.\Are you all right, Nana-chan?\So you do remember.\Then starting tomorrow, we're roommates, Nana-chan. response:	What in the world were you thinking?!
context: What a coincidence!\Who are you?\Am I such a forgettable person?\Sorry, sorry.\Are you all right, Nana-chan?\So you do remember.\Then starting tomorrow, we're roommates, Nana-chan.\What in the world were you thinking?! response:	Why not? Sharing is cool! Like the foreigners do!
context: Who are you?\Am I such a forgettable person?\Sorry, sorry.\Are you all right, Nana-chan?\So you do remember.\Then starting tomorrow, we're roommates, Nana-chan.\What in the world were you thinking?!\Why not? Sharing is cool! Like the foreigners do! response:	You're so easily fooled by others!
context: Am I such a forgettable person?\Sorry, sorry.\Are you all right, Nana-chan?\So you do remember.\Then starting tomorrow, we're roommates, Nana-chan.\What in the world were you thinking?!\Why not? Sharing is cool! Like the foreigners do!\You're so easily fooled by others! response:	I don't think it's a good idea for you to move in with a complete stranger.
context: Sorry, sorry.\Are you all right, Nana-chan?\So you do remember.\Then starting tomorrow, we're roommates, Nana-chan.\What in the world were you thinking?!\Why not? Sharing is cool! Like the foreigners do!\You're so easily fooled by others!\I don't think it's a good idea for you to move in with a complete stranger. response:	What were you thinking?
context: Are you all right, Nana-chan?\So you do remember.\Then starting tomorrow, we're roommates, Nana-chan.\What in the world were you thinking?!\Why not? Sharing is cool! Like the foreigners do!\You're so easily fooled by others!\I don't think it's a good idea for you to move in with a complete stranger.\What were you thinking? response:	Okay, I got it. Let's live together.
context: So you do remember.\Then starting tomorrow, we're roommates, Nana-chan.\What in the world were you thinking?!\Why not? Sharing is cool! Like the foreigners do!\You're so easily fooled by others!\I don't think it's a good idea for you to move in with a complete stranger.\What were you thinking?\Okay, I got it. Let's live together. response:	You wouldn't wanna live with me. You'll hate it.
context: Then starting tomorrow, we're roommates, Nana-chan.\What in the world were you thinking?!\Why not? Sharing is cool! Like the foreigners do!\You're so easily fooled by others!\I don't think it's a good idea for you to move in with a complete stranger.\What were you thinking?\Okay, I got it. Let's live together.\You wouldn't wanna live with me. You'll hate it. response:	I'm always wanting my own way, and I whine.
context: What in the world were you thinking?!\Why not? Sharing is cool! Like the foreigners do!\You're so easily fooled by others!\I don't think it's a good idea for you to move in with a complete stranger.\What were you thinking?\Okay, I got it. Let's live together.\You wouldn't wanna live with me. You'll hate it.\I'm always wanting my own way, and I whine. response:	You think I don't know that?
context: Why not? Sharing is cool! Like the foreigners do!\You're so easily fooled by others!\I don't think it's a good idea for you to move in with a complete stranger.\What were you thinking?\Okay, I got it. Let's live together.\You wouldn't wanna live with me. You'll hate it.\I'm always wanting my own way, and I whine.\You think I don't know that? response:	I'm used to it, or rather, I've given up about that.
context: You're so easily fooled by others!\I don't think it's a good idea for you to move in with a complete stranger.\What were you thinking?\Okay, I got it. Let's live together.\You wouldn't wanna live with me. You'll hate it.\I'm always wanting my own way, and I whine.\You think I don't know that?\I'm used to it, or rather, I've given up about that. response:	How dare you!
context: I don't think it's a good idea for you to move in with a complete stranger.\What were you thinking?\Okay, I got it. Let's live together.\You wouldn't wanna live with me. You'll hate it.\I'm always wanting my own way, and I whine.\You think I don't know that?\I'm used to it, or rather, I've given up about that.\How dare you! response:	Just kidding. Let's do it, okay?
context: What were you thinking?\Okay, I got it. Let's live together.\You wouldn't wanna live with me. You'll hate it.\I'm always wanting my own way, and I whine.\You think I don't know that?\I'm used to it, or rather, I've given up about that.\How dare you!\Just kidding. Let's do it, okay? response:	Shoji...
context: Okay, I got it. Let's live together.\You wouldn't wanna live with me. You'll hate it.\I'm always wanting my own way, and I whine.\You think I don't know that?\I'm used to it, or rather, I've given up about that.\How dare you!\Just kidding. Let's do it, okay?\Shoji... response:	Thank you.
context: You wouldn't wanna live with me. You'll hate it.\I'm always wanting my own way, and I whine.\You think I don't know that?\I'm used to it, or rather, I've given up about that.\How dare you!\Just kidding. Let's do it, okay?\Shoji...\Thank you. response:	That makes me happy.
context: I'm always wanting my own way, and I whine.\You think I don't know that?\I'm used to it, or rather, I've given up about that.\How dare you!\Just kidding. Let's do it, okay?\Shoji...\Thank you.\That makes me happy. response:	But I can't!
context: You think I don't know that?\I'm used to it, or rather, I've given up about that.\How dare you!\Just kidding. Let's do it, okay?\Shoji...\Thank you.\That makes me happy.\But I can't! response:	Those words were all I needed to hear.
context: I'm used to it, or rather, I've given up about that.\How dare you!\Just kidding. Let's do it, okay?\Shoji...\Thank you.\That makes me happy.\But I can't!\Those words were all I needed to hear. response:	You've chosen me over Sachiko.
context: How dare you!\Just kidding. Let's do it, okay?\Shoji...\Thank you.\That makes me happy.\But I can't!\Those words were all I needed to hear.\You've chosen me over Sachiko. response:	Who the heck is Sachiko?
context: Just kidding. Let's do it, okay?\Shoji...\Thank you.\That makes me happy.\But I can't!\Those words were all I needed to hear.\You've chosen me over Sachiko.\Who the heck is Sachiko? response:	You're just too kind.
context: Shoji...\Thank you.\That makes me happy.\But I can't!\Those words were all I needed to hear.\You've chosen me over Sachiko.\Who the heck is Sachiko?\You're just too kind. response:	If we live together,
context: Thank you.\That makes me happy.\But I can't!\Those words were all I needed to hear.\You've chosen me over Sachiko.\Who the heck is Sachiko?\You're just too kind.\If we live together, response:	I'm going to rely on you too much all the time.
context: That makes me happy.\But I can't!\Those words were all I needed to hear.\You've chosen me over Sachiko.\Who the heck is Sachiko?\You're just too kind.\If we live together,\I'm going to rely on you too much all the time. response:	I don't want to be a burden anymore than I already am.
context: But I can't!\Those words were all I needed to hear.\You've chosen me over Sachiko.\Who the heck is Sachiko?\You're just too kind.\If we live together,\I'm going to rely on you too much all the time.\I don't want to be a burden anymore than I already am. response:	Her effort in not wanting to be a burden is splendid for Nana's standards,
context: Those words were all I needed to hear.\You've chosen me over Sachiko.\Who the heck is Sachiko?\You're just too kind.\If we live together,\I'm going to rely on you too much all the time.\I don't want to be a burden anymore than I already am.\Her effort in not wanting to be a burden is splendid for Nana's standards, response:	or so I thought at the time.
context: You've chosen me over Sachiko.\Who the heck is Sachiko?\You're just too kind.\If we live together,\I'm going to rely on you too much all the time.\I don't want to be a burden anymore than I already am.\Her effort in not wanting to be a burden is splendid for Nana's standards,\or so I thought at the time. response:	But it was just a matter of Nana now relying on someone else instead.
context: Who the heck is Sachiko?\You're just too kind.\If we live together,\I'm going to rely on you too much all the time.\I don't want to be a burden anymore than I already am.\Her effort in not wanting to be a burden is splendid for Nana's standards,\or so I thought at the time.\But it was just a matter of Nana now relying on someone else instead. response:	The other Nana.
context: You're just too kind.\If we live together,\I'm going to rely on you too much all the time.\I don't want to be a burden anymore than I already am.\Her effort in not wanting to be a burden is splendid for Nana's standards,\or so I thought at the time.\But it was just a matter of Nana now relying on someone else instead.\The other Nana. response:	Although that's also what you'd expect of her.
context: If we live together,\I'm going to rely on you too much all the time.\I don't want to be a burden anymore than I already am.\Her effort in not wanting to be a burden is splendid for Nana's standards,\or so I thought at the time.\But it was just a matter of Nana now relying on someone else instead.\The other Nana.\Although that's also what you'd expect of her. response:	Hey Nana, don't you think these cups are super cute?
context: I'm going to rely on you too much all the time.\I don't want to be a burden anymore than I already am.\Her effort in not wanting to be a burden is splendid for Nana's standards,\or so I thought at the time.\But it was just a matter of Nana now relying on someone else instead.\The other Nana.\Although that's also what you'd expect of her.\Hey Nana, don't you think these cups are super cute? response:	You'd never imagine they're only a dollar each.
context: I don't want to be a burden anymore than I already am.\Her effort in not wanting to be a burden is splendid for Nana's standards,\or so I thought at the time.\But it was just a matter of Nana now relying on someone else instead.\The other Nana.\Although that's also what you'd expect of her.\Hey Nana, don't you think these cups are super cute?\You'd never imagine they're only a dollar each. response:	Strawberries?
context: Her effort in not wanting to be a burden is splendid for Nana's standards,\or so I thought at the time.\But it was just a matter of Nana now relying on someone else instead.\The other Nana.\Although that's also what you'd expect of her.\Hey Nana, don't you think these cups are super cute?\You'd never imagine they're only a dollar each.\Strawberries? response:	No?
context: or so I thought at the time.\But it was just a matter of Nana now relying on someone else instead.\The other Nana.\Although that's also what you'd expect of her.\Hey Nana, don't you think these cups are super cute?\You'd never imagine they're only a dollar each.\Strawberries?\No? response:	If you want it, go ahead and buy it.
context: But it was just a matter of Nana now relying on someone else instead.\The other Nana.\Although that's also what you'd expect of her.\Hey Nana, don't you think these cups are super cute?\You'd never imagine they're only a dollar each.\Strawberries?\No?\If you want it, go ahead and buy it. response:	Forget it then.
context: The other Nana.\Although that's also what you'd expect of her.\Hey Nana, don't you think these cups are super cute?\You'd never imagine they're only a dollar each.\Strawberries?\No?\If you want it, go ahead and buy it.\Forget it then. response:	Why?!
context: Although that's also what you'd expect of her.\Hey Nana, don't you think these cups are super cute?\You'd never imagine they're only a dollar each.\Strawberries?\No?\If you want it, go ahead and buy it.\Forget it then.\Why?! response:	Because. If you're not interested, I don't want it either.
context: Hey Nana, don't you think these cups are super cute?\You'd never imagine they're only a dollar each.\Strawberries?\No?\If you want it, go ahead and buy it.\Forget it then.\Why?!\Because. If you're not interested, I don't want it either. response:	I wanna use the same things you do.
context: You'd never imagine they're only a dollar each.\Strawberries?\No?\If you want it, go ahead and buy it.\Forget it then.\Why?!\Because. If you're not interested, I don't want it either.\I wanna use the same things you do. response:	I don't care what we use. Let's just get the shopping done.
context: Strawberries?\No?\If you want it, go ahead and buy it.\Forget it then.\Why?!\Because. If you're not interested, I don't want it either.\I wanna use the same things you do.\I don't care what we use. Let's just get the shopping done. response:	But you don't like this, do you? The strawberries.
context: No?\If you want it, go ahead and buy it.\Forget it then.\Why?!\Because. If you're not interested, I don't want it either.\I wanna use the same things you do.\I don't care what we use. Let's just get the shopping done.\But you don't like this, do you? The strawberries. response:	Ah, sure I love strawberries...
context: If you want it, go ahead and buy it.\Forget it then.\Why?!\Because. If you're not interested, I don't want it either.\I wanna use the same things you do.\I don't care what we use. Let's just get the shopping done.\But you don't like this, do you? The strawberries.\Ah, sure I love strawberries... response:	Then I'm getting these.
context: Forget it then.\Why?!\Because. If you're not interested, I don't want it either.\I wanna use the same things you do.\I don't care what we use. Let's just get the shopping done.\But you don't like this, do you? The strawberries.\Ah, sure I love strawberries...\Then I'm getting these. response:	I feel for Shoji.
context: Why?!\Because. If you're not interested, I don't want it either.\I wanna use the same things you do.\I don't care what we use. Let's just get the shopping done.\But you don't like this, do you? The strawberries.\Ah, sure I love strawberries...\Then I'm getting these.\I feel for Shoji. response:	What's that supposed to mean?
context: Because. If you're not interested, I don't want it either.\I wanna use the same things you do.\I don't care what we use. Let's just get the shopping done.\But you don't like this, do you? The strawberries.\Ah, sure I love strawberries...\Then I'm getting these.\I feel for Shoji.\What's that supposed to mean? response:	Well, you're like... You know, kinda like a dog.
context: I wanna use the same things you do.\I don't care what we use. Let's just get the shopping done.\But you don't like this, do you? The strawberries.\Ah, sure I love strawberries...\Then I'm getting these.\I feel for Shoji.\What's that supposed to mean?\Well, you're like... You know, kinda like a dog. response:	I am?
context: I don't care what we use. Let's just get the shopping done.\But you don't like this, do you? The strawberries.\Ah, sure I love strawberries...\Then I'm getting these.\I feel for Shoji.\What's that supposed to mean?\Well, you're like... You know, kinda like a dog.\I am? response:	You kinda stick around friendly-like and you're real sincere,
context: But you don't like this, do you? The strawberries.\Ah, sure I love strawberries...\Then I'm getting these.\I feel for Shoji.\What's that supposed to mean?\Well, you're like... You know, kinda like a dog.\I am?\You kinda stick around friendly-like and you're real sincere, response:	but you need a lot of caring.
context: Ah, sure I love strawberries...\Then I'm getting these.\I feel for Shoji.\What's that supposed to mean?\Well, you're like... You know, kinda like a dog.\I am?\You kinda stick around friendly-like and you're real sincere,\but you need a lot of caring. response:	Like, not that I mind,
context: Then I'm getting these.\I feel for Shoji.\What's that supposed to mean?\Well, you're like... You know, kinda like a dog.\I am?\You kinda stick around friendly-like and you're real sincere,\but you need a lot of caring.\Like, not that I mind, response:	I was thinking about getting a pet anyway.
context: I feel for Shoji.\What's that supposed to mean?\Well, you're like... You know, kinda like a dog.\I am?\You kinda stick around friendly-like and you're real sincere,\but you need a lot of caring.\Like, not that I mind,\I was thinking about getting a pet anyway. response:	Hey Hachi, want me to buy you a toy?
context: What's that supposed to mean?\Well, you're like... You know, kinda like a dog.\I am?\You kinda stick around friendly-like and you're real sincere,\but you need a lot of caring.\Like, not that I mind,\I was thinking about getting a pet anyway.\Hey Hachi, want me to buy you a toy? response:	Hachi? Don't you have a cuter name for me?
context: Well, you're like... You know, kinda like a dog.\I am?\You kinda stick around friendly-like and you're real sincere,\but you need a lot of caring.\Like, not that I mind,\I was thinking about getting a pet anyway.\Hey Hachi, want me to buy you a toy?\Hachi? Don't you have a cuter name for me? response:	So you guys are Nana and Hachi? What a combination.
context: I am?\You kinda stick around friendly-like and you're real sincere,\but you need a lot of caring.\Like, not that I mind,\I was thinking about getting a pet anyway.\Hey Hachi, want me to buy you a toy?\Hachi? Don't you have a cuter name for me?\So you guys are Nana and Hachi? What a combination. response:	Well, actually my name is Nana too,
context: You kinda stick around friendly-like and you're real sincere,\but you need a lot of caring.\Like, not that I mind,\I was thinking about getting a pet anyway.\Hey Hachi, want me to buy you a toy?\Hachi? Don't you have a cuter name for me?\So you guys are Nana and Hachi? What a combination.\Well, actually my name is Nana too, response:	but it's confusing to have the same name, so Nana...
context: but you need a lot of caring.\Like, not that I mind,\I was thinking about getting a pet anyway.\Hey Hachi, want me to buy you a toy?\Hachi? Don't you have a cuter name for me?\So you guys are Nana and Hachi? What a combination.\Well, actually my name is Nana too,\but it's confusing to have the same name, so Nana... response:	Was that the reason? It's because you're like a pet dog.
context: Like, not that I mind,\I was thinking about getting a pet anyway.\Hey Hachi, want me to buy you a toy?\Hachi? Don't you have a cuter name for me?\So you guys are Nana and Hachi? What a combination.\Well, actually my name is Nana too,\but it's confusing to have the same name, so Nana...\Was that the reason? It's because you're like a pet dog. response:	- Beer. Want some? - Yay!
context: I was thinking about getting a pet anyway.\Hey Hachi, want me to buy you a toy?\Hachi? Don't you have a cuter name for me?\So you guys are Nana and Hachi? What a combination.\Well, actually my name is Nana too,\but it's confusing to have the same name, so Nana...\Was that the reason? It's because you're like a pet dog.\- Beer. Want some? - Yay! response:	No, not yay! You got work, remember?
context: Hey Hachi, want me to buy you a toy?\Hachi? Don't you have a cuter name for me?\So you guys are Nana and Hachi? What a combination.\Well, actually my name is Nana too,\but it's confusing to have the same name, so Nana...\Was that the reason? It's because you're like a pet dog.\- Beer. Want some? - Yay!\No, not yay! You got work, remember? response:	But I'm thirsty! No, I'm hungry!
context: Hachi? Don't you have a cuter name for me?\So you guys are Nana and Hachi? What a combination.\Well, actually my name is Nana too,\but it's confusing to have the same name, so Nana...\Was that the reason? It's because you're like a pet dog.\- Beer. Want some? - Yay!\No, not yay! You got work, remember?\But I'm thirsty! No, I'm hungry! response:	I should have bought something!
context: So you guys are Nana and Hachi? What a combination.\Well, actually my name is Nana too,\but it's confusing to have the same name, so Nana...\Was that the reason? It's because you're like a pet dog.\- Beer. Want some? - Yay!\No, not yay! You got work, remember?\But I'm thirsty! No, I'm hungry!\I should have bought something! response:	By the way, I ate the hamburger.
context: Well, actually my name is Nana too,\but it's confusing to have the same name, so Nana...\Was that the reason? It's because you're like a pet dog.\- Beer. Want some? - Yay!\No, not yay! You got work, remember?\But I'm thirsty! No, I'm hungry!\I should have bought something!\By the way, I ate the hamburger. response:	It was awesome good! Thanks.
context: but it's confusing to have the same name, so Nana...\Was that the reason? It's because you're like a pet dog.\- Beer. Want some? - Yay!\No, not yay! You got work, remember?\But I'm thirsty! No, I'm hungry!\I should have bought something!\By the way, I ate the hamburger.\It was awesome good! Thanks. response:	You ate it all by yourself. Not fair!
context: Was that the reason? It's because you're like a pet dog.\- Beer. Want some? - Yay!\No, not yay! You got work, remember?\But I'm thirsty! No, I'm hungry!\I should have bought something!\By the way, I ate the hamburger.\It was awesome good! Thanks.\You ate it all by yourself. Not fair! response:	Well then, write do not eat on the darn thing next time!
context: - Beer. Want some? - Yay!\No, not yay! You got work, remember?\But I'm thirsty! No, I'm hungry!\I should have bought something!\By the way, I ate the hamburger.\It was awesome good! Thanks.\You ate it all by yourself. Not fair!\Well then, write do not eat on the darn thing next time! response:	Found a cute bakery!
context: No, not yay! You got work, remember?\But I'm thirsty! No, I'm hungry!\I should have bought something!\By the way, I ate the hamburger.\It was awesome good! Thanks.\You ate it all by yourself. Not fair!\Well then, write do not eat on the darn thing next time!\Found a cute bakery! response:	They all look really good! I don't know which one to get!
context: But I'm thirsty! No, I'm hungry!\I should have bought something!\By the way, I ate the hamburger.\It was awesome good! Thanks.\You ate it all by yourself. Not fair!\Well then, write do not eat on the darn thing next time!\Found a cute bakery!\They all look really good! I don't know which one to get! response:	You really do have a good nose, don't you?
context: I should have bought something!\By the way, I ate the hamburger.\It was awesome good! Thanks.\You ate it all by yourself. Not fair!\Well then, write do not eat on the darn thing next time!\Found a cute bakery!\They all look really good! I don't know which one to get!\You really do have a good nose, don't you? response:	Being a dog.
context: By the way, I ate the hamburger.\It was awesome good! Thanks.\You ate it all by yourself. Not fair!\Well then, write do not eat on the darn thing next time!\Found a cute bakery!\They all look really good! I don't know which one to get!\You really do have a good nose, don't you?\Being a dog. response:	Hey Nana. I've been looking for this CD.
context: It was awesome good! Thanks.\You ate it all by yourself. Not fair!\Well then, write do not eat on the darn thing next time!\Found a cute bakery!\They all look really good! I don't know which one to get!\You really do have a good nose, don't you?\Being a dog.\Hey Nana. I've been looking for this CD. response:	Would you mind if we look in that shop?
context: You ate it all by yourself. Not fair!\Well then, write do not eat on the darn thing next time!\Found a cute bakery!\They all look really good! I don't know which one to get!\You really do have a good nose, don't you?\Being a dog.\Hey Nana. I've been looking for this CD.\Would you mind if we look in that shop? response:	I don't mind, but do you have a CD player?
context: Well then, write do not eat on the darn thing next time!\Found a cute bakery!\They all look really good! I don't know which one to get!\You really do have a good nose, don't you?\Being a dog.\Hey Nana. I've been looking for this CD.\Would you mind if we look in that shop?\I don't mind, but do you have a CD player? response:	Well, if you wanna use mine, that's fine by me.
context: Found a cute bakery!\They all look really good! I don't know which one to get!\You really do have a good nose, don't you?\Being a dog.\Hey Nana. I've been looking for this CD.\Would you mind if we look in that shop?\I don't mind, but do you have a CD player?\Well, if you wanna use mine, that's fine by me. response:	Thank you!
context: They all look really good! I don't know which one to get!\You really do have a good nose, don't you?\Being a dog.\Hey Nana. I've been looking for this CD.\Would you mind if we look in that shop?\I don't mind, but do you have a CD player?\Well, if you wanna use mine, that's fine by me.\Thank you! response:	Great, they still had a few left!
context: You really do have a good nose, don't you?\Being a dog.\Hey Nana. I've been looking for this CD.\Would you mind if we look in that shop?\I don't mind, but do you have a CD player?\Well, if you wanna use mine, that's fine by me.\Thank you!\Great, they still had a few left! response:	The new Trapnest album went on sale today!
context: Being a dog.\Hey Nana. I've been looking for this CD.\Would you mind if we look in that shop?\I don't mind, but do you have a CD player?\Well, if you wanna use mine, that's fine by me.\Thank you!\Great, they still had a few left!\The new Trapnest album went on sale today! response:	I just love them.
context: Hey Nana. I've been looking for this CD.\Would you mind if we look in that shop?\I don't mind, but do you have a CD player?\Well, if you wanna use mine, that's fine by me.\Thank you!\Great, they still had a few left!\The new Trapnest album went on sale today!\I just love them. response:	If you'd like, you should listen to them, too.
context: Would you mind if we look in that shop?\I don't mind, but do you have a CD player?\Well, if you wanna use mine, that's fine by me.\Thank you!\Great, they still had a few left!\The new Trapnest album went on sale today!\I just love them.\If you'd like, you should listen to them, too. response:	They're super cool.
context: I don't mind, but do you have a CD player?\Well, if you wanna use mine, that's fine by me.\Thank you!\Great, they still had a few left!\The new Trapnest album went on sale today!\I just love them.\If you'd like, you should listen to them, too.\They're super cool. response:	Hang on a minute while I go and pay for this.
context: Well, if you wanna use mine, that's fine by me.\Thank you!\Great, they still had a few left!\The new Trapnest album went on sale today!\I just love them.\If you'd like, you should listen to them, too.\They're super cool.\Hang on a minute while I go and pay for this. response:	You like this?
context: Thank you!\Great, they still had a few left!\The new Trapnest album went on sale today!\I just love them.\If you'd like, you should listen to them, too.\They're super cool.\Hang on a minute while I go and pay for this.\You like this? response:	I got it from a street vendor.
context: Great, they still had a few left!\The new Trapnest album went on sale today!\I just love them.\If you'd like, you should listen to them, too.\They're super cool.\Hang on a minute while I go and pay for this.\You like this?\I got it from a street vendor. response:	It's a Sid Vicious pad lock.
context: The new Trapnest album went on sale today!\I just love them.\If you'd like, you should listen to them, too.\They're super cool.\Hang on a minute while I go and pay for this.\You like this?\I got it from a street vendor.\It's a Sid Vicious pad lock. response:	And who are you? Nancy?
context: I just love them.\If you'd like, you should listen to them, too.\They're super cool.\Hang on a minute while I go and pay for this.\You like this?\I got it from a street vendor.\It's a Sid Vicious pad lock.\And who are you? Nancy? response:	So what are you going to do putting a lock on me?
context: If you'd like, you should listen to them, too.\They're super cool.\Hang on a minute while I go and pay for this.\You like this?\I got it from a street vendor.\It's a Sid Vicious pad lock.\And who are you? Nancy?\So what are you going to do putting a lock on me? response:	Hey Ren. If I were to die, would you die with me?
context: They're super cool.\Hang on a minute while I go and pay for this.\You like this?\I got it from a street vendor.\It's a Sid Vicious pad lock.\And who are you? Nancy?\So what are you going to do putting a lock on me?\Hey Ren. If I were to die, would you die with me? response:	Okay.
context: Hang on a minute while I go and pay for this.\You like this?\I got it from a street vendor.\It's a Sid Vicious pad lock.\And who are you? Nancy?\So what are you going to do putting a lock on me?\Hey Ren. If I were to die, would you die with me?\Okay. response:	The other Nana also seems to have quite a history.
context: You like this?\I got it from a street vendor.\It's a Sid Vicious pad lock.\And who are you? Nancy?\So what are you going to do putting a lock on me?\Hey Ren. If I were to die, would you die with me?\Okay.\The other Nana also seems to have quite a history. response:	You got that right.
context: I got it from a street vendor.\It's a Sid Vicious pad lock.\And who are you? Nancy?\So what are you going to do putting a lock on me?\Hey Ren. If I were to die, would you die with me?\Okay.\The other Nana also seems to have quite a history.\You got that right. response:	You know, it's as if the more she became closer to the other Nana,
context: It's a Sid Vicious pad lock.\And who are you? Nancy?\So what are you going to do putting a lock on me?\Hey Ren. If I were to die, would you die with me?\Okay.\The other Nana also seems to have quite a history.\You got that right.\You know, it's as if the more she became closer to the other Nana, response:	the more the distance between she and Shoji increased.
context: And who are you? Nancy?\So what are you going to do putting a lock on me?\Hey Ren. If I were to die, would you die with me?\Okay.\The other Nana also seems to have quite a history.\You got that right.\You know, it's as if the more she became closer to the other Nana,\the more the distance between she and Shoji increased. response:	That's right.
context: So what are you going to do putting a lock on me?\Hey Ren. If I were to die, would you die with me?\Okay.\The other Nana also seems to have quite a history.\You got that right.\You know, it's as if the more she became closer to the other Nana,\the more the distance between she and Shoji increased.\That's right. response:	I should've known there was something going on,
context: Hey Ren. If I were to die, would you die with me?\Okay.\The other Nana also seems to have quite a history.\You got that right.\You know, it's as if the more she became closer to the other Nana,\the more the distance between she and Shoji increased.\That's right.\I should've known there was something going on, response:	you finding a job so quickly.
context: Okay.\The other Nana also seems to have quite a history.\You got that right.\You know, it's as if the more she became closer to the other Nana,\the more the distance between she and Shoji increased.\That's right.\I should've known there was something going on,\you finding a job so quickly. response:	Didn't expect such a young boss.
context: The other Nana also seems to have quite a history.\You got that right.\You know, it's as if the more she became closer to the other Nana,\the more the distance between she and Shoji increased.\That's right.\I should've known there was something going on,\you finding a job so quickly.\Didn't expect such a young boss. response:	Koichi Sato! Another burger please.
context: You got that right.\You know, it's as if the more she became closer to the other Nana,\the more the distance between she and Shoji increased.\That's right.\I should've known there was something going on,\you finding a job so quickly.\Didn't expect such a young boss.\Koichi Sato! Another burger please. response:	You got it.
context: You know, it's as if the more she became closer to the other Nana,\the more the distance between she and Shoji increased.\That's right.\I should've known there was something going on,\you finding a job so quickly.\Didn't expect such a young boss.\Koichi Sato! Another burger please.\You got it. response:	Hey, you know I don't care.
context: the more the distance between she and Shoji increased.\That's right.\I should've known there was something going on,\you finding a job so quickly.\Didn't expect such a young boss.\Koichi Sato! Another burger please.\You got it.\Hey, you know I don't care. response:	As long as you have a job.
context: That's right.\I should've known there was something going on,\you finding a job so quickly.\Didn't expect such a young boss.\Koichi Sato! Another burger please.\You got it.\Hey, you know I don't care.\As long as you have a job. response:	Never mind the reasons for sticking to it.
context: I should've known there was something going on,\you finding a job so quickly.\Didn't expect such a young boss.\Koichi Sato! Another burger please.\You got it.\Hey, you know I don't care.\As long as you have a job.\Never mind the reasons for sticking to it. response:	Just don't give Shoji a hard time.
context: you finding a job so quickly.\Didn't expect such a young boss.\Koichi Sato! Another burger please.\You got it.\Hey, you know I don't care.\As long as you have a job.\Never mind the reasons for sticking to it.\Just don't give Shoji a hard time. response:	Like last night, too, he got drunk and started saying stuff.
context: Didn't expect such a young boss.\Koichi Sato! Another burger please.\You got it.\Hey, you know I don't care.\As long as you have a job.\Never mind the reasons for sticking to it.\Just don't give Shoji a hard time.\Like last night, too, he got drunk and started saying stuff. response:	Saying stuff?!
context: Koichi Sato! Another burger please.\You got it.\Hey, you know I don't care.\As long as you have a job.\Never mind the reasons for sticking to it.\Just don't give Shoji a hard time.\Like last night, too, he got drunk and started saying stuff.\Saying stuff?! response:	Last night, too? Is he always saying stuff about me?
context: You got it.\Hey, you know I don't care.\As long as you have a job.\Never mind the reasons for sticking to it.\Just don't give Shoji a hard time.\Like last night, too, he got drunk and started saying stuff.\Saying stuff?!\Last night, too? Is he always saying stuff about me? response:	Uh...
context: Hey, you know I don't care.\As long as you have a job.\Never mind the reasons for sticking to it.\Just don't give Shoji a hard time.\Like last night, too, he got drunk and started saying stuff.\Saying stuff?!\Last night, too? Is he always saying stuff about me?\Uh... response:	So actually, Shoji really doesn't like me!
context: As long as you have a job.\Never mind the reasons for sticking to it.\Just don't give Shoji a hard time.\Like last night, too, he got drunk and started saying stuff.\Saying stuff?!\Last night, too? Is he always saying stuff about me?\Uh...\So actually, Shoji really doesn't like me! response:	Because I'm good for nothing!
context: Never mind the reasons for sticking to it.\Just don't give Shoji a hard time.\Like last night, too, he got drunk and started saying stuff.\Saying stuff?!\Last night, too? Is he always saying stuff about me?\Uh...\So actually, Shoji really doesn't like me!\Because I'm good for nothing! response:	It's not like that.
context: Just don't give Shoji a hard time.\Like last night, too, he got drunk and started saying stuff.\Saying stuff?!\Last night, too? Is he always saying stuff about me?\Uh...\So actually, Shoji really doesn't like me!\Because I'm good for nothing!\It's not like that. response:	Shoji is so in love with you,
context: Like last night, too, he got drunk and started saying stuff.\Saying stuff?!\Last night, too? Is he always saying stuff about me?\Uh...\So actually, Shoji really doesn't like me!\Because I'm good for nothing!\It's not like that.\Shoji is so in love with you, response:	he doesn't know what to do with himself.
context: Saying stuff?!\Last night, too? Is he always saying stuff about me?\Uh...\So actually, Shoji really doesn't like me!\Because I'm good for nothing!\It's not like that.\Shoji is so in love with you,\he doesn't know what to do with himself. response:	You're not going to find a man like that just anywhere,
context: Last night, too? Is he always saying stuff about me?\Uh...\So actually, Shoji really doesn't like me!\Because I'm good for nothing!\It's not like that.\Shoji is so in love with you,\he doesn't know what to do with himself.\You're not going to find a man like that just anywhere, response:	you know that?
context: Uh...\So actually, Shoji really doesn't like me!\Because I'm good for nothing!\It's not like that.\Shoji is so in love with you,\he doesn't know what to do with himself.\You're not going to find a man like that just anywhere,\you know that? response:	You gotta take better care of him, man.
context: So actually, Shoji really doesn't like me!\Because I'm good for nothing!\It's not like that.\Shoji is so in love with you,\he doesn't know what to do with himself.\You're not going to find a man like that just anywhere,\you know that?\You gotta take better care of him, man. response:	Otherwise that's when heaven'll get you back.
context: Because I'm good for nothing!\It's not like that.\Shoji is so in love with you,\he doesn't know what to do with himself.\You're not going to find a man like that just anywhere,\you know that?\You gotta take better care of him, man.\Otherwise that's when heaven'll get you back. response:	Work again? What are you working so much for?
context: It's not like that.\Shoji is so in love with you,\he doesn't know what to do with himself.\You're not going to find a man like that just anywhere,\you know that?\You gotta take better care of him, man.\Otherwise that's when heaven'll get you back.\Work again? What are you working so much for? response:	Your parents send you money, don't they?
context: Shoji is so in love with you,\he doesn't know what to do with himself.\You're not going to find a man like that just anywhere,\you know that?\You gotta take better care of him, man.\Otherwise that's when heaven'll get you back.\Work again? What are you working so much for?\Your parents send you money, don't they? response:	Not enough to live on.
context: he doesn't know what to do with himself.\You're not going to find a man like that just anywhere,\you know that?\You gotta take better care of him, man.\Otherwise that's when heaven'll get you back.\Work again? What are you working so much for?\Your parents send you money, don't they?\Not enough to live on. response:	When I start school, I won't have time to work.
context: You're not going to find a man like that just anywhere,\you know that?\You gotta take better care of him, man.\Otherwise that's when heaven'll get you back.\Work again? What are you working so much for?\Your parents send you money, don't they?\Not enough to live on.\When I start school, I won't have time to work. response:	I've got to save up while I can.
context: you know that?\You gotta take better care of him, man.\Otherwise that's when heaven'll get you back.\Work again? What are you working so much for?\Your parents send you money, don't they?\Not enough to live on.\When I start school, I won't have time to work.\I've got to save up while I can. response:	That's what you say.
context: You gotta take better care of him, man.\Otherwise that's when heaven'll get you back.\Work again? What are you working so much for?\Your parents send you money, don't they?\Not enough to live on.\When I start school, I won't have time to work.\I've got to save up while I can.\That's what you say. response:	You're not spending money on Sachiko, I hope!
context: Otherwise that's when heaven'll get you back.\Work again? What are you working so much for?\Your parents send you money, don't they?\Not enough to live on.\When I start school, I won't have time to work.\I've got to save up while I can.\That's what you say.\You're not spending money on Sachiko, I hope! response:	Buying her Louis Vuitton bags and Prada shoes.
context: Work again? What are you working so much for?\Your parents send you money, don't they?\Not enough to live on.\When I start school, I won't have time to work.\I've got to save up while I can.\That's what you say.\You're not spending money on Sachiko, I hope!\Buying her Louis Vuitton bags and Prada shoes. response:	But she really likes these brands.
context: Your parents send you money, don't they?\Not enough to live on.\When I start school, I won't have time to work.\I've got to save up while I can.\That's what you say.\You're not spending money on Sachiko, I hope!\Buying her Louis Vuitton bags and Prada shoes.\But she really likes these brands. response:	I'm just kidding!
context: Not enough to live on.\When I start school, I won't have time to work.\I've got to save up while I can.\That's what you say.\You're not spending money on Sachiko, I hope!\Buying her Louis Vuitton bags and Prada shoes.\But she really likes these brands.\I'm just kidding! response:	You're the one that keeps bringing her up!
context: When I start school, I won't have time to work.\I've got to save up while I can.\That's what you say.\You're not spending money on Sachiko, I hope!\Buying her Louis Vuitton bags and Prada shoes.\But she really likes these brands.\I'm just kidding!\You're the one that keeps bringing her up! response:	I know, but I came all the way to Tokyo to be with you
context: I've got to save up while I can.\That's what you say.\You're not spending money on Sachiko, I hope!\Buying her Louis Vuitton bags and Prada shoes.\But she really likes these brands.\I'm just kidding!\You're the one that keeps bringing her up!\I know, but I came all the way to Tokyo to be with you response:	and you spend all of your time working.
context: That's what you say.\You're not spending money on Sachiko, I hope!\Buying her Louis Vuitton bags and Prada shoes.\But she really likes these brands.\I'm just kidding!\You're the one that keeps bringing her up!\I know, but I came all the way to Tokyo to be with you\and you spend all of your time working. response:	I just wish you would make some time for me.
context: You're not spending money on Sachiko, I hope!\Buying her Louis Vuitton bags and Prada shoes.\But she really likes these brands.\I'm just kidding!\You're the one that keeps bringing her up!\I know, but I came all the way to Tokyo to be with you\and you spend all of your time working.\I just wish you would make some time for me. response:	You're the one that's not being considerate.
context: Buying her Louis Vuitton bags and Prada shoes.\But she really likes these brands.\I'm just kidding!\You're the one that keeps bringing her up!\I know, but I came all the way to Tokyo to be with you\and you spend all of your time working.\I just wish you would make some time for me.\You're the one that's not being considerate. response:	Why should I always have to adjust to your plans?
context: But she really likes these brands.\I'm just kidding!\You're the one that keeps bringing her up!\I know, but I came all the way to Tokyo to be with you\and you spend all of your time working.\I just wish you would make some time for me.\You're the one that's not being considerate.\Why should I always have to adjust to your plans? response:	I've got to go to work now, so I'm off.
context: I'm just kidding!\You're the one that keeps bringing her up!\I know, but I came all the way to Tokyo to be with you\and you spend all of your time working.\I just wish you would make some time for me.\You're the one that's not being considerate.\Why should I always have to adjust to your plans?\I've got to go to work now, so I'm off. response:	I just remembered. You sent me an email yesterday.
context: You're the one that keeps bringing her up!\I know, but I came all the way to Tokyo to be with you\and you spend all of your time working.\I just wish you would make some time for me.\You're the one that's not being considerate.\Why should I always have to adjust to your plans?\I've got to go to work now, so I'm off.\I just remembered. You sent me an email yesterday. response:	Huh?
context: I know, but I came all the way to Tokyo to be with you\and you spend all of your time working.\I just wish you would make some time for me.\You're the one that's not being considerate.\Why should I always have to adjust to your plans?\I've got to go to work now, so I'm off.\I just remembered. You sent me an email yesterday.\Huh? response:	Well, if it's not important, never mind.
context: and you spend all of your time working.\I just wish you would make some time for me.\You're the one that's not being considerate.\Why should I always have to adjust to your plans?\I've got to go to work now, so I'm off.\I just remembered. You sent me an email yesterday.\Huh?\Well, if it's not important, never mind. response:	It's just that I fell asleep without noticing it came.
context: I just wish you would make some time for me.\You're the one that's not being considerate.\Why should I always have to adjust to your plans?\I've got to go to work now, so I'm off.\I just remembered. You sent me an email yesterday.\Huh?\Well, if it's not important, never mind.\It's just that I fell asleep without noticing it came. response:	Sorry.
context: You're the one that's not being considerate.\Why should I always have to adjust to your plans?\I've got to go to work now, so I'm off.\I just remembered. You sent me an email yesterday.\Huh?\Well, if it's not important, never mind.\It's just that I fell asleep without noticing it came.\Sorry. response:	Oh yeah, I did send one.
context: Why should I always have to adjust to your plans?\I've got to go to work now, so I'm off.\I just remembered. You sent me an email yesterday.\Huh?\Well, if it's not important, never mind.\It's just that I fell asleep without noticing it came.\Sorry.\Oh yeah, I did send one. response:	What did I write?
context: I've got to go to work now, so I'm off.\I just remembered. You sent me an email yesterday.\Huh?\Well, if it's not important, never mind.\It's just that I fell asleep without noticing it came.\Sorry.\Oh yeah, I did send one.\What did I write? response:	Shoji, I'm on my way home. Call me when you get off work. What did I write?
context: I just remembered. You sent me an email yesterday.\Huh?\Well, if it's not important, never mind.\It's just that I fell asleep without noticing it came.\Sorry.\Oh yeah, I did send one.\What did I write?\Shoji, I'm on my way home. Call me when you get off work. What did I write? response:	Shoji, I'm on my way home. Call me when you get off work.
context: Huh?\Well, if it's not important, never mind.\It's just that I fell asleep without noticing it came.\Sorry.\Oh yeah, I did send one.\What did I write?\Shoji, I'm on my way home. Call me when you get off work. What did I write?\Shoji, I'm on my way home. Call me when you get off work. response:	Come on, don't look so gloomy.
context: Well, if it's not important, never mind.\It's just that I fell asleep without noticing it came.\Sorry.\Oh yeah, I did send one.\What did I write?\Shoji, I'm on my way home. Call me when you get off work. What did I write?\Shoji, I'm on my way home. Call me when you get off work.\Come on, don't look so gloomy. response:	Right. Love will always have its ups and downs.
context: It's just that I fell asleep without noticing it came.\Sorry.\Oh yeah, I did send one.\What did I write?\Shoji, I'm on my way home. Call me when you get off work. What did I write?\Shoji, I'm on my way home. Call me when you get off work.\Come on, don't look so gloomy.\Right. Love will always have its ups and downs. response:	Oh, by the way, that band of the other Nana!
context: Sorry.\Oh yeah, I did send one.\What did I write?\Shoji, I'm on my way home. Call me when you get off work. What did I write?\Shoji, I'm on my way home. Call me when you get off work.\Come on, don't look so gloomy.\Right. Love will always have its ups and downs.\Oh, by the way, that band of the other Nana! response:	They've got their band members now, don't they?
context: Oh yeah, I did send one.\What did I write?\Shoji, I'm on my way home. Call me when you get off work. What did I write?\Shoji, I'm on my way home. Call me when you get off work.\Come on, don't look so gloomy.\Right. Love will always have its ups and downs.\Oh, by the way, that band of the other Nana!\They've got their band members now, don't they? response:	Y-Yeah, you're right.
context: What did I write?\Shoji, I'm on my way home. Call me when you get off work. What did I write?\Shoji, I'm on my way home. Call me when you get off work.\Come on, don't look so gloomy.\Right. Love will always have its ups and downs.\Oh, by the way, that band of the other Nana!\They've got their band members now, don't they?\Y-Yeah, you're right. response:	That's the flower of the lotus, isn't it?
context: Shoji, I'm on my way home. Call me when you get off work. What did I write?\Shoji, I'm on my way home. Call me when you get off work.\Come on, don't look so gloomy.\Right. Love will always have its ups and downs.\Oh, by the way, that band of the other Nana!\They've got their band members now, don't they?\Y-Yeah, you're right.\That's the flower of the lotus, isn't it? response:	Why did you choose the lotus?
context: Shoji, I'm on my way home. Call me when you get off work.\Come on, don't look so gloomy.\Right. Love will always have its ups and downs.\Oh, by the way, that band of the other Nana!\They've got their band members now, don't they?\Y-Yeah, you're right.\That's the flower of the lotus, isn't it?\Why did you choose the lotus? response:	Actually, it's the ren.
context: Come on, don't look so gloomy.\Right. Love will always have its ups and downs.\Oh, by the way, that band of the other Nana!\They've got their band members now, don't they?\Y-Yeah, you're right.\That's the flower of the lotus, isn't it?\Why did you choose the lotus?\Actually, it's the ren. response:	Huh? Sui-ren?
context: Right. Love will always have its ups and downs.\Oh, by the way, that band of the other Nana!\They've got their band members now, don't they?\Y-Yeah, you're right.\That's the flower of the lotus, isn't it?\Why did you choose the lotus?\Actually, it's the ren.\Huh? Sui-ren? response:	Just plain ren.
context: Oh, by the way, that band of the other Nana!\They've got their band members now, don't they?\Y-Yeah, you're right.\That's the flower of the lotus, isn't it?\Why did you choose the lotus?\Actually, it's the ren.\Huh? Sui-ren?\Just plain ren. response:	You mean lotus.
context: They've got their band members now, don't they?\Y-Yeah, you're right.\That's the flower of the lotus, isn't it?\Why did you choose the lotus?\Actually, it's the ren.\Huh? Sui-ren?\Just plain ren.\You mean lotus. response:	I said no.
context: Y-Yeah, you're right.\That's the flower of the lotus, isn't it?\Why did you choose the lotus?\Actually, it's the ren.\Huh? Sui-ren?\Just plain ren.\You mean lotus.\I said no. response:	But that's totally a lotus.
context: That's the flower of the lotus, isn't it?\Why did you choose the lotus?\Actually, it's the ren.\Huh? Sui-ren?\Just plain ren.\You mean lotus.\I said no.\But that's totally a lotus. response:	Oh shut up!
context: Why did you choose the lotus?\Actually, it's the ren.\Huh? Sui-ren?\Just plain ren.\You mean lotus.\I said no.\But that's totally a lotus.\Oh shut up! response:	But it definitely is a lotus. Why are you being so stubborn?
context: Actually, it's the ren.\Huh? Sui-ren?\Just plain ren.\You mean lotus.\I said no.\But that's totally a lotus.\Oh shut up!\But it definitely is a lotus. Why are you being so stubborn? response:	Who's the stubborn one?!
context: Huh? Sui-ren?\Just plain ren.\You mean lotus.\I said no.\But that's totally a lotus.\Oh shut up!\But it definitely is a lotus. Why are you being so stubborn?\Who's the stubborn one?! response:	Who could it be at this time of night?
context: Just plain ren.\You mean lotus.\I said no.\But that's totally a lotus.\Oh shut up!\But it definitely is a lotus. Why are you being so stubborn?\Who's the stubborn one?!\Who could it be at this time of night? response:	Good evening.
context: You mean lotus.\I said no.\But that's totally a lotus.\Oh shut up!\But it definitely is a lotus. Why are you being so stubborn?\Who's the stubborn one?!\Who could it be at this time of night?\Good evening. response:	Nobu! What the heck are you doing here?!
context: I said no.\But that's totally a lotus.\Oh shut up!\But it definitely is a lotus. Why are you being so stubborn?\Who's the stubborn one?!\Who could it be at this time of night?\Good evening.\Nobu! What the heck are you doing here?! response:	Oh wonderful! The exact response I was expecting!
context: But that's totally a lotus.\Oh shut up!\But it definitely is a lotus. Why are you being so stubborn?\Who's the stubborn one?!\Who could it be at this time of night?\Good evening.\Nobu! What the heck are you doing here?!\Oh wonderful! The exact response I was expecting! response:	Good!
context: Oh shut up!\But it definitely is a lotus. Why are you being so stubborn?\Who's the stubborn one?!\Who could it be at this time of night?\Good evening.\Nobu! What the heck are you doing here?!\Oh wonderful! The exact response I was expecting!\Good! response:	Get outta here. Go home!
context: But it definitely is a lotus. Why are you being so stubborn?\Who's the stubborn one?!\Who could it be at this time of night?\Good evening.\Nobu! What the heck are you doing here?!\Oh wonderful! The exact response I was expecting!\Good!\Get outta here. Go home! response:	Nana! Please! Let me stay here just one night!
context: Who's the stubborn one?!\Who could it be at this time of night?\Good evening.\Nobu! What the heck are you doing here?!\Oh wonderful! The exact response I was expecting!\Good!\Get outta here. Go home!\Nana! Please! Let me stay here just one night! response:	No way.
context: Who could it be at this time of night?\Good evening.\Nobu! What the heck are you doing here?!\Oh wonderful! The exact response I was expecting!\Good!\Get outta here. Go home!\Nana! Please! Let me stay here just one night!\No way. response:	- In fact, I... - I don't wanna hear it.
context: Good evening.\Nobu! What the heck are you doing here?!\Oh wonderful! The exact response I was expecting!\Good!\Get outta here. Go home!\Nana! Please! Let me stay here just one night!\No way.\- In fact, I... - I don't wanna hear it. response:	I ran away from home.
context: Nobu! What the heck are you doing here?!\Oh wonderful! The exact response I was expecting!\Good!\Get outta here. Go home!\Nana! Please! Let me stay here just one night!\No way.\- In fact, I... - I don't wanna hear it.\I ran away from home. response:	I told you, I don't wanna hear it!
context: Oh wonderful! The exact response I was expecting!\Good!\Get outta here. Go home!\Nana! Please! Let me stay here just one night!\No way.\- In fact, I... - I don't wanna hear it.\I ran away from home.\I told you, I don't wanna hear it! response:	Nana!
context: Good!\Get outta here. Go home!\Nana! Please! Let me stay here just one night!\No way.\- In fact, I... - I don't wanna hear it.\I ran away from home.\I told you, I don't wanna hear it!\Nana! response:	It's for him. He needs to smarten up!
context: Get outta here. Go home!\Nana! Please! Let me stay here just one night!\No way.\- In fact, I... - I don't wanna hear it.\I ran away from home.\I told you, I don't wanna hear it!\Nana!\It's for him. He needs to smarten up! response:	Now you listen to me, Nobu.
context: Nana! Please! Let me stay here just one night!\No way.\- In fact, I... - I don't wanna hear it.\I ran away from home.\I told you, I don't wanna hear it!\Nana!\It's for him. He needs to smarten up!\Now you listen to me, Nobu. response:	You are to follow your father's footsteps and run that huge Japanese inn.
context: No way.\- In fact, I... - I don't wanna hear it.\I ran away from home.\I told you, I don't wanna hear it!\Nana!\It's for him. He needs to smarten up!\Now you listen to me, Nobu.\You are to follow your father's footsteps and run that huge Japanese inn. response:	Get it through your head.
context: - In fact, I... - I don't wanna hear it.\I ran away from home.\I told you, I don't wanna hear it!\Nana!\It's for him. He needs to smarten up!\Now you listen to me, Nobu.\You are to follow your father's footsteps and run that huge Japanese inn.\Get it through your head. response:	I didn't choose to be born into that family.
context: I ran away from home.\I told you, I don't wanna hear it!\Nana!\It's for him. He needs to smarten up!\Now you listen to me, Nobu.\You are to follow your father's footsteps and run that huge Japanese inn.\Get it through your head.\I didn't choose to be born into that family. response:	Quit being a brat about it!
context: I told you, I don't wanna hear it!\Nana!\It's for him. He needs to smarten up!\Now you listen to me, Nobu.\You are to follow your father's footsteps and run that huge Japanese inn.\Get it through your head.\I didn't choose to be born into that family.\Quit being a brat about it! response:	As long as I can play my guitar, I'm happy.
context: Nana!\It's for him. He needs to smarten up!\Now you listen to me, Nobu.\You are to follow your father's footsteps and run that huge Japanese inn.\Get it through your head.\I didn't choose to be born into that family.\Quit being a brat about it!\As long as I can play my guitar, I'm happy. response:	And I wanna play for you.
context: It's for him. He needs to smarten up!\Now you listen to me, Nobu.\You are to follow your father's footsteps and run that huge Japanese inn.\Get it through your head.\I didn't choose to be born into that family.\Quit being a brat about it!\As long as I can play my guitar, I'm happy.\And I wanna play for you. response:	Don't make me repeat myself.
context: Now you listen to me, Nobu.\You are to follow your father's footsteps and run that huge Japanese inn.\Get it through your head.\I didn't choose to be born into that family.\Quit being a brat about it!\As long as I can play my guitar, I'm happy.\And I wanna play for you.\Don't make me repeat myself. response:	Hello Yasu? Do something about this stupid son, will ya?!
context: You are to follow your father's footsteps and run that huge Japanese inn.\Get it through your head.\I didn't choose to be born into that family.\Quit being a brat about it!\As long as I can play my guitar, I'm happy.\And I wanna play for you.\Don't make me repeat myself.\Hello Yasu? Do something about this stupid son, will ya?! response:	Oh sorry, but he insisted that he'd go.
context: Get it through your head.\I didn't choose to be born into that family.\Quit being a brat about it!\As long as I can play my guitar, I'm happy.\And I wanna play for you.\Don't make me repeat myself.\Hello Yasu? Do something about this stupid son, will ya?!\Oh sorry, but he insisted that he'd go. response:	What do you mean, but?! What are you gonna do about it?!
context: I didn't choose to be born into that family.\Quit being a brat about it!\As long as I can play my guitar, I'm happy.\And I wanna play for you.\Don't make me repeat myself.\Hello Yasu? Do something about this stupid son, will ya?!\Oh sorry, but he insisted that he'd go.\What do you mean, but?! What are you gonna do about it?! response:	There's nothing I can do about it, Nana.
context: Quit being a brat about it!\As long as I can play my guitar, I'm happy.\And I wanna play for you.\Don't make me repeat myself.\Hello Yasu? Do something about this stupid son, will ya?!\Oh sorry, but he insisted that he'd go.\What do you mean, but?! What are you gonna do about it?!\There's nothing I can do about it, Nana. response:	Nobu's serious.
context: As long as I can play my guitar, I'm happy.\And I wanna play for you.\Don't make me repeat myself.\Hello Yasu? Do something about this stupid son, will ya?!\Oh sorry, but he insisted that he'd go.\What do you mean, but?! What are you gonna do about it?!\There's nothing I can do about it, Nana.\Nobu's serious. response:	Why don't you find...
context: And I wanna play for you.\Don't make me repeat myself.\Hello Yasu? Do something about this stupid son, will ya?!\Oh sorry, but he insisted that he'd go.\What do you mean, but?! What are you gonna do about it?!\There's nothing I can do about it, Nana.\Nobu's serious.\Why don't you find... response:	some new band members and start over?
context: Don't make me repeat myself.\Hello Yasu? Do something about this stupid son, will ya?!\Oh sorry, but he insisted that he'd go.\What do you mean, but?! What are you gonna do about it?!\There's nothing I can do about it, Nana.\Nobu's serious.\Why don't you find...\some new band members and start over? response:	Oh by the way, did ya listen to the tape?
context: Hello Yasu? Do something about this stupid son, will ya?!\Oh sorry, but he insisted that he'd go.\What do you mean, but?! What are you gonna do about it?!\There's nothing I can do about it, Nana.\Nobu's serious.\Why don't you find...\some new band members and start over?\Oh by the way, did ya listen to the tape? response:	Tape?
context: Oh sorry, but he insisted that he'd go.\What do you mean, but?! What are you gonna do about it?!\There's nothing I can do about it, Nana.\Nobu's serious.\Why don't you find...\some new band members and start over?\Oh by the way, did ya listen to the tape?\Tape? response:	The new number Nobu wrote.
context: What do you mean, but?! What are you gonna do about it?!\There's nothing I can do about it, Nana.\Nobu's serious.\Why don't you find...\some new band members and start over?\Oh by the way, did ya listen to the tape?\Tape?\The new number Nobu wrote. response:	It's good.
context: There's nothing I can do about it, Nana.\Nobu's serious.\Why don't you find...\some new band members and start over?\Oh by the way, did ya listen to the tape?\Tape?\The new number Nobu wrote.\It's good. response:	If you sing it, in my opinion, nobody's got a chance over you guys.
context: Nobu's serious.\Why don't you find...\some new band members and start over?\Oh by the way, did ya listen to the tape?\Tape?\The new number Nobu wrote.\It's good.\If you sing it, in my opinion, nobody's got a chance over you guys. response:	What's this?
context: Why don't you find...\some new band members and start over?\Oh by the way, did ya listen to the tape?\Tape?\The new number Nobu wrote.\It's good.\If you sing it, in my opinion, nobody's got a chance over you guys.\What's this? response:	Man, only one guest in the house tonight?
context: some new band members and start over?\Oh by the way, did ya listen to the tape?\Tape?\The new number Nobu wrote.\It's good.\If you sing it, in my opinion, nobody's got a chance over you guys.\What's this?\Man, only one guest in the house tonight? response:	Pretty shabby if you ask me.
context: Oh by the way, did ya listen to the tape?\Tape?\The new number Nobu wrote.\It's good.\If you sing it, in my opinion, nobody's got a chance over you guys.\What's this?\Man, only one guest in the house tonight?\Pretty shabby if you ask me. response:	Oh, well, I guess that's how it is when just starting off.
context: Tape?\The new number Nobu wrote.\It's good.\If you sing it, in my opinion, nobody's got a chance over you guys.\What's this?\Man, only one guest in the house tonight?\Pretty shabby if you ask me.\Oh, well, I guess that's how it is when just starting off. response:	One's better than none.
context: The new number Nobu wrote.\It's good.\If you sing it, in my opinion, nobody's got a chance over you guys.\What's this?\Man, only one guest in the house tonight?\Pretty shabby if you ask me.\Oh, well, I guess that's how it is when just starting off.\One's better than none. response:	Good evening. We're Blast.
context: It's good.\If you sing it, in my opinion, nobody's got a chance over you guys.\What's this?\Man, only one guest in the house tonight?\Pretty shabby if you ask me.\Oh, well, I guess that's how it is when just starting off.\One's better than none.\Good evening. We're Blast. response:	Good evening...
context: If you sing it, in my opinion, nobody's got a chance over you guys.\What's this?\Man, only one guest in the house tonight?\Pretty shabby if you ask me.\Oh, well, I guess that's how it is when just starting off.\One's better than none.\Good evening. We're Blast.\Good evening... response:	I'll make this a night you'll never forget.
context: What's this?\Man, only one guest in the house tonight?\Pretty shabby if you ask me.\Oh, well, I guess that's how it is when just starting off.\One's better than none.\Good evening. We're Blast.\Good evening...\I'll make this a night you'll never forget. response:	Looking for a drummer and bassist! Wanna join our band and go pro? Those of you who like the Sex Pistols Ask the store clerk for details
context: Man, only one guest in the house tonight?\Pretty shabby if you ask me.\Oh, well, I guess that's how it is when just starting off.\One's better than none.\Good evening. We're Blast.\Good evening...\I'll make this a night you'll never forget.\Looking for a drummer and bassist! Wanna join our band and go pro? Those of you who like the Sex Pistols Ask the store clerk for details response:	I just saw the poster out front.
context: Pretty shabby if you ask me.\Oh, well, I guess that's how it is when just starting off.\One's better than none.\Good evening. We're Blast.\Good evening...\I'll make this a night you'll never forget.\Looking for a drummer and bassist! Wanna join our band and go pro? Those of you who like the Sex Pistols Ask the store clerk for details\I just saw the poster out front. response:	Ow!
context: Oh, well, I guess that's how it is when just starting off.\One's better than none.\Good evening. We're Blast.\Good evening...\I'll make this a night you'll never forget.\Looking for a drummer and bassist! Wanna join our band and go pro? Those of you who like the Sex Pistols Ask the store clerk for details\I just saw the poster out front.\Ow! response:	Nana!
context: One's better than none.\Good evening. We're Blast.\Good evening...\I'll make this a night you'll never forget.\Looking for a drummer and bassist! Wanna join our band and go pro? Those of you who like the Sex Pistols Ask the store clerk for details\I just saw the poster out front.\Ow!\Nana! response:	I'm sorry, did I do something weird?
context: Good evening. We're Blast.\Good evening...\I'll make this a night you'll never forget.\Looking for a drummer and bassist! Wanna join our band and go pro? Those of you who like the Sex Pistols Ask the store clerk for details\I just saw the poster out front.\Ow!\Nana!\I'm sorry, did I do something weird? response:	No, it's not that at all.
context: Good evening...\I'll make this a night you'll never forget.\Looking for a drummer and bassist! Wanna join our band and go pro? Those of you who like the Sex Pistols Ask the store clerk for details\I just saw the poster out front.\Ow!\Nana!\I'm sorry, did I do something weird?\No, it's not that at all. response:	You just surprised us. You're a lot better than we expected.
context: I'll make this a night you'll never forget.\Looking for a drummer and bassist! Wanna join our band and go pro? Those of you who like the Sex Pistols Ask the store clerk for details\I just saw the poster out front.\Ow!\Nana!\I'm sorry, did I do something weird?\No, it's not that at all.\You just surprised us. You're a lot better than we expected. response:	What do you think, Nana? This kid's good.
context: Looking for a drummer and bassist! Wanna join our band and go pro? Those of you who like the Sex Pistols Ask the store clerk for details\I just saw the poster out front.\Ow!\Nana!\I'm sorry, did I do something weird?\No, it's not that at all.\You just surprised us. You're a lot better than we expected.\What do you think, Nana? This kid's good. response:	Let's let him in, okay?
context: I just saw the poster out front.\Ow!\Nana!\I'm sorry, did I do something weird?\No, it's not that at all.\You just surprised us. You're a lot better than we expected.\What do you think, Nana? This kid's good.\Let's let him in, okay? response:	So, your name's, Shinichi. Is that right?
context: Ow!\Nana!\I'm sorry, did I do something weird?\No, it's not that at all.\You just surprised us. You're a lot better than we expected.\What do you think, Nana? This kid's good.\Let's let him in, okay?\So, your name's, Shinichi. Is that right? response:	Yes.
context: Nana!\I'm sorry, did I do something weird?\No, it's not that at all.\You just surprised us. You're a lot better than we expected.\What do you think, Nana? This kid's good.\Let's let him in, okay?\So, your name's, Shinichi. Is that right?\Yes. response:	Name a guitarist you respect.
context: I'm sorry, did I do something weird?\No, it's not that at all.\You just surprised us. You're a lot better than we expected.\What do you think, Nana? This kid's good.\Let's let him in, okay?\So, your name's, Shinichi. Is that right?\Yes.\Name a guitarist you respect. response:	Ren Honjo!
context: No, it's not that at all.\You just surprised us. You're a lot better than we expected.\What do you think, Nana? This kid's good.\Let's let him in, okay?\So, your name's, Shinichi. Is that right?\Yes.\Name a guitarist you respect.\Ren Honjo! response:	There's one thing you have to promise me first.
context: You just surprised us. You're a lot better than we expected.\What do you think, Nana? This kid's good.\Let's let him in, okay?\So, your name's, Shinichi. Is that right?\Yes.\Name a guitarist you respect.\Ren Honjo!\There's one thing you have to promise me first. response:	If you can't, then you're gonna hafta decline right this moment.
context: What do you think, Nana? This kid's good.\Let's let him in, okay?\So, your name's, Shinichi. Is that right?\Yes.\Name a guitarist you respect.\Ren Honjo!\There's one thing you have to promise me first.\If you can't, then you're gonna hafta decline right this moment. response:	Shin, do better than Ren.
context: Let's let him in, okay?\So, your name's, Shinichi. Is that right?\Yes.\Name a guitarist you respect.\Ren Honjo!\There's one thing you have to promise me first.\If you can't, then you're gonna hafta decline right this moment.\Shin, do better than Ren. response:	Yes! Of course, that's what I intend to do.
context: So, your name's, Shinichi. Is that right?\Yes.\Name a guitarist you respect.\Ren Honjo!\There's one thing you have to promise me first.\If you can't, then you're gonna hafta decline right this moment.\Shin, do better than Ren.\Yes! Of course, that's what I intend to do. response:	Isn't that wonderful?
context: Yes.\Name a guitarist you respect.\Ren Honjo!\There's one thing you have to promise me first.\If you can't, then you're gonna hafta decline right this moment.\Shin, do better than Ren.\Yes! Of course, that's what I intend to do.\Isn't that wonderful? response:	You found such a great bass player in such a short time!
context: Name a guitarist you respect.\Ren Honjo!\There's one thing you have to promise me first.\If you can't, then you're gonna hafta decline right this moment.\Shin, do better than Ren.\Yes! Of course, that's what I intend to do.\Isn't that wonderful?\You found such a great bass player in such a short time! response:	And he's cute!
context: Ren Honjo!\There's one thing you have to promise me first.\If you can't, then you're gonna hafta decline right this moment.\Shin, do better than Ren.\Yes! Of course, that's what I intend to do.\Isn't that wonderful?\You found such a great bass player in such a short time!\And he's cute! response:	So who do you have to thank? Hey, who do you have to thank?
context: There's one thing you have to promise me first.\If you can't, then you're gonna hafta decline right this moment.\Shin, do better than Ren.\Yes! Of course, that's what I intend to do.\Isn't that wonderful?\You found such a great bass player in such a short time!\And he's cute!\So who do you have to thank? Hey, who do you have to thank? response:	You want a prize that badly?
context: If you can't, then you're gonna hafta decline right this moment.\Shin, do better than Ren.\Yes! Of course, that's what I intend to do.\Isn't that wonderful?\You found such a great bass player in such a short time!\And he's cute!\So who do you have to thank? Hey, who do you have to thank?\You want a prize that badly? response:	Let's see, then...
context: Shin, do better than Ren.\Yes! Of course, that's what I intend to do.\Isn't that wonderful?\You found such a great bass player in such a short time!\And he's cute!\So who do you have to thank? Hey, who do you have to thank?\You want a prize that badly?\Let's see, then... response:	Don't litter!
context: Yes! Of course, that's what I intend to do.\Isn't that wonderful?\You found such a great bass player in such a short time!\And he's cute!\So who do you have to thank? Hey, who do you have to thank?\You want a prize that badly?\Let's see, then...\Don't litter! response:	Thank you, Hachiko.
context: Isn't that wonderful?\You found such a great bass player in such a short time!\And he's cute!\So who do you have to thank? Hey, who do you have to thank?\You want a prize that badly?\Let's see, then...\Don't litter!\Thank you, Hachiko. response:	I-I thought you didn't hit on women!
context: You found such a great bass player in such a short time!\And he's cute!\So who do you have to thank? Hey, who do you have to thank?\You want a prize that badly?\Let's see, then...\Don't litter!\Thank you, Hachiko.\I-I thought you didn't hit on women! response:	It's not right! I have a boyfriend!
context: And he's cute!\So who do you have to thank? Hey, who do you have to thank?\You want a prize that badly?\Let's see, then...\Don't litter!\Thank you, Hachiko.\I-I thought you didn't hit on women!\It's not right! I have a boyfriend! response:	What's she getting all uptight about over a kiss?
context: So who do you have to thank? Hey, who do you have to thank?\You want a prize that badly?\Let's see, then...\Don't litter!\Thank you, Hachiko.\I-I thought you didn't hit on women!\It's not right! I have a boyfriend!\What's she getting all uptight about over a kiss? response:	It's not like she's a virgin.
context: You want a prize that badly?\Let's see, then...\Don't litter!\Thank you, Hachiko.\I-I thought you didn't hit on women!\It's not right! I have a boyfriend!\What's she getting all uptight about over a kiss?\It's not like she's a virgin. response:	Say, shouldn't you call Natsuko and thank her?
context: Let's see, then...\Don't litter!\Thank you, Hachiko.\I-I thought you didn't hit on women!\It's not right! I have a boyfriend!\What's she getting all uptight about over a kiss?\It's not like she's a virgin.\Say, shouldn't you call Natsuko and thank her? response:	I'll do it later.
context: Don't litter!\Thank you, Hachiko.\I-I thought you didn't hit on women!\It's not right! I have a boyfriend!\What's she getting all uptight about over a kiss?\It's not like she's a virgin.\Say, shouldn't you call Natsuko and thank her?\I'll do it later. response:	Oh, I see. If you call now, you'd be embarrassed
context: Thank you, Hachiko.\I-I thought you didn't hit on women!\It's not right! I have a boyfriend!\What's she getting all uptight about over a kiss?\It's not like she's a virgin.\Say, shouldn't you call Natsuko and thank her?\I'll do it later.\Oh, I see. If you call now, you'd be embarrassed response:	because you'll cry the moment you hear mommy's voice.
context: I-I thought you didn't hit on women!\It's not right! I have a boyfriend!\What's she getting all uptight about over a kiss?\It's not like she's a virgin.\Say, shouldn't you call Natsuko and thank her?\I'll do it later.\Oh, I see. If you call now, you'd be embarrassed\because you'll cry the moment you hear mommy's voice. response:	Well, sure.
context: It's not right! I have a boyfriend!\What's she getting all uptight about over a kiss?\It's not like she's a virgin.\Say, shouldn't you call Natsuko and thank her?\I'll do it later.\Oh, I see. If you call now, you'd be embarrassed\because you'll cry the moment you hear mommy's voice.\Well, sure. response:	You get homesick too, sometimes, don't you, Nana?
context: What's she getting all uptight about over a kiss?\It's not like she's a virgin.\Say, shouldn't you call Natsuko and thank her?\I'll do it later.\Oh, I see. If you call now, you'd be embarrassed\because you'll cry the moment you hear mommy's voice.\Well, sure.\You get homesick too, sometimes, don't you, Nana? response:	No, since I don't have a home.
context: It's not like she's a virgin.\Say, shouldn't you call Natsuko and thank her?\I'll do it later.\Oh, I see. If you call now, you'd be embarrassed\because you'll cry the moment you hear mommy's voice.\Well, sure.\You get homesick too, sometimes, don't you, Nana?\No, since I don't have a home. response:	There you go, trying to be cool again.
context: Say, shouldn't you call Natsuko and thank her?\I'll do it later.\Oh, I see. If you call now, you'd be embarrassed\because you'll cry the moment you hear mommy's voice.\Well, sure.\You get homesick too, sometimes, don't you, Nana?\No, since I don't have a home.\There you go, trying to be cool again. response:	Yasu, Blast is the band you started.
context: I'll do it later.\Oh, I see. If you call now, you'd be embarrassed\because you'll cry the moment you hear mommy's voice.\Well, sure.\You get homesick too, sometimes, don't you, Nana?\No, since I don't have a home.\There you go, trying to be cool again.\Yasu, Blast is the band you started. response:	Yeah. I was so worried I couldn't sleep at night.
context: Oh, I see. If you call now, you'd be embarrassed\because you'll cry the moment you hear mommy's voice.\Well, sure.\You get homesick too, sometimes, don't you, Nana?\No, since I don't have a home.\There you go, trying to be cool again.\Yasu, Blast is the band you started.\Yeah. I was so worried I couldn't sleep at night. response:	Besides, there are law firms in Tokyo too.
context: because you'll cry the moment you hear mommy's voice.\Well, sure.\You get homesick too, sometimes, don't you, Nana?\No, since I don't have a home.\There you go, trying to be cool again.\Yasu, Blast is the band you started.\Yeah. I was so worried I couldn't sleep at night.\Besides, there are law firms in Tokyo too. response:	The other Nana began to sing, and she now has her band members.
context: Well, sure.\You get homesick too, sometimes, don't you, Nana?\No, since I don't have a home.\There you go, trying to be cool again.\Yasu, Blast is the band you started.\Yeah. I was so worried I couldn't sleep at night.\Besides, there are law firms in Tokyo too.\The other Nana began to sing, and she now has her band members. response:	I'll bet every day is new and inspiring for Nana.
context: You get homesick too, sometimes, don't you, Nana?\No, since I don't have a home.\There you go, trying to be cool again.\Yasu, Blast is the band you started.\Yeah. I was so worried I couldn't sleep at night.\Besides, there are law firms in Tokyo too.\The other Nana began to sing, and she now has her band members.\I'll bet every day is new and inspiring for Nana. response:	Yeah, but she's practically ignored Shoji.
context: No, since I don't have a home.\There you go, trying to be cool again.\Yasu, Blast is the band you started.\Yeah. I was so worried I couldn't sleep at night.\Besides, there are law firms in Tokyo too.\The other Nana began to sing, and she now has her band members.\I'll bet every day is new and inspiring for Nana.\Yeah, but she's practically ignored Shoji. response:	And as if to fill that gap in Shoji's life... in comes Sachiko.
context: There you go, trying to be cool again.\Yasu, Blast is the band you started.\Yeah. I was so worried I couldn't sleep at night.\Besides, there are law firms in Tokyo too.\The other Nana began to sing, and she now has her band members.\I'll bet every day is new and inspiring for Nana.\Yeah, but she's practically ignored Shoji.\And as if to fill that gap in Shoji's life... in comes Sachiko. response:	That's right. The real Sachiko.
context: Yasu, Blast is the band you started.\Yeah. I was so worried I couldn't sleep at night.\Besides, there are law firms in Tokyo too.\The other Nana began to sing, and she now has her band members.\I'll bet every day is new and inspiring for Nana.\Yeah, but she's practically ignored Shoji.\And as if to fill that gap in Shoji's life... in comes Sachiko.\That's right. The real Sachiko. response:	My name is Sachiko Kawamura. It's nice to meet you.
context: Yeah. I was so worried I couldn't sleep at night.\Besides, there are law firms in Tokyo too.\The other Nana began to sing, and she now has her band members.\I'll bet every day is new and inspiring for Nana.\Yeah, but she's practically ignored Shoji.\And as if to fill that gap in Shoji's life... in comes Sachiko.\That's right. The real Sachiko.\My name is Sachiko Kawamura. It's nice to meet you. response:	Your first name?
context: Besides, there are law firms in Tokyo too.\The other Nana began to sing, and she now has her band members.\I'll bet every day is new and inspiring for Nana.\Yeah, but she's practically ignored Shoji.\And as if to fill that gap in Shoji's life... in comes Sachiko.\That's right. The real Sachiko.\My name is Sachiko Kawamura. It's nice to meet you.\Your first name? response:	Sachiko.
context: The other Nana began to sing, and she now has her band members.\I'll bet every day is new and inspiring for Nana.\Yeah, but she's practically ignored Shoji.\And as if to fill that gap in Shoji's life... in comes Sachiko.\That's right. The real Sachiko.\My name is Sachiko Kawamura. It's nice to meet you.\Your first name?\Sachiko. response:	Do you...
context: I'll bet every day is new and inspiring for Nana.\Yeah, but she's practically ignored Shoji.\And as if to fill that gap in Shoji's life... in comes Sachiko.\That's right. The real Sachiko.\My name is Sachiko Kawamura. It's nice to meet you.\Your first name?\Sachiko.\Do you... response:	Do you like Louis Vuitton and Prada?
context: Yeah, but she's practically ignored Shoji.\And as if to fill that gap in Shoji's life... in comes Sachiko.\That's right. The real Sachiko.\My name is Sachiko Kawamura. It's nice to meet you.\Your first name?\Sachiko.\Do you...\Do you like Louis Vuitton and Prada? response:	Huh?
context: And as if to fill that gap in Shoji's life... in comes Sachiko.\That's right. The real Sachiko.\My name is Sachiko Kawamura. It's nice to meet you.\Your first name?\Sachiko.\Do you...\Do you like Louis Vuitton and Prada?\Huh? response:	I get it.
context: That's right. The real Sachiko.\My name is Sachiko Kawamura. It's nice to meet you.\Your first name?\Sachiko.\Do you...\Do you like Louis Vuitton and Prada?\Huh?\I get it. response:	Well, I was just as surprised.
context: My name is Sachiko Kawamura. It's nice to meet you.\Your first name?\Sachiko.\Do you...\Do you like Louis Vuitton and Prada?\Huh?\I get it.\Well, I was just as surprised. response:	You have the same employer, go to the same university,
context: Your first name?\Sachiko.\Do you...\Do you like Louis Vuitton and Prada?\Huh?\I get it.\Well, I was just as surprised.\You have the same employer, go to the same university, response:	and enroll at the same faculty.
context: Sachiko.\Do you...\Do you like Louis Vuitton and Prada?\Huh?\I get it.\Well, I was just as surprised.\You have the same employer, go to the same university,\and enroll at the same faculty. response:	Guess you pretty well hafta get along.
context: Do you...\Do you like Louis Vuitton and Prada?\Huh?\I get it.\Well, I was just as surprised.\You have the same employer, go to the same university,\and enroll at the same faculty.\Guess you pretty well hafta get along. response:	Yes, but Sachiko was accepted on her first try,
context: Do you like Louis Vuitton and Prada?\Huh?\I get it.\Well, I was just as surprised.\You have the same employer, go to the same university,\and enroll at the same faculty.\Guess you pretty well hafta get along.\Yes, but Sachiko was accepted on her first try, response:	so she's two years younger.
context: Huh?\I get it.\Well, I was just as surprised.\You have the same employer, go to the same university,\and enroll at the same faculty.\Guess you pretty well hafta get along.\Yes, but Sachiko was accepted on her first try,\so she's two years younger. response:	Sachiko?
context: I get it.\Well, I was just as surprised.\You have the same employer, go to the same university,\and enroll at the same faculty.\Guess you pretty well hafta get along.\Yes, but Sachiko was accepted on her first try,\so she's two years younger.\Sachiko? response:	I can't help it. She asked me to call her that.
context: Well, I was just as surprised.\You have the same employer, go to the same university,\and enroll at the same faculty.\Guess you pretty well hafta get along.\Yes, but Sachiko was accepted on her first try,\so she's two years younger.\Sachiko?\I can't help it. She asked me to call her that. response:	There was no reason to refuse.
context: You have the same employer, go to the same university,\and enroll at the same faculty.\Guess you pretty well hafta get along.\Yes, but Sachiko was accepted on her first try,\so she's two years younger.\Sachiko?\I can't help it. She asked me to call her that.\There was no reason to refuse. response:	She's clearly your type. Petite and fair-skinned.
context: and enroll at the same faculty.\Guess you pretty well hafta get along.\Yes, but Sachiko was accepted on her first try,\so she's two years younger.\Sachiko?\I can't help it. She asked me to call her that.\There was no reason to refuse.\She's clearly your type. Petite and fair-skinned. response:	You can't help it.
context: Guess you pretty well hafta get along.\Yes, but Sachiko was accepted on her first try,\so she's two years younger.\Sachiko?\I can't help it. She asked me to call her that.\There was no reason to refuse.\She's clearly your type. Petite and fair-skinned.\You can't help it. response:	But I'm telling you, it's not like that!
context: Yes, but Sachiko was accepted on her first try,\so she's two years younger.\Sachiko?\I can't help it. She asked me to call her that.\There was no reason to refuse.\She's clearly your type. Petite and fair-skinned.\You can't help it.\But I'm telling you, it's not like that! response:	I'm proud that you're holding back.
context: so she's two years younger.\Sachiko?\I can't help it. She asked me to call her that.\There was no reason to refuse.\She's clearly your type. Petite and fair-skinned.\You can't help it.\But I'm telling you, it's not like that!\I'm proud that you're holding back. response:	She's back.
context: Sachiko?\I can't help it. She asked me to call her that.\There was no reason to refuse.\She's clearly your type. Petite and fair-skinned.\You can't help it.\But I'm telling you, it's not like that!\I'm proud that you're holding back.\She's back. response:	Here, Shoji. Is coffee okay?
context: I can't help it. She asked me to call her that.\There was no reason to refuse.\She's clearly your type. Petite and fair-skinned.\You can't help it.\But I'm telling you, it's not like that!\I'm proud that you're holding back.\She's back.\Here, Shoji. Is coffee okay? response:	Yeah. Thanks.
context: There was no reason to refuse.\She's clearly your type. Petite and fair-skinned.\You can't help it.\But I'm telling you, it's not like that!\I'm proud that you're holding back.\She's back.\Here, Shoji. Is coffee okay?\Yeah. Thanks. response:	Mr. Kyosuke, which would you prefer?
context: She's clearly your type. Petite and fair-skinned.\You can't help it.\But I'm telling you, it's not like that!\I'm proud that you're holding back.\She's back.\Here, Shoji. Is coffee okay?\Yeah. Thanks.\Mr. Kyosuke, which would you prefer? response:	Just call me Kyosuke, Sa-chan.
context: You can't help it.\But I'm telling you, it's not like that!\I'm proud that you're holding back.\She's back.\Here, Shoji. Is coffee okay?\Yeah. Thanks.\Mr. Kyosuke, which would you prefer?\Just call me Kyosuke, Sa-chan. response:	That's gonna be trouble.
context: But I'm telling you, it's not like that!\I'm proud that you're holding back.\She's back.\Here, Shoji. Is coffee okay?\Yeah. Thanks.\Mr. Kyosuke, which would you prefer?\Just call me Kyosuke, Sa-chan.\That's gonna be trouble. response:	But even I find her cute.
context: I'm proud that you're holding back.\She's back.\Here, Shoji. Is coffee okay?\Yeah. Thanks.\Mr. Kyosuke, which would you prefer?\Just call me Kyosuke, Sa-chan.\That's gonna be trouble.\But even I find her cute. response:	This is definitely bad.
context: She's back.\Here, Shoji. Is coffee okay?\Yeah. Thanks.\Mr. Kyosuke, which would you prefer?\Just call me Kyosuke, Sa-chan.\That's gonna be trouble.\But even I find her cute.\This is definitely bad. response:	Oh! My shoe!
context: Here, Shoji. Is coffee okay?\Yeah. Thanks.\Mr. Kyosuke, which would you prefer?\Just call me Kyosuke, Sa-chan.\That's gonna be trouble.\But even I find her cute.\This is definitely bad.\Oh! My shoe! response:	Shoji!
context: Yeah. Thanks.\Mr. Kyosuke, which would you prefer?\Just call me Kyosuke, Sa-chan.\That's gonna be trouble.\But even I find her cute.\This is definitely bad.\Oh! My shoe!\Shoji! response:	Huh?!
context: Mr. Kyosuke, which would you prefer?\Just call me Kyosuke, Sa-chan.\That's gonna be trouble.\But even I find her cute.\This is definitely bad.\Oh! My shoe!\Shoji!\Huh?! response:	Sorry, Shoji. Go on ahead. You'll miss the last train!
context: Just call me Kyosuke, Sa-chan.\That's gonna be trouble.\But even I find her cute.\This is definitely bad.\Oh! My shoe!\Shoji!\Huh?!\Sorry, Shoji. Go on ahead. You'll miss the last train! response:	Hey!
context: That's gonna be trouble.\But even I find her cute.\This is definitely bad.\Oh! My shoe!\Shoji!\Huh?!\Sorry, Shoji. Go on ahead. You'll miss the last train!\Hey! response:	You knew you would hafta run for the last train.
context: But even I find her cute.\This is definitely bad.\Oh! My shoe!\Shoji!\Huh?!\Sorry, Shoji. Go on ahead. You'll miss the last train!\Hey!\You knew you would hafta run for the last train. response:	So why did you hafta wear those shoes?
context: This is definitely bad.\Oh! My shoe!\Shoji!\Huh?!\Sorry, Shoji. Go on ahead. You'll miss the last train!\Hey!\You knew you would hafta run for the last train.\So why did you hafta wear those shoes? response:	I did it on purpose.
context: Oh! My shoe!\Shoji!\Huh?!\Sorry, Shoji. Go on ahead. You'll miss the last train!\Hey!\You knew you would hafta run for the last train.\So why did you hafta wear those shoes?\I did it on purpose. response:	This seriously doesn't look good.
context: Shoji!\Huh?!\Sorry, Shoji. Go on ahead. You'll miss the last train!\Hey!\You knew you would hafta run for the last train.\So why did you hafta wear those shoes?\I did it on purpose.\This seriously doesn't look good. response:	I did it on purpose.
context: Huh?!\Sorry, Shoji. Go on ahead. You'll miss the last train!\Hey!\You knew you would hafta run for the last train.\So why did you hafta wear those shoes?\I did it on purpose.\This seriously doesn't look good.\I did it on purpose. response:	It's her secret weapon. I did it on purpose.
context: Sorry, Shoji. Go on ahead. You'll miss the last train!\Hey!\You knew you would hafta run for the last train.\So why did you hafta wear those shoes?\I did it on purpose.\This seriously doesn't look good.\I did it on purpose.\It's her secret weapon. I did it on purpose. response:	- So, what are you gonna do about it? - What are you gonna do about it?
context: Hey!\You knew you would hafta run for the last train.\So why did you hafta wear those shoes?\I did it on purpose.\This seriously doesn't look good.\I did it on purpose.\It's her secret weapon. I did it on purpose.\- So, what are you gonna do about it? - What are you gonna do about it? response:	So, there you have it.
context: You knew you would hafta run for the last train.\So why did you hafta wear those shoes?\I did it on purpose.\This seriously doesn't look good.\I did it on purpose.\It's her secret weapon. I did it on purpose.\- So, what are you gonna do about it? - What are you gonna do about it?\So, there you have it. response:	Well, that all depends on whether or not
context: So why did you hafta wear those shoes?\I did it on purpose.\This seriously doesn't look good.\I did it on purpose.\It's her secret weapon. I did it on purpose.\- So, what are you gonna do about it? - What are you gonna do about it?\So, there you have it.\Well, that all depends on whether or not response:	the Demon Lord wants it or not.
context: I did it on purpose.\This seriously doesn't look good.\I did it on purpose.\It's her secret weapon. I did it on purpose.\- So, what are you gonna do about it? - What are you gonna do about it?\So, there you have it.\Well, that all depends on whether or not\the Demon Lord wants it or not. response:	Bye-bye.
context: This seriously doesn't look good.\I did it on purpose.\It's her secret weapon. I did it on purpose.\- So, what are you gonna do about it? - What are you gonna do about it?\So, there you have it.\Well, that all depends on whether or not\the Demon Lord wants it or not.\Bye-bye. response:	- Good-bye. - Good-bye.
context: I did it on purpose.\It's her secret weapon. I did it on purpose.\- So, what are you gonna do about it? - What are you gonna do about it?\So, there you have it.\Well, that all depends on whether or not\the Demon Lord wants it or not.\Bye-bye.\- Good-bye. - Good-bye. response:	I reached into the sky
context: It's her secret weapon. I did it on purpose.\- So, what are you gonna do about it? - What are you gonna do about it?\So, there you have it.\Well, that all depends on whether or not\the Demon Lord wants it or not.\Bye-bye.\- Good-bye. - Good-bye.\I reached into the sky response:	But I couldn't reach what I wanted
context: - So, what are you gonna do about it? - What are you gonna do about it?\So, there you have it.\Well, that all depends on whether or not\the Demon Lord wants it or not.\Bye-bye.\- Good-bye. - Good-bye.\I reached into the sky\But I couldn't reach what I wanted response:	They grew smaller and disappeared into the sky
context: So, there you have it.\Well, that all depends on whether or not\the Demon Lord wants it or not.\Bye-bye.\- Good-bye. - Good-bye.\I reached into the sky\But I couldn't reach what I wanted\They grew smaller and disappeared into the sky response:	Like colorful balloons
context: Well, that all depends on whether or not\the Demon Lord wants it or not.\Bye-bye.\- Good-bye. - Good-bye.\I reached into the sky\But I couldn't reach what I wanted\They grew smaller and disappeared into the sky\Like colorful balloons response:	I'm alone
context: the Demon Lord wants it or not.\Bye-bye.\- Good-bye. - Good-bye.\I reached into the sky\But I couldn't reach what I wanted\They grew smaller and disappeared into the sky\Like colorful balloons\I'm alone response:	My hand had no place to go
context: Bye-bye.\- Good-bye. - Good-bye.\I reached into the sky\But I couldn't reach what I wanted\They grew smaller and disappeared into the sky\Like colorful balloons\I'm alone\My hand had no place to go response:	And gently you took it
context: - Good-bye. - Good-bye.\I reached into the sky\But I couldn't reach what I wanted\They grew smaller and disappeared into the sky\Like colorful balloons\I'm alone\My hand had no place to go\And gently you took it response:	Starless night
context: I reached into the sky\But I couldn't reach what I wanted\They grew smaller and disappeared into the sky\Like colorful balloons\I'm alone\My hand had no place to go\And gently you took it\Starless night response:	I won't look back at the shadow of my past
context: But I couldn't reach what I wanted\They grew smaller and disappeared into the sky\Like colorful balloons\I'm alone\My hand had no place to go\And gently you took it\Starless night\I won't look back at the shadow of my past response:	I want to feel your warmth
context: They grew smaller and disappeared into the sky\Like colorful balloons\I'm alone\My hand had no place to go\And gently you took it\Starless night\I won't look back at the shadow of my past\I want to feel your warmth response:	Tears are falling down
context: Like colorful balloons\I'm alone\My hand had no place to go\And gently you took it\Starless night\I won't look back at the shadow of my past\I want to feel your warmth\Tears are falling down response:	Even if I'm unsure I won't let go
context: I'm alone\My hand had no place to go\And gently you took it\Starless night\I won't look back at the shadow of my past\I want to feel your warmth\Tears are falling down\Even if I'm unsure I won't let go response:	Of your hand holding mine