context: Rule the Court response:	I'm sure you're sick of hearing this,
context: Rule the Court\I'm sure you're sick of hearing this, response:	Seijoh!
context: Rule the Court\I'm sure you're sick of hearing this,\Seijoh! response:	but make sure you serve strong.
context: Rule the Court\I'm sure you're sick of hearing this,\Seijoh!\but make sure you serve strong. response:	It can't be helped if their 10 scores some points.
context: Rule the Court\I'm sure you're sick of hearing this,\Seijoh!\but make sure you serve strong.\It can't be helped if their 10 scores some points. response:	Seijoh!
context: Rule the Court\I'm sure you're sick of hearing this,\Seijoh!\but make sure you serve strong.\It can't be helped if their 10 scores some points.\Seijoh! response:	Limit his path and pick up the ball.
context: Rule the Court\I'm sure you're sick of hearing this,\Seijoh!\but make sure you serve strong.\It can't be helped if their 10 scores some points.\Seijoh!\Limit his path and pick up the ball. response:	Right!
context: Rule the Court\I'm sure you're sick of hearing this,\Seijoh!\but make sure you serve strong.\It can't be helped if their 10 scores some points.\Seijoh!\Limit his path and pick up the ball.\Right! response:	You guys are strong.
context: I'm sure you're sick of hearing this,\Seijoh!\but make sure you serve strong.\It can't be helped if their 10 scores some points.\Seijoh!\Limit his path and pick up the ball.\Right!\You guys are strong. response:	Seijoh!
context: Seijoh!\but make sure you serve strong.\It can't be helped if their 10 scores some points.\Seijoh!\Limit his path and pick up the ball.\Right!\You guys are strong.\Seijoh! response:	Yeah!
context: but make sure you serve strong.\It can't be helped if their 10 scores some points.\Seijoh!\Limit his path and pick up the ball.\Right!\You guys are strong.\Seijoh!\Yeah! response:	Seijoh!
context: It can't be helped if their 10 scores some points.\Seijoh!\Limit his path and pick up the ball.\Right!\You guys are strong.\Seijoh!\Yeah!\Seijoh! response:	Fly
context: Seijoh!\Limit his path and pick up the ball.\Right!\You guys are strong.\Seijoh!\Yeah!\Seijoh!\Fly response:	Just remember, don't let Oikawa do whatever he wants with his serves.
context: Limit his path and pick up the ball.\Right!\You guys are strong.\Seijoh!\Yeah!\Seijoh!\Fly\Just remember, don't let Oikawa do whatever he wants with his serves. response:	Just get it up. Get it up, no matter what.
context: Right!\You guys are strong.\Seijoh!\Yeah!\Seijoh!\Fly\Just remember, don't let Oikawa do whatever he wants with his serves.\Just get it up. Get it up, no matter what. response:	Then, someone will connect.
context: You guys are strong.\Seijoh!\Yeah!\Seijoh!\Fly\Just remember, don't let Oikawa do whatever he wants with his serves.\Just get it up. Get it up, no matter what.\Then, someone will connect. response:	Right!
context: Seijoh!\Yeah!\Seijoh!\Fly\Just remember, don't let Oikawa do whatever he wants with his serves.\Just get it up. Get it up, no matter what.\Then, someone will connect.\Right! response:	If an enemy you must defeat one day is called an archenemy,
context: Yeah!\Seijoh!\Fly\Just remember, don't let Oikawa do whatever he wants with his serves.\Just get it up. Get it up, no matter what.\Then, someone will connect.\Right!\If an enemy you must defeat one day is called an archenemy, response:	then for Karasuno, Aoba Johsai is indeed that.
context: Seijoh!\Fly\Just remember, don't let Oikawa do whatever he wants with his serves.\Just get it up. Get it up, no matter what.\Then, someone will connect.\Right!\If an enemy you must defeat one day is called an archenemy,\then for Karasuno, Aoba Johsai is indeed that. response:	You are going to be the ones
context: Fly\Just remember, don't let Oikawa do whatever he wants with his serves.\Just get it up. Get it up, no matter what.\Then, someone will connect.\Right!\If an enemy you must defeat one day is called an archenemy,\then for Karasuno, Aoba Johsai is indeed that.\You are going to be the ones response:	who are going to win this battle against your archenemy.
context: Just remember, don't let Oikawa do whatever he wants with his serves.\Just get it up. Get it up, no matter what.\Then, someone will connect.\Right!\If an enemy you must defeat one day is called an archenemy,\then for Karasuno, Aoba Johsai is indeed that.\You are going to be the ones\who are going to win this battle against your archenemy. response:	Yeah!
context: Just get it up. Get it up, no matter what.\Then, someone will connect.\Right!\If an enemy you must defeat one day is called an archenemy,\then for Karasuno, Aoba Johsai is indeed that.\You are going to be the ones\who are going to win this battle against your archenemy.\Yeah! response:	The final set...
context: Then, someone will connect.\Right!\If an enemy you must defeat one day is called an archenemy,\then for Karasuno, Aoba Johsai is indeed that.\You are going to be the ones\who are going to win this battle against your archenemy.\Yeah!\The final set... response:	We're going to surpass Aoba Johsai.
context: Right!\If an enemy you must defeat one day is called an archenemy,\then for Karasuno, Aoba Johsai is indeed that.\You are going to be the ones\who are going to win this battle against your archenemy.\Yeah!\The final set...\We're going to surpass Aoba Johsai. response:	We're going to surpass them with this team!
context: If an enemy you must defeat one day is called an archenemy,\then for Karasuno, Aoba Johsai is indeed that.\You are going to be the ones\who are going to win this battle against your archenemy.\Yeah!\The final set...\We're going to surpass Aoba Johsai.\We're going to surpass them with this team! response:	Karasuno, fight!
context: then for Karasuno, Aoba Johsai is indeed that.\You are going to be the ones\who are going to win this battle against your archenemy.\Yeah!\The final set...\We're going to surpass Aoba Johsai.\We're going to surpass them with this team!\Karasuno, fight! response:	Yeah!
context: You are going to be the ones\who are going to win this battle against your archenemy.\Yeah!\The final set...\We're going to surpass Aoba Johsai.\We're going to surpass them with this team!\Karasuno, fight!\Yeah! response:	Haikyu!!
context: who are going to win this battle against your archenemy.\Yeah!\The final set...\We're going to surpass Aoba Johsai.\We're going to surpass them with this team!\Karasuno, fight!\Yeah!\Haikyu!! response:	Episode 23: Team
context: Yeah!\The final set...\We're going to surpass Aoba Johsai.\We're going to surpass them with this team!\Karasuno, fight!\Yeah!\Haikyu!!\Episode 23: Team response:	This is finally it...
context: The final set...\We're going to surpass Aoba Johsai.\We're going to surpass them with this team!\Karasuno, fight!\Yeah!\Haikyu!!\Episode 23: Team\This is finally it... response:	Yeah...
context: We're going to surpass Aoba Johsai.\We're going to surpass them with this team!\Karasuno, fight!\Yeah!\Haikyu!!\Episode 23: Team\This is finally it...\Yeah... response:	The set where they settle things with Seijoh.
context: We're going to surpass them with this team!\Karasuno, fight!\Yeah!\Haikyu!!\Episode 23: Team\This is finally it...\Yeah...\The set where they settle things with Seijoh. response:	Nice serve!
context: Karasuno, fight!\Yeah!\Haikyu!!\Episode 23: Team\This is finally it...\Yeah...\The set where they settle things with Seijoh.\Nice serve! response:	Go, Asahi!
context: Yeah!\Haikyu!!\Episode 23: Team\This is finally it...\Yeah...\The set where they settle things with Seijoh.\Nice serve!\Go, Asahi! response:	All right!
context: Haikyu!!\Episode 23: Team\This is finally it...\Yeah...\The set where they settle things with Seijoh.\Nice serve!\Go, Asahi!\All right! response:	Oikawa-san, nice serve!
context: Episode 23: Team\This is finally it...\Yeah...\The set where they settle things with Seijoh.\Nice serve!\Go, Asahi!\All right!\Oikawa-san, nice serve! response:	Get it up... Get it up, no matter what.
context: This is finally it...\Yeah...\The set where they settle things with Seijoh.\Nice serve!\Go, Asahi!\All right!\Oikawa-san, nice serve!\Get it up... Get it up, no matter what. response:	We can't let them gain the lead this early.
context: Yeah...\The set where they settle things with Seijoh.\Nice serve!\Go, Asahi!\All right!\Oikawa-san, nice serve!\Get it up... Get it up, no matter what.\We can't let them gain the lead this early. response:	Please! Cut them off with this one!
context: The set where they settle things with Seijoh.\Nice serve!\Go, Asahi!\All right!\Oikawa-san, nice serve!\Get it up... Get it up, no matter what.\We can't let them gain the lead this early.\Please! Cut them off with this one! response:	That speed...
context: Nice serve!\Go, Asahi!\All right!\Oikawa-san, nice serve!\Get it up... Get it up, no matter what.\We can't let them gain the lead this early.\Please! Cut them off with this one!\That speed... response:	It's past the net! It's coming direct!
context: Go, Asahi!\All right!\Oikawa-san, nice serve!\Get it up... Get it up, no matter what.\We can't let them gain the lead this early.\Please! Cut them off with this one!\That speed...\It's past the net! It's coming direct! response:	It's right in front of me, but my reaction's delayed.
context: All right!\Oikawa-san, nice serve!\Get it up... Get it up, no matter what.\We can't let them gain the lead this early.\Please! Cut them off with this one!\That speed...\It's past the net! It's coming direct!\It's right in front of me, but my reaction's delayed. response:	Kyotani! Direct!
context: Oikawa-san, nice serve!\Get it up... Get it up, no matter what.\We can't let them gain the lead this early.\Please! Cut them off with this one!\That speed...\It's past the net! It's coming direct!\It's right in front of me, but my reaction's delayed.\Kyotani! Direct! response:	All right!
context: Get it up... Get it up, no matter what.\We can't let them gain the lead this early.\Please! Cut them off with this one!\That speed...\It's past the net! It's coming direct!\It's right in front of me, but my reaction's delayed.\Kyotani! Direct!\All right! response:	Great, great, Kentaro! Push it, push it, Kentaro. One more time!
context: We can't let them gain the lead this early.\Please! Cut them off with this one!\That speed...\It's past the net! It's coming direct!\It's right in front of me, but my reaction's delayed.\Kyotani! Direct!\All right!\Great, great, Kentaro! Push it, push it, Kentaro. One more time! response:	Good. It looks like Mad Dog-chan's engine's still warmed up.
context: Please! Cut them off with this one!\That speed...\It's past the net! It's coming direct!\It's right in front of me, but my reaction's delayed.\Kyotani! Direct!\All right!\Great, great, Kentaro! Push it, push it, Kentaro. One more time!\Good. It looks like Mad Dog-chan's engine's still warmed up. response:	Oikawa's serves are definitely a problem.
context: That speed...\It's past the net! It's coming direct!\It's right in front of me, but my reaction's delayed.\Kyotani! Direct!\All right!\Great, great, Kentaro! Push it, push it, Kentaro. One more time!\Good. It looks like Mad Dog-chan's engine's still warmed up.\Oikawa's serves are definitely a problem. response:	Please... Cut them off.
context: It's past the net! It's coming direct!\It's right in front of me, but my reaction's delayed.\Kyotani! Direct!\All right!\Great, great, Kentaro! Push it, push it, Kentaro. One more time!\Good. It looks like Mad Dog-chan's engine's still warmed up.\Oikawa's serves are definitely a problem.\Please... Cut them off. response:	Karasuno, fight!
context: It's right in front of me, but my reaction's delayed.\Kyotani! Direct!\All right!\Great, great, Kentaro! Push it, push it, Kentaro. One more time!\Good. It looks like Mad Dog-chan's engine's still warmed up.\Oikawa's serves are definitely a problem.\Please... Cut them off.\Karasuno, fight! response:	Oikawa, one more! Nice serve!
context: Kyotani! Direct!\All right!\Great, great, Kentaro! Push it, push it, Kentaro. One more time!\Good. It looks like Mad Dog-chan's engine's still warmed up.\Oikawa's serves are definitely a problem.\Please... Cut them off.\Karasuno, fight!\Oikawa, one more! Nice serve! response:	All right!
context: All right!\Great, great, Kentaro! Push it, push it, Kentaro. One more time!\Good. It looks like Mad Dog-chan's engine's still warmed up.\Oikawa's serves are definitely a problem.\Please... Cut them off.\Karasuno, fight!\Oikawa, one more! Nice serve!\All right! response:	It's up!
context: Great, great, Kentaro! Push it, push it, Kentaro. One more time!\Good. It looks like Mad Dog-chan's engine's still warmed up.\Oikawa's serves are definitely a problem.\Please... Cut them off.\Karasuno, fight!\Oikawa, one more! Nice serve!\All right!\It's up! response:	Cover!
context: Good. It looks like Mad Dog-chan's engine's still warmed up.\Oikawa's serves are definitely a problem.\Please... Cut them off.\Karasuno, fight!\Oikawa, one more! Nice serve!\All right!\It's up!\Cover! response:	Yeah!
context: Oikawa's serves are definitely a problem.\Please... Cut them off.\Karasuno, fight!\Oikawa, one more! Nice serve!\All right!\It's up!\Cover!\Yeah! response:	Tanaka, nice kill!
context: Please... Cut them off.\Karasuno, fight!\Oikawa, one more! Nice serve!\All right!\It's up!\Cover!\Yeah!\Tanaka, nice kill! response:	They somehow managed to stop it.
context: Karasuno, fight!\Oikawa, one more! Nice serve!\All right!\It's up!\Cover!\Yeah!\Tanaka, nice kill!\They somehow managed to stop it. response:	Thanks!
context: Oikawa, one more! Nice serve!\All right!\It's up!\Cover!\Yeah!\Tanaka, nice kill!\They somehow managed to stop it.\Thanks! response:	Ryu, well done!
context: All right!\It's up!\Cover!\Yeah!\Tanaka, nice kill!\They somehow managed to stop it.\Thanks!\Ryu, well done! response:	All right!
context: It's up!\Cover!\Yeah!\Tanaka, nice kill!\They somehow managed to stop it.\Thanks!\Ryu, well done!\All right! response:	Tsukishima! You're serving next!
context: Cover!\Yeah!\Tanaka, nice kill!\They somehow managed to stop it.\Thanks!\Ryu, well done!\All right!\Tsukishima! You're serving next! response:	Oh, right.
context: Yeah!\Tanaka, nice kill!\They somehow managed to stop it.\Thanks!\Ryu, well done!\All right!\Tsukishima! You're serving next!\Oh, right. response:	Aoba Johsai Karasuno
context: Tanaka, nice kill!\They somehow managed to stop it.\Thanks!\Ryu, well done!\All right!\Tsukishima! You're serving next!\Oh, right.\Aoba Johsai Karasuno response:	Tsukishima, nice serve!
context: They somehow managed to stop it.\Thanks!\Ryu, well done!\All right!\Tsukishima! You're serving next!\Oh, right.\Aoba Johsai Karasuno\Tsukishima, nice serve! response:	Got it!
context: Thanks!\Ryu, well done!\All right!\Tsukishima! You're serving next!\Oh, right.\Aoba Johsai Karasuno\Tsukishima, nice serve!\Got it! response:	Mad Dog-chan!
context: Ryu, well done!\All right!\Tsukishima! You're serving next!\Oh, right.\Aoba Johsai Karasuno\Tsukishima, nice serve!\Got it!\Mad Dog-chan! response:	Yeah!
context: All right!\Tsukishima! You're serving next!\Oh, right.\Aoba Johsai Karasuno\Tsukishima, nice serve!\Got it!\Mad Dog-chan!\Yeah! response:	Great, great, Kentaro! Push it, push it, Kentaro! One more time.
context: Tsukishima! You're serving next!\Oh, right.\Aoba Johsai Karasuno\Tsukishima, nice serve!\Got it!\Mad Dog-chan!\Yeah!\Great, great, Kentaro! Push it, push it, Kentaro! One more time. response:	Nice kill!
context: Oh, right.\Aoba Johsai Karasuno\Tsukishima, nice serve!\Got it!\Mad Dog-chan!\Yeah!\Great, great, Kentaro! Push it, push it, Kentaro! One more time.\Nice kill! response:	Kyotani has a lot more energy when he's on the front line.
context: Aoba Johsai Karasuno\Tsukishima, nice serve!\Got it!\Mad Dog-chan!\Yeah!\Great, great, Kentaro! Push it, push it, Kentaro! One more time.\Nice kill!\Kyotani has a lot more energy when he's on the front line. response:	Hopefully he'll be able to keep it up until the end.
context: Tsukishima, nice serve!\Got it!\Mad Dog-chan!\Yeah!\Great, great, Kentaro! Push it, push it, Kentaro! One more time.\Nice kill!\Kyotani has a lot more energy when he's on the front line.\Hopefully he'll be able to keep it up until the end. response:	An ace with both power and technique...
context: Got it!\Mad Dog-chan!\Yeah!\Great, great, Kentaro! Push it, push it, Kentaro! One more time.\Nice kill!\Kyotani has a lot more energy when he's on the front line.\Hopefully he'll be able to keep it up until the end.\An ace with both power and technique... response:	Not only is his attack powerful,
context: Mad Dog-chan!\Yeah!\Great, great, Kentaro! Push it, push it, Kentaro! One more time.\Nice kill!\Kyotani has a lot more energy when he's on the front line.\Hopefully he'll be able to keep it up until the end.\An ace with both power and technique...\Not only is his attack powerful, response:	but that 16 is also a troublesome decoy.
context: Yeah!\Great, great, Kentaro! Push it, push it, Kentaro! One more time.\Nice kill!\Kyotani has a lot more energy when he's on the front line.\Hopefully he'll be able to keep it up until the end.\An ace with both power and technique...\Not only is his attack powerful,\but that 16 is also a troublesome decoy. response:	And then Oikawa's serves that rack up points...
context: Great, great, Kentaro! Push it, push it, Kentaro! One more time.\Nice kill!\Kyotani has a lot more energy when he's on the front line.\Hopefully he'll be able to keep it up until the end.\An ace with both power and technique...\Not only is his attack powerful,\but that 16 is also a troublesome decoy.\And then Oikawa's serves that rack up points... response:	If we can't counter those, it's going to break us.
context: Nice kill!\Kyotani has a lot more energy when he's on the front line.\Hopefully he'll be able to keep it up until the end.\An ace with both power and technique...\Not only is his attack powerful,\but that 16 is also a troublesome decoy.\And then Oikawa's serves that rack up points...\If we can't counter those, it's going to break us. response:	Both of us are high in ability.
context: Kyotani has a lot more energy when he's on the front line.\Hopefully he'll be able to keep it up until the end.\An ace with both power and technique...\Not only is his attack powerful,\but that 16 is also a troublesome decoy.\And then Oikawa's serves that rack up points...\If we can't counter those, it's going to break us.\Both of us are high in ability. response:	The more we struggle for dominance,
context: Hopefully he'll be able to keep it up until the end.\An ace with both power and technique...\Not only is his attack powerful,\but that 16 is also a troublesome decoy.\And then Oikawa's serves that rack up points...\If we can't counter those, it's going to break us.\Both of us are high in ability.\The more we struggle for dominance, response:	the more fatal the consequences will be
context: An ace with both power and technique...\Not only is his attack powerful,\but that 16 is also a troublesome decoy.\And then Oikawa's serves that rack up points...\If we can't counter those, it's going to break us.\Both of us are high in ability.\The more we struggle for dominance,\the more fatal the consequences will be response:	when one of us loses our balance.
context: Not only is his attack powerful,\but that 16 is also a troublesome decoy.\And then Oikawa's serves that rack up points...\If we can't counter those, it's going to break us.\Both of us are high in ability.\The more we struggle for dominance,\the more fatal the consequences will be\when one of us loses our balance. response:	Rule the Court
context: but that 16 is also a troublesome decoy.\And then Oikawa's serves that rack up points...\If we can't counter those, it's going to break us.\Both of us are high in ability.\The more we struggle for dominance,\the more fatal the consequences will be\when one of us loses our balance.\Rule the Court response:	Hang on and don't let go!
context: And then Oikawa's serves that rack up points...\If we can't counter those, it's going to break us.\Both of us are high in ability.\The more we struggle for dominance,\the more fatal the consequences will be\when one of us loses our balance.\Rule the Court\Hang on and don't let go! response:	All right!
context: If we can't counter those, it's going to break us.\Both of us are high in ability.\The more we struggle for dominance,\the more fatal the consequences will be\when one of us loses our balance.\Rule the Court\Hang on and don't let go!\All right! response:	Aoba Johsai Karasuno
context: Both of us are high in ability.\The more we struggle for dominance,\the more fatal the consequences will be\when one of us loses our balance.\Rule the Court\Hang on and don't let go!\All right!\Aoba Johsai Karasuno response:	The final set's also really close.
context: The more we struggle for dominance,\the more fatal the consequences will be\when one of us loses our balance.\Rule the Court\Hang on and don't let go!\All right!\Aoba Johsai Karasuno\The final set's also really close. response:	But no one's taken a significant lead yet.
context: the more fatal the consequences will be\when one of us loses our balance.\Rule the Court\Hang on and don't let go!\All right!\Aoba Johsai Karasuno\The final set's also really close.\But no one's taken a significant lead yet. response:	They've got to fight real hard not to get left behind right now.
context: when one of us loses our balance.\Rule the Court\Hang on and don't let go!\All right!\Aoba Johsai Karasuno\The final set's also really close.\But no one's taken a significant lead yet.\They've got to fight real hard not to get left behind right now. response:	Asahi! Get this one!
context: Rule the Court\Hang on and don't let go!\All right!\Aoba Johsai Karasuno\The final set's also really close.\But no one's taken a significant lead yet.\They've got to fight real hard not to get left behind right now.\Asahi! Get this one! response:	Yeah!
context: Hang on and don't let go!\All right!\Aoba Johsai Karasuno\The final set's also really close.\But no one's taken a significant lead yet.\They've got to fight real hard not to get left behind right now.\Asahi! Get this one!\Yeah! response:	Nice course!
context: All right!\Aoba Johsai Karasuno\The final set's also really close.\But no one's taken a significant lead yet.\They've got to fight real hard not to get left behind right now.\Asahi! Get this one!\Yeah!\Nice course! response:	There's no way you could have gotten that one.
context: Aoba Johsai Karasuno\The final set's also really close.\But no one's taken a significant lead yet.\They've got to fight real hard not to get left behind right now.\Asahi! Get this one!\Yeah!\Nice course!\There's no way you could have gotten that one. response:	We'll get the next one!
context: The final set's also really close.\But no one's taken a significant lead yet.\They've got to fight real hard not to get left behind right now.\Asahi! Get this one!\Yeah!\Nice course!\There's no way you could have gotten that one.\We'll get the next one! response:	Aoba Johsai Karasuno
context: But no one's taken a significant lead yet.\They've got to fight real hard not to get left behind right now.\Asahi! Get this one!\Yeah!\Nice course!\There's no way you could have gotten that one.\We'll get the next one!\Aoba Johsai Karasuno response:	Asahi, one more! Nice serve!
context: They've got to fight real hard not to get left behind right now.\Asahi! Get this one!\Yeah!\Nice course!\There's no way you could have gotten that one.\We'll get the next one!\Aoba Johsai Karasuno\Asahi, one more! Nice serve! response:	Yeah.
context: Asahi! Get this one!\Yeah!\Nice course!\There's no way you could have gotten that one.\We'll get the next one!\Aoba Johsai Karasuno\Asahi, one more! Nice serve!\Yeah. response:	Nice receive!
context: Yeah!\Nice course!\There's no way you could have gotten that one.\We'll get the next one!\Aoba Johsai Karasuno\Asahi, one more! Nice serve!\Yeah.\Nice receive! response:	Yeah!
context: Nice course!\There's no way you could have gotten that one.\We'll get the next one!\Aoba Johsai Karasuno\Asahi, one more! Nice serve!\Yeah.\Nice receive!\Yeah! response:	Damn it...
context: There's no way you could have gotten that one.\We'll get the next one!\Aoba Johsai Karasuno\Asahi, one more! Nice serve!\Yeah.\Nice receive!\Yeah!\Damn it... response:	And there he is again.
context: We'll get the next one!\Aoba Johsai Karasuno\Asahi, one more! Nice serve!\Yeah.\Nice receive!\Yeah!\Damn it...\And there he is again. response:	Oikawa, nice serve!
context: Aoba Johsai Karasuno\Asahi, one more! Nice serve!\Yeah.\Nice receive!\Yeah!\Damn it...\And there he is again.\Oikawa, nice serve! response:	Yes! Now score and cut off Oikawa's serves!
context: Asahi, one more! Nice serve!\Yeah.\Nice receive!\Yeah!\Damn it...\And there he is again.\Oikawa, nice serve!\Yes! Now score and cut off Oikawa's serves! response:	Chance ball! Tanaka!
context: Yeah.\Nice receive!\Yeah!\Damn it...\And there he is again.\Oikawa, nice serve!\Yes! Now score and cut off Oikawa's serves!\Chance ball! Tanaka! response:	Yeah!
context: Nice receive!\Yeah!\Damn it...\And there he is again.\Oikawa, nice serve!\Yes! Now score and cut off Oikawa's serves!\Chance ball! Tanaka!\Yeah! response:	A quick's coming!
context: Yeah!\Damn it...\And there he is again.\Oikawa, nice serve!\Yes! Now score and cut off Oikawa's serves!\Chance ball! Tanaka!\Yeah!\A quick's coming! response:	Nice receive!
context: Damn it...\And there he is again.\Oikawa, nice serve!\Yes! Now score and cut off Oikawa's serves!\Chance ball! Tanaka!\Yeah!\A quick's coming!\Nice receive! response:	Kyotani, get the last!
context: And there he is again.\Oikawa, nice serve!\Yes! Now score and cut off Oikawa's serves!\Chance ball! Tanaka!\Yeah!\A quick's coming!\Nice receive!\Kyotani, get the last! response:	Right! Right!
context: Oikawa, nice serve!\Yes! Now score and cut off Oikawa's serves!\Chance ball! Tanaka!\Yeah!\A quick's coming!\Nice receive!\Kyotani, get the last!\Right! Right! response:	Tanaka-san...
context: Yes! Now score and cut off Oikawa's serves!\Chance ball! Tanaka!\Yeah!\A quick's coming!\Nice receive!\Kyotani, get the last!\Right! Right!\Tanaka-san... response:	Blocked out!
context: Chance ball! Tanaka!\Yeah!\A quick's coming!\Nice receive!\Kyotani, get the last!\Right! Right!\Tanaka-san...\Blocked out! response:	All right! They cut it off!
context: Yeah!\A quick's coming!\Nice receive!\Kyotani, get the last!\Right! Right!\Tanaka-san...\Blocked out!\All right! They cut it off! response:	Yes!
context: A quick's coming!\Nice receive!\Kyotani, get the last!\Right! Right!\Tanaka-san...\Blocked out!\All right! They cut it off!\Yes! response:	Nice block!
context: Nice receive!\Kyotani, get the last!\Right! Right!\Tanaka-san...\Blocked out!\All right! They cut it off!\Yes!\Nice block! response:	Tsukki and Tanaka switched up blocks just now.
context: Kyotani, get the last!\Right! Right!\Tanaka-san...\Blocked out!\All right! They cut it off!\Yes!\Nice block!\Tsukki and Tanaka switched up blocks just now. response:	Yeah.
context: Right! Right!\Tanaka-san...\Blocked out!\All right! They cut it off!\Yes!\Nice block!\Tsukki and Tanaka switched up blocks just now.\Yeah. response:	Did they read that a straight was coming?
context: Tanaka-san...\Blocked out!\All right! They cut it off!\Yes!\Nice block!\Tsukki and Tanaka switched up blocks just now.\Yeah.\Did they read that a straight was coming? response:	Great job, Tsukishima!
context: Blocked out!\All right! They cut it off!\Yes!\Nice block!\Tsukki and Tanaka switched up blocks just now.\Yeah.\Did they read that a straight was coming?\Great job, Tsukishima! response:	I knew it...
context: All right! They cut it off!\Yes!\Nice block!\Tsukki and Tanaka switched up blocks just now.\Yeah.\Did they read that a straight was coming?\Great job, Tsukishima!\I knew it... response:	Tanaka was getting into it with that 16, right?
context: Yes!\Nice block!\Tsukki and Tanaka switched up blocks just now.\Yeah.\Did they read that a straight was coming?\Great job, Tsukishima!\I knew it...\Tanaka was getting into it with that 16, right? response:	You mean he was picking a fight?
context: Nice block!\Tsukki and Tanaka switched up blocks just now.\Yeah.\Did they read that a straight was coming?\Great job, Tsukishima!\I knew it...\Tanaka was getting into it with that 16, right?\You mean he was picking a fight? response:	Like in the second set,
context: Tsukki and Tanaka switched up blocks just now.\Yeah.\Did they read that a straight was coming?\Great job, Tsukishima!\I knew it...\Tanaka was getting into it with that 16, right?\You mean he was picking a fight?\Like in the second set, response:	he kept targeting their 16 and wiping.
context: Yeah.\Did they read that a straight was coming?\Great job, Tsukishima!\I knew it...\Tanaka was getting into it with that 16, right?\You mean he was picking a fight?\Like in the second set,\he kept targeting their 16 and wiping. response:	There was no block for a cross,
context: Did they read that a straight was coming?\Great job, Tsukishima!\I knew it...\Tanaka was getting into it with that 16, right?\You mean he was picking a fight?\Like in the second set,\he kept targeting their 16 and wiping.\There was no block for a cross, response:	so he went for the more narrow straight... right by 16.
context: Great job, Tsukishima!\I knew it...\Tanaka was getting into it with that 16, right?\You mean he was picking a fight?\Like in the second set,\he kept targeting their 16 and wiping.\There was no block for a cross,\so he went for the more narrow straight... right by 16. response:	Seriously? I didn't notice.
context: I knew it...\Tanaka was getting into it with that 16, right?\You mean he was picking a fight?\Like in the second set,\he kept targeting their 16 and wiping.\There was no block for a cross,\so he went for the more narrow straight... right by 16.\Seriously? I didn't notice. response:	It looks like their 16 is fighting back,
context: Tanaka was getting into it with that 16, right?\You mean he was picking a fight?\Like in the second set,\he kept targeting their 16 and wiping.\There was no block for a cross,\so he went for the more narrow straight... right by 16.\Seriously? I didn't notice.\It looks like their 16 is fighting back, response:	and hitting straights on the side where Tanaka is.
context: You mean he was picking a fight?\Like in the second set,\he kept targeting their 16 and wiping.\There was no block for a cross,\so he went for the more narrow straight... right by 16.\Seriously? I didn't notice.\It looks like their 16 is fighting back,\and hitting straights on the side where Tanaka is. response:	I think Tsukishima also figured that out.
context: Like in the second set,\he kept targeting their 16 and wiping.\There was no block for a cross,\so he went for the more narrow straight... right by 16.\Seriously? I didn't notice.\It looks like their 16 is fighting back,\and hitting straights on the side where Tanaka is.\I think Tsukishima also figured that out. response:	Great job reading that, Tsukishima!
context: he kept targeting their 16 and wiping.\There was no block for a cross,\so he went for the more narrow straight... right by 16.\Seriously? I didn't notice.\It looks like their 16 is fighting back,\and hitting straights on the side where Tanaka is.\I think Tsukishima also figured that out.\Great job reading that, Tsukishima! response:	How'd you come up with that?
context: There was no block for a cross,\so he went for the more narrow straight... right by 16.\Seriously? I didn't notice.\It looks like their 16 is fighting back,\and hitting straights on the side where Tanaka is.\I think Tsukishima also figured that out.\Great job reading that, Tsukishima!\How'd you come up with that? response:	It was nothing.
context: so he went for the more narrow straight... right by 16.\Seriously? I didn't notice.\It looks like their 16 is fighting back,\and hitting straights on the side where Tanaka is.\I think Tsukishima also figured that out.\Great job reading that, Tsukishima!\How'd you come up with that?\It was nothing. response:	This is a chance to gain momentum.
context: Seriously? I didn't notice.\It looks like their 16 is fighting back,\and hitting straights on the side where Tanaka is.\I think Tsukishima also figured that out.\Great job reading that, Tsukishima!\How'd you come up with that?\It was nothing.\This is a chance to gain momentum. response:	Don't let it go to waste!
context: It looks like their 16 is fighting back,\and hitting straights on the side where Tanaka is.\I think Tsukishima also figured that out.\Great job reading that, Tsukishima!\How'd you come up with that?\It was nothing.\This is a chance to gain momentum.\Don't let it go to waste! response:	Got it!
context: and hitting straights on the side where Tanaka is.\I think Tsukishima also figured that out.\Great job reading that, Tsukishima!\How'd you come up with that?\It was nothing.\This is a chance to gain momentum.\Don't let it go to waste!\Got it! response:	Nice receive.
context: I think Tsukishima also figured that out.\Great job reading that, Tsukishima!\How'd you come up with that?\It was nothing.\This is a chance to gain momentum.\Don't let it go to waste!\Got it!\Nice receive. response:	That 16's coming!
context: Great job reading that, Tsukishima!\How'd you come up with that?\It was nothing.\This is a chance to gain momentum.\Don't let it go to waste!\Got it!\Nice receive.\That 16's coming! response:	Get it back yourself.
context: How'd you come up with that?\It was nothing.\This is a chance to gain momentum.\Don't let it go to waste!\Got it!\Nice receive.\That 16's coming!\Get it back yourself. response:	Out!
context: It was nothing.\This is a chance to gain momentum.\Don't let it go to waste!\Got it!\Nice receive.\That 16's coming!\Get it back yourself.\Out! response:	All right!
context: This is a chance to gain momentum.\Don't let it go to waste!\Got it!\Nice receive.\That 16's coming!\Get it back yourself.\Out!\All right! response:	Yes! Here it is!
context: Don't let it go to waste!\Got it!\Nice receive.\That 16's coming!\Get it back yourself.\Out!\All right!\Yes! Here it is! response:	Aoba Johsai Karasuno
context: Got it!\Nice receive.\That 16's coming!\Get it back yourself.\Out!\All right!\Yes! Here it is!\Aoba Johsai Karasuno response:	Yeah! They turned it around!
context: Nice receive.\That 16's coming!\Get it back yourself.\Out!\All right!\Yes! Here it is!\Aoba Johsai Karasuno\Yeah! They turned it around! response:	Keep it up!
context: That 16's coming!\Get it back yourself.\Out!\All right!\Yes! Here it is!\Aoba Johsai Karasuno\Yeah! They turned it around!\Keep it up! response:	Yeah!
context: Get it back yourself.\Out!\All right!\Yes! Here it is!\Aoba Johsai Karasuno\Yeah! They turned it around!\Keep it up!\Yeah! response:	I think that they managed to rile up 16 pretty well.
context: Out!\All right!\Yes! Here it is!\Aoba Johsai Karasuno\Yeah! They turned it around!\Keep it up!\Yeah!\I think that they managed to rile up 16 pretty well. response:	Don't tell me Ryu did that on purpose!
context: All right!\Yes! Here it is!\Aoba Johsai Karasuno\Yeah! They turned it around!\Keep it up!\Yeah!\I think that they managed to rile up 16 pretty well.\Don't tell me Ryu did that on purpose! response:	No, Ryu may have been challenging him, but that wasn't his goal.
context: Yes! Here it is!\Aoba Johsai Karasuno\Yeah! They turned it around!\Keep it up!\Yeah!\I think that they managed to rile up 16 pretty well.\Don't tell me Ryu did that on purpose!\No, Ryu may have been challenging him, but that wasn't his goal. response:	That's just his nature.
context: Aoba Johsai Karasuno\Yeah! They turned it around!\Keep it up!\Yeah!\I think that they managed to rile up 16 pretty well.\Don't tell me Ryu did that on purpose!\No, Ryu may have been challenging him, but that wasn't his goal.\That's just his nature. response:	So it's like Tsukishima was able to take advantage of that nature.
context: Yeah! They turned it around!\Keep it up!\Yeah!\I think that they managed to rile up 16 pretty well.\Don't tell me Ryu did that on purpose!\No, Ryu may have been challenging him, but that wasn't his goal.\That's just his nature.\So it's like Tsukishima was able to take advantage of that nature. response:	Now we see a crack in the apparently infallible Seijoh.
context: Keep it up!\Yeah!\I think that they managed to rile up 16 pretty well.\Don't tell me Ryu did that on purpose!\No, Ryu may have been challenging him, but that wasn't his goal.\That's just his nature.\So it's like Tsukishima was able to take advantage of that nature.\Now we see a crack in the apparently infallible Seijoh. response:	This is our chance to break through!
context: Yeah!\I think that they managed to rile up 16 pretty well.\Don't tell me Ryu did that on purpose!\No, Ryu may have been challenging him, but that wasn't his goal.\That's just his nature.\So it's like Tsukishima was able to take advantage of that nature.\Now we see a crack in the apparently infallible Seijoh.\This is our chance to break through! response:	We're gonna push forward!
context: I think that they managed to rile up 16 pretty well.\Don't tell me Ryu did that on purpose!\No, Ryu may have been challenging him, but that wasn't his goal.\That's just his nature.\So it's like Tsukishima was able to take advantage of that nature.\Now we see a crack in the apparently infallible Seijoh.\This is our chance to break through!\We're gonna push forward! response:	Yeah!
context: Don't tell me Ryu did that on purpose!\No, Ryu may have been challenging him, but that wasn't his goal.\That's just his nature.\So it's like Tsukishima was able to take advantage of that nature.\Now we see a crack in the apparently infallible Seijoh.\This is our chance to break through!\We're gonna push forward!\Yeah! response:	Yeah!
context: No, Ryu may have been challenging him, but that wasn't his goal.\That's just his nature.\So it's like Tsukishima was able to take advantage of that nature.\Now we see a crack in the apparently infallible Seijoh.\This is our chance to break through!\We're gonna push forward!\Yeah!\Yeah! response:	Haikyu!!
context: That's just his nature.\So it's like Tsukishima was able to take advantage of that nature.\Now we see a crack in the apparently infallible Seijoh.\This is our chance to break through!\We're gonna push forward!\Yeah!\Yeah!\Haikyu!! response:	Haikyu!!
context: So it's like Tsukishima was able to take advantage of that nature.\Now we see a crack in the apparently infallible Seijoh.\This is our chance to break through!\We're gonna push forward!\Yeah!\Yeah!\Haikyu!!\Haikyu!! response:	Who's that? A high school kid?
context: Now we see a crack in the apparently infallible Seijoh.\This is our chance to break through!\We're gonna push forward!\Yeah!\Yeah!\Haikyu!!\Haikyu!!\Who's that? A high school kid? response:	Apparently, he just wants to practice.
context: This is our chance to break through!\We're gonna push forward!\Yeah!\Yeah!\Haikyu!!\Haikyu!!\Who's that? A high school kid?\Apparently, he just wants to practice. response:	I saw him in another group on Saturday.
context: We're gonna push forward!\Yeah!\Yeah!\Haikyu!!\Haikyu!!\Who's that? A high school kid?\Apparently, he just wants to practice.\I saw him in another group on Saturday. response:	If he's in high school, doesn't he have club activities?
context: Yeah!\Yeah!\Haikyu!!\Haikyu!!\Who's that? A high school kid?\Apparently, he just wants to practice.\I saw him in another group on Saturday.\If he's in high school, doesn't he have club activities? response:	He's probably the type that doesn't get along with the rest of the club.
context: Yeah!\Haikyu!!\Haikyu!!\Who's that? A high school kid?\Apparently, he just wants to practice.\I saw him in another group on Saturday.\If he's in high school, doesn't he have club activities?\He's probably the type that doesn't get along with the rest of the club. response:	Is he going through his rebellious stage?
context: Haikyu!!\Haikyu!!\Who's that? A high school kid?\Apparently, he just wants to practice.\I saw him in another group on Saturday.\If he's in high school, doesn't he have club activities?\He's probably the type that doesn't get along with the rest of the club.\Is he going through his rebellious stage? response:	I'm surprised he's playing a team sport.
context: Haikyu!!\Who's that? A high school kid?\Apparently, he just wants to practice.\I saw him in another group on Saturday.\If he's in high school, doesn't he have club activities?\He's probably the type that doesn't get along with the rest of the club.\Is he going through his rebellious stage?\I'm surprised he's playing a team sport. response:	I'm sure he's playing because there's something he likes about it.
context: Who's that? A high school kid?\Apparently, he just wants to practice.\I saw him in another group on Saturday.\If he's in high school, doesn't he have club activities?\He's probably the type that doesn't get along with the rest of the club.\Is he going through his rebellious stage?\I'm surprised he's playing a team sport.\I'm sure he's playing because there's something he likes about it. response:	Ah, Kiyoshi-san. Hi.
context: Apparently, he just wants to practice.\I saw him in another group on Saturday.\If he's in high school, doesn't he have club activities?\He's probably the type that doesn't get along with the rest of the club.\Is he going through his rebellious stage?\I'm surprised he's playing a team sport.\I'm sure he's playing because there's something he likes about it.\Ah, Kiyoshi-san. Hi. response:	Otherwise, he wouldn't be practicing here like this.
context: I saw him in another group on Saturday.\If he's in high school, doesn't he have club activities?\He's probably the type that doesn't get along with the rest of the club.\Is he going through his rebellious stage?\I'm surprised he's playing a team sport.\I'm sure he's playing because there's something he likes about it.\Ah, Kiyoshi-san. Hi.\Otherwise, he wouldn't be practicing here like this. response:	Japan! Japan! Japan! Japan!
context: If he's in high school, doesn't he have club activities?\He's probably the type that doesn't get along with the rest of the club.\Is he going through his rebellious stage?\I'm surprised he's playing a team sport.\I'm sure he's playing because there's something he likes about it.\Ah, Kiyoshi-san. Hi.\Otherwise, he wouldn't be practicing here like this.\Japan! Japan! Japan! Japan! response:	W-Well, we always need people, so I think it's okay.
context: He's probably the type that doesn't get along with the rest of the club.\Is he going through his rebellious stage?\I'm surprised he's playing a team sport.\I'm sure he's playing because there's something he likes about it.\Ah, Kiyoshi-san. Hi.\Otherwise, he wouldn't be practicing here like this.\Japan! Japan! Japan! Japan!\W-Well, we always need people, so I think it's okay. response:	Not to mention, he's better than us.
context: Is he going through his rebellious stage?\I'm surprised he's playing a team sport.\I'm sure he's playing because there's something he likes about it.\Ah, Kiyoshi-san. Hi.\Otherwise, he wouldn't be practicing here like this.\Japan! Japan! Japan! Japan!\W-Well, we always need people, so I think it's okay.\Not to mention, he's better than us. response:	Wha?!
context: I'm surprised he's playing a team sport.\I'm sure he's playing because there's something he likes about it.\Ah, Kiyoshi-san. Hi.\Otherwise, he wouldn't be practicing here like this.\Japan! Japan! Japan! Japan!\W-Well, we always need people, so I think it's okay.\Not to mention, he's better than us.\Wha?! response:	I wouldn't lose to him!
context: I'm sure he's playing because there's something he likes about it.\Ah, Kiyoshi-san. Hi.\Otherwise, he wouldn't be practicing here like this.\Japan! Japan! Japan! Japan!\W-Well, we always need people, so I think it's okay.\Not to mention, he's better than us.\Wha?!\I wouldn't lose to him! response:	Aw, you're all mad.
context: Ah, Kiyoshi-san. Hi.\Otherwise, he wouldn't be practicing here like this.\Japan! Japan! Japan! Japan!\W-Well, we always need people, so I think it's okay.\Not to mention, he's better than us.\Wha?!\I wouldn't lose to him!\Aw, you're all mad. response:	Shut up.
context: Otherwise, he wouldn't be practicing here like this.\Japan! Japan! Japan! Japan!\W-Well, we always need people, so I think it's okay.\Not to mention, he's better than us.\Wha?!\I wouldn't lose to him!\Aw, you're all mad.\Shut up. response:	Tsukishima, one more! Nice serve!
context: Japan! Japan! Japan! Japan!\W-Well, we always need people, so I think it's okay.\Not to mention, he's better than us.\Wha?!\I wouldn't lose to him!\Aw, you're all mad.\Shut up.\Tsukishima, one more! Nice serve! response:	Got it!
context: W-Well, we always need people, so I think it's okay.\Not to mention, he's better than us.\Wha?!\I wouldn't lose to him!\Aw, you're all mad.\Shut up.\Tsukishima, one more! Nice serve!\Got it! response:	Mad Dog-chan!
context: Not to mention, he's better than us.\Wha?!\I wouldn't lose to him!\Aw, you're all mad.\Shut up.\Tsukishima, one more! Nice serve!\Got it!\Mad Dog-chan! response:	All right!
context: Wha?!\I wouldn't lose to him!\Aw, you're all mad.\Shut up.\Tsukishima, one more! Nice serve!\Got it!\Mad Dog-chan!\All right! response:	Aoba Johsai Karasuno
context: I wouldn't lose to him!\Aw, you're all mad.\Shut up.\Tsukishima, one more! Nice serve!\Got it!\Mad Dog-chan!\All right!\Aoba Johsai Karasuno response:	The time out didn't help, did it?
context: Aw, you're all mad.\Shut up.\Tsukishima, one more! Nice serve!\Got it!\Mad Dog-chan!\All right!\Aoba Johsai Karasuno\The time out didn't help, did it? response:	I don't think so.
context: Shut up.\Tsukishima, one more! Nice serve!\Got it!\Mad Dog-chan!\All right!\Aoba Johsai Karasuno\The time out didn't help, did it?\I don't think so. response:	Seijoh's got plenty of players, so why don't they switch?
context: Tsukishima, one more! Nice serve!\Got it!\Mad Dog-chan!\All right!\Aoba Johsai Karasuno\The time out didn't help, did it?\I don't think so.\Seijoh's got plenty of players, so why don't they switch? response:	Switch!
context: Got it!\Mad Dog-chan!\All right!\Aoba Johsai Karasuno\The time out didn't help, did it?\I don't think so.\Seijoh's got plenty of players, so why don't they switch?\Switch! response:	Hey.
context: Mad Dog-chan!\All right!\Aoba Johsai Karasuno\The time out didn't help, did it?\I don't think so.\Seijoh's got plenty of players, so why don't they switch?\Switch!\Hey. response:	Go, Iwa-chan. Now.
context: All right!\Aoba Johsai Karasuno\The time out didn't help, did it?\I don't think so.\Seijoh's got plenty of players, so why don't they switch?\Switch!\Hey.\Go, Iwa-chan. Now. response:	Calm down if you want to get back out on the court.
context: Aoba Johsai Karasuno\The time out didn't help, did it?\I don't think so.\Seijoh's got plenty of players, so why don't they switch?\Switch!\Hey.\Go, Iwa-chan. Now.\Calm down if you want to get back out on the court. response:	Hurry up and pull yourself together.
context: The time out didn't help, did it?\I don't think so.\Seijoh's got plenty of players, so why don't they switch?\Switch!\Hey.\Go, Iwa-chan. Now.\Calm down if you want to get back out on the court.\Hurry up and pull yourself together. response:	We don't have anything left after this.
context: I don't think so.\Seijoh's got plenty of players, so why don't they switch?\Switch!\Hey.\Go, Iwa-chan. Now.\Calm down if you want to get back out on the court.\Hurry up and pull yourself together.\We don't have anything left after this. response:	Shut up. Like I care.
context: Seijoh's got plenty of players, so why don't they switch?\Switch!\Hey.\Go, Iwa-chan. Now.\Calm down if you want to get back out on the court.\Hurry up and pull yourself together.\We don't have anything left after this.\Shut up. Like I care. response:	All right!
context: Switch!\Hey.\Go, Iwa-chan. Now.\Calm down if you want to get back out on the court.\Hurry up and pull yourself together.\We don't have anything left after this.\Shut up. Like I care.\All right! response:	Yahaba, don't push him too much.
context: Hey.\Go, Iwa-chan. Now.\Calm down if you want to get back out on the court.\Hurry up and pull yourself together.\We don't have anything left after this.\Shut up. Like I care.\All right!\Yahaba, don't push him too much. response:	Sorry, but no.
context: Go, Iwa-chan. Now.\Calm down if you want to get back out on the court.\Hurry up and pull yourself together.\We don't have anything left after this.\Shut up. Like I care.\All right!\Yahaba, don't push him too much.\Sorry, but no. response:	You let the opponent provoke you,
context: Calm down if you want to get back out on the court.\Hurry up and pull yourself together.\We don't have anything left after this.\Shut up. Like I care.\All right!\Yahaba, don't push him too much.\Sorry, but no.\You let the opponent provoke you, response:	got pissed off, and then fizzled out.
context: Hurry up and pull yourself together.\We don't have anything left after this.\Shut up. Like I care.\All right!\Yahaba, don't push him too much.\Sorry, but no.\You let the opponent provoke you,\got pissed off, and then fizzled out. response:	Talk about lame.
context: We don't have anything left after this.\Shut up. Like I care.\All right!\Yahaba, don't push him too much.\Sorry, but no.\You let the opponent provoke you,\got pissed off, and then fizzled out.\Talk about lame. response:	Ah?
context: Shut up. Like I care.\All right!\Yahaba, don't push him too much.\Sorry, but no.\You let the opponent provoke you,\got pissed off, and then fizzled out.\Talk about lame.\Ah? response:	You had the nerve to come back,
context: All right!\Yahaba, don't push him too much.\Sorry, but no.\You let the opponent provoke you,\got pissed off, and then fizzled out.\Talk about lame.\Ah?\You had the nerve to come back, response:	and then got to go right into a match.
context: Yahaba, don't push him too much.\Sorry, but no.\You let the opponent provoke you,\got pissed off, and then fizzled out.\Talk about lame.\Ah?\You had the nerve to come back,\and then got to go right into a match. response:	Some guys who have a problem with that.
context: Sorry, but no.\You let the opponent provoke you,\got pissed off, and then fizzled out.\Talk about lame.\Ah?\You had the nerve to come back,\and then got to go right into a match.\Some guys who have a problem with that. response:	Like me.
context: You let the opponent provoke you,\got pissed off, and then fizzled out.\Talk about lame.\Ah?\You had the nerve to come back,\and then got to go right into a match.\Some guys who have a problem with that.\Like me. response:	But...
context: got pissed off, and then fizzled out.\Talk about lame.\Ah?\You had the nerve to come back,\and then got to go right into a match.\Some guys who have a problem with that.\Like me.\But... response:	It's not like he caused a problem,
context: Talk about lame.\Ah?\You had the nerve to come back,\and then got to go right into a match.\Some guys who have a problem with that.\Like me.\But...\It's not like he caused a problem, response:	so I guess it doesn't matter as long as we can use him in a match.
context: Ah?\You had the nerve to come back,\and then got to go right into a match.\Some guys who have a problem with that.\Like me.\But...\It's not like he caused a problem,\so I guess it doesn't matter as long as we can use him in a match. response:	Will he be able to keep up at practice?
context: You had the nerve to come back,\and then got to go right into a match.\Some guys who have a problem with that.\Like me.\But...\It's not like he caused a problem,\so I guess it doesn't matter as long as we can use him in a match.\Will he be able to keep up at practice? response:	He'll have blanks to fill in.
context: and then got to go right into a match.\Some guys who have a problem with that.\Like me.\But...\It's not like he caused a problem,\so I guess it doesn't matter as long as we can use him in a match.\Will he be able to keep up at practice?\He'll have blanks to fill in. response:	Including communication.
context: Some guys who have a problem with that.\Like me.\But...\It's not like he caused a problem,\so I guess it doesn't matter as long as we can use him in a match.\Will he be able to keep up at practice?\He'll have blanks to fill in.\Including communication. response:	Well...
context: Like me.\But...\It's not like he caused a problem,\so I guess it doesn't matter as long as we can use him in a match.\Will he be able to keep up at practice?\He'll have blanks to fill in.\Including communication.\Well... response:	Those aren't the moves of someone who hasn't been practicing.
context: But...\It's not like he caused a problem,\so I guess it doesn't matter as long as we can use him in a match.\Will he be able to keep up at practice?\He'll have blanks to fill in.\Including communication.\Well...\Those aren't the moves of someone who hasn't been practicing. response:	I thought he was pretty cold, both to you and to us.
context: It's not like he caused a problem,\so I guess it doesn't matter as long as we can use him in a match.\Will he be able to keep up at practice?\He'll have blanks to fill in.\Including communication.\Well...\Those aren't the moves of someone who hasn't been practicing.\I thought he was pretty cold, both to you and to us. response:	But that's not the problem.
context: so I guess it doesn't matter as long as we can use him in a match.\Will he be able to keep up at practice?\He'll have blanks to fill in.\Including communication.\Well...\Those aren't the moves of someone who hasn't been practicing.\I thought he was pretty cold, both to you and to us.\But that's not the problem. response:	Left!
context: Will he be able to keep up at practice?\He'll have blanks to fill in.\Including communication.\Well...\Those aren't the moves of someone who hasn't been practicing.\I thought he was pretty cold, both to you and to us.\But that's not the problem.\Left! response:	The players we need in order to win are chosen as regulars.
context: He'll have blanks to fill in.\Including communication.\Well...\Those aren't the moves of someone who hasn't been practicing.\I thought he was pretty cold, both to you and to us.\But that's not the problem.\Left!\The players we need in order to win are chosen as regulars. response:	One-touch!
context: Including communication.\Well...\Those aren't the moves of someone who hasn't been practicing.\I thought he was pretty cold, both to you and to us.\But that's not the problem.\Left!\The players we need in order to win are chosen as regulars.\One-touch! response:	Cover! Cover!
context: Well...\Those aren't the moves of someone who hasn't been practicing.\I thought he was pretty cold, both to you and to us.\But that's not the problem.\Left!\The players we need in order to win are chosen as regulars.\One-touch!\Cover! Cover! response:	Got it!
context: Those aren't the moves of someone who hasn't been practicing.\I thought he was pretty cold, both to you and to us.\But that's not the problem.\Left!\The players we need in order to win are chosen as regulars.\One-touch!\Cover! Cover!\Got it! response:	You were chosen...
context: I thought he was pretty cold, both to you and to us.\But that's not the problem.\Left!\The players we need in order to win are chosen as regulars.\One-touch!\Cover! Cover!\Got it!\You were chosen... response:	So do your job right.
context: But that's not the problem.\Left!\The players we need in order to win are chosen as regulars.\One-touch!\Cover! Cover!\Got it!\You were chosen...\So do your job right. response:	I think Yahaba's gonna get bitten.
context: Left!\The players we need in order to win are chosen as regulars.\One-touch!\Cover! Cover!\Got it!\You were chosen...\So do your job right.\I think Yahaba's gonna get bitten. response:	Hope he's okay.
context: The players we need in order to win are chosen as regulars.\One-touch!\Cover! Cover!\Got it!\You were chosen...\So do your job right.\I think Yahaba's gonna get bitten.\Hope he's okay. response:	You go stop him.
context: One-touch!\Cover! Cover!\Got it!\You were chosen...\So do your job right.\I think Yahaba's gonna get bitten.\Hope he's okay.\You go stop him. response:	Nope.
context: Cover! Cover!\Got it!\You were chosen...\So do your job right.\I think Yahaba's gonna get bitten.\Hope he's okay.\You go stop him.\Nope. response:	Well, that's just a front.
context: Got it!\You were chosen...\So do your job right.\I think Yahaba's gonna get bitten.\Hope he's okay.\You go stop him.\Nope.\Well, that's just a front. response:	If you track dirt onto our senpais' stage,
context: You were chosen...\So do your job right.\I think Yahaba's gonna get bitten.\Hope he's okay.\You go stop him.\Nope.\Well, that's just a front.\If you track dirt onto our senpais' stage, response:	I'll never forgive you.
context: So do your job right.\I think Yahaba's gonna get bitten.\Hope he's okay.\You go stop him.\Nope.\Well, that's just a front.\If you track dirt onto our senpais' stage,\I'll never forgive you. response:	You...
context: I think Yahaba's gonna get bitten.\Hope he's okay.\You go stop him.\Nope.\Well, that's just a front.\If you track dirt onto our senpais' stage,\I'll never forgive you.\You... response:	I thought you were more shallow than that.
context: Hope he's okay.\You go stop him.\Nope.\Well, that's just a front.\If you track dirt onto our senpais' stage,\I'll never forgive you.\You...\I thought you were more shallow than that. response:	You're not wrong there.
context: You go stop him.\Nope.\Well, that's just a front.\If you track dirt onto our senpais' stage,\I'll never forgive you.\You...\I thought you were more shallow than that.\You're not wrong there. response:	I may be shallow, but I respect our senpais.
context: Nope.\Well, that's just a front.\If you track dirt onto our senpais' stage,\I'll never forgive you.\You...\I thought you were more shallow than that.\You're not wrong there.\I may be shallow, but I respect our senpais. response:	As long as you're on the court, any point won or lost belongs to the team.
context: Well, that's just a front.\If you track dirt onto our senpais' stage,\I'll never forgive you.\You...\I thought you were more shallow than that.\You're not wrong there.\I may be shallow, but I respect our senpais.\As long as you're on the court, any point won or lost belongs to the team. response:	So come on. Help us out.
context: If you track dirt onto our senpais' stage,\I'll never forgive you.\You...\I thought you were more shallow than that.\You're not wrong there.\I may be shallow, but I respect our senpais.\As long as you're on the court, any point won or lost belongs to the team.\So come on. Help us out. response:	Got it!
context: I'll never forgive you.\You...\I thought you were more shallow than that.\You're not wrong there.\I may be shallow, but I respect our senpais.\As long as you're on the court, any point won or lost belongs to the team.\So come on. Help us out.\Got it! response:	Center!
context: You...\I thought you were more shallow than that.\You're not wrong there.\I may be shallow, but I respect our senpais.\As long as you're on the court, any point won or lost belongs to the team.\So come on. Help us out.\Got it!\Center! response:	Kunimi-chan!
context: I thought you were more shallow than that.\You're not wrong there.\I may be shallow, but I respect our senpais.\As long as you're on the court, any point won or lost belongs to the team.\So come on. Help us out.\Got it!\Center!\Kunimi-chan! response:	Kunimi's attack is... possibly...
context: You're not wrong there.\I may be shallow, but I respect our senpais.\As long as you're on the court, any point won or lost belongs to the team.\So come on. Help us out.\Got it!\Center!\Kunimi-chan!\Kunimi's attack is... possibly... response:	A feint!
context: I may be shallow, but I respect our senpais.\As long as you're on the court, any point won or lost belongs to the team.\So come on. Help us out.\Got it!\Center!\Kunimi-chan!\Kunimi's attack is... possibly...\A feint! response:	Ryu!
context: As long as you're on the court, any point won or lost belongs to the team.\So come on. Help us out.\Got it!\Center!\Kunimi-chan!\Kunimi's attack is... possibly...\A feint!\Ryu! response:	All right!
context: So come on. Help us out.\Got it!\Center!\Kunimi-chan!\Kunimi's attack is... possibly...\A feint!\Ryu!\All right! response:	Aoba Johsai Karasuno
context: Got it!\Center!\Kunimi-chan!\Kunimi's attack is... possibly...\A feint!\Ryu!\All right!\Aoba Johsai Karasuno response:	Nice kill!
context: Center!\Kunimi-chan!\Kunimi's attack is... possibly...\A feint!\Ryu!\All right!\Aoba Johsai Karasuno\Nice kill! response:	Good job reading that, Kageyama.
context: Kunimi-chan!\Kunimi's attack is... possibly...\A feint!\Ryu!\All right!\Aoba Johsai Karasuno\Nice kill!\Good job reading that, Kageyama. response:	Thanks.
context: Kunimi's attack is... possibly...\A feint!\Ryu!\All right!\Aoba Johsai Karasuno\Nice kill!\Good job reading that, Kageyama.\Thanks. response:	Huh? I guess he's back.
context: A feint!\Ryu!\All right!\Aoba Johsai Karasuno\Nice kill!\Good job reading that, Kageyama.\Thanks.\Huh? I guess he's back. response:	So he's coming back...
context: Ryu!\All right!\Aoba Johsai Karasuno\Nice kill!\Good job reading that, Kageyama.\Thanks.\Huh? I guess he's back.\So he's coming back... response:	That was fast.
context: All right!\Aoba Johsai Karasuno\Nice kill!\Good job reading that, Kageyama.\Thanks.\Huh? I guess he's back.\So he's coming back...\That was fast. response:	I'm sure it's a gamble for Seijoh, though.
context: Aoba Johsai Karasuno\Nice kill!\Good job reading that, Kageyama.\Thanks.\Huh? I guess he's back.\So he's coming back...\That was fast.\I'm sure it's a gamble for Seijoh, though. response:	All right!
context: Nice kill!\Good job reading that, Kageyama.\Thanks.\Huh? I guess he's back.\So he's coming back...\That was fast.\I'm sure it's a gamble for Seijoh, though.\All right! response:	Out! Out!
context: Good job reading that, Kageyama.\Thanks.\Huh? I guess he's back.\So he's coming back...\That was fast.\I'm sure it's a gamble for Seijoh, though.\All right!\Out! Out! response:	All right!
context: Thanks.\Huh? I guess he's back.\So he's coming back...\That was fast.\I'm sure it's a gamble for Seijoh, though.\All right!\Out! Out!\All right! response:	D-Don't mind!
context: Huh? I guess he's back.\So he's coming back...\That was fast.\I'm sure it's a gamble for Seijoh, though.\All right!\Out! Out!\All right!\D-Don't mind! response:	Uwamushi Jr High Minamisan Jr High
context: So he's coming back...\That was fast.\I'm sure it's a gamble for Seijoh, though.\All right!\Out! Out!\All right!\D-Don't mind!\Uwamushi Jr High Minamisan Jr High response:	He's not doing well today.
context: That was fast.\I'm sure it's a gamble for Seijoh, though.\All right!\Out! Out!\All right!\D-Don't mind!\Uwamushi Jr High Minamisan Jr High\He's not doing well today. response:	What should we do?
context: I'm sure it's a gamble for Seijoh, though.\All right!\Out! Out!\All right!\D-Don't mind!\Uwamushi Jr High Minamisan Jr High\He's not doing well today.\What should we do? response:	No one's got more power than he does, either...
context: All right!\Out! Out!\All right!\D-Don't mind!\Uwamushi Jr High Minamisan Jr High\He's not doing well today.\What should we do?\No one's got more power than he does, either... response:	But if the situation gets any worse,
context: Out! Out!\All right!\D-Don't mind!\Uwamushi Jr High Minamisan Jr High\He's not doing well today.\What should we do?\No one's got more power than he does, either...\But if the situation gets any worse, response:	he's going to get really annoying.
context: All right!\D-Don't mind!\Uwamushi Jr High Minamisan Jr High\He's not doing well today.\What should we do?\No one's got more power than he does, either...\But if the situation gets any worse,\he's going to get really annoying. response:	Let's see how things go.
context: D-Don't mind!\Uwamushi Jr High Minamisan Jr High\He's not doing well today.\What should we do?\No one's got more power than he does, either...\But if the situation gets any worse,\he's going to get really annoying.\Let's see how things go. response:	Tanaka, nice serve!
context: Uwamushi Jr High Minamisan Jr High\He's not doing well today.\What should we do?\No one's got more power than he does, either...\But if the situation gets any worse,\he's going to get really annoying.\Let's see how things go.\Tanaka, nice serve! response:	Yes.
context: He's not doing well today.\What should we do?\No one's got more power than he does, either...\But if the situation gets any worse,\he's going to get really annoying.\Let's see how things go.\Tanaka, nice serve!\Yes. response:	Nice receive!
context: What should we do?\No one's got more power than he does, either...\But if the situation gets any worse,\he's going to get really annoying.\Let's see how things go.\Tanaka, nice serve!\Yes.\Nice receive! response:	Mad Dog-chan!
context: No one's got more power than he does, either...\But if the situation gets any worse,\he's going to get really annoying.\Let's see how things go.\Tanaka, nice serve!\Yes.\Nice receive!\Mad Dog-chan! response:	Oikawa's a total sadist.
context: But if the situation gets any worse,\he's going to get really annoying.\Let's see how things go.\Tanaka, nice serve!\Yes.\Nice receive!\Mad Dog-chan!\Oikawa's a total sadist. response:	Absolute trust with no words involved...
context: he's going to get really annoying.\Let's see how things go.\Tanaka, nice serve!\Yes.\Nice receive!\Mad Dog-chan!\Oikawa's a total sadist.\Absolute trust with no words involved... response:	It's been a while since you started coming here, Lone Wolf High School Kid.
context: Let's see how things go.\Tanaka, nice serve!\Yes.\Nice receive!\Mad Dog-chan!\Oikawa's a total sadist.\Absolute trust with no words involved...\It's been a while since you started coming here, Lone Wolf High School Kid. response:	I heard you were in Aoba Johsai.
context: Tanaka, nice serve!\Yes.\Nice receive!\Mad Dog-chan!\Oikawa's a total sadist.\Absolute trust with no words involved...\It's been a while since you started coming here, Lone Wolf High School Kid.\I heard you were in Aoba Johsai. response:	That's a pretty strong school.
context: Yes.\Nice receive!\Mad Dog-chan!\Oikawa's a total sadist.\Absolute trust with no words involved...\It's been a while since you started coming here, Lone Wolf High School Kid.\I heard you were in Aoba Johsai.\That's a pretty strong school. response:	I actually couldn't get into that school.
context: Nice receive!\Mad Dog-chan!\Oikawa's a total sadist.\Absolute trust with no words involved...\It's been a while since you started coming here, Lone Wolf High School Kid.\I heard you were in Aoba Johsai.\That's a pretty strong school.\I actually couldn't get into that school. response:	Running away from the team,
context: Mad Dog-chan!\Oikawa's a total sadist.\Absolute trust with no words involved...\It's been a while since you started coming here, Lone Wolf High School Kid.\I heard you were in Aoba Johsai.\That's a pretty strong school.\I actually couldn't get into that school.\Running away from the team, response:	and practicing elsewhere without rest...
context: Oikawa's a total sadist.\Absolute trust with no words involved...\It's been a while since you started coming here, Lone Wolf High School Kid.\I heard you were in Aoba Johsai.\That's a pretty strong school.\I actually couldn't get into that school.\Running away from the team,\and practicing elsewhere without rest... response:	You're sure taking the easy way out.
context: Absolute trust with no words involved...\It's been a while since you started coming here, Lone Wolf High School Kid.\I heard you were in Aoba Johsai.\That's a pretty strong school.\I actually couldn't get into that school.\Running away from the team,\and practicing elsewhere without rest...\You're sure taking the easy way out. response:	What?!
context: It's been a while since you started coming here, Lone Wolf High School Kid.\I heard you were in Aoba Johsai.\That's a pretty strong school.\I actually couldn't get into that school.\Running away from the team,\and practicing elsewhere without rest...\You're sure taking the easy way out.\What?! response:	A team is reliable and also annoying, at times.
context: I heard you were in Aoba Johsai.\That's a pretty strong school.\I actually couldn't get into that school.\Running away from the team,\and practicing elsewhere without rest...\You're sure taking the easy way out.\What?!\A team is reliable and also annoying, at times. response:	They're strong allies, yet cause a lot of stress.
context: That's a pretty strong school.\I actually couldn't get into that school.\Running away from the team,\and practicing elsewhere without rest...\You're sure taking the easy way out.\What?!\A team is reliable and also annoying, at times.\They're strong allies, yet cause a lot of stress. response:	You can't even deal with that,
context: I actually couldn't get into that school.\Running away from the team,\and practicing elsewhere without rest...\You're sure taking the easy way out.\What?!\A team is reliable and also annoying, at times.\They're strong allies, yet cause a lot of stress.\You can't even deal with that, response:	and you think you're playing volleyball?
context: Running away from the team,\and practicing elsewhere without rest...\You're sure taking the easy way out.\What?!\A team is reliable and also annoying, at times.\They're strong allies, yet cause a lot of stress.\You can't even deal with that,\and you think you're playing volleyball? response:	You need to face the team, and have the team face you.
context: and practicing elsewhere without rest...\You're sure taking the easy way out.\What?!\A team is reliable and also annoying, at times.\They're strong allies, yet cause a lot of stress.\You can't even deal with that,\and you think you're playing volleyball?\You need to face the team, and have the team face you. response:	If you're able to do that, you'll both clash and become even stronger.
context: You're sure taking the easy way out.\What?!\A team is reliable and also annoying, at times.\They're strong allies, yet cause a lot of stress.\You can't even deal with that,\and you think you're playing volleyball?\You need to face the team, and have the team face you.\If you're able to do that, you'll both clash and become even stronger. response:	All right!
context: What?!\A team is reliable and also annoying, at times.\They're strong allies, yet cause a lot of stress.\You can't even deal with that,\and you think you're playing volleyball?\You need to face the team, and have the team face you.\If you're able to do that, you'll both clash and become even stronger.\All right! response:	And if you're able to do that, just know that you're lucky.
context: A team is reliable and also annoying, at times.\They're strong allies, yet cause a lot of stress.\You can't even deal with that,\and you think you're playing volleyball?\You need to face the team, and have the team face you.\If you're able to do that, you'll both clash and become even stronger.\All right!\And if you're able to do that, just know that you're lucky. response:	Teams like that don't exist everywhere.
context: They're strong allies, yet cause a lot of stress.\You can't even deal with that,\and you think you're playing volleyball?\You need to face the team, and have the team face you.\If you're able to do that, you'll both clash and become even stronger.\All right!\And if you're able to do that, just know that you're lucky.\Teams like that don't exist everywhere. response:	All right!
context: You can't even deal with that,\and you think you're playing volleyball?\You need to face the team, and have the team face you.\If you're able to do that, you'll both clash and become even stronger.\All right!\And if you're able to do that, just know that you're lucky.\Teams like that don't exist everywhere.\All right! response:	Looks like a great team.
context: and you think you're playing volleyball?\You need to face the team, and have the team face you.\If you're able to do that, you'll both clash and become even stronger.\All right!\And if you're able to do that, just know that you're lucky.\Teams like that don't exist everywhere.\All right!\Looks like a great team. response:	Make sure you face them properly.
context: You need to face the team, and have the team face you.\If you're able to do that, you'll both clash and become even stronger.\All right!\And if you're able to do that, just know that you're lucky.\Teams like that don't exist everywhere.\All right!\Looks like a great team.\Make sure you face them properly. response:	Sorry! I'll get the next one!
context: If you're able to do that, you'll both clash and become even stronger.\All right!\And if you're able to do that, just know that you're lucky.\Teams like that don't exist everywhere.\All right!\Looks like a great team.\Make sure you face them properly.\Sorry! I'll get the next one! response:	Yeah!
context: All right!\And if you're able to do that, just know that you're lucky.\Teams like that don't exist everywhere.\All right!\Looks like a great team.\Make sure you face them properly.\Sorry! I'll get the next one!\Yeah! response:	Aoba Johsai Karasuno
context: And if you're able to do that, just know that you're lucky.\Teams like that don't exist everywhere.\All right!\Looks like a great team.\Make sure you face them properly.\Sorry! I'll get the next one!\Yeah!\Aoba Johsai Karasuno response:	Kyotani, you're serving next.
context: Teams like that don't exist everywhere.\All right!\Looks like a great team.\Make sure you face them properly.\Sorry! I'll get the next one!\Yeah!\Aoba Johsai Karasuno\Kyotani, you're serving next. response:	Nice hit.
context: All right!\Looks like a great team.\Make sure you face them properly.\Sorry! I'll get the next one!\Yeah!\Aoba Johsai Karasuno\Kyotani, you're serving next.\Nice hit. response:	Yeah.
context: Looks like a great team.\Make sure you face them properly.\Sorry! I'll get the next one!\Yeah!\Aoba Johsai Karasuno\Kyotani, you're serving next.\Nice hit.\Yeah. response:	If that 16 was in Karasuno,
context: Make sure you face them properly.\Sorry! I'll get the next one!\Yeah!\Aoba Johsai Karasuno\Kyotani, you're serving next.\Nice hit.\Yeah.\If that 16 was in Karasuno, response:	I wonder what I'd do in this situation.
context: Sorry! I'll get the next one!\Yeah!\Aoba Johsai Karasuno\Kyotani, you're serving next.\Nice hit.\Yeah.\If that 16 was in Karasuno,\I wonder what I'd do in this situation. response:	Oikawa...
context: Yeah!\Aoba Johsai Karasuno\Kyotani, you're serving next.\Nice hit.\Yeah.\If that 16 was in Karasuno,\I wonder what I'd do in this situation.\Oikawa... response:	He truly is amazing and terrifying.
context: Aoba Johsai Karasuno\Kyotani, you're serving next.\Nice hit.\Yeah.\If that 16 was in Karasuno,\I wonder what I'd do in this situation.\Oikawa...\He truly is amazing and terrifying. response:	All right, let's get this one!
context: Kyotani, you're serving next.\Nice hit.\Yeah.\If that 16 was in Karasuno,\I wonder what I'd do in this situation.\Oikawa...\He truly is amazing and terrifying.\All right, let's get this one! response:	Yeah!
context: Nice hit.\Yeah.\If that 16 was in Karasuno,\I wonder what I'd do in this situation.\Oikawa...\He truly is amazing and terrifying.\All right, let's get this one!\Yeah! response:	With that play, it appears as though their oddball 16
context: Yeah.\If that 16 was in Karasuno,\I wonder what I'd do in this situation.\Oikawa...\He truly is amazing and terrifying.\All right, let's get this one!\Yeah!\With that play, it appears as though their oddball 16 response:	now fits in with the rest of the team.
context: If that 16 was in Karasuno,\I wonder what I'd do in this situation.\Oikawa...\He truly is amazing and terrifying.\All right, let's get this one!\Yeah!\With that play, it appears as though their oddball 16\now fits in with the rest of the team. response:	That's not good.
context: I wonder what I'd do in this situation.\Oikawa...\He truly is amazing and terrifying.\All right, let's get this one!\Yeah!\With that play, it appears as though their oddball 16\now fits in with the rest of the team.\That's not good. response:	We haven't lost
context: Oikawa...\He truly is amazing and terrifying.\All right, let's get this one!\Yeah!\With that play, it appears as though their oddball 16\now fits in with the rest of the team.\That's not good.\We haven't lost response:	when it comes to our strength as a team.
context: He truly is amazing and terrifying.\All right, let's get this one!\Yeah!\With that play, it appears as though their oddball 16\now fits in with the rest of the team.\That's not good.\We haven't lost\when it comes to our strength as a team. response:	We've only just begun.
context: All right, let's get this one!\Yeah!\With that play, it appears as though their oddball 16\now fits in with the rest of the team.\That's not good.\We haven't lost\when it comes to our strength as a team.\We've only just begun. response:	Yeah.
context: Yeah!\With that play, it appears as though their oddball 16\now fits in with the rest of the team.\That's not good.\We haven't lost\when it comes to our strength as a team.\We've only just begun.\Yeah. response:	Kyotani, nice serve!
context: With that play, it appears as though their oddball 16\now fits in with the rest of the team.\That's not good.\We haven't lost\when it comes to our strength as a team.\We've only just begun.\Yeah.\Kyotani, nice serve! response:	Ryu!
context: now fits in with the rest of the team.\That's not good.\We haven't lost\when it comes to our strength as a team.\We've only just begun.\Yeah.\Kyotani, nice serve!\Ryu! response:	Yeah!
context: That's not good.\We haven't lost\when it comes to our strength as a team.\We've only just begun.\Yeah.\Kyotani, nice serve!\Ryu!\Yeah! response:	Nice receive!
context: We haven't lost\when it comes to our strength as a team.\We've only just begun.\Yeah.\Kyotani, nice serve!\Ryu!\Yeah!\Nice receive! response:	Watacchi, nice!
context: when it comes to our strength as a team.\We've only just begun.\Yeah.\Kyotani, nice serve!\Ryu!\Yeah!\Nice receive!\Watacchi, nice! response:	Counter!
context: We've only just begun.\Yeah.\Kyotani, nice serve!\Ryu!\Yeah!\Nice receive!\Watacchi, nice!\Counter! response:	All right!
context: Yeah.\Kyotani, nice serve!\Ryu!\Yeah!\Nice receive!\Watacchi, nice!\Counter!\All right! response:	Damn it...
context: Kyotani, nice serve!\Ryu!\Yeah!\Nice receive!\Watacchi, nice!\Counter!\All right!\Damn it... response:	Aoba Johsai Karasuno
context: Ryu!\Yeah!\Nice receive!\Watacchi, nice!\Counter!\All right!\Damn it...\Aoba Johsai Karasuno response:	They're tied!
context: Yeah!\Nice receive!\Watacchi, nice!\Counter!\All right!\Damn it...\Aoba Johsai Karasuno\They're tied! response:	Seijoh caught up!
context: Nice receive!\Watacchi, nice!\Counter!\All right!\Damn it...\Aoba Johsai Karasuno\They're tied!\Seijoh caught up! response:	Kyotani, one more!
context: Watacchi, nice!\Counter!\All right!\Damn it...\Aoba Johsai Karasuno\They're tied!\Seijoh caught up!\Kyotani, one more! response:	All right!
context: Counter!\All right!\Damn it...\Aoba Johsai Karasuno\They're tied!\Seijoh caught up!\Kyotani, one more!\All right! response:	Chance ball!
context: All right!\Damn it...\Aoba Johsai Karasuno\They're tied!\Seijoh caught up!\Kyotani, one more!\All right!\Chance ball! response:	Hit it, Asahi!
context: Damn it...\Aoba Johsai Karasuno\They're tied!\Seijoh caught up!\Kyotani, one more!\All right!\Chance ball!\Hit it, Asahi! response:	Damn it... Sorry.
context: Aoba Johsai Karasuno\They're tied!\Seijoh caught up!\Kyotani, one more!\All right!\Chance ball!\Hit it, Asahi!\Damn it... Sorry. response:	All right!
context: They're tied!\Seijoh caught up!\Kyotani, one more!\All right!\Chance ball!\Hit it, Asahi!\Damn it... Sorry.\All right! response:	You're awesome, Asahi-san.
context: Seijoh caught up!\Kyotani, one more!\All right!\Chance ball!\Hit it, Asahi!\Damn it... Sorry.\All right!\You're awesome, Asahi-san. response:	It got totally knocked out.
context: Kyotani, one more!\All right!\Chance ball!\Hit it, Asahi!\Damn it... Sorry.\All right!\You're awesome, Asahi-san.\It got totally knocked out. response:	Thanks!
context: All right!\Chance ball!\Hit it, Asahi!\Damn it... Sorry.\All right!\You're awesome, Asahi-san.\It got totally knocked out.\Thanks! response:	Who's the senpai here?
context: Chance ball!\Hit it, Asahi!\Damn it... Sorry.\All right!\You're awesome, Asahi-san.\It got totally knocked out.\Thanks!\Who's the senpai here? response:	With Hinata's spike,
context: Hit it, Asahi!\Damn it... Sorry.\All right!\You're awesome, Asahi-san.\It got totally knocked out.\Thanks!\Who's the senpai here?\With Hinata's spike, response:	if the course is narrowed or read, it'll get picked up.
context: Damn it... Sorry.\All right!\You're awesome, Asahi-san.\It got totally knocked out.\Thanks!\Who's the senpai here?\With Hinata's spike,\if the course is narrowed or read, it'll get picked up. response:	Yeah...
context: All right!\You're awesome, Asahi-san.\It got totally knocked out.\Thanks!\Who's the senpai here?\With Hinata's spike,\if the course is narrowed or read, it'll get picked up.\Yeah... response:	We have to use Hinata better...
context: You're awesome, Asahi-san.\It got totally knocked out.\Thanks!\Who's the senpai here?\With Hinata's spike,\if the course is narrowed or read, it'll get picked up.\Yeah...\We have to use Hinata better... response:	All right!
context: It got totally knocked out.\Thanks!\Who's the senpai here?\With Hinata's spike,\if the course is narrowed or read, it'll get picked up.\Yeah...\We have to use Hinata better...\All right! response:	Karasuno Aoba Johsai
context: Thanks!\Who's the senpai here?\With Hinata's spike,\if the course is narrowed or read, it'll get picked up.\Yeah...\We have to use Hinata better...\All right!\Karasuno Aoba Johsai response:	Geh, again?
context: Who's the senpai here?\With Hinata's spike,\if the course is narrowed or read, it'll get picked up.\Yeah...\We have to use Hinata better...\All right!\Karasuno Aoba Johsai\Geh, again? response:	I feel like my lifespan get shorter
context: With Hinata's spike,\if the course is narrowed or read, it'll get picked up.\Yeah...\We have to use Hinata better...\All right!\Karasuno Aoba Johsai\Geh, again?\I feel like my lifespan get shorter response:	Oikawa, one more! Nice serve!
context: if the course is narrowed or read, it'll get picked up.\Yeah...\We have to use Hinata better...\All right!\Karasuno Aoba Johsai\Geh, again?\I feel like my lifespan get shorter\Oikawa, one more! Nice serve! response:	every time Oikawa-kun's time to serve comes around.
context: Yeah...\We have to use Hinata better...\All right!\Karasuno Aoba Johsai\Geh, again?\I feel like my lifespan get shorter\Oikawa, one more! Nice serve!\every time Oikawa-kun's time to serve comes around. response:	Oikawa-san, we're counting on you!
context: We have to use Hinata better...\All right!\Karasuno Aoba Johsai\Geh, again?\I feel like my lifespan get shorter\Oikawa, one more! Nice serve!\every time Oikawa-kun's time to serve comes around.\Oikawa-san, we're counting on you! response:	I feel like I'm going to throw up.
context: All right!\Karasuno Aoba Johsai\Geh, again?\I feel like my lifespan get shorter\Oikawa, one more! Nice serve!\every time Oikawa-kun's time to serve comes around.\Oikawa-san, we're counting on you!\I feel like I'm going to throw up. response:	I'm sure everyone on this side feels that way...
context: Karasuno Aoba Johsai\Geh, again?\I feel like my lifespan get shorter\Oikawa, one more! Nice serve!\every time Oikawa-kun's time to serve comes around.\Oikawa-san, we're counting on you!\I feel like I'm going to throw up.\I'm sure everyone on this side feels that way... response:	We're almost done with the middle of the set...
context: Geh, again?\I feel like my lifespan get shorter\Oikawa, one more! Nice serve!\every time Oikawa-kun's time to serve comes around.\Oikawa-san, we're counting on you!\I feel like I'm going to throw up.\I'm sure everyone on this side feels that way...\We're almost done with the middle of the set... response:	Losing a lot of points right now would be fatal.
context: I feel like my lifespan get shorter\Oikawa, one more! Nice serve!\every time Oikawa-kun's time to serve comes around.\Oikawa-san, we're counting on you!\I feel like I'm going to throw up.\I'm sure everyone on this side feels that way...\We're almost done with the middle of the set...\Losing a lot of points right now would be fatal. response:	Stop him now!
context: Oikawa, one more! Nice serve!\every time Oikawa-kun's time to serve comes around.\Oikawa-san, we're counting on you!\I feel like I'm going to throw up.\I'm sure everyone on this side feels that way...\We're almost done with the middle of the set...\Losing a lot of points right now would be fatal.\Stop him now! response:	Bring it!
context: every time Oikawa-kun's time to serve comes around.\Oikawa-san, we're counting on you!\I feel like I'm going to throw up.\I'm sure everyone on this side feels that way...\We're almost done with the middle of the set...\Losing a lot of points right now would be fatal.\Stop him now!\Bring it! response:	Daichi-san!
context: Oikawa-san, we're counting on you!\I feel like I'm going to throw up.\I'm sure everyone on this side feels that way...\We're almost done with the middle of the set...\Losing a lot of points right now would be fatal.\Stop him now!\Bring it!\Daichi-san! response:	I can't believe he got that.
context: I feel like I'm going to throw up.\I'm sure everyone on this side feels that way...\We're almost done with the middle of the set...\Losing a lot of points right now would be fatal.\Stop him now!\Bring it!\Daichi-san!\I can't believe he got that. response:	Chance ball!
context: I'm sure everyone on this side feels that way...\We're almost done with the middle of the set...\Losing a lot of points right now would be fatal.\Stop him now!\Bring it!\Daichi-san!\I can't believe he got that.\Chance ball! response:	Damn it!
context: We're almost done with the middle of the set...\Losing a lot of points right now would be fatal.\Stop him now!\Bring it!\Daichi-san!\I can't believe he got that.\Chance ball!\Damn it! response:	A quick is coming!
context: Losing a lot of points right now would be fatal.\Stop him now!\Bring it!\Daichi-san!\I can't believe he got that.\Chance ball!\Damn it!\A quick is coming! response:	Kindaichi!
context: Stop him now!\Bring it!\Daichi-san!\I can't believe he got that.\Chance ball!\Damn it!\A quick is coming!\Kindaichi! response:	Don't mind!
context: Bring it!\Daichi-san!\I can't believe he got that.\Chance ball!\Damn it!\A quick is coming!\Kindaichi!\Don't mind! response:	If you have a request, tell me!
context: Daichi-san!\I can't believe he got that.\Chance ball!\Damn it!\A quick is coming!\Kindaichi!\Don't mind!\If you have a request, tell me! response:	If I tell Oikawa-san, he'll figure it out and if I don't, he won't get it.
context: I can't believe he got that.\Chance ball!\Damn it!\A quick is coming!\Kindaichi!\Don't mind!\If you have a request, tell me!\If I tell Oikawa-san, he'll figure it out and if I don't, he won't get it. response:	Say, Oikawa-san.
context: Chance ball!\Damn it!\A quick is coming!\Kindaichi!\Don't mind!\If you have a request, tell me!\If I tell Oikawa-san, he'll figure it out and if I don't, he won't get it.\Say, Oikawa-san. response:	With that one, it's a bit hard to sync or like, uh...
context: Damn it!\A quick is coming!\Kindaichi!\Don't mind!\If you have a request, tell me!\If I tell Oikawa-san, he'll figure it out and if I don't, he won't get it.\Say, Oikawa-san.\With that one, it's a bit hard to sync or like, uh... response:	Okay, got it.
context: A quick is coming!\Kindaichi!\Don't mind!\If you have a request, tell me!\If I tell Oikawa-san, he'll figure it out and if I don't, he won't get it.\Say, Oikawa-san.\With that one, it's a bit hard to sync or like, uh...\Okay, got it. response:	But try again without changing anything.
context: Kindaichi!\Don't mind!\If you have a request, tell me!\If I tell Oikawa-san, he'll figure it out and if I don't, he won't get it.\Say, Oikawa-san.\With that one, it's a bit hard to sync or like, uh...\Okay, got it.\But try again without changing anything. response:	Again?
context: Don't mind!\If you have a request, tell me!\If I tell Oikawa-san, he'll figure it out and if I don't, he won't get it.\Say, Oikawa-san.\With that one, it's a bit hard to sync or like, uh...\Okay, got it.\But try again without changing anything.\Again? response:	Your point of impact,
context: If you have a request, tell me!\If I tell Oikawa-san, he'll figure it out and if I don't, he won't get it.\Say, Oikawa-san.\With that one, it's a bit hard to sync or like, uh...\Okay, got it.\But try again without changing anything.\Again?\Your point of impact, response:	is about one ball's length ahead..
context: If I tell Oikawa-san, he'll figure it out and if I don't, he won't get it.\Say, Oikawa-san.\With that one, it's a bit hard to sync or like, uh...\Okay, got it.\But try again without changing anything.\Again?\Your point of impact,\is about one ball's length ahead.. response:	Great, great, Yutaro! Push it, push it, Yutaro! One more time!
context: Say, Oikawa-san.\With that one, it's a bit hard to sync or like, uh...\Okay, got it.\But try again without changing anything.\Again?\Your point of impact,\is about one ball's length ahead..\Great, great, Yutaro! Push it, push it, Yutaro! One more time! response:	Yes!
context: With that one, it's a bit hard to sync or like, uh...\Okay, got it.\But try again without changing anything.\Again?\Your point of impact,\is about one ball's length ahead..\Great, great, Yutaro! Push it, push it, Yutaro! One more time!\Yes! response:	A really sharp wipe...
context: Okay, got it.\But try again without changing anything.\Again?\Your point of impact,\is about one ball's length ahead..\Great, great, Yutaro! Push it, push it, Yutaro! One more time!\Yes!\A really sharp wipe... response:	Kindachi's movements are different from the Inter-High.
context: But try again without changing anything.\Again?\Your point of impact,\is about one ball's length ahead..\Great, great, Yutaro! Push it, push it, Yutaro! One more time!\Yes!\A really sharp wipe...\Kindachi's movements are different from the Inter-High. response:	Don't mind! We'll stop it with this one!
context: Again?\Your point of impact,\is about one ball's length ahead..\Great, great, Yutaro! Push it, push it, Yutaro! One more time!\Yes!\A really sharp wipe...\Kindachi's movements are different from the Inter-High.\Don't mind! We'll stop it with this one! response:	Concentrate!
context: Your point of impact,\is about one ball's length ahead..\Great, great, Yutaro! Push it, push it, Yutaro! One more time!\Yes!\A really sharp wipe...\Kindachi's movements are different from the Inter-High.\Don't mind! We'll stop it with this one!\Concentrate! response:	Karasuno Aoba Johsai
context: is about one ball's length ahead..\Great, great, Yutaro! Push it, push it, Yutaro! One more time!\Yes!\A really sharp wipe...\Kindachi's movements are different from the Inter-High.\Don't mind! We'll stop it with this one!\Concentrate!\Karasuno Aoba Johsai response:	Break!
context: Great, great, Yutaro! Push it, push it, Yutaro! One more time!\Yes!\A really sharp wipe...\Kindachi's movements are different from the Inter-High.\Don't mind! We'll stop it with this one!\Concentrate!\Karasuno Aoba Johsai\Break! response:	We're in the latter half and Seijoh's turning it around.
context: Yes!\A really sharp wipe...\Kindachi's movements are different from the Inter-High.\Don't mind! We'll stop it with this one!\Concentrate!\Karasuno Aoba Johsai\Break!\We're in the latter half and Seijoh's turning it around. response:	It's now an all-out war between the teams.
context: A really sharp wipe...\Kindachi's movements are different from the Inter-High.\Don't mind! We'll stop it with this one!\Concentrate!\Karasuno Aoba Johsai\Break!\We're in the latter half and Seijoh's turning it around.\It's now an all-out war between the teams. response:	Yes...
context: Kindachi's movements are different from the Inter-High.\Don't mind! We'll stop it with this one!\Concentrate!\Karasuno Aoba Johsai\Break!\We're in the latter half and Seijoh's turning it around.\It's now an all-out war between the teams.\Yes... response:	And the one that brings the whole Aoba Johsai team up
context: Don't mind! We'll stop it with this one!\Concentrate!\Karasuno Aoba Johsai\Break!\We're in the latter half and Seijoh's turning it around.\It's now an all-out war between the teams.\Yes...\And the one that brings the whole Aoba Johsai team up response:	is Oikawa-kun, right?
context: Concentrate!\Karasuno Aoba Johsai\Break!\We're in the latter half and Seijoh's turning it around.\It's now an all-out war between the teams.\Yes...\And the one that brings the whole Aoba Johsai team up\is Oikawa-kun, right? response:	Oikawa-san, one more! Nice serve!
context: Karasuno Aoba Johsai\Break!\We're in the latter half and Seijoh's turning it around.\It's now an all-out war between the teams.\Yes...\And the one that brings the whole Aoba Johsai team up\is Oikawa-kun, right?\Oikawa-san, one more! Nice serve! response:	Yeah, I know, Sensei.
context: Break!\We're in the latter half and Seijoh's turning it around.\It's now an all-out war between the teams.\Yes...\And the one that brings the whole Aoba Johsai team up\is Oikawa-kun, right?\Oikawa-san, one more! Nice serve!\Yeah, I know, Sensei. response:	Our team's even stronger than this.
context: We're in the latter half and Seijoh's turning it around.\It's now an all-out war between the teams.\Yes...\And the one that brings the whole Aoba Johsai team up\is Oikawa-kun, right?\Oikawa-san, one more! Nice serve!\Yeah, I know, Sensei.\Our team's even stronger than this. response:	Bring it!
context: It's now an all-out war between the teams.\Yes...\And the one that brings the whole Aoba Johsai team up\is Oikawa-kun, right?\Oikawa-san, one more! Nice serve!\Yeah, I know, Sensei.\Our team's even stronger than this.\Bring it! response:	Come on!
context: Yes...\And the one that brings the whole Aoba Johsai team up\is Oikawa-kun, right?\Oikawa-san, one more! Nice serve!\Yeah, I know, Sensei.\Our team's even stronger than this.\Bring it!\Come on! response:	Oikawa-san, one more! Nice serve!
context: And the one that brings the whole Aoba Johsai team up\is Oikawa-kun, right?\Oikawa-san, one more! Nice serve!\Yeah, I know, Sensei.\Our team's even stronger than this.\Bring it!\Come on!\Oikawa-san, one more! Nice serve! response:	Sorry!
context: is Oikawa-kun, right?\Oikawa-san, one more! Nice serve!\Yeah, I know, Sensei.\Our team's even stronger than this.\Bring it!\Come on!\Oikawa-san, one more! Nice serve!\Sorry! response:	Tsukishima, get it!
context: Oikawa-san, one more! Nice serve!\Yeah, I know, Sensei.\Our team's even stronger than this.\Bring it!\Come on!\Oikawa-san, one more! Nice serve!\Sorry!\Tsukishima, get it! response:	Push through, Kindaichi!
context: Yeah, I know, Sensei.\Our team's even stronger than this.\Bring it!\Come on!\Oikawa-san, one more! Nice serve!\Sorry!\Tsukishima, get it!\Push through, Kindaichi! response:	All right!
context: Our team's even stronger than this.\Bring it!\Come on!\Oikawa-san, one more! Nice serve!\Sorry!\Tsukishima, get it!\Push through, Kindaichi!\All right! response:	Thanks, Tsukishima!
context: Bring it!\Come on!\Oikawa-san, one more! Nice serve!\Sorry!\Tsukishima, get it!\Push through, Kindaichi!\All right!\Thanks, Tsukishima! response:	Tsukishima, you're serving next!
context: Come on!\Oikawa-san, one more! Nice serve!\Sorry!\Tsukishima, get it!\Push through, Kindaichi!\All right!\Thanks, Tsukishima!\Tsukishima, you're serving next! response:	Go wild out there, Shoyo!
context: Oikawa-san, one more! Nice serve!\Sorry!\Tsukishima, get it!\Push through, Kindaichi!\All right!\Thanks, Tsukishima!\Tsukishima, you're serving next!\Go wild out there, Shoyo! response:	Right!
context: Sorry!\Tsukishima, get it!\Push through, Kindaichi!\All right!\Thanks, Tsukishima!\Tsukishima, you're serving next!\Go wild out there, Shoyo!\Right! response:	Cut it off with this one!
context: Tsukishima, get it!\Push through, Kindaichi!\All right!\Thanks, Tsukishima!\Tsukishima, you're serving next!\Go wild out there, Shoyo!\Right!\Cut it off with this one! response:	Yeah!
context: Push through, Kindaichi!\All right!\Thanks, Tsukishima!\Tsukishima, you're serving next!\Go wild out there, Shoyo!\Right!\Cut it off with this one!\Yeah! response:	The Great King really is amazing.
context: All right!\Thanks, Tsukishima!\Tsukishima, you're serving next!\Go wild out there, Shoyo!\Right!\Cut it off with this one!\Yeah!\The Great King really is amazing. response:	Do you really understand that?
context: Thanks, Tsukishima!\Tsukishima, you're serving next!\Go wild out there, Shoyo!\Right!\Cut it off with this one!\Yeah!\The Great King really is amazing.\Do you really understand that? response:	I can at least tell something is amazing about him.
context: Tsukishima, you're serving next!\Go wild out there, Shoyo!\Right!\Cut it off with this one!\Yeah!\The Great King really is amazing.\Do you really understand that?\I can at least tell something is amazing about him. response:	But!
context: Go wild out there, Shoyo!\Right!\Cut it off with this one!\Yeah!\The Great King really is amazing.\Do you really understand that?\I can at least tell something is amazing about him.\But! response:	If I'm here, you're invincible.
context: Right!\Cut it off with this one!\Yeah!\The Great King really is amazing.\Do you really understand that?\I can at least tell something is amazing about him.\But!\If I'm here, you're invincible. response:	That's super awesome.
context: Cut it off with this one!\Yeah!\The Great King really is amazing.\Do you really understand that?\I can at least tell something is amazing about him.\But!\If I'm here, you're invincible.\That's super awesome. response:	Seriously...
context: Yeah!\The Great King really is amazing.\Do you really understand that?\I can at least tell something is amazing about him.\But!\If I'm here, you're invincible.\That's super awesome.\Seriously... response:	All of your spikes kept getting picked up, so what are you talking about?
context: The Great King really is amazing.\Do you really understand that?\I can at least tell something is amazing about him.\But!\If I'm here, you're invincible.\That's super awesome.\Seriously...\All of your spikes kept getting picked up, so what are you talking about? response:	What'd you say?!
context: Do you really understand that?\I can at least tell something is amazing about him.\But!\If I'm here, you're invincible.\That's super awesome.\Seriously...\All of your spikes kept getting picked up, so what are you talking about?\What'd you say?! response:	Baseless courage... Nice.
context: I can at least tell something is amazing about him.\But!\If I'm here, you're invincible.\That's super awesome.\Seriously...\All of your spikes kept getting picked up, so what are you talking about?\What'd you say?!\Baseless courage... Nice. response:	Th-There is though... there's base.
context: But!\If I'm here, you're invincible.\That's super awesome.\Seriously...\All of your spikes kept getting picked up, so what are you talking about?\What'd you say?!\Baseless courage... Nice.\Th-There is though... there's base. response:	All right!
context: If I'm here, you're invincible.\That's super awesome.\Seriously...\All of your spikes kept getting picked up, so what are you talking about?\What'd you say?!\Baseless courage... Nice.\Th-There is though... there's base.\All right! response:	Nice receive!
context: That's super awesome.\Seriously...\All of your spikes kept getting picked up, so what are you talking about?\What'd you say?!\Baseless courage... Nice.\Th-There is though... there's base.\All right!\Nice receive! response:	Mad Dog-chan!
context: Seriously...\All of your spikes kept getting picked up, so what are you talking about?\What'd you say?!\Baseless courage... Nice.\Th-There is though... there's base.\All right!\Nice receive!\Mad Dog-chan! response:	Nice one-touch!
context: All of your spikes kept getting picked up, so what are you talking about?\What'd you say?!\Baseless courage... Nice.\Th-There is though... there's base.\All right!\Nice receive!\Mad Dog-chan!\Nice one-touch! response:	Got it!
context: What'd you say?!\Baseless courage... Nice.\Th-There is though... there's base.\All right!\Nice receive!\Mad Dog-chan!\Nice one-touch!\Got it! response:	Bring it to me!
context: Baseless courage... Nice.\Th-There is though... there's base.\All right!\Nice receive!\Mad Dog-chan!\Nice one-touch!\Got it!\Bring it to me! response:	I flew too far forward...
context: Th-There is though... there's base.\All right!\Nice receive!\Mad Dog-chan!\Nice one-touch!\Got it!\Bring it to me!\I flew too far forward... response:	The net's super close.
context: All right!\Nice receive!\Mad Dog-chan!\Nice one-touch!\Got it!\Bring it to me!\I flew too far forward...\The net's super close. response:	Isn't the toss a bit close to the net?!
context: Nice receive!\Mad Dog-chan!\Nice one-touch!\Got it!\Bring it to me!\I flew too far forward...\The net's super close.\Isn't the toss a bit close to the net?! response:	It's basically right above the net!
context: Mad Dog-chan!\Nice one-touch!\Got it!\Bring it to me!\I flew too far forward...\The net's super close.\Isn't the toss a bit close to the net?!\It's basically right above the net! response:	No one's there!
context: Nice one-touch!\Got it!\Bring it to me!\I flew too far forward...\The net's super close.\Isn't the toss a bit close to the net?!\It's basically right above the net!\No one's there! response:	Up front!
context: Got it!\Bring it to me!\I flew too far forward...\The net's super close.\Isn't the toss a bit close to the net?!\It's basically right above the net!\No one's there!\Up front! response:	Slam it down!
context: Bring it to me!\I flew too far forward...\The net's super close.\Isn't the toss a bit close to the net?!\It's basically right above the net!\No one's there!\Up front!\Slam it down! response:	We're playing the final set, score 17 to 16...
context: I flew too far forward...\The net's super close.\Isn't the toss a bit close to the net?!\It's basically right above the net!\No one's there!\Up front!\Slam it down!\We're playing the final set, score 17 to 16... response:	It's really close.
context: The net's super close.\Isn't the toss a bit close to the net?!\It's basically right above the net!\No one's there!\Up front!\Slam it down!\We're playing the final set, score 17 to 16...\It's really close. response:	Yeah.
context: Isn't the toss a bit close to the net?!\It's basically right above the net!\No one's there!\Up front!\Slam it down!\We're playing the final set, score 17 to 16...\It's really close.\Yeah. response:	We're gonna win, no matter what!
context: It's basically right above the net!\No one's there!\Up front!\Slam it down!\We're playing the final set, score 17 to 16...\It's really close.\Yeah.\We're gonna win, no matter what! response:	Yeah.
context: No one's there!\Up front!\Slam it down!\We're playing the final set, score 17 to 16...\It's really close.\Yeah.\We're gonna win, no matter what!\Yeah. response:	Bring it all to me!
context: Up front!\Slam it down!\We're playing the final set, score 17 to 16...\It's really close.\Yeah.\We're gonna win, no matter what!\Yeah.\Bring it all to me! response:	Next time on Haikyu!! : The Absolute Limit Switch.
context: Slam it down!\We're playing the final set, score 17 to 16...\It's really close.\Yeah.\We're gonna win, no matter what!\Yeah.\Bring it all to me!\Next time on Haikyu!! : The Absolute Limit Switch. response:	Episode 24 The Absolute Limit Switch
context: We're playing the final set, score 17 to 16...\It's really close.\Yeah.\We're gonna win, no matter what!\Yeah.\Bring it all to me!\Next time on Haikyu!! : The Absolute Limit Switch.\Episode 24 The Absolute Limit Switch response:	Don't just ignore me!