context: It appeared as though humanity would be destroyed by the demons. response:	But a single mage saved them all.
context: It appeared as though humanity would be destroyed by the demons.\But a single mage saved them all. response:	He was called the Wizard King, and he became a legend.
context: It appeared as though humanity would be destroyed by the demons.\But a single mage saved them all.\He was called the Wizard King, and he became a legend. response:	And so, we're giving you your first mission.
context: It appeared as though humanity would be destroyed by the demons.\But a single mage saved them all.\He was called the Wizard King, and he became a legend.\And so, we're giving you your first mission. response:	Our first mission...
context: It appeared as though humanity would be destroyed by the demons.\But a single mage saved them all.\He was called the Wizard King, and he became a legend.\And so, we're giving you your first mission.\Our first mission... response:	Wh-What is it?
context: It appeared as though humanity would be destroyed by the demons.\But a single mage saved them all.\He was called the Wizard King, and he became a legend.\And so, we're giving you your first mission.\Our first mission...\Wh-What is it? response:	It had better be something worthy of me as a royal.
context: It appeared as though humanity would be destroyed by the demons.\But a single mage saved them all.\He was called the Wizard King, and he became a legend.\And so, we're giving you your first mission.\Our first mission...\Wh-What is it?\It had better be something worthy of me as a royal. response:	Yeah, you should be honored.
context: It appeared as though humanity would be destroyed by the demons.\But a single mage saved them all.\He was called the Wizard King, and he became a legend.\And so, we're giving you your first mission.\Our first mission...\Wh-What is it?\It had better be something worthy of me as a royal.\Yeah, you should be honored. response:	You'll be hunting wild boars in Saussy Village!
context: But a single mage saved them all.\He was called the Wizard King, and he became a legend.\And so, we're giving you your first mission.\Our first mission...\Wh-What is it?\It had better be something worthy of me as a royal.\Yeah, you should be honored.\You'll be hunting wild boars in Saussy Village! response:	Wild...
context: He was called the Wizard King, and he became a legend.\And so, we're giving you your first mission.\Our first mission...\Wh-What is it?\It had better be something worthy of me as a royal.\Yeah, you should be honored.\You'll be hunting wild boars in Saussy Village!\Wild... response:	Boar!
context: And so, we're giving you your first mission.\Our first mission...\Wh-What is it?\It had better be something worthy of me as a royal.\Yeah, you should be honored.\You'll be hunting wild boars in Saussy Village!\Wild...\Boar! response:	What kind of lame mission is that?
context: Our first mission...\Wh-What is it?\It had better be something worthy of me as a royal.\Yeah, you should be honored.\You'll be hunting wild boars in Saussy Village!\Wild...\Boar!\What kind of lame mission is that? response:	What are you calling lame?!
context: Wh-What is it?\It had better be something worthy of me as a royal.\Yeah, you should be honored.\You'll be hunting wild boars in Saussy Village!\Wild...\Boar!\What kind of lame mission is that?\What are you calling lame?! response:	I can beat a wild boar with my bare hands!
context: It had better be something worthy of me as a royal.\Yeah, you should be honored.\You'll be hunting wild boars in Saussy Village!\Wild...\Boar!\What kind of lame mission is that?\What are you calling lame?!\I can beat a wild boar with my bare hands! response:	Don't you dare underestimate wild boars!
context: Yeah, you should be honored.\You'll be hunting wild boars in Saussy Village!\Wild...\Boar!\What kind of lame mission is that?\What are you calling lame?!\I can beat a wild boar with my bare hands!\Don't you dare underestimate wild boars! response:	Are you going to go, or are you going to die?
context: You'll be hunting wild boars in Saussy Village!\Wild...\Boar!\What kind of lame mission is that?\What are you calling lame?!\I can beat a wild boar with my bare hands!\Don't you dare underestimate wild boars!\Are you going to go, or are you going to die? response:	Which will it be?
context: Wild...\Boar!\What kind of lame mission is that?\What are you calling lame?!\I can beat a wild boar with my bare hands!\Don't you dare underestimate wild boars!\Are you going to go, or are you going to die?\Which will it be? response:	We'll go!
context: Boar!\What kind of lame mission is that?\What are you calling lame?!\I can beat a wild boar with my bare hands!\Don't you dare underestimate wild boars!\Are you going to go, or are you going to die?\Which will it be?\We'll go! response:	Even if it's just hunting wild boars, this is our first mission as Magic Knights.
context: What kind of lame mission is that?\What are you calling lame?!\I can beat a wild boar with my bare hands!\Don't you dare underestimate wild boars!\Are you going to go, or are you going to die?\Which will it be?\We'll go!\Even if it's just hunting wild boars, this is our first mission as Magic Knights. response:	I'm so excited!
context: What are you calling lame?!\I can beat a wild boar with my bare hands!\Don't you dare underestimate wild boars!\Are you going to go, or are you going to die?\Which will it be?\We'll go!\Even if it's just hunting wild boars, this is our first mission as Magic Knights.\I'm so excited! response:	I'm supposed to get rid of wild boars?
context: I can beat a wild boar with my bare hands!\Don't you dare underestimate wild boars!\Are you going to go, or are you going to die?\Which will it be?\We'll go!\Even if it's just hunting wild boars, this is our first mission as Magic Knights.\I'm so excited!\I'm supposed to get rid of wild boars? response:	What? You're still complaining?
context: Don't you dare underestimate wild boars!\Are you going to go, or are you going to die?\Which will it be?\We'll go!\Even if it's just hunting wild boars, this is our first mission as Magic Knights.\I'm so excited!\I'm supposed to get rid of wild boars?\What? You're still complaining? response:	I'm not complaining... It's just...
context: Are you going to go, or are you going to die?\Which will it be?\We'll go!\Even if it's just hunting wild boars, this is our first mission as Magic Knights.\I'm so excited!\I'm supposed to get rid of wild boars?\What? You're still complaining?\I'm not complaining... It's just... response:	I was just wondering if I should go, since I can't control my magical powers.
context: Which will it be?\We'll go!\Even if it's just hunting wild boars, this is our first mission as Magic Knights.\I'm so excited!\I'm supposed to get rid of wild boars?\What? You're still complaining?\I'm not complaining... It's just...\I was just wondering if I should go, since I can't control my magical powers. response:	Her name is...
context: We'll go!\Even if it's just hunting wild boars, this is our first mission as Magic Knights.\I'm so excited!\I'm supposed to get rid of wild boars?\What? You're still complaining?\I'm not complaining... It's just...\I was just wondering if I should go, since I can't control my magical powers.\Her name is... response:	Crazy Cyclone!
context: Even if it's just hunting wild boars, this is our first mission as Magic Knights.\I'm so excited!\I'm supposed to get rid of wild boars?\What? You're still complaining?\I'm not complaining... It's just...\I was just wondering if I should go, since I can't control my magical powers.\Her name is...\Crazy Cyclone! response:	Crazy Cyclone
context: I'm so excited!\I'm supposed to get rid of wild boars?\What? You're still complaining?\I'm not complaining... It's just...\I was just wondering if I should go, since I can't control my magical powers.\Her name is...\Crazy Cyclone!\Crazy Cyclone response:	So cool!
context: I'm supposed to get rid of wild boars?\What? You're still complaining?\I'm not complaining... It's just...\I was just wondering if I should go, since I can't control my magical powers.\Her name is...\Crazy Cyclone!\Crazy Cyclone\So cool! response:	I know, right?! Isn't she a beaut?
context: What? You're still complaining?\I'm not complaining... It's just...\I was just wondering if I should go, since I can't control my magical powers.\Her name is...\Crazy Cyclone!\Crazy Cyclone\So cool!\I know, right?! Isn't she a beaut? response:	Yeah, she is!
context: I'm not complaining... It's just...\I was just wondering if I should go, since I can't control my magical powers.\Her name is...\Crazy Cyclone!\Crazy Cyclone\So cool!\I know, right?! Isn't she a beaut?\Yeah, she is! response:	Lame.
context: I was just wondering if I should go, since I can't control my magical powers.\Her name is...\Crazy Cyclone!\Crazy Cyclone\So cool!\I know, right?! Isn't she a beaut?\Yeah, she is!\Lame. response:	A man never goes back on his word!
context: Her name is...\Crazy Cyclone!\Crazy Cyclone\So cool!\I know, right?! Isn't she a beaut?\Yeah, she is!\Lame.\A man never goes back on his word! response:	Here we go!
context: Crazy Cyclone!\Crazy Cyclone\So cool!\I know, right?! Isn't she a beaut?\Yeah, she is!\Lame.\A man never goes back on his word!\Here we go! response:	Fly!
context: Crazy Cyclone\So cool!\I know, right?! Isn't she a beaut?\Yeah, she is!\Lame.\A man never goes back on his word!\Here we go!\Fly! response:	Yahoo!
context: So cool!\I know, right?! Isn't she a beaut?\Yeah, she is!\Lame.\A man never goes back on his word!\Here we go!\Fly!\Yahoo! response:	This is amazing, Magna! We're one with the wind!
context: I know, right?! Isn't she a beaut?\Yeah, she is!\Lame.\A man never goes back on his word!\Here we go!\Fly!\Yahoo!\This is amazing, Magna! We're one with the wind! response:	And if you don't want to die, better squeeze up closer, Stupidsta!
context: Yeah, she is!\Lame.\A man never goes back on his word!\Here we go!\Fly!\Yahoo!\This is amazing, Magna! We're one with the wind!\And if you don't want to die, better squeeze up closer, Stupidsta! response:	Yes, sir!
context: Lame.\A man never goes back on his word!\Here we go!\Fly!\Yahoo!\This is amazing, Magna! We're one with the wind!\And if you don't want to die, better squeeze up closer, Stupidsta!\Yes, sir! response:	So this is where the magic stone is located.
context: A man never goes back on his word!\Here we go!\Fly!\Yahoo!\This is amazing, Magna! We're one with the wind!\And if you don't want to die, better squeeze up closer, Stupidsta!\Yes, sir!\So this is where the magic stone is located. response:	We're going to find it.
context: Here we go!\Fly!\Yahoo!\This is amazing, Magna! We're one with the wind!\And if you don't want to die, better squeeze up closer, Stupidsta!\Yes, sir!\So this is where the magic stone is located.\We're going to find it. response:	Yes, sir!
context: Fly!\Yahoo!\This is amazing, Magna! We're one with the wind!\And if you don't want to die, better squeeze up closer, Stupidsta!\Yes, sir!\So this is where the magic stone is located.\We're going to find it.\Yes, sir! response:	Be lost in the mist.
context: Yahoo!\This is amazing, Magna! We're one with the wind!\And if you don't want to die, better squeeze up closer, Stupidsta!\Yes, sir!\So this is where the magic stone is located.\We're going to find it.\Yes, sir!\Be lost in the mist. response:	Beasts
context: This is amazing, Magna! We're one with the wind!\And if you don't want to die, better squeeze up closer, Stupidsta!\Yes, sir!\So this is where the magic stone is located.\We're going to find it.\Yes, sir!\Be lost in the mist.\Beasts response:	Grey words can't make anything happen
context: And if you don't want to die, better squeeze up closer, Stupidsta!\Yes, sir!\So this is where the magic stone is located.\We're going to find it.\Yes, sir!\Be lost in the mist.\Beasts\Grey words can't make anything happen response:	I know, yeah I know
context: Yes, sir!\So this is where the magic stone is located.\We're going to find it.\Yes, sir!\Be lost in the mist.\Beasts\Grey words can't make anything happen\I know, yeah I know response:	Wishing to fly freely across the sky
context: So this is where the magic stone is located.\We're going to find it.\Yes, sir!\Be lost in the mist.\Beasts\Grey words can't make anything happen\I know, yeah I know\Wishing to fly freely across the sky response:	I dreamed it all my life
context: We're going to find it.\Yes, sir!\Be lost in the mist.\Beasts\Grey words can't make anything happen\I know, yeah I know\Wishing to fly freely across the sky\I dreamed it all my life response:	Step by step I go, though it's a doubtful world
context: Yes, sir!\Be lost in the mist.\Beasts\Grey words can't make anything happen\I know, yeah I know\Wishing to fly freely across the sky\I dreamed it all my life\Step by step I go, though it's a doubtful world response:	Don't care how much I fall
context: Be lost in the mist.\Beasts\Grey words can't make anything happen\I know, yeah I know\Wishing to fly freely across the sky\I dreamed it all my life\Step by step I go, though it's a doubtful world\Don't care how much I fall response:	Instinct is my guide, I never give up
context: Beasts\Grey words can't make anything happen\I know, yeah I know\Wishing to fly freely across the sky\I dreamed it all my life\Step by step I go, though it's a doubtful world\Don't care how much I fall\Instinct is my guide, I never give up response:	To faraway future, I burst out running
context: Grey words can't make anything happen\I know, yeah I know\Wishing to fly freely across the sky\I dreamed it all my life\Step by step I go, though it's a doubtful world\Don't care how much I fall\Instinct is my guide, I never give up\To faraway future, I burst out running response:	Go beyond even the unseen fears
context: I know, yeah I know\Wishing to fly freely across the sky\I dreamed it all my life\Step by step I go, though it's a doubtful world\Don't care how much I fall\Instinct is my guide, I never give up\To faraway future, I burst out running\Go beyond even the unseen fears response:	The vision I had, so I can be myself
context: Wishing to fly freely across the sky\I dreamed it all my life\Step by step I go, though it's a doubtful world\Don't care how much I fall\Instinct is my guide, I never give up\To faraway future, I burst out running\Go beyond even the unseen fears\The vision I had, so I can be myself response:	Someday I will write the next page
context: I dreamed it all my life\Step by step I go, though it's a doubtful world\Don't care how much I fall\Instinct is my guide, I never give up\To faraway future, I burst out running\Go beyond even the unseen fears\The vision I had, so I can be myself\Someday I will write the next page response:	You are my hope
context: Step by step I go, though it's a doubtful world\Don't care how much I fall\Instinct is my guide, I never give up\To faraway future, I burst out running\Go beyond even the unseen fears\The vision I had, so I can be myself\Someday I will write the next page\You are my hope response:	Like that page from someday
context: Don't care how much I fall\Instinct is my guide, I never give up\To faraway future, I burst out running\Go beyond even the unseen fears\The vision I had, so I can be myself\Someday I will write the next page\You are my hope\Like that page from someday response:	I was able to meet you
context: Instinct is my guide, I never give up\To faraway future, I burst out running\Go beyond even the unseen fears\The vision I had, so I can be myself\Someday I will write the next page\You are my hope\Like that page from someday\I was able to meet you response:	I call this a miracle
context: To faraway future, I burst out running\Go beyond even the unseen fears\The vision I had, so I can be myself\Someday I will write the next page\You are my hope\Like that page from someday\I was able to meet you\I call this a miracle response:	A wild boar's after me! It's huge!
context: Go beyond even the unseen fears\The vision I had, so I can be myself\Someday I will write the next page\You are my hope\Like that page from someday\I was able to meet you\I call this a miracle\A wild boar's after me! It's huge! response:	Actually, is that even a wild boar?!
context: The vision I had, so I can be myself\Someday I will write the next page\You are my hope\Like that page from someday\I was able to meet you\I call this a miracle\A wild boar's after me! It's huge!\Actually, is that even a wild boar?! response:	Isn't it using some magic of its own?!
context: Someday I will write the next page\You are my hope\Like that page from someday\I was able to meet you\I call this a miracle\A wild boar's after me! It's huge!\Actually, is that even a wild boar?!\Isn't it using some magic of its own?! response:	It's super fast!
context: You are my hope\Like that page from someday\I was able to meet you\I call this a miracle\A wild boar's after me! It's huge!\Actually, is that even a wild boar?!\Isn't it using some magic of its own?!\It's super fast! response:	Shouldn't we rescue him?
context: Like that page from someday\I was able to meet you\I call this a miracle\A wild boar's after me! It's huge!\Actually, is that even a wild boar?!\Isn't it using some magic of its own?!\It's super fast!\Shouldn't we rescue him? response:	I'm taking a break.
context: I was able to meet you\I call this a miracle\A wild boar's after me! It's huge!\Actually, is that even a wild boar?!\Isn't it using some magic of its own?!\It's super fast!\Shouldn't we rescue him?\I'm taking a break. response:	My magical powers are pretty much drained after flying you two this far.
context: I call this a miracle\A wild boar's after me! It's huge!\Actually, is that even a wild boar?!\Isn't it using some magic of its own?!\It's super fast!\Shouldn't we rescue him?\I'm taking a break.\My magical powers are pretty much drained after flying you two this far. response:	I'm sure he'll be fine. He's pretty tough.
context: A wild boar's after me! It's huge!\Actually, is that even a wild boar?!\Isn't it using some magic of its own?!\It's super fast!\Shouldn't we rescue him?\I'm taking a break.\My magical powers are pretty much drained after flying you two this far.\I'm sure he'll be fine. He's pretty tough. response:	But...
context: Actually, is that even a wild boar?!\Isn't it using some magic of its own?!\It's super fast!\Shouldn't we rescue him?\I'm taking a break.\My magical powers are pretty much drained after flying you two this far.\I'm sure he'll be fine. He's pretty tough.\But... response:	If you're so worried, you go save him.
context: Isn't it using some magic of its own?!\It's super fast!\Shouldn't we rescue him?\I'm taking a break.\My magical powers are pretty much drained after flying you two this far.\I'm sure he'll be fine. He's pretty tough.\But...\If you're so worried, you go save him. response:	I can do this.
context: It's super fast!\Shouldn't we rescue him?\I'm taking a break.\My magical powers are pretty much drained after flying you two this far.\I'm sure he'll be fine. He's pretty tough.\But...\If you're so worried, you go save him.\I can do this. response:	Why me?!
context: Shouldn't we rescue him?\I'm taking a break.\My magical powers are pretty much drained after flying you two this far.\I'm sure he'll be fine. He's pretty tough.\But...\If you're so worried, you go save him.\I can do this.\Why me?! response:	I've got you now!
context: I'm taking a break.\My magical powers are pretty much drained after flying you two this far.\I'm sure he'll be fine. He's pretty tough.\But...\If you're so worried, you go save him.\I can do this.\Why me?!\I've got you now! response:	I finally got'im.
context: My magical powers are pretty much drained after flying you two this far.\I'm sure he'll be fine. He's pretty tough.\But...\If you're so worried, you go save him.\I can do this.\Why me?!\I've got you now!\I finally got'im. response:	Great job, Asta.
context: I'm sure he'll be fine. He's pretty tough.\But...\If you're so worried, you go save him.\I can do this.\Why me?!\I've got you now!\I finally got'im.\Great job, Asta. response:	But it ain't over yet.
context: But...\If you're so worried, you go save him.\I can do this.\Why me?!\I've got you now!\I finally got'im.\Great job, Asta.\But it ain't over yet. response:	What a haul!
context: If you're so worried, you go save him.\I can do this.\Why me?!\I've got you now!\I finally got'im.\Great job, Asta.\But it ain't over yet.\What a haul! response:	You're pretty amazing.
context: I can do this.\Why me?!\I've got you now!\I finally got'im.\Great job, Asta.\But it ain't over yet.\What a haul!\You're pretty amazing. response:	Three or four wild boars ain't nothing.
context: Why me?!\I've got you now!\I finally got'im.\Great job, Asta.\But it ain't over yet.\What a haul!\You're pretty amazing.\Three or four wild boars ain't nothing. response:	You've got some impressive brute strength.
context: I've got you now!\I finally got'im.\Great job, Asta.\But it ain't over yet.\What a haul!\You're pretty amazing.\Three or four wild boars ain't nothing.\You've got some impressive brute strength. response:	This should make Old Man Seihi happy. Let's have ourselves a wild boar party.
context: I finally got'im.\Great job, Asta.\But it ain't over yet.\What a haul!\You're pretty amazing.\Three or four wild boars ain't nothing.\You've got some impressive brute strength.\This should make Old Man Seihi happy. Let's have ourselves a wild boar party. response:	This mayor of Saussy Village... Seihi? You know him?
context: Great job, Asta.\But it ain't over yet.\What a haul!\You're pretty amazing.\Three or four wild boars ain't nothing.\You've got some impressive brute strength.\This should make Old Man Seihi happy. Let's have ourselves a wild boar party.\This mayor of Saussy Village... Seihi? You know him? response:	Yeah. I've known him for a long time.
context: But it ain't over yet.\What a haul!\You're pretty amazing.\Three or four wild boars ain't nothing.\You've got some impressive brute strength.\This should make Old Man Seihi happy. Let's have ourselves a wild boar party.\This mayor of Saussy Village... Seihi? You know him?\Yeah. I've known him for a long time. response:	I'm from Rayaka Village, which is just past here,
context: What a haul!\You're pretty amazing.\Three or four wild boars ain't nothing.\You've got some impressive brute strength.\This should make Old Man Seihi happy. Let's have ourselves a wild boar party.\This mayor of Saussy Village... Seihi? You know him?\Yeah. I've known him for a long time.\I'm from Rayaka Village, which is just past here, response:	Used to be?
context: You're pretty amazing.\Three or four wild boars ain't nothing.\You've got some impressive brute strength.\This should make Old Man Seihi happy. Let's have ourselves a wild boar party.\This mayor of Saussy Village... Seihi? You know him?\Yeah. I've known him for a long time.\I'm from Rayaka Village, which is just past here,\Used to be? response:	Like you aren't now?
context: Three or four wild boars ain't nothing.\You've got some impressive brute strength.\This should make Old Man Seihi happy. Let's have ourselves a wild boar party.\This mayor of Saussy Village... Seihi? You know him?\Yeah. I've known him for a long time.\I'm from Rayaka Village, which is just past here,\Used to be?\Like you aren't now? response:	I got a big head after I got my grimoire
context: You've got some impressive brute strength.\This should make Old Man Seihi happy. Let's have ourselves a wild boar party.\This mayor of Saussy Village... Seihi? You know him?\Yeah. I've known him for a long time.\I'm from Rayaka Village, which is just past here,\Used to be?\Like you aren't now?\I got a big head after I got my grimoire response:	and went into Saussy Village with the intent of taking over, too.
context: This should make Old Man Seihi happy. Let's have ourselves a wild boar party.\This mayor of Saussy Village... Seihi? You know him?\Yeah. I've known him for a long time.\I'm from Rayaka Village, which is just past here,\Used to be?\Like you aren't now?\I got a big head after I got my grimoire\and went into Saussy Village with the intent of taking over, too. response:	And then...
context: This mayor of Saussy Village... Seihi? You know him?\Yeah. I've known him for a long time.\I'm from Rayaka Village, which is just past here,\Used to be?\Like you aren't now?\I got a big head after I got my grimoire\and went into Saussy Village with the intent of taking over, too.\And then... response:	Take that!
context: Yeah. I've known him for a long time.\I'm from Rayaka Village, which is just past here,\Used to be?\Like you aren't now?\I got a big head after I got my grimoire\and went into Saussy Village with the intent of taking over, too.\And then...\Take that! response:	Hey, you little brat! What do you think you're doing?!
context: I'm from Rayaka Village, which is just past here,\Used to be?\Like you aren't now?\I got a big head after I got my grimoire\and went into Saussy Village with the intent of taking over, too.\And then...\Take that!\Hey, you little brat! What do you think you're doing?! response:	You wanna get hurt, old man?
context: Used to be?\Like you aren't now?\I got a big head after I got my grimoire\and went into Saussy Village with the intent of taking over, too.\And then...\Take that!\Hey, you little brat! What do you think you're doing?!\You wanna get hurt, old man? response:	You're the one that's gonna get hurt!
context: Like you aren't now?\I got a big head after I got my grimoire\and went into Saussy Village with the intent of taking over, too.\And then...\Take that!\Hey, you little brat! What do you think you're doing?!\You wanna get hurt, old man?\You're the one that's gonna get hurt! response:	Take that!
context: I got a big head after I got my grimoire\and went into Saussy Village with the intent of taking over, too.\And then...\Take that!\Hey, you little brat! What do you think you're doing?!\You wanna get hurt, old man?\You're the one that's gonna get hurt!\Take that! response:	Time for your punishment!
context: and went into Saussy Village with the intent of taking over, too.\And then...\Take that!\Hey, you little brat! What do you think you're doing?!\You wanna get hurt, old man?\You're the one that's gonna get hurt!\Take that!\Time for your punishment! response:	That's dangerous!
context: And then...\Take that!\Hey, you little brat! What do you think you're doing?!\You wanna get hurt, old man?\You're the one that's gonna get hurt!\Take that!\Time for your punishment!\That's dangerous! response:	And now...
context: Take that!\Hey, you little brat! What do you think you're doing?!\You wanna get hurt, old man?\You're the one that's gonna get hurt!\Take that!\Time for your punishment!\That's dangerous!\And now... response:	Wh-What the hell are you doing?
context: Hey, you little brat! What do you think you're doing?!\You wanna get hurt, old man?\You're the one that's gonna get hurt!\Take that!\Time for your punishment!\That's dangerous!\And now...\Wh-What the hell are you doing? response:	Time for an ass whoopin'!
context: You wanna get hurt, old man?\You're the one that's gonna get hurt!\Take that!\Time for your punishment!\That's dangerous!\And now...\Wh-What the hell are you doing?\Time for an ass whoopin'! response:	Hey! Damn it!
context: You're the one that's gonna get hurt!\Take that!\Time for your punishment!\That's dangerous!\And now...\Wh-What the hell are you doing?\Time for an ass whoopin'!\Hey! Damn it! response:	Since then, I've challenged that old man many times.
context: Take that!\Time for your punishment!\That's dangerous!\And now...\Wh-What the hell are you doing?\Time for an ass whoopin'!\Hey! Damn it!\Since then, I've challenged that old man many times. response:	Real men don't make trouble for others!
context: Time for your punishment!\That's dangerous!\And now...\Wh-What the hell are you doing?\Time for an ass whoopin'!\Hey! Damn it!\Since then, I've challenged that old man many times.\Real men don't make trouble for others! response:	Take that!
context: That's dangerous!\And now...\Wh-What the hell are you doing?\Time for an ass whoopin'!\Hey! Damn it!\Since then, I've challenged that old man many times.\Real men don't make trouble for others!\Take that! response:	Help the weak and humble the strong. That's what a true man does.
context: And now...\Wh-What the hell are you doing?\Time for an ass whoopin'!\Hey! Damn it!\Since then, I've challenged that old man many times.\Real men don't make trouble for others!\Take that!\Help the weak and humble the strong. That's what a true man does. response:	Golden!
context: Wh-What the hell are you doing?\Time for an ass whoopin'!\Hey! Damn it!\Since then, I've challenged that old man many times.\Real men don't make trouble for others!\Take that!\Help the weak and humble the strong. That's what a true man does.\Golden! response:	Real men don't make others worry about them.
context: Time for an ass whoopin'!\Hey! Damn it!\Since then, I've challenged that old man many times.\Real men don't make trouble for others!\Take that!\Help the weak and humble the strong. That's what a true man does.\Golden!\Real men don't make others worry about them. response:	He whooped my ass every time.
context: Hey! Damn it!\Since then, I've challenged that old man many times.\Real men don't make trouble for others!\Take that!\Help the weak and humble the strong. That's what a true man does.\Golden!\Real men don't make others worry about them.\He whooped my ass every time. response:	He must be strong.
context: Since then, I've challenged that old man many times.\Real men don't make trouble for others!\Take that!\Help the weak and humble the strong. That's what a true man does.\Golden!\Real men don't make others worry about them.\He whooped my ass every time.\He must be strong. response:	I found this out later, but Old Man Seihi
context: Real men don't make trouble for others!\Take that!\Help the weak and humble the strong. That's what a true man does.\Golden!\Real men don't make others worry about them.\He whooped my ass every time.\He must be strong.\I found this out later, but Old Man Seihi response:	had enough magical power that he aspired to be a Magic Knight when he was younger.
context: Take that!\Help the weak and humble the strong. That's what a true man does.\Golden!\Real men don't make others worry about them.\He whooped my ass every time.\He must be strong.\I found this out later, but Old Man Seihi\had enough magical power that he aspired to be a Magic Knight when he was younger. response:	He's the one who suggested that I take the Magic Knights Entrance Exam.
context: Help the weak and humble the strong. That's what a true man does.\Golden!\Real men don't make others worry about them.\He whooped my ass every time.\He must be strong.\I found this out later, but Old Man Seihi\had enough magical power that he aspired to be a Magic Knight when he was younger.\He's the one who suggested that I take the Magic Knights Entrance Exam. response:	Oh? Looks like you've improved a bit.
context: Golden!\Real men don't make others worry about them.\He whooped my ass every time.\He must be strong.\I found this out later, but Old Man Seihi\had enough magical power that he aspired to be a Magic Knight when he was younger.\He's the one who suggested that I take the Magic Knights Entrance Exam.\Oh? Looks like you've improved a bit. response:	W-Well, I'm getting the hang of using my grimoire.
context: Real men don't make others worry about them.\He whooped my ass every time.\He must be strong.\I found this out later, but Old Man Seihi\had enough magical power that he aspired to be a Magic Knight when he was younger.\He's the one who suggested that I take the Magic Knights Entrance Exam.\Oh? Looks like you've improved a bit.\W-Well, I'm getting the hang of using my grimoire. response:	In that case, why don't you try taking the Magic Knights Entrance Exam?
context: He whooped my ass every time.\He must be strong.\I found this out later, but Old Man Seihi\had enough magical power that he aspired to be a Magic Knight when he was younger.\He's the one who suggested that I take the Magic Knights Entrance Exam.\Oh? Looks like you've improved a bit.\W-Well, I'm getting the hang of using my grimoire.\In that case, why don't you try taking the Magic Knights Entrance Exam? response:	Huh?
context: He must be strong.\I found this out later, but Old Man Seihi\had enough magical power that he aspired to be a Magic Knight when he was younger.\He's the one who suggested that I take the Magic Knights Entrance Exam.\Oh? Looks like you've improved a bit.\W-Well, I'm getting the hang of using my grimoire.\In that case, why don't you try taking the Magic Knights Entrance Exam?\Huh? response:	M-Me? Take the entrance exam?
context: I found this out later, but Old Man Seihi\had enough magical power that he aspired to be a Magic Knight when he was younger.\He's the one who suggested that I take the Magic Knights Entrance Exam.\Oh? Looks like you've improved a bit.\W-Well, I'm getting the hang of using my grimoire.\In that case, why don't you try taking the Magic Knights Entrance Exam?\Huh?\M-Me? Take the entrance exam? response:	You've got skill.
context: had enough magical power that he aspired to be a Magic Knight when he was younger.\He's the one who suggested that I take the Magic Knights Entrance Exam.\Oh? Looks like you've improved a bit.\W-Well, I'm getting the hang of using my grimoire.\In that case, why don't you try taking the Magic Knights Entrance Exam?\Huh?\M-Me? Take the entrance exam?\You've got skill. response:	There's... no way that'll happen. I'm a commoner from the boonies.
context: He's the one who suggested that I take the Magic Knights Entrance Exam.\Oh? Looks like you've improved a bit.\W-Well, I'm getting the hang of using my grimoire.\In that case, why don't you try taking the Magic Knights Entrance Exam?\Huh?\M-Me? Take the entrance exam?\You've got skill.\There's... no way that'll happen. I'm a commoner from the boonies. response:	Nothing's written in stone!
context: Oh? Looks like you've improved a bit.\W-Well, I'm getting the hang of using my grimoire.\In that case, why don't you try taking the Magic Knights Entrance Exam?\Huh?\M-Me? Take the entrance exam?\You've got skill.\There's... no way that'll happen. I'm a commoner from the boonies.\Nothing's written in stone! response:	What does being from the boonies or being a commoner have to do with anything?
context: W-Well, I'm getting the hang of using my grimoire.\In that case, why don't you try taking the Magic Knights Entrance Exam?\Huh?\M-Me? Take the entrance exam?\You've got skill.\There's... no way that'll happen. I'm a commoner from the boonies.\Nothing's written in stone!\What does being from the boonies or being a commoner have to do with anything? response:	It's up to you to take hold of your own future.
context: In that case, why don't you try taking the Magic Knights Entrance Exam?\Huh?\M-Me? Take the entrance exam?\You've got skill.\There's... no way that'll happen. I'm a commoner from the boonies.\Nothing's written in stone!\What does being from the boonies or being a commoner have to do with anything?\It's up to you to take hold of your own future. response:	I'm sure you'll be able to fulfill the dream I couldn't.
context: Huh?\M-Me? Take the entrance exam?\You've got skill.\There's... no way that'll happen. I'm a commoner from the boonies.\Nothing's written in stone!\What does being from the boonies or being a commoner have to do with anything?\It's up to you to take hold of your own future.\I'm sure you'll be able to fulfill the dream I couldn't. response:	Old Man...
context: M-Me? Take the entrance exam?\You've got skill.\There's... no way that'll happen. I'm a commoner from the boonies.\Nothing's written in stone!\What does being from the boonies or being a commoner have to do with anything?\It's up to you to take hold of your own future.\I'm sure you'll be able to fulfill the dream I couldn't.\Old Man... response:	Be a man, Magna.
context: You've got skill.\There's... no way that'll happen. I'm a commoner from the boonies.\Nothing's written in stone!\What does being from the boonies or being a commoner have to do with anything?\It's up to you to take hold of your own future.\I'm sure you'll be able to fulfill the dream I couldn't.\Old Man...\Be a man, Magna. response:	So what do Magic Knights do, anyway?
context: There's... no way that'll happen. I'm a commoner from the boonies.\Nothing's written in stone!\What does being from the boonies or being a commoner have to do with anything?\It's up to you to take hold of your own future.\I'm sure you'll be able to fulfill the dream I couldn't.\Old Man...\Be a man, Magna.\So what do Magic Knights do, anyway? response:	You don't even know that?!
context: Nothing's written in stone!\What does being from the boonies or being a commoner have to do with anything?\It's up to you to take hold of your own future.\I'm sure you'll be able to fulfill the dream I couldn't.\Old Man...\Be a man, Magna.\So what do Magic Knights do, anyway?\You don't even know that?! response:	It's all because of him that I'm here right now.
context: What does being from the boonies or being a commoner have to do with anything?\It's up to you to take hold of your own future.\I'm sure you'll be able to fulfill the dream I couldn't.\Old Man...\Be a man, Magna.\So what do Magic Knights do, anyway?\You don't even know that?!\It's all because of him that I'm here right now. response:	When I passed the Magic Knights Entrance Exam, he was happier for me than anyone.
context: It's up to you to take hold of your own future.\I'm sure you'll be able to fulfill the dream I couldn't.\Old Man...\Be a man, Magna.\So what do Magic Knights do, anyway?\You don't even know that?!\It's all because of him that I'm here right now.\When I passed the Magic Knights Entrance Exam, he was happier for me than anyone. response:	He must be a nice person.
context: I'm sure you'll be able to fulfill the dream I couldn't.\Old Man...\Be a man, Magna.\So what do Magic Knights do, anyway?\You don't even know that?!\It's all because of him that I'm here right now.\When I passed the Magic Knights Entrance Exam, he was happier for me than anyone.\He must be a nice person. response:	Yeah.
context: Old Man...\Be a man, Magna.\So what do Magic Knights do, anyway?\You don't even know that?!\It's all because of him that I'm here right now.\When I passed the Magic Knights Entrance Exam, he was happier for me than anyone.\He must be a nice person.\Yeah. response:	And he went to the royal capital...
context: Be a man, Magna.\So what do Magic Knights do, anyway?\You don't even know that?!\It's all because of him that I'm here right now.\When I passed the Magic Knights Entrance Exam, he was happier for me than anyone.\He must be a nice person.\Yeah.\And he went to the royal capital... response:	well, to get rich quick so he could make some money for his village,
context: So what do Magic Knights do, anyway?\You don't even know that?!\It's all because of him that I'm here right now.\When I passed the Magic Knights Entrance Exam, he was happier for me than anyone.\He must be a nice person.\Yeah.\And he went to the royal capital...\well, to get rich quick so he could make some money for his village, response:	but I think he also came to see me.
context: You don't even know that?!\It's all because of him that I'm here right now.\When I passed the Magic Knights Entrance Exam, he was happier for me than anyone.\He must be a nice person.\Yeah.\And he went to the royal capital...\well, to get rich quick so he could make some money for his village,\but I think he also came to see me. response:	He did take me for every bit of change I had, though!
context: It's all because of him that I'm here right now.\When I passed the Magic Knights Entrance Exam, he was happier for me than anyone.\He must be a nice person.\Yeah.\And he went to the royal capital...\well, to get rich quick so he could make some money for his village,\but I think he also came to see me.\He did take me for every bit of change I had, though! response:	But he's the one who showed me what a real man should be.
context: When I passed the Magic Knights Entrance Exam, he was happier for me than anyone.\He must be a nice person.\Yeah.\And he went to the royal capital...\well, to get rich quick so he could make some money for his village,\but I think he also came to see me.\He did take me for every bit of change I had, though!\But he's the one who showed me what a real man should be. response:	I wanted to be like him, the person I respect most after Mister Yami...
context: He must be a nice person.\Yeah.\And he went to the royal capital...\well, to get rich quick so he could make some money for his village,\but I think he also came to see me.\He did take me for every bit of change I had, though!\But he's the one who showed me what a real man should be.\I wanted to be like him, the person I respect most after Mister Yami... response:	Magna?
context: Yeah.\And he went to the royal capital...\well, to get rich quick so he could make some money for his village,\but I think he also came to see me.\He did take me for every bit of change I had, though!\But he's the one who showed me what a real man should be.\I wanted to be like him, the person I respect most after Mister Yami...\Magna? response:	The hell is that?!
context: And he went to the royal capital...\well, to get rich quick so he could make some money for his village,\but I think he also came to see me.\He did take me for every bit of change I had, though!\But he's the one who showed me what a real man should be.\I wanted to be like him, the person I respect most after Mister Yami...\Magna?\The hell is that?! response:	The village...
context: well, to get rich quick so he could make some money for his village,\but I think he also came to see me.\He did take me for every bit of change I had, though!\But he's the one who showed me what a real man should be.\I wanted to be like him, the person I respect most after Mister Yami...\Magna?\The hell is that?!\The village... response:	It's covered in mist.
context: but I think he also came to see me.\He did take me for every bit of change I had, though!\But he's the one who showed me what a real man should be.\I wanted to be like him, the person I respect most after Mister Yami...\Magna?\The hell is that?!\The village...\It's covered in mist. response:	Wow, the weather sucks in that town.
context: He did take me for every bit of change I had, though!\But he's the one who showed me what a real man should be.\I wanted to be like him, the person I respect most after Mister Yami...\Magna?\The hell is that?!\The village...\It's covered in mist.\Wow, the weather sucks in that town. response:	You idiot! That's magic.
context: But he's the one who showed me what a real man should be.\I wanted to be like him, the person I respect most after Mister Yami...\Magna?\The hell is that?!\The village...\It's covered in mist.\Wow, the weather sucks in that town.\You idiot! That's magic. response:	What?!
context: I wanted to be like him, the person I respect most after Mister Yami...\Magna?\The hell is that?!\The village...\It's covered in mist.\Wow, the weather sucks in that town.\You idiot! That's magic.\What?! response:	Saussy Village
context: Magna?\The hell is that?!\The village...\It's covered in mist.\Wow, the weather sucks in that town.\You idiot! That's magic.\What?!\Saussy Village response:	A magical mist?
context: The hell is that?!\The village...\It's covered in mist.\Wow, the weather sucks in that town.\You idiot! That's magic.\What?!\Saussy Village\A magical mist? response:	Once we enter it, we probably won't be able to get anywhere.
context: The village...\It's covered in mist.\Wow, the weather sucks in that town.\You idiot! That's magic.\What?!\Saussy Village\A magical mist?\Once we enter it, we probably won't be able to get anywhere. response:	We'll lose our sense of direction and end up wandering around in the mist.
context: It's covered in mist.\Wow, the weather sucks in that town.\You idiot! That's magic.\What?!\Saussy Village\A magical mist?\Once we enter it, we probably won't be able to get anywhere.\We'll lose our sense of direction and end up wandering around in the mist. response:	Magic that can cover a whole village...
context: Wow, the weather sucks in that town.\You idiot! That's magic.\What?!\Saussy Village\A magical mist?\Once we enter it, we probably won't be able to get anywhere.\We'll lose our sense of direction and end up wandering around in the mist.\Magic that can cover a whole village... response:	None of the villagers have magic this strong.
context: You idiot! That's magic.\What?!\Saussy Village\A magical mist?\Once we enter it, we probably won't be able to get anywhere.\We'll lose our sense of direction and end up wandering around in the mist.\Magic that can cover a whole village...\None of the villagers have magic this strong. response:	Of course, this isn't Old Man Seihi's magic, either.
context: What?!\Saussy Village\A magical mist?\Once we enter it, we probably won't be able to get anywhere.\We'll lose our sense of direction and end up wandering around in the mist.\Magic that can cover a whole village...\None of the villagers have magic this strong.\Of course, this isn't Old Man Seihi's magic, either. response:	What's going on?
context: Saussy Village\A magical mist?\Once we enter it, we probably won't be able to get anywhere.\We'll lose our sense of direction and end up wandering around in the mist.\Magic that can cover a whole village...\None of the villagers have magic this strong.\Of course, this isn't Old Man Seihi's magic, either.\What's going on? response:	Hey!
context: A magical mist?\Once we enter it, we probably won't be able to get anywhere.\We'll lose our sense of direction and end up wandering around in the mist.\Magic that can cover a whole village...\None of the villagers have magic this strong.\Of course, this isn't Old Man Seihi's magic, either.\What's going on?\Hey! response:	Yes, sir?
context: Once we enter it, we probably won't be able to get anywhere.\We'll lose our sense of direction and end up wandering around in the mist.\Magic that can cover a whole village...\None of the villagers have magic this strong.\Of course, this isn't Old Man Seihi's magic, either.\What's going on?\Hey!\Yes, sir? response:	Cut through the mist with your sword.
context: We'll lose our sense of direction and end up wandering around in the mist.\Magic that can cover a whole village...\None of the villagers have magic this strong.\Of course, this isn't Old Man Seihi's magic, either.\What's going on?\Hey!\Yes, sir?\Cut through the mist with your sword. response:	Sure thing!
context: Magic that can cover a whole village...\None of the villagers have magic this strong.\Of course, this isn't Old Man Seihi's magic, either.\What's going on?\Hey!\Yes, sir?\Cut through the mist with your sword.\Sure thing! response:	Huh?
context: None of the villagers have magic this strong.\Of course, this isn't Old Man Seihi's magic, either.\What's going on?\Hey!\Yes, sir?\Cut through the mist with your sword.\Sure thing!\Huh? response:	That's a dumb thing to say. You can't cut through mist with a sword.
context: Of course, this isn't Old Man Seihi's magic, either.\What's going on?\Hey!\Yes, sir?\Cut through the mist with your sword.\Sure thing!\Huh?\That's a dumb thing to say. You can't cut through mist with a sword. response:	You're the dumb one!
context: What's going on?\Hey!\Yes, sir?\Cut through the mist with your sword.\Sure thing!\Huh?\That's a dumb thing to say. You can't cut through mist with a sword.\You're the dumb one! response:	Since it's magic, you can cut through it with your sword!
context: Hey!\Yes, sir?\Cut through the mist with your sword.\Sure thing!\Huh?\That's a dumb thing to say. You can't cut through mist with a sword.\You're the dumb one!\Since it's magic, you can cut through it with your sword! response:	Oh, yeah!
context: Yes, sir?\Cut through the mist with your sword.\Sure thing!\Huh?\That's a dumb thing to say. You can't cut through mist with a sword.\You're the dumb one!\Since it's magic, you can cut through it with your sword!\Oh, yeah! response:	Good. Now, let's go.
context: Cut through the mist with your sword.\Sure thing!\Huh?\That's a dumb thing to say. You can't cut through mist with a sword.\You're the dumb one!\Since it's magic, you can cut through it with your sword!\Oh, yeah!\Good. Now, let's go. response:	Right!
context: Sure thing!\Huh?\That's a dumb thing to say. You can't cut through mist with a sword.\You're the dumb one!\Since it's magic, you can cut through it with your sword!\Oh, yeah!\Good. Now, let's go.\Right! response:	Take a right there.
context: Huh?\That's a dumb thing to say. You can't cut through mist with a sword.\You're the dumb one!\Since it's magic, you can cut through it with your sword!\Oh, yeah!\Good. Now, let's go.\Right!\Take a right there. response:	Got it!
context: That's a dumb thing to say. You can't cut through mist with a sword.\You're the dumb one!\Since it's magic, you can cut through it with your sword!\Oh, yeah!\Good. Now, let's go.\Right!\Take a right there.\Got it! response:	Take a left there.
context: You're the dumb one!\Since it's magic, you can cut through it with your sword!\Oh, yeah!\Good. Now, let's go.\Right!\Take a right there.\Got it!\Take a left there. response:	Right!
context: Since it's magic, you can cut through it with your sword!\Oh, yeah!\Good. Now, let's go.\Right!\Take a right there.\Got it!\Take a left there.\Right! response:	You seem to know where you're going.
context: Oh, yeah!\Good. Now, let's go.\Right!\Take a right there.\Got it!\Take a left there.\Right!\You seem to know where you're going. response:	Well, yeah. Left.
context: Good. Now, let's go.\Right!\Take a right there.\Got it!\Take a left there.\Right!\You seem to know where you're going.\Well, yeah. Left. response:	Did you feel that?
context: Right!\Take a right there.\Got it!\Take a left there.\Right!\You seem to know where you're going.\Well, yeah. Left.\Did you feel that? response:	Yes. Powerful magic.
context: Take a right there.\Got it!\Take a left there.\Right!\You seem to know where you're going.\Well, yeah. Left.\Did you feel that?\Yes. Powerful magic. response:	Straight ahead. Be careful.
context: Got it!\Take a left there.\Right!\You seem to know where you're going.\Well, yeah. Left.\Did you feel that?\Yes. Powerful magic.\Straight ahead. Be careful. response:	We should end up in the square.
context: Take a left there.\Right!\You seem to know where you're going.\Well, yeah. Left.\Did you feel that?\Yes. Powerful magic.\Straight ahead. Be careful.\We should end up in the square. response:	This is your execution.
context: Right!\You seem to know where you're going.\Well, yeah. Left.\Did you feel that?\Yes. Powerful magic.\Straight ahead. Be careful.\We should end up in the square.\This is your execution. response:	Explosive Scattershot!
context: You seem to know where you're going.\Well, yeah. Left.\Did you feel that?\Yes. Powerful magic.\Straight ahead. Be careful.\We should end up in the square.\This is your execution.\Explosive Scattershot! response:	The Magic Knights...
context: Well, yeah. Left.\Did you feel that?\Yes. Powerful magic.\Straight ahead. Be careful.\We should end up in the square.\This is your execution.\Explosive Scattershot!\The Magic Knights... response:	They've come to save us!
context: Did you feel that?\Yes. Powerful magic.\Straight ahead. Be careful.\We should end up in the square.\This is your execution.\Explosive Scattershot!\The Magic Knights...\They've come to save us! response:	Magna, it's you!
context: Yes. Powerful magic.\Straight ahead. Be careful.\We should end up in the square.\This is your execution.\Explosive Scattershot!\The Magic Knights...\They've come to save us!\Magna, it's you! response:	Nick! What the heck's going on?
context: Straight ahead. Be careful.\We should end up in the square.\This is your execution.\Explosive Scattershot!\The Magic Knights...\They've come to save us!\Magna, it's you!\Nick! What the heck's going on? response:	Old Man!
context: We should end up in the square.\This is your execution.\Explosive Scattershot!\The Magic Knights...\They've come to save us!\Magna, it's you!\Nick! What the heck's going on?\Old Man! response:	Hey! Wake up!
context: This is your execution.\Explosive Scattershot!\The Magic Knights...\They've come to save us!\Magna, it's you!\Nick! What the heck's going on?\Old Man!\Hey! Wake up! response:	Old Man...
context: Explosive Scattershot!\The Magic Knights...\They've come to save us!\Magna, it's you!\Nick! What the heck's going on?\Old Man!\Hey! Wake up!\Old Man... response:	The mayor...
context: The Magic Knights...\They've come to save us!\Magna, it's you!\Nick! What the heck's going on?\Old Man!\Hey! Wake up!\Old Man...\The mayor... response:	He tried to protect us.
context: They've come to save us!\Magna, it's you!\Nick! What the heck's going on?\Old Man!\Hey! Wake up!\Old Man...\The mayor...\He tried to protect us. response:	Grandpa, they came. The Magic Knights...
context: Magna, it's you!\Nick! What the heck's going on?\Old Man!\Hey! Wake up!\Old Man...\The mayor...\He tried to protect us.\Grandpa, they came. The Magic Knights... response:	Your prayers were answered.
context: Nick! What the heck's going on?\Old Man!\Hey! Wake up!\Old Man...\The mayor...\He tried to protect us.\Grandpa, they came. The Magic Knights...\Your prayers were answered. response:	A person can just die... so easily?
context: Old Man!\Hey! Wake up!\Old Man...\The mayor...\He tried to protect us.\Grandpa, they came. The Magic Knights...\Your prayers were answered.\A person can just die... so easily? response:	Are you the bastard who did this?!
context: Hey! Wake up!\Old Man...\The mayor...\He tried to protect us.\Grandpa, they came. The Magic Knights...\Your prayers were answered.\A person can just die... so easily?\Are you the bastard who did this?! response:	How dare you put me behind schedule?
context: Old Man...\The mayor...\He tried to protect us.\Grandpa, they came. The Magic Knights...\Your prayers were answered.\A person can just die... so easily?\Are you the bastard who did this?!\How dare you put me behind schedule? response:	You'll all be executed in ten seconds.
context: The mayor...\He tried to protect us.\Grandpa, they came. The Magic Knights...\Your prayers were answered.\A person can just die... so easily?\Are you the bastard who did this?!\How dare you put me behind schedule?\You'll all be executed in ten seconds. response:	Crap! I'm short on magic!
context: He tried to protect us.\Grandpa, they came. The Magic Knights...\Your prayers were answered.\A person can just die... so easily?\Are you the bastard who did this?!\How dare you put me behind schedule?\You'll all be executed in ten seconds.\Crap! I'm short on magic! response:	Asta!
context: Grandpa, they came. The Magic Knights...\Your prayers were answered.\A person can just die... so easily?\Are you the bastard who did this?!\How dare you put me behind schedule?\You'll all be executed in ten seconds.\Crap! I'm short on magic!\Asta! response:	I won't forgive this!
context: Your prayers were answered.\A person can just die... so easily?\Are you the bastard who did this?!\How dare you put me behind schedule?\You'll all be executed in ten seconds.\Crap! I'm short on magic!\Asta!\I won't forgive this! response:	How could you do something so cruel?
context: A person can just die... so easily?\Are you the bastard who did this?!\How dare you put me behind schedule?\You'll all be executed in ten seconds.\Crap! I'm short on magic!\Asta!\I won't forgive this!\How could you do something so cruel? response:	Who the heck are you guys?!
context: Are you the bastard who did this?!\How dare you put me behind schedule?\You'll all be executed in ten seconds.\Crap! I'm short on magic!\Asta!\I won't forgive this!\How could you do something so cruel?\Who the heck are you guys?! response:	They don't seem like spies from the Diamond Kingdom
context: How dare you put me behind schedule?\You'll all be executed in ten seconds.\Crap! I'm short on magic!\Asta!\I won't forgive this!\How could you do something so cruel?\Who the heck are you guys?!\They don't seem like spies from the Diamond Kingdom response:	or barbarians here to trash the village.
context: You'll all be executed in ten seconds.\Crap! I'm short on magic!\Asta!\I won't forgive this!\How could you do something so cruel?\Who the heck are you guys?!\They don't seem like spies from the Diamond Kingdom\or barbarians here to trash the village. response:	Who are these guys?
context: Crap! I'm short on magic!\Asta!\I won't forgive this!\How could you do something so cruel?\Who the heck are you guys?!\They don't seem like spies from the Diamond Kingdom\or barbarians here to trash the village.\Who are these guys? response:	I don't recall hearing anything about Magic Knights showing up.
context: Asta!\I won't forgive this!\How could you do something so cruel?\Who the heck are you guys?!\They don't seem like spies from the Diamond Kingdom\or barbarians here to trash the village.\Who are these guys?\I don't recall hearing anything about Magic Knights showing up. response:	Could they be out on some unofficial mission?
context: I won't forgive this!\How could you do something so cruel?\Who the heck are you guys?!\They don't seem like spies from the Diamond Kingdom\or barbarians here to trash the village.\Who are these guys?\I don't recall hearing anything about Magic Knights showing up.\Could they be out on some unofficial mission? response:	And how did they get into the village through our mist barrier?
context: How could you do something so cruel?\Who the heck are you guys?!\They don't seem like spies from the Diamond Kingdom\or barbarians here to trash the village.\Who are these guys?\I don't recall hearing anything about Magic Knights showing up.\Could they be out on some unofficial mission?\And how did they get into the village through our mist barrier? response:	The Black Bulls...
context: Who the heck are you guys?!\They don't seem like spies from the Diamond Kingdom\or barbarians here to trash the village.\Who are these guys?\I don't recall hearing anything about Magic Knights showing up.\Could they be out on some unofficial mission?\And how did they get into the village through our mist barrier?\The Black Bulls... response:	Crude heretics that don't fit in with the rest of the Magic Knights.
context: They don't seem like spies from the Diamond Kingdom\or barbarians here to trash the village.\Who are these guys?\I don't recall hearing anything about Magic Knights showing up.\Could they be out on some unofficial mission?\And how did they get into the village through our mist barrier?\The Black Bulls...\Crude heretics that don't fit in with the rest of the Magic Knights. response:	Dealing with them would be a waste of time.
context: or barbarians here to trash the village.\Who are these guys?\I don't recall hearing anything about Magic Knights showing up.\Could they be out on some unofficial mission?\And how did they get into the village through our mist barrier?\The Black Bulls...\Crude heretics that don't fit in with the rest of the Magic Knights.\Dealing with them would be a waste of time. response:	Five minutes...
context: Who are these guys?\I don't recall hearing anything about Magic Knights showing up.\Could they be out on some unofficial mission?\And how did they get into the village through our mist barrier?\The Black Bulls...\Crude heretics that don't fit in with the rest of the Magic Knights.\Dealing with them would be a waste of time.\Five minutes... response:	We'll get rid of the useless villagers that didn't know anything
context: I don't recall hearing anything about Magic Knights showing up.\Could they be out on some unofficial mission?\And how did they get into the village through our mist barrier?\The Black Bulls...\Crude heretics that don't fit in with the rest of the Magic Knights.\Dealing with them would be a waste of time.\Five minutes...\We'll get rid of the useless villagers that didn't know anything response:	and seek what we came here for.
context: Could they be out on some unofficial mission?\And how did they get into the village through our mist barrier?\The Black Bulls...\Crude heretics that don't fit in with the rest of the Magic Knights.\Dealing with them would be a waste of time.\Five minutes...\We'll get rid of the useless villagers that didn't know anything\and seek what we came here for. response:	Don't ignore me!
context: And how did they get into the village through our mist barrier?\The Black Bulls...\Crude heretics that don't fit in with the rest of the Magic Knights.\Dealing with them would be a waste of time.\Five minutes...\We'll get rid of the useless villagers that didn't know anything\and seek what we came here for.\Don't ignore me! response:	Mist Magic: Whirlpool of Illusory Mist.
context: The Black Bulls...\Crude heretics that don't fit in with the rest of the Magic Knights.\Dealing with them would be a waste of time.\Five minutes...\We'll get rid of the useless villagers that didn't know anything\and seek what we came here for.\Don't ignore me!\Mist Magic: Whirlpool of Illusory Mist. response:	You're a fool to think you could get near Lord Heath so easily.
context: Crude heretics that don't fit in with the rest of the Magic Knights.\Dealing with them would be a waste of time.\Five minutes...\We'll get rid of the useless villagers that didn't know anything\and seek what we came here for.\Don't ignore me!\Mist Magic: Whirlpool of Illusory Mist.\You're a fool to think you could get near Lord Heath so easily. response:	Damn you!
context: Dealing with them would be a waste of time.\Five minutes...\We'll get rid of the useless villagers that didn't know anything\and seek what we came here for.\Don't ignore me!\Mist Magic: Whirlpool of Illusory Mist.\You're a fool to think you could get near Lord Heath so easily.\Damn you! response:	Be lost in the mist.
context: Five minutes...\We'll get rid of the useless villagers that didn't know anything\and seek what we came here for.\Don't ignore me!\Mist Magic: Whirlpool of Illusory Mist.\You're a fool to think you could get near Lord Heath so easily.\Damn you!\Be lost in the mist. response:	No, I won't!
context: We'll get rid of the useless villagers that didn't know anything\and seek what we came here for.\Don't ignore me!\Mist Magic: Whirlpool of Illusory Mist.\You're a fool to think you could get near Lord Heath so easily.\Damn you!\Be lost in the mist.\No, I won't! response:	He cut through my ice magic earlier. I don't know what kind of magic he uses...
context: and seek what we came here for.\Don't ignore me!\Mist Magic: Whirlpool of Illusory Mist.\You're a fool to think you could get near Lord Heath so easily.\Damn you!\Be lost in the mist.\No, I won't!\He cut through my ice magic earlier. I don't know what kind of magic he uses... response:	But his sword negates magic.
context: Don't ignore me!\Mist Magic: Whirlpool of Illusory Mist.\You're a fool to think you could get near Lord Heath so easily.\Damn you!\Be lost in the mist.\No, I won't!\He cut through my ice magic earlier. I don't know what kind of magic he uses...\But his sword negates magic. response:	We shouldn't let him get too close.
context: Mist Magic: Whirlpool of Illusory Mist.\You're a fool to think you could get near Lord Heath so easily.\Damn you!\Be lost in the mist.\No, I won't!\He cut through my ice magic earlier. I don't know what kind of magic he uses...\But his sword negates magic.\We shouldn't let him get too close. response:	I'm asking you why you tried to kill all these villagers!
context: You're a fool to think you could get near Lord Heath so easily.\Damn you!\Be lost in the mist.\No, I won't!\He cut through my ice magic earlier. I don't know what kind of magic he uses...\But his sword negates magic.\We shouldn't let him get too close.\I'm asking you why you tried to kill all these villagers! response:	This world is split into several regions.
context: Damn you!\Be lost in the mist.\No, I won't!\He cut through my ice magic earlier. I don't know what kind of magic he uses...\But his sword negates magic.\We shouldn't let him get too close.\I'm asking you why you tried to kill all these villagers!\This world is split into several regions. response:	Forsaken Realm
context: Be lost in the mist.\No, I won't!\He cut through my ice magic earlier. I don't know what kind of magic he uses...\But his sword negates magic.\We shouldn't let him get too close.\I'm asking you why you tried to kill all these villagers!\This world is split into several regions.\Forsaken Realm response:	Common Realm
context: No, I won't!\He cut through my ice magic earlier. I don't know what kind of magic he uses...\But his sword negates magic.\We shouldn't let him get too close.\I'm asking you why you tried to kill all these villagers!\This world is split into several regions.\Forsaken Realm\Common Realm response:	Noble Realm
context: He cut through my ice magic earlier. I don't know what kind of magic he uses...\But his sword negates magic.\We shouldn't let him get too close.\I'm asking you why you tried to kill all these villagers!\This world is split into several regions.\Forsaken Realm\Common Realm\Noble Realm response:	Diamond Kingdom
context: But his sword negates magic.\We shouldn't let him get too close.\I'm asking you why you tried to kill all these villagers!\This world is split into several regions.\Forsaken Realm\Common Realm\Noble Realm\Diamond Kingdom response:	Heart Kingdom
context: We shouldn't let him get too close.\I'm asking you why you tried to kill all these villagers!\This world is split into several regions.\Forsaken Realm\Common Realm\Noble Realm\Diamond Kingdom\Heart Kingdom response:	Saussy
context: I'm asking you why you tried to kill all these villagers!\This world is split into several regions.\Forsaken Realm\Common Realm\Noble Realm\Diamond Kingdom\Heart Kingdom\Saussy response:	Rayaka
context: This world is split into several regions.\Forsaken Realm\Common Realm\Noble Realm\Diamond Kingdom\Heart Kingdom\Saussy\Rayaka response:	The Noble Realm where royalty lives, the Common Realm where the commoners live,
context: Forsaken Realm\Common Realm\Noble Realm\Diamond Kingdom\Heart Kingdom\Saussy\Rayaka\The Noble Realm where royalty lives, the Common Realm where the commoners live, response:	Spade Kingdom
context: Common Realm\Noble Realm\Diamond Kingdom\Heart Kingdom\Saussy\Rayaka\The Noble Realm where royalty lives, the Common Realm where the commoners live,\Spade Kingdom response:	and the Forsaken Realm.
context: Noble Realm\Diamond Kingdom\Heart Kingdom\Saussy\Rayaka\The Noble Realm where royalty lives, the Common Realm where the commoners live,\Spade Kingdom\and the Forsaken Realm. response:	Huh?
context: Diamond Kingdom\Heart Kingdom\Saussy\Rayaka\The Noble Realm where royalty lives, the Common Realm where the commoners live,\Spade Kingdom\and the Forsaken Realm.\Huh? response:	This village, Saussy, is located in the Forsaken Realm.
context: Heart Kingdom\Saussy\Rayaka\The Noble Realm where royalty lives, the Common Realm where the commoners live,\Spade Kingdom\and the Forsaken Realm.\Huh?\This village, Saussy, is located in the Forsaken Realm. response:	Most of those who inhabit the Forsaken Realm are
context: Saussy\Rayaka\The Noble Realm where royalty lives, the Common Realm where the commoners live,\Spade Kingdom\and the Forsaken Realm.\Huh?\This village, Saussy, is located in the Forsaken Realm.\Most of those who inhabit the Forsaken Realm are response:	an inferior race that can only use enough magic to complete daily tasks.
context: Rayaka\The Noble Realm where royalty lives, the Common Realm where the commoners live,\Spade Kingdom\and the Forsaken Realm.\Huh?\This village, Saussy, is located in the Forsaken Realm.\Most of those who inhabit the Forsaken Realm are\an inferior race that can only use enough magic to complete daily tasks. response:	They're basically mindless beasts.
context: The Noble Realm where royalty lives, the Common Realm where the commoners live,\Spade Kingdom\and the Forsaken Realm.\Huh?\This village, Saussy, is located in the Forsaken Realm.\Most of those who inhabit the Forsaken Realm are\an inferior race that can only use enough magic to complete daily tasks.\They're basically mindless beasts. response:	I was only trying to get rid of the mindless beasts
context: Spade Kingdom\and the Forsaken Realm.\Huh?\This village, Saussy, is located in the Forsaken Realm.\Most of those who inhabit the Forsaken Realm are\an inferior race that can only use enough magic to complete daily tasks.\They're basically mindless beasts.\I was only trying to get rid of the mindless beasts response:	that might steal more of my precious time.
context: and the Forsaken Realm.\Huh?\This village, Saussy, is located in the Forsaken Realm.\Most of those who inhabit the Forsaken Realm are\an inferior race that can only use enough magic to complete daily tasks.\They're basically mindless beasts.\I was only trying to get rid of the mindless beasts\that might steal more of my precious time. response:	Beasts?
context: Huh?\This village, Saussy, is located in the Forsaken Realm.\Most of those who inhabit the Forsaken Realm are\an inferior race that can only use enough magic to complete daily tasks.\They're basically mindless beasts.\I was only trying to get rid of the mindless beasts\that might steal more of my precious time.\Beasts? response:	The three of you
context: This village, Saussy, is located in the Forsaken Realm.\Most of those who inhabit the Forsaken Realm are\an inferior race that can only use enough magic to complete daily tasks.\They're basically mindless beasts.\I was only trying to get rid of the mindless beasts\that might steal more of my precious time.\Beasts?\The three of you response:	also had enough magical power to join the Magic Knights, did you not?
context: Most of those who inhabit the Forsaken Realm are\an inferior race that can only use enough magic to complete daily tasks.\They're basically mindless beasts.\I was only trying to get rid of the mindless beasts\that might steal more of my precious time.\Beasts?\The three of you\also had enough magical power to join the Magic Knights, did you not? response:	You're only trying to save them because it's your mission.
context: an inferior race that can only use enough magic to complete daily tasks.\They're basically mindless beasts.\I was only trying to get rid of the mindless beasts\that might steal more of my precious time.\Beasts?\The three of you\also had enough magical power to join the Magic Knights, did you not?\You're only trying to save them because it's your mission. response:	But in truth, they look like lowly beasts to you, do they not?
context: They're basically mindless beasts.\I was only trying to get rid of the mindless beasts\that might steal more of my precious time.\Beasts?\The three of you\also had enough magical power to join the Magic Knights, did you not?\You're only trying to save them because it's your mission.\But in truth, they look like lowly beasts to you, do they not? response:	Living in the upper realms must be nice.
context: I was only trying to get rid of the mindless beasts\that might steal more of my precious time.\Beasts?\The three of you\also had enough magical power to join the Magic Knights, did you not?\You're only trying to save them because it's your mission.\But in truth, they look like lowly beasts to you, do they not?\Living in the upper realms must be nice. response:	I'm sure they're living a life of luxury.
context: that might steal more of my precious time.\Beasts?\The three of you\also had enough magical power to join the Magic Knights, did you not?\You're only trying to save them because it's your mission.\But in truth, they look like lowly beasts to you, do they not?\Living in the upper realms must be nice.\I'm sure they're living a life of luxury. response:	If you're so jealous, you should just go there.
context: Beasts?\The three of you\also had enough magical power to join the Magic Knights, did you not?\You're only trying to save them because it's your mission.\But in truth, they look like lowly beasts to you, do they not?\Living in the upper realms must be nice.\I'm sure they're living a life of luxury.\If you're so jealous, you should just go there. response:	It's not that easy.
context: The three of you\also had enough magical power to join the Magic Knights, did you not?\You're only trying to save them because it's your mission.\But in truth, they look like lowly beasts to you, do they not?\Living in the upper realms must be nice.\I'm sure they're living a life of luxury.\If you're so jealous, you should just go there.\It's not that easy. response:	Why not?
context: also had enough magical power to join the Magic Knights, did you not?\You're only trying to save them because it's your mission.\But in truth, they look like lowly beasts to you, do they not?\Living in the upper realms must be nice.\I'm sure they're living a life of luxury.\If you're so jealous, you should just go there.\It's not that easy.\Why not? response:	Only those who possess strong magical powers can live in the realms above us.
context: You're only trying to save them because it's your mission.\But in truth, they look like lowly beasts to you, do they not?\Living in the upper realms must be nice.\I'm sure they're living a life of luxury.\If you're so jealous, you should just go there.\It's not that easy.\Why not?\Only those who possess strong magical powers can live in the realms above us. response:	There's prejudice against those who lack magical powers.
context: But in truth, they look like lowly beasts to you, do they not?\Living in the upper realms must be nice.\I'm sure they're living a life of luxury.\If you're so jealous, you should just go there.\It's not that easy.\Why not?\Only those who possess strong magical powers can live in the realms above us.\There's prejudice against those who lack magical powers. response:	Even though we're all human.
context: Living in the upper realms must be nice.\I'm sure they're living a life of luxury.\If you're so jealous, you should just go there.\It's not that easy.\Why not?\Only those who possess strong magical powers can live in the realms above us.\There's prejudice against those who lack magical powers.\Even though we're all human. response:	Huh... Then after I join the Magic Knights and become the Wizard King,
context: I'm sure they're living a life of luxury.\If you're so jealous, you should just go there.\It's not that easy.\Why not?\Only those who possess strong magical powers can live in the realms above us.\There's prejudice against those who lack magical powers.\Even though we're all human.\Huh... Then after I join the Magic Knights and become the Wizard King, response:	I'll get rid of those prejudices and make our village flourish even more!
context: If you're so jealous, you should just go there.\It's not that easy.\Why not?\Only those who possess strong magical powers can live in the realms above us.\There's prejudice against those who lack magical powers.\Even though we're all human.\Huh... Then after I join the Magic Knights and become the Wizard King,\I'll get rid of those prejudices and make our village flourish even more! response:	Thank you, Asta.
context: It's not that easy.\Why not?\Only those who possess strong magical powers can live in the realms above us.\There's prejudice against those who lack magical powers.\Even though we're all human.\Huh... Then after I join the Magic Knights and become the Wizard King,\I'll get rid of those prejudices and make our village flourish even more!\Thank you, Asta. response:	If the likes of you could manage that, we wouldn't be struggling.
context: Why not?\Only those who possess strong magical powers can live in the realms above us.\There's prejudice against those who lack magical powers.\Even though we're all human.\Huh... Then after I join the Magic Knights and become the Wizard King,\I'll get rid of those prejudices and make our village flourish even more!\Thank you, Asta.\If the likes of you could manage that, we wouldn't be struggling. response:	What did you say, you brat?! I'm older than you!
context: Only those who possess strong magical powers can live in the realms above us.\There's prejudice against those who lack magical powers.\Even though we're all human.\Huh... Then after I join the Magic Knights and become the Wizard King,\I'll get rid of those prejudices and make our village flourish even more!\Thank you, Asta.\If the likes of you could manage that, we wouldn't be struggling.\What did you say, you brat?! I'm older than you! response:	You couldn't even join the Magic Knights, let alone become the Wizard King.
context: There's prejudice against those who lack magical powers.\Even though we're all human.\Huh... Then after I join the Magic Knights and become the Wizard King,\I'll get rid of those prejudices and make our village flourish even more!\Thank you, Asta.\If the likes of you could manage that, we wouldn't be struggling.\What did you say, you brat?! I'm older than you!\You couldn't even join the Magic Knights, let alone become the Wizard King. response:	You don't even have any magical powers.
context: Even though we're all human.\Huh... Then after I join the Magic Knights and become the Wizard King,\I'll get rid of those prejudices and make our village flourish even more!\Thank you, Asta.\If the likes of you could manage that, we wouldn't be struggling.\What did you say, you brat?! I'm older than you!\You couldn't even join the Magic Knights, let alone become the Wizard King.\You don't even have any magical powers. response:	Hey!
context: Huh... Then after I join the Magic Knights and become the Wizard King,\I'll get rid of those prejudices and make our village flourish even more!\Thank you, Asta.\If the likes of you could manage that, we wouldn't be struggling.\What did you say, you brat?! I'm older than you!\You couldn't even join the Magic Knights, let alone become the Wizard King.\You don't even have any magical powers.\Hey! response:	Those people you called beasts
context: I'll get rid of those prejudices and make our village flourish even more!\Thank you, Asta.\If the likes of you could manage that, we wouldn't be struggling.\What did you say, you brat?! I'm older than you!\You couldn't even join the Magic Knights, let alone become the Wizard King.\You don't even have any magical powers.\Hey!\Those people you called beasts response:	are lives I have to protect!
context: Thank you, Asta.\If the likes of you could manage that, we wouldn't be struggling.\What did you say, you brat?! I'm older than you!\You couldn't even join the Magic Knights, let alone become the Wizard King.\You don't even have any magical powers.\Hey!\Those people you called beasts\are lives I have to protect! response:	I see. So the filthy beasts are that valuable to you.
context: If the likes of you could manage that, we wouldn't be struggling.\What did you say, you brat?! I'm older than you!\You couldn't even join the Magic Knights, let alone become the Wizard King.\You don't even have any magical powers.\Hey!\Those people you called beasts\are lives I have to protect!\I see. So the filthy beasts are that valuable to you. response:	I'll send those icicles right back at y
context: What did you say, you brat?! I'm older than you!\You couldn't even join the Magic Knights, let alone become the Wizard King.\You don't even have any magical powers.\Hey!\Those people you called beasts\are lives I have to protect!\I see. So the filthy beasts are that valuable to you.\I'll send those icicles right back at y response:	Th-This is...
context: You couldn't even join the Magic Knights, let alone become the Wizard King.\You don't even have any magical powers.\Hey!\Those people you called beasts\are lives I have to protect!\I see. So the filthy beasts are that valuable to you.\I'll send those icicles right back at y\Th-This is... response:	Ice and Mist Compound Magic: Endless Ice Cage.
context: You don't even have any magical powers.\Hey!\Those people you called beasts\are lives I have to protect!\I see. So the filthy beasts are that valuable to you.\I'll send those icicles right back at y\Th-This is...\Ice and Mist Compound Magic: Endless Ice Cage. response:	Do you think you can protect those beasts now?
context: Hey!\Those people you called beasts\are lives I have to protect!\I see. So the filthy beasts are that valuable to you.\I'll send those icicles right back at y\Th-This is...\Ice and Mist Compound Magic: Endless Ice Cage.\Do you think you can protect those beasts now? response:	I'm not very partial to the term gradually,
context: Those people you called beasts\are lives I have to protect!\I see. So the filthy beasts are that valuable to you.\I'll send those icicles right back at y\Th-This is...\Ice and Mist Compound Magic: Endless Ice Cage.\Do you think you can protect those beasts now?\I'm not very partial to the term gradually, response:	but this seems like it'll be the most effective.
context: are lives I have to protect!\I see. So the filthy beasts are that valuable to you.\I'll send those icicles right back at y\Th-This is...\Ice and Mist Compound Magic: Endless Ice Cage.\Do you think you can protect those beasts now?\I'm not very partial to the term gradually,\but this seems like it'll be the most effective. response:	Asta!
context: I see. So the filthy beasts are that valuable to you.\I'll send those icicles right back at y\Th-This is...\Ice and Mist Compound Magic: Endless Ice Cage.\Do you think you can protect those beasts now?\I'm not very partial to the term gradually,\but this seems like it'll be the most effective.\Asta! response:	Dissolve.
context: I'll send those icicles right back at y\Th-This is...\Ice and Mist Compound Magic: Endless Ice Cage.\Do you think you can protect those beasts now?\I'm not very partial to the term gradually,\but this seems like it'll be the most effective.\Asta!\Dissolve. response:	Not only can you negate magic, you can repel it, as well.
context: Th-This is...\Ice and Mist Compound Magic: Endless Ice Cage.\Do you think you can protect those beasts now?\I'm not very partial to the term gradually,\but this seems like it'll be the most effective.\Asta!\Dissolve.\Not only can you negate magic, you can repel it, as well. response:	But that is not enough to defeat me.
context: Ice and Mist Compound Magic: Endless Ice Cage.\Do you think you can protect those beasts now?\I'm not very partial to the term gradually,\but this seems like it'll be the most effective.\Asta!\Dissolve.\Not only can you negate magic, you can repel it, as well.\But that is not enough to defeat me. response:	The blades of ice will come one after another.
context: Do you think you can protect those beasts now?\I'm not very partial to the term gradually,\but this seems like it'll be the most effective.\Asta!\Dissolve.\Not only can you negate magic, you can repel it, as well.\But that is not enough to defeat me.\The blades of ice will come one after another. response:	Now, just try and protect them.
context: I'm not very partial to the term gradually,\but this seems like it'll be the most effective.\Asta!\Dissolve.\Not only can you negate magic, you can repel it, as well.\But that is not enough to defeat me.\The blades of ice will come one after another.\Now, just try and protect them. response:	Damn you!
context: but this seems like it'll be the most effective.\Asta!\Dissolve.\Not only can you negate magic, you can repel it, as well.\But that is not enough to defeat me.\The blades of ice will come one after another.\Now, just try and protect them.\Damn you! response:	It's going to take everything Asta and I have to protect the villagers.
context: Asta!\Dissolve.\Not only can you negate magic, you can repel it, as well.\But that is not enough to defeat me.\The blades of ice will come one after another.\Now, just try and protect them.\Damn you!\It's going to take everything Asta and I have to protect the villagers. response:	Not to mention, my powers are reaching their limit.
context: Dissolve.\Not only can you negate magic, you can repel it, as well.\But that is not enough to defeat me.\The blades of ice will come one after another.\Now, just try and protect them.\Damn you!\It's going to take everything Asta and I have to protect the villagers.\Not to mention, my powers are reaching their limit. response:	And they have four guys who are at least Magic Knight level.
context: Not only can you negate magic, you can repel it, as well.\But that is not enough to defeat me.\The blades of ice will come one after another.\Now, just try and protect them.\Damn you!\It's going to take everything Asta and I have to protect the villagers.\Not to mention, my powers are reaching their limit.\And they have four guys who are at least Magic Knight level. response:	And that guy's still hiding his true powers!
context: But that is not enough to defeat me.\The blades of ice will come one after another.\Now, just try and protect them.\Damn you!\It's going to take everything Asta and I have to protect the villagers.\Not to mention, my powers are reaching their limit.\And they have four guys who are at least Magic Knight level.\And that guy's still hiding his true powers! response:	This turned out to be one hell of a first mission for those two!
context: The blades of ice will come one after another.\Now, just try and protect them.\Damn you!\It's going to take everything Asta and I have to protect the villagers.\Not to mention, my powers are reaching their limit.\And they have four guys who are at least Magic Knight level.\And that guy's still hiding his true powers!\This turned out to be one hell of a first mission for those two! response:	This isn't good!
context: Now, just try and protect them.\Damn you!\It's going to take everything Asta and I have to protect the villagers.\Not to mention, my powers are reaching their limit.\And they have four guys who are at least Magic Knight level.\And that guy's still hiding his true powers!\This turned out to be one hell of a first mission for those two!\This isn't good! response:	But if I cut and run now, I'm not a real man!
context: Damn you!\It's going to take everything Asta and I have to protect the villagers.\Not to mention, my powers are reaching their limit.\And they have four guys who are at least Magic Knight level.\And that guy's still hiding his true powers!\This turned out to be one hell of a first mission for those two!\This isn't good!\But if I cut and run now, I'm not a real man! response:	It just so happens I'm a lowly commoner myself! I'll protect you!
context: It's going to take everything Asta and I have to protect the villagers.\Not to mention, my powers are reaching their limit.\And they have four guys who are at least Magic Knight level.\And that guy's still hiding his true powers!\This turned out to be one hell of a first mission for those two!\This isn't good!\But if I cut and run now, I'm not a real man!\It just so happens I'm a lowly commoner myself! I'll protect you! response:	Magna!
context: Not to mention, my powers are reaching their limit.\And they have four guys who are at least Magic Knight level.\And that guy's still hiding his true powers!\This turned out to be one hell of a first mission for those two!\This isn't good!\But if I cut and run now, I'm not a real man!\It just so happens I'm a lowly commoner myself! I'll protect you!\Magna! response:	I wonder how long you'll last.
context: And they have four guys who are at least Magic Knight level.\And that guy's still hiding his true powers!\This turned out to be one hell of a first mission for those two!\This isn't good!\But if I cut and run now, I'm not a real man!\It just so happens I'm a lowly commoner myself! I'll protect you!\Magna!\I wonder how long you'll last. response:	To think one of you can't even control her powers...
context: And that guy's still hiding his true powers!\This turned out to be one hell of a first mission for those two!\This isn't good!\But if I cut and run now, I'm not a real man!\It just so happens I'm a lowly commoner myself! I'll protect you!\Magna!\I wonder how long you'll last.\To think one of you can't even control her powers... response:	I guess the Black Bulls were truly desperate for members.
context: This turned out to be one hell of a first mission for those two!\This isn't good!\But if I cut and run now, I'm not a real man!\It just so happens I'm a lowly commoner myself! I'll protect you!\Magna!\I wonder how long you'll last.\To think one of you can't even control her powers...\I guess the Black Bulls were truly desperate for members. response:	These frail little beasts who can't even protect themselves...
context: This isn't good!\But if I cut and run now, I'm not a real man!\It just so happens I'm a lowly commoner myself! I'll protect you!\Magna!\I wonder how long you'll last.\To think one of you can't even control her powers...\I guess the Black Bulls were truly desperate for members.\These frail little beasts who can't even protect themselves... response:	If you abandon them, I'll let you live, Magic Knights.
context: But if I cut and run now, I'm not a real man!\It just so happens I'm a lowly commoner myself! I'll protect you!\Magna!\I wonder how long you'll last.\To think one of you can't even control her powers...\I guess the Black Bulls were truly desperate for members.\These frail little beasts who can't even protect themselves...\If you abandon them, I'll let you live, Magic Knights. response:	Like hell I'll abandon them!
context: It just so happens I'm a lowly commoner myself! I'll protect you!\Magna!\I wonder how long you'll last.\To think one of you can't even control her powers...\I guess the Black Bulls were truly desperate for members.\These frail little beasts who can't even protect themselves...\If you abandon them, I'll let you live, Magic Knights.\Like hell I'll abandon them! response:	A real man doesn't abandon anybody!
context: Magna!\I wonder how long you'll last.\To think one of you can't even control her powers...\I guess the Black Bulls were truly desperate for members.\These frail little beasts who can't even protect themselves...\If you abandon them, I'll let you live, Magic Knights.\Like hell I'll abandon them!\A real man doesn't abandon anybody! response:	I'm... royalty.
context: I wonder how long you'll last.\To think one of you can't even control her powers...\I guess the Black Bulls were truly desperate for members.\These frail little beasts who can't even protect themselves...\If you abandon them, I'll let you live, Magic Knights.\Like hell I'll abandon them!\A real man doesn't abandon anybody!\I'm... royalty. response:	I have more magical power than anyone else here.
context: To think one of you can't even control her powers...\I guess the Black Bulls were truly desperate for members.\These frail little beasts who can't even protect themselves...\If you abandon them, I'll let you live, Magic Knights.\Like hell I'll abandon them!\A real man doesn't abandon anybody!\I'm... royalty.\I have more magical power than anyone else here. response:	Step back, Lady Noe!
context: I guess the Black Bulls were truly desperate for members.\These frail little beasts who can't even protect themselves...\If you abandon them, I'll let you live, Magic Knights.\Like hell I'll abandon them!\A real man doesn't abandon anybody!\I'm... royalty.\I have more magical power than anyone else here.\Step back, Lady Noe! response:	And yet I'm just holding them back!
context: These frail little beasts who can't even protect themselves...\If you abandon them, I'll let you live, Magic Knights.\Like hell I'll abandon them!\A real man doesn't abandon anybody!\I'm... royalty.\I have more magical power than anyone else here.\Step back, Lady Noe!\And yet I'm just holding them back! response:	There's no reason for me to be here.
context: If you abandon them, I'll let you live, Magic Knights.\Like hell I'll abandon them!\A real man doesn't abandon anybody!\I'm... royalty.\I have more magical power than anyone else here.\Step back, Lady Noe!\And yet I'm just holding them back!\There's no reason for me to be here. response:	If you abandon them, I'll let you live...
context: Like hell I'll abandon them!\A real man doesn't abandon anybody!\I'm... royalty.\I have more magical power than anyone else here.\Step back, Lady Noe!\And yet I'm just holding them back!\There's no reason for me to be here.\If you abandon them, I'll let you live... response:	That's right. I'm royalty.
context: A real man doesn't abandon anybody!\I'm... royalty.\I have more magical power than anyone else here.\Step back, Lady Noe!\And yet I'm just holding them back!\There's no reason for me to be here.\If you abandon them, I'll let you live...\That's right. I'm royalty. response:	I'm not supposed to die in a village like this.
context: I'm... royalty.\I have more magical power than anyone else here.\Step back, Lady Noe!\And yet I'm just holding them back!\There's no reason for me to be here.\If you abandon them, I'll let you live...\That's right. I'm royalty.\I'm not supposed to die in a village like this. response:	I should just run
context: I have more magical power than anyone else here.\Step back, Lady Noe!\And yet I'm just holding them back!\There's no reason for me to be here.\If you abandon them, I'll let you live...\That's right. I'm royalty.\I'm not supposed to die in a village like this.\I should just run response:	Miss Magic Knight...
context: Step back, Lady Noe!\And yet I'm just holding them back!\There's no reason for me to be here.\If you abandon them, I'll let you live...\That's right. I'm royalty.\I'm not supposed to die in a village like this.\I should just run\Miss Magic Knight... response:	Save us!
context: And yet I'm just holding them back!\There's no reason for me to be here.\If you abandon them, I'll let you live...\That's right. I'm royalty.\I'm not supposed to die in a village like this.\I should just run\Miss Magic Knight...\Save us! response:	This little girl is asking for help.
context: There's no reason for me to be here.\If you abandon them, I'll let you live...\That's right. I'm royalty.\I'm not supposed to die in a village like this.\I should just run\Miss Magic Knight...\Save us!\This little girl is asking for help. response:	I'm going to protect them!
context: If you abandon them, I'll let you live...\That's right. I'm royalty.\I'm not supposed to die in a village like this.\I should just run\Miss Magic Knight...\Save us!\This little girl is asking for help.\I'm going to protect them! response:	A new spell?
context: That's right. I'm royalty.\I'm not supposed to die in a village like this.\I should just run\Miss Magic Knight...\Save us!\This little girl is asking for help.\I'm going to protect them!\A new spell? response:	There's no way...
context: I'm not supposed to die in a village like this.\I should just run\Miss Magic Knight...\Save us!\This little girl is asking for help.\I'm going to protect them!\A new spell?\There's no way... response:	I can run now!
context: I should just run\Miss Magic Knight...\Save us!\This little girl is asking for help.\I'm going to protect them!\A new spell?\There's no way...\I can run now! response:	I'll protect them! I'm royalty,
context: Miss Magic Knight...\Save us!\This little girl is asking for help.\I'm going to protect them!\A new spell?\There's no way...\I can run now!\I'll protect them! I'm royalty, response:	and a member of the Black Bulls!
context: Save us!\This little girl is asking for help.\I'm going to protect them!\A new spell?\There's no way...\I can run now!\I'll protect them! I'm royalty,\and a member of the Black Bulls! response:	No one can escape from here
context: This little girl is asking for help.\I'm going to protect them!\A new spell?\There's no way...\I can run now!\I'll protect them! I'm royalty,\and a member of the Black Bulls!\No one can escape from here response:	Once again in the small closed off classroom
context: I'm going to protect them!\A new spell?\There's no way...\I can run now!\I'll protect them! I'm royalty,\and a member of the Black Bulls!\No one can escape from here\Once again in the small closed off classroom response:	The star of the class was shining yet again
context: A new spell?\There's no way...\I can run now!\I'll protect them! I'm royalty,\and a member of the Black Bulls!\No one can escape from here\Once again in the small closed off classroom\The star of the class was shining yet again response:	They shine so bright that I close my eyes
context: There's no way...\I can run now!\I'll protect them! I'm royalty,\and a member of the Black Bulls!\No one can escape from here\Once again in the small closed off classroom\The star of the class was shining yet again\They shine so bright that I close my eyes response:	I've thought many times
context: I can run now!\I'll protect them! I'm royalty,\and a member of the Black Bulls!\No one can escape from here\Once again in the small closed off classroom\The star of the class was shining yet again\They shine so bright that I close my eyes\I've thought many times response:	That the revolution was within my hands
context: I'll protect them! I'm royalty,\and a member of the Black Bulls!\No one can escape from here\Once again in the small closed off classroom\The star of the class was shining yet again\They shine so bright that I close my eyes\I've thought many times\That the revolution was within my hands response:	Isn't it strange? If you want to laugh, go ahead and laugh
context: and a member of the Black Bulls!\No one can escape from here\Once again in the small closed off classroom\The star of the class was shining yet again\They shine so bright that I close my eyes\I've thought many times\That the revolution was within my hands\Isn't it strange? If you want to laugh, go ahead and laugh response:	The rest of us who were left behind wanted to become something
context: No one can escape from here\Once again in the small closed off classroom\The star of the class was shining yet again\They shine so bright that I close my eyes\I've thought many times\That the revolution was within my hands\Isn't it strange? If you want to laugh, go ahead and laugh\The rest of us who were left behind wanted to become something response:	We repeat the same morning over and over
context: Once again in the small closed off classroom\The star of the class was shining yet again\They shine so bright that I close my eyes\I've thought many times\That the revolution was within my hands\Isn't it strange? If you want to laugh, go ahead and laugh\The rest of us who were left behind wanted to become something\We repeat the same morning over and over response:	You're the only one who can choose your tomorrow
context: The star of the class was shining yet again\They shine so bright that I close my eyes\I've thought many times\That the revolution was within my hands\Isn't it strange? If you want to laugh, go ahead and laugh\The rest of us who were left behind wanted to become something\We repeat the same morning over and over\You're the only one who can choose your tomorrow response:	Let's go beyond our current selves
context: They shine so bright that I close my eyes\I've thought many times\That the revolution was within my hands\Isn't it strange? If you want to laugh, go ahead and laugh\The rest of us who were left behind wanted to become something\We repeat the same morning over and over\You're the only one who can choose your tomorrow\Let's go beyond our current selves response:	Petit Clover!
context: I've thought many times\That the revolution was within my hands\Isn't it strange? If you want to laugh, go ahead and laugh\The rest of us who were left behind wanted to become something\We repeat the same morning over and over\You're the only one who can choose your tomorrow\Let's go beyond our current selves\Petit Clover! response:	Separation and Reunion
context: That the revolution was within my hands\Isn't it strange? If you want to laugh, go ahead and laugh\The rest of us who were left behind wanted to become something\We repeat the same morning over and over\You're the only one who can choose your tomorrow\Let's go beyond our current selves\Petit Clover!\Separation and Reunion response:	Boar, boar, boar... boar, boar, boar.
context: Isn't it strange? If you want to laugh, go ahead and laugh\The rest of us who were left behind wanted to become something\We repeat the same morning over and over\You're the only one who can choose your tomorrow\Let's go beyond our current selves\Petit Clover!\Separation and Reunion\Boar, boar, boar... boar, boar, boar. response:	Boar, boar, boar, boar...
context: The rest of us who were left behind wanted to become something\We repeat the same morning over and over\You're the only one who can choose your tomorrow\Let's go beyond our current selves\Petit Clover!\Separation and Reunion\Boar, boar, boar... boar, boar, boar.\Boar, boar, boar, boar... response:	I'm sorry I destroyed the fields!
context: We repeat the same morning over and over\You're the only one who can choose your tomorrow\Let's go beyond our current selves\Petit Clover!\Separation and Reunion\Boar, boar, boar... boar, boar, boar.\Boar, boar, boar, boar...\I'm sorry I destroyed the fields! response:	Oh, all right. Just don't do it again!
context: You're the only one who can choose your tomorrow\Let's go beyond our current selves\Petit Clover!\Separation and Reunion\Boar, boar, boar... boar, boar, boar.\Boar, boar, boar, boar...\I'm sorry I destroyed the fields!\Oh, all right. Just don't do it again! response:	I won't!
context: Let's go beyond our current selves\Petit Clover!\Separation and Reunion\Boar, boar, boar... boar, boar, boar.\Boar, boar, boar, boar...\I'm sorry I destroyed the fields!\Oh, all right. Just don't do it again!\I won't! response:	Boar! Boar!
context: Petit Clover!\Separation and Reunion\Boar, boar, boar... boar, boar, boar.\Boar, boar, boar, boar...\I'm sorry I destroyed the fields!\Oh, all right. Just don't do it again!\I won't!\Boar! Boar! response:	Boar!
context: Separation and Reunion\Boar, boar, boar... boar, boar, boar.\Boar, boar, boar, boar...\I'm sorry I destroyed the fields!\Oh, all right. Just don't do it again!\I won't!\Boar! Boar!\Boar! response:	Take care!
context: Boar, boar, boar... boar, boar, boar.\Boar, boar, boar, boar...\I'm sorry I destroyed the fields!\Oh, all right. Just don't do it again!\I won't!\Boar! Boar!\Boar!\Take care! response:	Check out Black Clover next week, too!
context: Boar, boar, boar, boar...\I'm sorry I destroyed the fields!\Oh, all right. Just don't do it again!\I won't!\Boar! Boar!\Boar!\Take care!\Check out Black Clover next week, too! response:	Boar!
context: I'm sorry I destroyed the fields!\Oh, all right. Just don't do it again!\I won't!\Boar! Boar!\Boar!\Take care!\Check out Black Clover next week, too!\Boar! response:	That's awesome, Noelle!
context: Oh, all right. Just don't do it again!\I won't!\Boar! Boar!\Boar!\Take care!\Check out Black Clover next week, too!\Boar!\That's awesome, Noelle! response:	A path will always open, as long as you don't give up!
context: I won't!\Boar! Boar!\Boar!\Take care!\Check out Black Clover next week, too!\Boar!\That's awesome, Noelle!\A path will always open, as long as you don't give up! response:	We're going to protect everyone, no matter what!
context: Boar! Boar!\Boar!\Take care!\Check out Black Clover next week, too!\Boar!\That's awesome, Noelle!\A path will always open, as long as you don't give up!\We're going to protect everyone, no matter what! response:	Black Clover, Page 10: Those Who Protect.
context: Boar!\Take care!\Check out Black Clover next week, too!\Boar!\That's awesome, Noelle!\A path will always open, as long as you don't give up!\We're going to protect everyone, no matter what!\Black Clover, Page 10: Those Who Protect. response:	Page 10 Those Who Protect
context: Take care!\Check out Black Clover next week, too!\Boar!\That's awesome, Noelle!\A path will always open, as long as you don't give up!\We're going to protect everyone, no matter what!\Black Clover, Page 10: Those Who Protect.\Page 10 Those Who Protect response:	Not giving up is my magic!