context: Otani-kun. response:	Good morning!
context: Otani-kun.\Good morning! response:	Gross!
context: Otani-kun.\Good morning!\Gross! response:	What do you mean, gross?
context: Otani-kun.\Good morning!\Gross!\What do you mean, gross? response:	Is that the kind of attitude you should have towards your girlfriend?
context: Otani-kun.\Good morning!\Gross!\What do you mean, gross?\Is that the kind of attitude you should have towards your girlfriend? response:	Don't you think your attitude is a little arrogant?
context: Otani-kun.\Good morning!\Gross!\What do you mean, gross?\Is that the kind of attitude you should have towards your girlfriend?\Don't you think your attitude is a little arrogant? response:	I've suffered a lot up till now.
context: Otani-kun.\Good morning!\Gross!\What do you mean, gross?\Is that the kind of attitude you should have towards your girlfriend?\Don't you think your attitude is a little arrogant?\I've suffered a lot up till now. response:	I need compensation.
context: Otani-kun.\Good morning!\Gross!\What do you mean, gross?\Is that the kind of attitude you should have towards your girlfriend?\Don't you think your attitude is a little arrogant?\I've suffered a lot up till now.\I need compensation. response:	What do you mean, compensation?
context: Good morning!\Gross!\What do you mean, gross?\Is that the kind of attitude you should have towards your girlfriend?\Don't you think your attitude is a little arrogant?\I've suffered a lot up till now.\I need compensation.\What do you mean, compensation? response:	A-chan!
context: Gross!\What do you mean, gross?\Is that the kind of attitude you should have towards your girlfriend?\Don't you think your attitude is a little arrogant?\I've suffered a lot up till now.\I need compensation.\What do you mean, compensation?\A-chan! response:	Good morning.
context: What do you mean, gross?\Is that the kind of attitude you should have towards your girlfriend?\Don't you think your attitude is a little arrogant?\I've suffered a lot up till now.\I need compensation.\What do you mean, compensation?\A-chan!\Good morning. response:	Ah, this girl is...
context: Is that the kind of attitude you should have towards your girlfriend?\Don't you think your attitude is a little arrogant?\I've suffered a lot up till now.\I need compensation.\What do you mean, compensation?\A-chan!\Good morning.\Ah, this girl is... response:	Meimei-chan!
context: Don't you think your attitude is a little arrogant?\I've suffered a lot up till now.\I need compensation.\What do you mean, compensation?\A-chan!\Good morning.\Ah, this girl is...\Meimei-chan! response:	It's Mimi!
context: I've suffered a lot up till now.\I need compensation.\What do you mean, compensation?\A-chan!\Good morning.\Ah, this girl is...\Meimei-chan!\It's Mimi! response:	Your girlfriend sure is funny.
context: I need compensation.\What do you mean, compensation?\A-chan!\Good morning.\Ah, this girl is...\Meimei-chan!\It's Mimi!\Your girlfriend sure is funny. response:	Oh no! We're gonna be late!
context: What do you mean, compensation?\A-chan!\Good morning.\Ah, this girl is...\Meimei-chan!\It's Mimi!\Your girlfriend sure is funny.\Oh no! We're gonna be late! response:	That's because you took so long.
context: A-chan!\Good morning.\Ah, this girl is...\Meimei-chan!\It's Mimi!\Your girlfriend sure is funny.\Oh no! We're gonna be late!\That's because you took so long. response:	That's because you were being stupid.
context: Good morning.\Ah, this girl is...\Meimei-chan!\It's Mimi!\Your girlfriend sure is funny.\Oh no! We're gonna be late!\That's because you took so long.\That's because you were being stupid. response:	See ya, Mimi-chan.
context: Ah, this girl is...\Meimei-chan!\It's Mimi!\Your girlfriend sure is funny.\Oh no! We're gonna be late!\That's because you took so long.\That's because you were being stupid.\See ya, Mimi-chan. response:	Declaration of War!! The Dangerous Beauty Who Burns With Jealousy!!
context: Meimei-chan!\It's Mimi!\Your girlfriend sure is funny.\Oh no! We're gonna be late!\That's because you took so long.\That's because you were being stupid.\See ya, Mimi-chan.\Declaration of War!! The Dangerous Beauty Who Burns With Jealousy!! response:	What's this?! Why didn't you tell us?!
context: It's Mimi!\Your girlfriend sure is funny.\Oh no! We're gonna be late!\That's because you took so long.\That's because you were being stupid.\See ya, Mimi-chan.\Declaration of War!! The Dangerous Beauty Who Burns With Jealousy!!\What's this?! Why didn't you tell us?! response:	When did this happen?
context: Your girlfriend sure is funny.\Oh no! We're gonna be late!\That's because you took so long.\That's because you were being stupid.\See ya, Mimi-chan.\Declaration of War!! The Dangerous Beauty Who Burns With Jealousy!!\What's this?! Why didn't you tell us?!\When did this happen? response:	I see. Congratulations.
context: Oh no! We're gonna be late!\That's because you took so long.\That's because you were being stupid.\See ya, Mimi-chan.\Declaration of War!! The Dangerous Beauty Who Burns With Jealousy!!\What's this?! Why didn't you tell us?!\When did this happen?\I see. Congratulations. response:	What did you say when you asked her out?
context: That's because you took so long.\That's because you were being stupid.\See ya, Mimi-chan.\Declaration of War!! The Dangerous Beauty Who Burns With Jealousy!!\What's this?! Why didn't you tell us?!\When did this happen?\I see. Congratulations.\What did you say when you asked her out? response:	Oh? That's great. Congratulations.
context: That's because you were being stupid.\See ya, Mimi-chan.\Declaration of War!! The Dangerous Beauty Who Burns With Jealousy!!\What's this?! Why didn't you tell us?!\When did this happen?\I see. Congratulations.\What did you say when you asked her out?\Oh? That's great. Congratulations. response:	Is this true, Senpai?
context: See ya, Mimi-chan.\Declaration of War!! The Dangerous Beauty Who Burns With Jealousy!!\What's this?! Why didn't you tell us?!\When did this happen?\I see. Congratulations.\What did you say when you asked her out?\Oh? That's great. Congratulations.\Is this true, Senpai? response:	Ahdsakafajdags!
context: Declaration of War!! The Dangerous Beauty Who Burns With Jealousy!!\What's this?! Why didn't you tell us?!\When did this happen?\I see. Congratulations.\What did you say when you asked her out?\Oh? That's great. Congratulations.\Is this true, Senpai?\Ahdsakafajdags! response:	This is wonderful.
context: What's this?! Why didn't you tell us?!\When did this happen?\I see. Congratulations.\What did you say when you asked her out?\Oh? That's great. Congratulations.\Is this true, Senpai?\Ahdsakafajdags!\This is wonderful. response:	I'm so moved!
context: When did this happen?\I see. Congratulations.\What did you say when you asked her out?\Oh? That's great. Congratulations.\Is this true, Senpai?\Ahdsakafajdags!\This is wonderful.\I'm so moved! response:	So the comedy duo is finally a couple.
context: I see. Congratulations.\What did you say when you asked her out?\Oh? That's great. Congratulations.\Is this true, Senpai?\Ahdsakafajdags!\This is wonderful.\I'm so moved!\So the comedy duo is finally a couple. response:	Congratulations!
context: What did you say when you asked her out?\Oh? That's great. Congratulations.\Is this true, Senpai?\Ahdsakafajdags!\This is wonderful.\I'm so moved!\So the comedy duo is finally a couple.\Congratulations! response:	Thank you.
context: Oh? That's great. Congratulations.\Is this true, Senpai?\Ahdsakafajdags!\This is wonderful.\I'm so moved!\So the comedy duo is finally a couple.\Congratulations!\Thank you. response:	Don't make such a big deal out of it.
context: Is this true, Senpai?\Ahdsakafajdags!\This is wonderful.\I'm so moved!\So the comedy duo is finally a couple.\Congratulations!\Thank you.\Don't make such a big deal out of it. response:	Why?!
context: Ahdsakafajdags!\This is wonderful.\I'm so moved!\So the comedy duo is finally a couple.\Congratulations!\Thank you.\Don't make such a big deal out of it.\Why?! response:	Please tell me why, Risa!
context: This is wonderful.\I'm so moved!\So the comedy duo is finally a couple.\Congratulations!\Thank you.\Don't make such a big deal out of it.\Why?!\Please tell me why, Risa! response:	Think about this seriously! It's weird! Choosing a guy like that...
context: I'm so moved!\So the comedy duo is finally a couple.\Congratulations!\Thank you.\Don't make such a big deal out of it.\Why?!\Please tell me why, Risa!\Think about this seriously! It's weird! Choosing a guy like that... response:	What do you mean, a guy like me?
context: So the comedy duo is finally a couple.\Congratulations!\Thank you.\Don't make such a big deal out of it.\Why?!\Please tell me why, Risa!\Think about this seriously! It's weird! Choosing a guy like that...\What do you mean, a guy like me? response:	Beat it, mini-man!
context: Congratulations!\Thank you.\Don't make such a big deal out of it.\Why?!\Please tell me why, Risa!\Think about this seriously! It's weird! Choosing a guy like that...\What do you mean, a guy like me?\Beat it, mini-man! response:	Don't go getting cocky.
context: Thank you.\Don't make such a big deal out of it.\Why?!\Please tell me why, Risa!\Think about this seriously! It's weird! Choosing a guy like that...\What do you mean, a guy like me?\Beat it, mini-man!\Don't go getting cocky. response:	Who's getting cocky?
context: Don't make such a big deal out of it.\Why?!\Please tell me why, Risa!\Think about this seriously! It's weird! Choosing a guy like that...\What do you mean, a guy like me?\Beat it, mini-man!\Don't go getting cocky.\Who's getting cocky? response:	You...
context: Why?!\Please tell me why, Risa!\Think about this seriously! It's weird! Choosing a guy like that...\What do you mean, a guy like me?\Beat it, mini-man!\Don't go getting cocky.\Who's getting cocky?\You... response:	You...
context: Please tell me why, Risa!\Think about this seriously! It's weird! Choosing a guy like that...\What do you mean, a guy like me?\Beat it, mini-man!\Don't go getting cocky.\Who's getting cocky?\You...\You... response:	Fine...
context: Think about this seriously! It's weird! Choosing a guy like that...\What do you mean, a guy like me?\Beat it, mini-man!\Don't go getting cocky.\Who's getting cocky?\You...\You...\Fine... response:	I knew this day would come eventually.
context: What do you mean, a guy like me?\Beat it, mini-man!\Don't go getting cocky.\Who's getting cocky?\You...\You...\Fine...\I knew this day would come eventually. response:	Oh... that's right.
context: Beat it, mini-man!\Don't go getting cocky.\Who's getting cocky?\You...\You...\Fine...\I knew this day would come eventually.\Oh... that's right. response:	Sensei was looking for you two earlier.
context: Don't go getting cocky.\Who's getting cocky?\You...\You...\Fine...\I knew this day would come eventually.\Oh... that's right.\Sensei was looking for you two earlier. response:	It's over already?
context: Who's getting cocky?\You...\You...\Fine...\I knew this day would come eventually.\Oh... that's right.\Sensei was looking for you two earlier.\It's over already? response:	Did you forget your summer homework?
context: You...\You...\Fine...\I knew this day would come eventually.\Oh... that's right.\Sensei was looking for you two earlier.\It's over already?\Did you forget your summer homework? response:	Yes.
context: You...\Fine...\I knew this day would come eventually.\Oh... that's right.\Sensei was looking for you two earlier.\It's over already?\Did you forget your summer homework?\Yes. response:	Sorry.
context: Fine...\I knew this day would come eventually.\Oh... that's right.\Sensei was looking for you two earlier.\It's over already?\Did you forget your summer homework?\Yes.\Sorry. response:	Well, at this stage there's nothing more to say.
context: I knew this day would come eventually.\Oh... that's right.\Sensei was looking for you two earlier.\It's over already?\Did you forget your summer homework?\Yes.\Sorry.\Well, at this stage there's nothing more to say. response:	Just turn it in by Monday.
context: Oh... that's right.\Sensei was looking for you two earlier.\It's over already?\Did you forget your summer homework?\Yes.\Sorry.\Well, at this stage there's nothing more to say.\Just turn it in by Monday. response:	Yes.
context: Sensei was looking for you two earlier.\It's over already?\Did you forget your summer homework?\Yes.\Sorry.\Well, at this stage there's nothing more to say.\Just turn it in by Monday.\Yes. response:	I totally forgot about it.
context: It's over already?\Did you forget your summer homework?\Yes.\Sorry.\Well, at this stage there's nothing more to say.\Just turn it in by Monday.\Yes.\I totally forgot about it. response:	Let's work on it together.
context: Did you forget your summer homework?\Yes.\Sorry.\Well, at this stage there's nothing more to say.\Just turn it in by Monday.\Yes.\I totally forgot about it.\Let's work on it together. response:	Where?
context: Yes.\Sorry.\Well, at this stage there's nothing more to say.\Just turn it in by Monday.\Yes.\I totally forgot about it.\Let's work on it together.\Where? response:	Do you want to go to the library with Suzuki and the others?
context: Sorry.\Well, at this stage there's nothing more to say.\Just turn it in by Monday.\Yes.\I totally forgot about it.\Let's work on it together.\Where?\Do you want to go to the library with Suzuki and the others? response:	Bad idea.
context: Well, at this stage there's nothing more to say.\Just turn it in by Monday.\Yes.\I totally forgot about it.\Let's work on it together.\Where?\Do you want to go to the library with Suzuki and the others?\Bad idea. response:	If I'm in a quiet place like the library,
context: Just turn it in by Monday.\Yes.\I totally forgot about it.\Let's work on it together.\Where?\Do you want to go to the library with Suzuki and the others?\Bad idea.\If I'm in a quiet place like the library, response:	It will be all eek, won't it?
context: Yes.\I totally forgot about it.\Let's work on it together.\Where?\Do you want to go to the library with Suzuki and the others?\Bad idea.\If I'm in a quiet place like the library,\It will be all eek, won't it? response:	Want to come to my place?
context: I totally forgot about it.\Let's work on it together.\Where?\Do you want to go to the library with Suzuki and the others?\Bad idea.\If I'm in a quiet place like the library,\It will be all eek, won't it?\Want to come to my place? response:	You brought your girlfriend over?
context: Let's work on it together.\Where?\Do you want to go to the library with Suzuki and the others?\Bad idea.\If I'm in a quiet place like the library,\It will be all eek, won't it?\Want to come to my place?\You brought your girlfriend over? response:	What are you doing here?
context: Where?\Do you want to go to the library with Suzuki and the others?\Bad idea.\If I'm in a quiet place like the library,\It will be all eek, won't it?\Want to come to my place?\You brought your girlfriend over?\What are you doing here? response:	I brought today's milk for you.
context: Do you want to go to the library with Suzuki and the others?\Bad idea.\If I'm in a quiet place like the library,\It will be all eek, won't it?\Want to come to my place?\You brought your girlfriend over?\What are you doing here?\I brought today's milk for you. response:	M-milk?
context: Bad idea.\If I'm in a quiet place like the library,\It will be all eek, won't it?\Want to come to my place?\You brought your girlfriend over?\What are you doing here?\I brought today's milk for you.\M-milk? response:	She brings me milk every day, saying it'll make me taller.
context: If I'm in a quiet place like the library,\It will be all eek, won't it?\Want to come to my place?\You brought your girlfriend over?\What are you doing here?\I brought today's milk for you.\M-milk?\She brings me milk every day, saying it'll make me taller. response:	Today I've brought something really great.
context: It will be all eek, won't it?\Want to come to my place?\You brought your girlfriend over?\What are you doing here?\I brought today's milk for you.\M-milk?\She brings me milk every day, saying it'll make me taller.\Today I've brought something really great. response:	This is high-calcium milk,
context: Want to come to my place?\You brought your girlfriend over?\What are you doing here?\I brought today's milk for you.\M-milk?\She brings me milk every day, saying it'll make me taller.\Today I've brought something really great.\This is high-calcium milk, response:	What's so funny?!
context: You brought your girlfriend over?\What are you doing here?\I brought today's milk for you.\M-milk?\She brings me milk every day, saying it'll make me taller.\Today I've brought something really great.\This is high-calcium milk,\What's so funny?! response:	Well, milk...
context: What are you doing here?\I brought today's milk for you.\M-milk?\She brings me milk every day, saying it'll make me taller.\Today I've brought something really great.\This is high-calcium milk,\What's so funny?!\Well, milk... response:	If there's nothing else, hurry up and go home.
context: I brought today's milk for you.\M-milk?\She brings me milk every day, saying it'll make me taller.\Today I've brought something really great.\This is high-calcium milk,\What's so funny?!\Well, milk...\If there's nothing else, hurry up and go home. response:	Aww. But I wanted to chat with your girlfriend.
context: M-milk?\She brings me milk every day, saying it'll make me taller.\Today I've brought something really great.\This is high-calcium milk,\What's so funny?!\Well, milk...\If there's nothing else, hurry up and go home.\Aww. But I wanted to chat with your girlfriend. response:	No. We're gonna study now, so you can't.
context: She brings me milk every day, saying it'll make me taller.\Today I've brought something really great.\This is high-calcium milk,\What's so funny?!\Well, milk...\If there's nothing else, hurry up and go home.\Aww. But I wanted to chat with your girlfriend.\No. We're gonna study now, so you can't. response:	It's okay, Otani. It'll just be for a bit.
context: Today I've brought something really great.\This is high-calcium milk,\What's so funny?!\Well, milk...\If there's nothing else, hurry up and go home.\Aww. But I wanted to chat with your girlfriend.\No. We're gonna study now, so you can't.\It's okay, Otani. It'll just be for a bit. response:	Yeah!
context: This is high-calcium milk,\What's so funny?!\Well, milk...\If there's nothing else, hurry up and go home.\Aww. But I wanted to chat with your girlfriend.\No. We're gonna study now, so you can't.\It's okay, Otani. It'll just be for a bit.\Yeah! response:	Just for a bit, okay?
context: What's so funny?!\Well, milk...\If there's nothing else, hurry up and go home.\Aww. But I wanted to chat with your girlfriend.\No. We're gonna study now, so you can't.\It's okay, Otani. It'll just be for a bit.\Yeah!\Just for a bit, okay? response:	Understood.
context: Well, milk...\If there's nothing else, hurry up and go home.\Aww. But I wanted to chat with your girlfriend.\No. We're gonna study now, so you can't.\It's okay, Otani. It'll just be for a bit.\Yeah!\Just for a bit, okay?\Understood. response:	A-chan, could you come here for a sec?
context: If there's nothing else, hurry up and go home.\Aww. But I wanted to chat with your girlfriend.\No. We're gonna study now, so you can't.\It's okay, Otani. It'll just be for a bit.\Yeah!\Just for a bit, okay?\Understood.\A-chan, could you come here for a sec? response:	What is it? Geez...
context: Aww. But I wanted to chat with your girlfriend.\No. We're gonna study now, so you can't.\It's okay, Otani. It'll just be for a bit.\Yeah!\Just for a bit, okay?\Understood.\A-chan, could you come here for a sec?\What is it? Geez... response:	How cute...
context: No. We're gonna study now, so you can't.\It's okay, Otani. It'll just be for a bit.\Yeah!\Just for a bit, okay?\Understood.\A-chan, could you come here for a sec?\What is it? Geez...\How cute... response:	Mimi-chan, you're pretty tall and slim.
context: It's okay, Otani. It'll just be for a bit.\Yeah!\Just for a bit, okay?\Understood.\A-chan, could you come here for a sec?\What is it? Geez...\How cute...\Mimi-chan, you're pretty tall and slim. response:	How tall are you?
context: Yeah!\Just for a bit, okay?\Understood.\A-chan, could you come here for a sec?\What is it? Geez...\How cute...\Mimi-chan, you're pretty tall and slim.\How tall are you? response:	172 cm.
context: Just for a bit, okay?\Understood.\A-chan, could you come here for a sec?\What is it? Geez...\How cute...\Mimi-chan, you're pretty tall and slim.\How tall are you?\172 cm. response:	Wow! Same as me!
context: Understood.\A-chan, could you come here for a sec?\What is it? Geez...\How cute...\Mimi-chan, you're pretty tall and slim.\How tall are you?\172 cm.\Wow! Same as me! response:	Really?
context: A-chan, could you come here for a sec?\What is it? Geez...\How cute...\Mimi-chan, you're pretty tall and slim.\How tall are you?\172 cm.\Wow! Same as me!\Really? response:	But A-chan always said he'd never go out with a girl taller than him.
context: What is it? Geez...\How cute...\Mimi-chan, you're pretty tall and slim.\How tall are you?\172 cm.\Wow! Same as me!\Really?\But A-chan always said he'd never go out with a girl taller than him. response:	Ah. That'd be right.
context: How cute...\Mimi-chan, you're pretty tall and slim.\How tall are you?\172 cm.\Wow! Same as me!\Really?\But A-chan always said he'd never go out with a girl taller than him.\Ah. That'd be right. response:	But he doesn't seem to mind my height...
context: Mimi-chan, you're pretty tall and slim.\How tall are you?\172 cm.\Wow! Same as me!\Really?\But A-chan always said he'd never go out with a girl taller than him.\Ah. That'd be right.\But he doesn't seem to mind my height... response:	Hey, did you know that A-chan's last girlfriend was really short?
context: How tall are you?\172 cm.\Wow! Same as me!\Really?\But A-chan always said he'd never go out with a girl taller than him.\Ah. That'd be right.\But he doesn't seem to mind my height...\Hey, did you know that A-chan's last girlfriend was really short? response:	Yeah, I know.
context: 172 cm.\Wow! Same as me!\Really?\But A-chan always said he'd never go out with a girl taller than him.\Ah. That'd be right.\But he doesn't seem to mind my height...\Hey, did you know that A-chan's last girlfriend was really short?\Yeah, I know. response:	She was small and cute.
context: Wow! Same as me!\Really?\But A-chan always said he'd never go out with a girl taller than him.\Ah. That'd be right.\But he doesn't seem to mind my height...\Hey, did you know that A-chan's last girlfriend was really short?\Yeah, I know.\She was small and cute. response:	That's why I gave up on A-chan.
context: Really?\But A-chan always said he'd never go out with a girl taller than him.\Ah. That'd be right.\But he doesn't seem to mind my height...\Hey, did you know that A-chan's last girlfriend was really short?\Yeah, I know.\She was small and cute.\That's why I gave up on A-chan. response:	You like Otani, Mimi-chan?
context: But A-chan always said he'd never go out with a girl taller than him.\Ah. That'd be right.\But he doesn't seem to mind my height...\Hey, did you know that A-chan's last girlfriend was really short?\Yeah, I know.\She was small and cute.\That's why I gave up on A-chan.\You like Otani, Mimi-chan? response:	Yeah. But A-chan only likes short girls...
context: Ah. That'd be right.\But he doesn't seem to mind my height...\Hey, did you know that A-chan's last girlfriend was really short?\Yeah, I know.\She was small and cute.\That's why I gave up on A-chan.\You like Otani, Mimi-chan?\Yeah. But A-chan only likes short girls... response:	That's why I bring him milk every day, so that he'll grow taller.
context: But he doesn't seem to mind my height...\Hey, did you know that A-chan's last girlfriend was really short?\Yeah, I know.\She was small and cute.\That's why I gave up on A-chan.\You like Otani, Mimi-chan?\Yeah. But A-chan only likes short girls...\That's why I bring him milk every day, so that he'll grow taller. response:	I-I see...
context: Hey, did you know that A-chan's last girlfriend was really short?\Yeah, I know.\She was small and cute.\That's why I gave up on A-chan.\You like Otani, Mimi-chan?\Yeah. But A-chan only likes short girls...\That's why I bring him milk every day, so that he'll grow taller.\I-I see... response:	I decided that when A-chan grew taller than me, I'd become his girlfriend.
context: Yeah, I know.\She was small and cute.\That's why I gave up on A-chan.\You like Otani, Mimi-chan?\Yeah. But A-chan only likes short girls...\That's why I bring him milk every day, so that he'll grow taller.\I-I see...\I decided that when A-chan grew taller than me, I'd become his girlfriend. response:	Um... uh... Sorry, I guess...
context: She was small and cute.\That's why I gave up on A-chan.\You like Otani, Mimi-chan?\Yeah. But A-chan only likes short girls...\That's why I bring him milk every day, so that he'll grow taller.\I-I see...\I decided that when A-chan grew taller than me, I'd become his girlfriend.\Um... uh... Sorry, I guess... response:	Damn. I missed.
context: That's why I gave up on A-chan.\You like Otani, Mimi-chan?\Yeah. But A-chan only likes short girls...\That's why I bring him milk every day, so that he'll grow taller.\I-I see...\I decided that when A-chan grew taller than me, I'd become his girlfriend.\Um... uh... Sorry, I guess...\Damn. I missed. response:	Sorry?
context: You like Otani, Mimi-chan?\Yeah. But A-chan only likes short girls...\That's why I bring him milk every day, so that he'll grow taller.\I-I see...\I decided that when A-chan grew taller than me, I'd become his girlfriend.\Um... uh... Sorry, I guess...\Damn. I missed.\Sorry? response:	You've got some nerve!
context: Yeah. But A-chan only likes short girls...\That's why I bring him milk every day, so that he'll grow taller.\I-I see...\I decided that when A-chan grew taller than me, I'd become his girlfriend.\Um... uh... Sorry, I guess...\Damn. I missed.\Sorry?\You've got some nerve! response:	What kind of dirty trick did you pull to get him, eh?
context: That's why I bring him milk every day, so that he'll grow taller.\I-I see...\I decided that when A-chan grew taller than me, I'd become his girlfriend.\Um... uh... Sorry, I guess...\Damn. I missed.\Sorry?\You've got some nerve!\What kind of dirty trick did you pull to get him, eh? response:	Do you want me to thread a needle through your nostrils and tie a knot?
context: I-I see...\I decided that when A-chan grew taller than me, I'd become his girlfriend.\Um... uh... Sorry, I guess...\Damn. I missed.\Sorry?\You've got some nerve!\What kind of dirty trick did you pull to get him, eh?\Do you want me to thread a needle through your nostrils and tie a knot? response:	No... No, I don't.
context: I decided that when A-chan grew taller than me, I'd become his girlfriend.\Um... uh... Sorry, I guess...\Damn. I missed.\Sorry?\You've got some nerve!\What kind of dirty trick did you pull to get him, eh?\Do you want me to thread a needle through your nostrils and tie a knot?\No... No, I don't. response:	A-chan can't possibly have a girlfriend like you.
context: Um... uh... Sorry, I guess...\Damn. I missed.\Sorry?\You've got some nerve!\What kind of dirty trick did you pull to get him, eh?\Do you want me to thread a needle through your nostrils and tie a knot?\No... No, I don't.\A-chan can't possibly have a girlfriend like you. response:	M-M-Mimi-chan...
context: Damn. I missed.\Sorry?\You've got some nerve!\What kind of dirty trick did you pull to get him, eh?\Do you want me to thread a needle through your nostrils and tie a knot?\No... No, I don't.\A-chan can't possibly have a girlfriend like you.\M-M-Mimi-chan... response:	Don't say my name in that disgusting voice!
context: Sorry?\You've got some nerve!\What kind of dirty trick did you pull to get him, eh?\Do you want me to thread a needle through your nostrils and tie a knot?\No... No, I don't.\A-chan can't possibly have a girlfriend like you.\M-M-Mimi-chan...\Don't say my name in that disgusting voice! response:	If you get any closer to A-chan,
context: You've got some nerve!\What kind of dirty trick did you pull to get him, eh?\Do you want me to thread a needle through your nostrils and tie a knot?\No... No, I don't.\A-chan can't possibly have a girlfriend like you.\M-M-Mimi-chan...\Don't say my name in that disgusting voice!\If you get any closer to A-chan, response:	I brought tea.
context: What kind of dirty trick did you pull to get him, eh?\Do you want me to thread a needle through your nostrils and tie a knot?\No... No, I don't.\A-chan can't possibly have a girlfriend like you.\M-M-Mimi-chan...\Don't say my name in that disgusting voice!\If you get any closer to A-chan,\I brought tea. response:	Otani! Save me!
context: Do you want me to thread a needle through your nostrils and tie a knot?\No... No, I don't.\A-chan can't possibly have a girlfriend like you.\M-M-Mimi-chan...\Don't say my name in that disgusting voice!\If you get any closer to A-chan,\I brought tea.\Otani! Save me! response:	Cake! Cake!
context: No... No, I don't.\A-chan can't possibly have a girlfriend like you.\M-M-Mimi-chan...\Don't say my name in that disgusting voice!\If you get any closer to A-chan,\I brought tea.\Otani! Save me!\Cake! Cake! response:	I want the Mont Blanc cake!
context: A-chan can't possibly have a girlfriend like you.\M-M-Mimi-chan...\Don't say my name in that disgusting voice!\If you get any closer to A-chan,\I brought tea.\Otani! Save me!\Cake! Cake!\I want the Mont Blanc cake! response:	Can I start?
context: M-M-Mimi-chan...\Don't say my name in that disgusting voice!\If you get any closer to A-chan,\I brought tea.\Otani! Save me!\Cake! Cake!\I want the Mont Blanc cake!\Can I start? response:	G-Go ahead.
context: Don't say my name in that disgusting voice!\If you get any closer to A-chan,\I brought tea.\Otani! Save me!\Cake! Cake!\I want the Mont Blanc cake!\Can I start?\G-Go ahead. response:	Your girlfriend is really nice!
context: If you get any closer to A-chan,\I brought tea.\Otani! Save me!\Cake! Cake!\I want the Mont Blanc cake!\Can I start?\G-Go ahead.\Your girlfriend is really nice! response:	Was that a hallucination just now?
context: I brought tea.\Otani! Save me!\Cake! Cake!\I want the Mont Blanc cake!\Can I start?\G-Go ahead.\Your girlfriend is really nice!\Was that a hallucination just now? response:	What's the matter, Koizumi?
context: Otani! Save me!\Cake! Cake!\I want the Mont Blanc cake!\Can I start?\G-Go ahead.\Your girlfriend is really nice!\Was that a hallucination just now?\What's the matter, Koizumi? response:	Uh... Nothing.
context: Cake! Cake!\I want the Mont Blanc cake!\Can I start?\G-Go ahead.\Your girlfriend is really nice!\Was that a hallucination just now?\What's the matter, Koizumi?\Uh... Nothing. response:	It wasn't a hallucination.
context: I want the Mont Blanc cake!\Can I start?\G-Go ahead.\Your girlfriend is really nice!\Was that a hallucination just now?\What's the matter, Koizumi?\Uh... Nothing.\It wasn't a hallucination. response:	What's up with you?
context: Can I start?\G-Go ahead.\Your girlfriend is really nice!\Was that a hallucination just now?\What's the matter, Koizumi?\Uh... Nothing.\It wasn't a hallucination.\What's up with you? response:	Mimi, after you finish that, go home, okay?
context: G-Go ahead.\Your girlfriend is really nice!\Was that a hallucination just now?\What's the matter, Koizumi?\Uh... Nothing.\It wasn't a hallucination.\What's up with you?\Mimi, after you finish that, go home, okay? response:	Okay.
context: Your girlfriend is really nice!\Was that a hallucination just now?\What's the matter, Koizumi?\Uh... Nothing.\It wasn't a hallucination.\What's up with you?\Mimi, after you finish that, go home, okay?\Okay. response:	I had no idea she was a model.
context: Was that a hallucination just now?\What's the matter, Koizumi?\Uh... Nothing.\It wasn't a hallucination.\What's up with you?\Mimi, after you finish that, go home, okay?\Okay.\I had no idea she was a model. response:	So that's Otani-kun's neighbor?
context: What's the matter, Koizumi?\Uh... Nothing.\It wasn't a hallucination.\What's up with you?\Mimi, after you finish that, go home, okay?\Okay.\I had no idea she was a model.\So that's Otani-kun's neighbor? response:	She looks amazing.
context: Uh... Nothing.\It wasn't a hallucination.\What's up with you?\Mimi, after you finish that, go home, okay?\Okay.\I had no idea she was a model.\So that's Otani-kun's neighbor?\She looks amazing. response:	Oh, it's Mimi.
context: It wasn't a hallucination.\What's up with you?\Mimi, after you finish that, go home, okay?\Okay.\I had no idea she was a model.\So that's Otani-kun's neighbor?\She looks amazing.\Oh, it's Mimi. response:	Saying anything to Otani would be pointless.
context: What's up with you?\Mimi, after you finish that, go home, okay?\Okay.\I had no idea she was a model.\So that's Otani-kun's neighbor?\She looks amazing.\Oh, it's Mimi.\Saying anything to Otani would be pointless. response:	Well, there's no point in worrying.
context: Mimi, after you finish that, go home, okay?\Okay.\I had no idea she was a model.\So that's Otani-kun's neighbor?\She looks amazing.\Oh, it's Mimi.\Saying anything to Otani would be pointless.\Well, there's no point in worrying. response:	Want to go have some fun, now that we've turned in our homework?
context: Okay.\I had no idea she was a model.\So that's Otani-kun's neighbor?\She looks amazing.\Oh, it's Mimi.\Saying anything to Otani would be pointless.\Well, there's no point in worrying.\Want to go have some fun, now that we've turned in our homework? response:	Let's! Let's!
context: I had no idea she was a model.\So that's Otani-kun's neighbor?\She looks amazing.\Oh, it's Mimi.\Saying anything to Otani would be pointless.\Well, there's no point in worrying.\Want to go have some fun, now that we've turned in our homework?\Let's! Let's! response:	No matter what happens to me or what's said to me,
context: So that's Otani-kun's neighbor?\She looks amazing.\Oh, it's Mimi.\Saying anything to Otani would be pointless.\Well, there's no point in worrying.\Want to go have some fun, now that we've turned in our homework?\Let's! Let's!\No matter what happens to me or what's said to me, response:	A-chan!
context: She looks amazing.\Oh, it's Mimi.\Saying anything to Otani would be pointless.\Well, there's no point in worrying.\Want to go have some fun, now that we've turned in our homework?\Let's! Let's!\No matter what happens to me or what's said to me,\A-chan! response:	What are you doing here?
context: Oh, it's Mimi.\Saying anything to Otani would be pointless.\Well, there's no point in worrying.\Want to go have some fun, now that we've turned in our homework?\Let's! Let's!\No matter what happens to me or what's said to me,\A-chan!\What are you doing here? response:	Your girlfriend and I are really getting along.
context: Saying anything to Otani would be pointless.\Well, there's no point in worrying.\Want to go have some fun, now that we've turned in our homework?\Let's! Let's!\No matter what happens to me or what's said to me,\A-chan!\What are you doing here?\Your girlfriend and I are really getting along. response:	We're going to hang out together today, right?
context: Well, there's no point in worrying.\Want to go have some fun, now that we've turned in our homework?\Let's! Let's!\No matter what happens to me or what's said to me,\A-chan!\What are you doing here?\Your girlfriend and I are really getting along.\We're going to hang out together today, right? response:	Right?
context: Want to go have some fun, now that we've turned in our homework?\Let's! Let's!\No matter what happens to me or what's said to me,\A-chan!\What are you doing here?\Your girlfriend and I are really getting along.\We're going to hang out together today, right?\Right? response:	Okay, okay. In that case, you two go on ahead.
context: Let's! Let's!\No matter what happens to me or what's said to me,\A-chan!\What are you doing here?\Your girlfriend and I are really getting along.\We're going to hang out together today, right?\Right?\Okay, okay. In that case, you two go on ahead. response:	What about you, A-chan?
context: No matter what happens to me or what's said to me,\A-chan!\What are you doing here?\Your girlfriend and I are really getting along.\We're going to hang out together today, right?\Right?\Okay, okay. In that case, you two go on ahead.\What about you, A-chan? response:	I don't want to walk home between two amazons.
context: A-chan!\What are you doing here?\Your girlfriend and I are really getting along.\We're going to hang out together today, right?\Right?\Okay, okay. In that case, you two go on ahead.\What about you, A-chan?\I don't want to walk home between two amazons. response:	You'll look like a captured alien.
context: What are you doing here?\Your girlfriend and I are really getting along.\We're going to hang out together today, right?\Right?\Okay, okay. In that case, you two go on ahead.\What about you, A-chan?\I don't want to walk home between two amazons.\You'll look like a captured alien. response:	I'll smack you!
context: Your girlfriend and I are really getting along.\We're going to hang out together today, right?\Right?\Okay, okay. In that case, you two go on ahead.\What about you, A-chan?\I don't want to walk home between two amazons.\You'll look like a captured alien.\I'll smack you! response:	Man...
context: We're going to hang out together today, right?\Right?\Okay, okay. In that case, you two go on ahead.\What about you, A-chan?\I don't want to walk home between two amazons.\You'll look like a captured alien.\I'll smack you!\Man... response:	Ah! Wa-Wait! Otani!
context: Right?\Okay, okay. In that case, you two go on ahead.\What about you, A-chan?\I don't want to walk home between two amazons.\You'll look like a captured alien.\I'll smack you!\Man...\Ah! Wa-Wait! Otani! response:	Hey.
context: Okay, okay. In that case, you two go on ahead.\What about you, A-chan?\I don't want to walk home between two amazons.\You'll look like a captured alien.\I'll smack you!\Man...\Ah! Wa-Wait! Otani!\Hey. response:	Get it yet, hag?
context: What about you, A-chan?\I don't want to walk home between two amazons.\You'll look like a captured alien.\I'll smack you!\Man...\Ah! Wa-Wait! Otani!\Hey.\Get it yet, hag? response:	We need to have a little talk.
context: I don't want to walk home between two amazons.\You'll look like a captured alien.\I'll smack you!\Man...\Ah! Wa-Wait! Otani!\Hey.\Get it yet, hag?\We need to have a little talk. response:	Why has it come to this?
context: You'll look like a captured alien.\I'll smack you!\Man...\Ah! Wa-Wait! Otani!\Hey.\Get it yet, hag?\We need to have a little talk.\Why has it come to this? response:	She's totally staring me down.
context: I'll smack you!\Man...\Ah! Wa-Wait! Otani!\Hey.\Get it yet, hag?\We need to have a little talk.\Why has it come to this?\She's totally staring me down. response:	How did someone like you come to be going out with A-chan?
context: Man...\Ah! Wa-Wait! Otani!\Hey.\Get it yet, hag?\We need to have a little talk.\Why has it come to this?\She's totally staring me down.\How did someone like you come to be going out with A-chan? response:	I-I worked really hard!
context: Ah! Wa-Wait! Otani!\Hey.\Get it yet, hag?\We need to have a little talk.\Why has it come to this?\She's totally staring me down.\How did someone like you come to be going out with A-chan?\I-I worked really hard! response:	You idiot! I've been working really hard too!
context: Hey.\Get it yet, hag?\We need to have a little talk.\Why has it come to this?\She's totally staring me down.\How did someone like you come to be going out with A-chan?\I-I worked really hard!\You idiot! I've been working really hard too! response:	I'm really cute when I'm with A-chan, aren't I?
context: Get it yet, hag?\We need to have a little talk.\Why has it come to this?\She's totally staring me down.\How did someone like you come to be going out with A-chan?\I-I worked really hard!\You idiot! I've been working really hard too!\I'm really cute when I'm with A-chan, aren't I? response:	I've been acting like that ever since I met him.
context: We need to have a little talk.\Why has it come to this?\She's totally staring me down.\How did someone like you come to be going out with A-chan?\I-I worked really hard!\You idiot! I've been working really hard too!\I'm really cute when I'm with A-chan, aren't I?\I've been acting like that ever since I met him. response:	Do you have any idea how tiring that is?
context: Why has it come to this?\She's totally staring me down.\How did someone like you come to be going out with A-chan?\I-I worked really hard!\You idiot! I've been working really hard too!\I'm really cute when I'm with A-chan, aren't I?\I've been acting like that ever since I met him.\Do you have any idea how tiring that is? response:	Th-That would be difficult...
context: She's totally staring me down.\How did someone like you come to be going out with A-chan?\I-I worked really hard!\You idiot! I've been working really hard too!\I'm really cute when I'm with A-chan, aren't I?\I've been acting like that ever since I met him.\Do you have any idea how tiring that is?\Th-That would be difficult... response:	And that's not all.
context: How did someone like you come to be going out with A-chan?\I-I worked really hard!\You idiot! I've been working really hard too!\I'm really cute when I'm with A-chan, aren't I?\I've been acting like that ever since I met him.\Do you have any idea how tiring that is?\Th-That would be difficult...\And that's not all. response:	I give A-chan milk every single day,
context: I-I worked really hard!\You idiot! I've been working really hard too!\I'm really cute when I'm with A-chan, aren't I?\I've been acting like that ever since I met him.\Do you have any idea how tiring that is?\Th-That would be difficult...\And that's not all.\I give A-chan milk every single day, response:	Seriously?
context: You idiot! I've been working really hard too!\I'm really cute when I'm with A-chan, aren't I?\I've been acting like that ever since I met him.\Do you have any idea how tiring that is?\Th-That would be difficult...\And that's not all.\I give A-chan milk every single day,\Seriously? response:	Seriously.
context: I'm really cute when I'm with A-chan, aren't I?\I've been acting like that ever since I met him.\Do you have any idea how tiring that is?\Th-That would be difficult...\And that's not all.\I give A-chan milk every single day,\Seriously?\Seriously. response:	I, on the other hand, was already over 170 cm when I was in elementary school.
context: I've been acting like that ever since I met him.\Do you have any idea how tiring that is?\Th-That would be difficult...\And that's not all.\I give A-chan milk every single day,\Seriously?\Seriously.\I, on the other hand, was already over 170 cm when I was in elementary school. response:	I was already 168 cm when I was in the sixth grade.
context: Do you have any idea how tiring that is?\Th-That would be difficult...\And that's not all.\I give A-chan milk every single day,\Seriously?\Seriously.\I, on the other hand, was already over 170 cm when I was in elementary school.\I was already 168 cm when I was in the sixth grade. response:	No way. Are you serious?
context: Th-That would be difficult...\And that's not all.\I give A-chan milk every single day,\Seriously?\Seriously.\I, on the other hand, was already over 170 cm when I was in elementary school.\I was already 168 cm when I was in the sixth grade.\No way. Are you serious? response:	Man, I've been put at the back because of my height since I was in kindergarten.
context: And that's not all.\I give A-chan milk every single day,\Seriously?\Seriously.\I, on the other hand, was already over 170 cm when I was in elementary school.\I was already 168 cm when I was in the sixth grade.\No way. Are you serious?\Man, I've been put at the back because of my height since I was in kindergarten. response:	Me too! Me too!
context: I give A-chan milk every single day,\Seriously?\Seriously.\I, on the other hand, was already over 170 cm when I was in elementary school.\I was already 168 cm when I was in the sixth grade.\No way. Are you serious?\Man, I've been put at the back because of my height since I was in kindergarten.\Me too! Me too! response:	I was even taller than the tallest boy.
context: Seriously?\Seriously.\I, on the other hand, was already over 170 cm when I was in elementary school.\I was already 168 cm when I was in the sixth grade.\No way. Are you serious?\Man, I've been put at the back because of my height since I was in kindergarten.\Me too! Me too!\I was even taller than the tallest boy. response:	Me too!
context: Seriously.\I, on the other hand, was already over 170 cm when I was in elementary school.\I was already 168 cm when I was in the sixth grade.\No way. Are you serious?\Man, I've been put at the back because of my height since I was in kindergarten.\Me too! Me too!\I was even taller than the tallest boy.\Me too! response:	Its a real pain, huh?
context: I, on the other hand, was already over 170 cm when I was in elementary school.\I was already 168 cm when I was in the sixth grade.\No way. Are you serious?\Man, I've been put at the back because of my height since I was in kindergarten.\Me too! Me too!\I was even taller than the tallest boy.\Me too!\Its a real pain, huh? response:	No matter what you do, you always draw attention.
context: I was already 168 cm when I was in the sixth grade.\No way. Are you serious?\Man, I've been put at the back because of my height since I was in kindergarten.\Me too! Me too!\I was even taller than the tallest boy.\Me too!\Its a real pain, huh?\No matter what you do, you always draw attention. response:	Totally.
context: No way. Are you serious?\Man, I've been put at the back because of my height since I was in kindergarten.\Me too! Me too!\I was even taller than the tallest boy.\Me too!\Its a real pain, huh?\No matter what you do, you always draw attention.\Totally. response:	If you talk, even just for a second, the teacher always sees
context: Man, I've been put at the back because of my height since I was in kindergarten.\Me too! Me too!\I was even taller than the tallest boy.\Me too!\Its a real pain, huh?\No matter what you do, you always draw attention.\Totally.\If you talk, even just for a second, the teacher always sees response:	Hey! Why the hell am I reminiscing with an idiot like you?!
context: Me too! Me too!\I was even taller than the tallest boy.\Me too!\Its a real pain, huh?\No matter what you do, you always draw attention.\Totally.\If you talk, even just for a second, the teacher always sees\Hey! Why the hell am I reminiscing with an idiot like you?! response:	Uh... You were trying to catch me off guard?
context: I was even taller than the tallest boy.\Me too!\Its a real pain, huh?\No matter what you do, you always draw attention.\Totally.\If you talk, even just for a second, the teacher always sees\Hey! Why the hell am I reminiscing with an idiot like you?!\Uh... You were trying to catch me off guard? response:	Shut up!
context: Me too!\Its a real pain, huh?\No matter what you do, you always draw attention.\Totally.\If you talk, even just for a second, the teacher always sees\Hey! Why the hell am I reminiscing with an idiot like you?!\Uh... You were trying to catch me off guard?\Shut up! response:	When A-chan was going out with that short, cute girl, I completely gave up.
context: Its a real pain, huh?\No matter what you do, you always draw attention.\Totally.\If you talk, even just for a second, the teacher always sees\Hey! Why the hell am I reminiscing with an idiot like you?!\Uh... You were trying to catch me off guard?\Shut up!\When A-chan was going out with that short, cute girl, I completely gave up. response:	Naturally. You'd think you had no chance with your height.
context: No matter what you do, you always draw attention.\Totally.\If you talk, even just for a second, the teacher always sees\Hey! Why the hell am I reminiscing with an idiot like you?!\Uh... You were trying to catch me off guard?\Shut up!\When A-chan was going out with that short, cute girl, I completely gave up.\Naturally. You'd think you had no chance with your height. response:	I understand.
context: Totally.\If you talk, even just for a second, the teacher always sees\Hey! Why the hell am I reminiscing with an idiot like you?!\Uh... You were trying to catch me off guard?\Shut up!\When A-chan was going out with that short, cute girl, I completely gave up.\Naturally. You'd think you had no chance with your height.\I understand. response:	Right?
context: If you talk, even just for a second, the teacher always sees\Hey! Why the hell am I reminiscing with an idiot like you?!\Uh... You were trying to catch me off guard?\Shut up!\When A-chan was going out with that short, cute girl, I completely gave up.\Naturally. You'd think you had no chance with your height.\I understand.\Right? response:	That girl was really sweet.
context: Hey! Why the hell am I reminiscing with an idiot like you?!\Uh... You were trying to catch me off guard?\Shut up!\When A-chan was going out with that short, cute girl, I completely gave up.\Naturally. You'd think you had no chance with your height.\I understand.\Right?\That girl was really sweet. response:	I thought that deep down she would've been nasty.
context: Uh... You were trying to catch me off guard?\Shut up!\When A-chan was going out with that short, cute girl, I completely gave up.\Naturally. You'd think you had no chance with your height.\I understand.\Right?\That girl was really sweet.\I thought that deep down she would've been nasty. response:	Yeah. She's not like you, Mimi-chan.
context: Shut up!\When A-chan was going out with that short, cute girl, I completely gave up.\Naturally. You'd think you had no chance with your height.\I understand.\Right?\That girl was really sweet.\I thought that deep down she would've been nasty.\Yeah. She's not like you, Mimi-chan. response:	Yeah, yeah. Deep down I'm really a nasty
context: When A-chan was going out with that short, cute girl, I completely gave up.\Naturally. You'd think you had no chance with your height.\I understand.\Right?\That girl was really sweet.\I thought that deep down she would've been nasty.\Yeah. She's not like you, Mimi-chan.\Yeah, yeah. Deep down I'm really a nasty response:	Shut that damn mouth of yours!
context: Naturally. You'd think you had no chance with your height.\I understand.\Right?\That girl was really sweet.\I thought that deep down she would've been nasty.\Yeah. She's not like you, Mimi-chan.\Yeah, yeah. Deep down I'm really a nasty\Shut that damn mouth of yours! response:	Who the hell are you calling nasty, you idiot?!
context: I understand.\Right?\That girl was really sweet.\I thought that deep down she would've been nasty.\Yeah. She's not like you, Mimi-chan.\Yeah, yeah. Deep down I'm really a nasty\Shut that damn mouth of yours!\Who the hell are you calling nasty, you idiot?! response:	S-Sorry.
context: Right?\That girl was really sweet.\I thought that deep down she would've been nasty.\Yeah. She's not like you, Mimi-chan.\Yeah, yeah. Deep down I'm really a nasty\Shut that damn mouth of yours!\Who the hell are you calling nasty, you idiot?!\S-Sorry. response:	So after he broke up with that great girlfriend, he moved on to this?
context: That girl was really sweet.\I thought that deep down she would've been nasty.\Yeah. She's not like you, Mimi-chan.\Yeah, yeah. Deep down I'm really a nasty\Shut that damn mouth of yours!\Who the hell are you calling nasty, you idiot?!\S-Sorry.\So after he broke up with that great girlfriend, he moved on to this? response:	Tall and stupid!
context: I thought that deep down she would've been nasty.\Yeah. She's not like you, Mimi-chan.\Yeah, yeah. Deep down I'm really a nasty\Shut that damn mouth of yours!\Who the hell are you calling nasty, you idiot?!\S-Sorry.\So after he broke up with that great girlfriend, he moved on to this?\Tall and stupid! response:	In any case, I'm not going to lose to you.
context: Yeah. She's not like you, Mimi-chan.\Yeah, yeah. Deep down I'm really a nasty\Shut that damn mouth of yours!\Who the hell are you calling nasty, you idiot?!\S-Sorry.\So after he broke up with that great girlfriend, he moved on to this?\Tall and stupid!\In any case, I'm not going to lose to you. response:	I'm definitely going to win A-chan back.
context: Yeah, yeah. Deep down I'm really a nasty\Shut that damn mouth of yours!\Who the hell are you calling nasty, you idiot?!\S-Sorry.\So after he broke up with that great girlfriend, he moved on to this?\Tall and stupid!\In any case, I'm not going to lose to you.\I'm definitely going to win A-chan back. response:	That's all I have to say.
context: Shut that damn mouth of yours!\Who the hell are you calling nasty, you idiot?!\S-Sorry.\So after he broke up with that great girlfriend, he moved on to this?\Tall and stupid!\In any case, I'm not going to lose to you.\I'm definitely going to win A-chan back.\That's all I have to say. response:	W-Wait!
context: Who the hell are you calling nasty, you idiot?!\S-Sorry.\So after he broke up with that great girlfriend, he moved on to this?\Tall and stupid!\In any case, I'm not going to lose to you.\I'm definitely going to win A-chan back.\That's all I have to say.\W-Wait! response:	What is it?
context: S-Sorry.\So after he broke up with that great girlfriend, he moved on to this?\Tall and stupid!\In any case, I'm not going to lose to you.\I'm definitely going to win A-chan back.\That's all I have to say.\W-Wait!\What is it? response:	So-Sorry. Could you lend me some money?
context: So after he broke up with that great girlfriend, he moved on to this?\Tall and stupid!\In any case, I'm not going to lose to you.\I'm definitely going to win A-chan back.\That's all I have to say.\W-Wait!\What is it?\So-Sorry. Could you lend me some money? response:	I only have 50 yen on me.
context: Tall and stupid!\In any case, I'm not going to lose to you.\I'm definitely going to win A-chan back.\That's all I have to say.\W-Wait!\What is it?\So-Sorry. Could you lend me some money?\I only have 50 yen on me. response:	50...
context: In any case, I'm not going to lose to you.\I'm definitely going to win A-chan back.\That's all I have to say.\W-Wait!\What is it?\So-Sorry. Could you lend me some money?\I only have 50 yen on me.\50... response:	You've got some guts, walking into a family restaurant with only that much cash on you!
context: I'm definitely going to win A-chan back.\That's all I have to say.\W-Wait!\What is it?\So-Sorry. Could you lend me some money?\I only have 50 yen on me.\50...\You've got some guts, walking into a family restaurant with only that much cash on you! response:	I forgot that I bought a magazine today.
context: That's all I have to say.\W-Wait!\What is it?\So-Sorry. Could you lend me some money?\I only have 50 yen on me.\50...\You've got some guts, walking into a family restaurant with only that much cash on you!\I forgot that I bought a magazine today. response:	You looked so cute and sweet that I totally forgot.
context: W-Wait!\What is it?\So-Sorry. Could you lend me some money?\I only have 50 yen on me.\50...\You've got some guts, walking into a family restaurant with only that much cash on you!\I forgot that I bought a magazine today.\You looked so cute and sweet that I totally forgot. response:	Well, I guess that can't be helped.
context: What is it?\So-Sorry. Could you lend me some money?\I only have 50 yen on me.\50...\You've got some guts, walking into a family restaurant with only that much cash on you!\I forgot that I bought a magazine today.\You looked so cute and sweet that I totally forgot.\Well, I guess that can't be helped. response:	It was a special situation today, so I'll lend you some money.
context: So-Sorry. Could you lend me some money?\I only have 50 yen on me.\50...\You've got some guts, walking into a family restaurant with only that much cash on you!\I forgot that I bought a magazine today.\You looked so cute and sweet that I totally forgot.\Well, I guess that can't be helped.\It was a special situation today, so I'll lend you some money. response:	Wow. You sure are nice.
context: I only have 50 yen on me.\50...\You've got some guts, walking into a family restaurant with only that much cash on you!\I forgot that I bought a magazine today.\You looked so cute and sweet that I totally forgot.\Well, I guess that can't be helped.\It was a special situation today, so I'll lend you some money.\Wow. You sure are nice. response:	I think I left my purse at work.
context: 50...\You've got some guts, walking into a family restaurant with only that much cash on you!\I forgot that I bought a magazine today.\You looked so cute and sweet that I totally forgot.\Well, I guess that can't be helped.\It was a special situation today, so I'll lend you some money.\Wow. You sure are nice.\I think I left my purse at work. response:	What should we do?!
context: You've got some guts, walking into a family restaurant with only that much cash on you!\I forgot that I bought a magazine today.\You looked so cute and sweet that I totally forgot.\Well, I guess that can't be helped.\It was a special situation today, so I'll lend you some money.\Wow. You sure are nice.\I think I left my purse at work.\What should we do?! response:	No idea...
context: I forgot that I bought a magazine today.\You looked so cute and sweet that I totally forgot.\Well, I guess that can't be helped.\It was a special situation today, so I'll lend you some money.\Wow. You sure are nice.\I think I left my purse at work.\What should we do?!\No idea... response:	The total comes to 630 yen.
context: You looked so cute and sweet that I totally forgot.\Well, I guess that can't be helped.\It was a special situation today, so I'll lend you some money.\Wow. You sure are nice.\I think I left my purse at work.\What should we do?!\No idea...\The total comes to 630 yen. response:	What were you thinking?
context: Well, I guess that can't be helped.\It was a special situation today, so I'll lend you some money.\Wow. You sure are nice.\I think I left my purse at work.\What should we do?!\No idea...\The total comes to 630 yen.\What were you thinking? response:	I'm really sorry.
context: It was a special situation today, so I'll lend you some money.\Wow. You sure are nice.\I think I left my purse at work.\What should we do?!\No idea...\The total comes to 630 yen.\What were you thinking?\I'm really sorry. response:	A-chan.
context: Wow. You sure are nice.\I think I left my purse at work.\What should we do?!\No idea...\The total comes to 630 yen.\What were you thinking?\I'm really sorry.\A-chan. response:	Just what is it that you like about her?
context: I think I left my purse at work.\What should we do?!\No idea...\The total comes to 630 yen.\What were you thinking?\I'm really sorry.\A-chan.\Just what is it that you like about her? response:	What's this, all of a sudden?!
context: What should we do?!\No idea...\The total comes to 630 yen.\What were you thinking?\I'm really sorry.\A-chan.\Just what is it that you like about her?\What's this, all of a sudden?! response:	Well, she's nothing like your last girlfriend.
context: No idea...\The total comes to 630 yen.\What were you thinking?\I'm really sorry.\A-chan.\Just what is it that you like about her?\What's this, all of a sudden?!\Well, she's nothing like your last girlfriend. response:	She's taller than you,
context: The total comes to 630 yen.\What were you thinking?\I'm really sorry.\A-chan.\Just what is it that you like about her?\What's this, all of a sudden?!\Well, she's nothing like your last girlfriend.\She's taller than you, response:	I just can't see what's so great about her.
context: What were you thinking?\I'm really sorry.\A-chan.\Just what is it that you like about her?\What's this, all of a sudden?!\Well, she's nothing like your last girlfriend.\She's taller than you,\I just can't see what's so great about her. response:	This isn't the time or the place to talk about this.
context: I'm really sorry.\A-chan.\Just what is it that you like about her?\What's this, all of a sudden?!\Well, she's nothing like your last girlfriend.\She's taller than you,\I just can't see what's so great about her.\This isn't the time or the place to talk about this. response:	Tell me! I need to know!
context: A-chan.\Just what is it that you like about her?\What's this, all of a sudden?!\Well, she's nothing like your last girlfriend.\She's taller than you,\I just can't see what's so great about her.\This isn't the time or the place to talk about this.\Tell me! I need to know! response:	You don't need to. It's not like it's any of your business.
context: Just what is it that you like about her?\What's this, all of a sudden?!\Well, she's nothing like your last girlfriend.\She's taller than you,\I just can't see what's so great about her.\This isn't the time or the place to talk about this.\Tell me! I need to know!\You don't need to. It's not like it's any of your business. response:	Otani
context: What's this, all of a sudden?!\Well, she's nothing like your last girlfriend.\She's taller than you,\I just can't see what's so great about her.\This isn't the time or the place to talk about this.\Tell me! I need to know!\You don't need to. It's not like it's any of your business.\Otani response:	It is my business.
context: Well, she's nothing like your last girlfriend.\She's taller than you,\I just can't see what's so great about her.\This isn't the time or the place to talk about this.\Tell me! I need to know!\You don't need to. It's not like it's any of your business.\Otani\It is my business. response:	I like you much more than she does!
context: She's taller than you,\I just can't see what's so great about her.\This isn't the time or the place to talk about this.\Tell me! I need to know!\You don't need to. It's not like it's any of your business.\Otani\It is my business.\I like you much more than she does! response:	Mimi-chan...
context: I just can't see what's so great about her.\This isn't the time or the place to talk about this.\Tell me! I need to know!\You don't need to. It's not like it's any of your business.\Otani\It is my business.\I like you much more than she does!\Mimi-chan... response:	Are you serious?
context: This isn't the time or the place to talk about this.\Tell me! I need to know!\You don't need to. It's not like it's any of your business.\Otani\It is my business.\I like you much more than she does!\Mimi-chan...\Are you serious? response:	You're an idiot, A-chan!
context: Tell me! I need to know!\You don't need to. It's not like it's any of your business.\Otani\It is my business.\I like you much more than she does!\Mimi-chan...\Are you serious?\You're an idiot, A-chan! response:	Mimi?
context: You don't need to. It's not like it's any of your business.\Otani\It is my business.\I like you much more than she does!\Mimi-chan...\Are you serious?\You're an idiot, A-chan!\Mimi? response:	I'll go after her.
context: Otani\It is my business.\I like you much more than she does!\Mimi-chan...\Are you serious?\You're an idiot, A-chan!\Mimi?\I'll go after her. response:	Huh? Wait
context: It is my business.\I like you much more than she does!\Mimi-chan...\Are you serious?\You're an idiot, A-chan!\Mimi?\I'll go after her.\Huh? Wait response:	After all, I understand how Mimi-chan feels.
context: I like you much more than she does!\Mimi-chan...\Are you serious?\You're an idiot, A-chan!\Mimi?\I'll go after her.\Huh? Wait\After all, I understand how Mimi-chan feels. response:	Did A-chan say anything?
context: Mimi-chan...\Are you serious?\You're an idiot, A-chan!\Mimi?\I'll go after her.\Huh? Wait\After all, I understand how Mimi-chan feels.\Did A-chan say anything? response:	Is he angry with me?
context: Are you serious?\You're an idiot, A-chan!\Mimi?\I'll go after her.\Huh? Wait\After all, I understand how Mimi-chan feels.\Did A-chan say anything?\Is he angry with me? response:	No. He's not angry.
context: You're an idiot, A-chan!\Mimi?\I'll go after her.\Huh? Wait\After all, I understand how Mimi-chan feels.\Did A-chan say anything?\Is he angry with me?\No. He's not angry. response:	But I... I yelled at him and called him an idiot.
context: Mimi?\I'll go after her.\Huh? Wait\After all, I understand how Mimi-chan feels.\Did A-chan say anything?\Is he angry with me?\No. He's not angry.\But I... I yelled at him and called him an idiot. response:	You're an idiot, A-chan!
context: I'll go after her.\Huh? Wait\After all, I understand how Mimi-chan feels.\Did A-chan say anything?\Is he angry with me?\No. He's not angry.\But I... I yelled at him and called him an idiot.\You're an idiot, A-chan! response:	You don't need to worry about that.
context: Huh? Wait\After all, I understand how Mimi-chan feels.\Did A-chan say anything?\Is he angry with me?\No. He's not angry.\But I... I yelled at him and called him an idiot.\You're an idiot, A-chan!\You don't need to worry about that. response:	He really is an idiot, after all.
context: After all, I understand how Mimi-chan feels.\Did A-chan say anything?\Is he angry with me?\No. He's not angry.\But I... I yelled at him and called him an idiot.\You're an idiot, A-chan!\You don't need to worry about that.\He really is an idiot, after all. response:	How could he say that in response to a confession? That idiot...
context: Did A-chan say anything?\Is he angry with me?\No. He's not angry.\But I... I yelled at him and called him an idiot.\You're an idiot, A-chan!\You don't need to worry about that.\He really is an idiot, after all.\How could he say that in response to a confession? That idiot... response:	A-chan is not an idiot!
context: Is he angry with me?\No. He's not angry.\But I... I yelled at him and called him an idiot.\You're an idiot, A-chan!\You don't need to worry about that.\He really is an idiot, after all.\How could he say that in response to a confession? That idiot...\A-chan is not an idiot! response:	Anyone would be shocked by a sudden confession like that!
context: No. He's not angry.\But I... I yelled at him and called him an idiot.\You're an idiot, A-chan!\You don't need to worry about that.\He really is an idiot, after all.\How could he say that in response to a confession? That idiot...\A-chan is not an idiot!\Anyone would be shocked by a sudden confession like that! response:	I'm the one who was in the wrong.
context: But I... I yelled at him and called him an idiot.\You're an idiot, A-chan!\You don't need to worry about that.\He really is an idiot, after all.\How could he say that in response to a confession? That idiot...\A-chan is not an idiot!\Anyone would be shocked by a sudden confession like that!\I'm the one who was in the wrong. response:	Don't say bad things about A-chan!
context: You're an idiot, A-chan!\You don't need to worry about that.\He really is an idiot, after all.\How could he say that in response to a confession? That idiot...\A-chan is not an idiot!\Anyone would be shocked by a sudden confession like that!\I'm the one who was in the wrong.\Don't say bad things about A-chan! response:	I've never talked to him that way before.
context: You don't need to worry about that.\He really is an idiot, after all.\How could he say that in response to a confession? That idiot...\A-chan is not an idiot!\Anyone would be shocked by a sudden confession like that!\I'm the one who was in the wrong.\Don't say bad things about A-chan!\I've never talked to him that way before. response:	I lost it and said something I shouldn't have...
context: He really is an idiot, after all.\How could he say that in response to a confession? That idiot...\A-chan is not an idiot!\Anyone would be shocked by a sudden confession like that!\I'm the one who was in the wrong.\Don't say bad things about A-chan!\I've never talked to him that way before.\I lost it and said something I shouldn't have... response:	This is all your fault, you cow!
context: How could he say that in response to a confession? That idiot...\A-chan is not an idiot!\Anyone would be shocked by a sudden confession like that!\I'm the one who was in the wrong.\Don't say bad things about A-chan!\I've never talked to him that way before.\I lost it and said something I shouldn't have...\This is all your fault, you cow! response:	It's your fault that my life is falling apart!
context: A-chan is not an idiot!\Anyone would be shocked by a sudden confession like that!\I'm the one who was in the wrong.\Don't say bad things about A-chan!\I've never talked to him that way before.\I lost it and said something I shouldn't have...\This is all your fault, you cow!\It's your fault that my life is falling apart! response:	What are you gonna do about it, eh?
context: Anyone would be shocked by a sudden confession like that!\I'm the one who was in the wrong.\Don't say bad things about A-chan!\I've never talked to him that way before.\I lost it and said something I shouldn't have...\This is all your fault, you cow!\It's your fault that my life is falling apart!\What are you gonna do about it, eh? response:	Cat got your tongue? Why don't you try responding?
context: I'm the one who was in the wrong.\Don't say bad things about A-chan!\I've never talked to him that way before.\I lost it and said something I shouldn't have...\This is all your fault, you cow!\It's your fault that my life is falling apart!\What are you gonna do about it, eh?\Cat got your tongue? Why don't you try responding? response:	Are you lookin' for a fight, you dumb bitch?!
context: Don't say bad things about A-chan!\I've never talked to him that way before.\I lost it and said something I shouldn't have...\This is all your fault, you cow!\It's your fault that my life is falling apart!\What are you gonna do about it, eh?\Cat got your tongue? Why don't you try responding?\Are you lookin' for a fight, you dumb bitch?! response:	Mi...mi...
context: I've never talked to him that way before.\I lost it and said something I shouldn't have...\This is all your fault, you cow!\It's your fault that my life is falling apart!\What are you gonna do about it, eh?\Cat got your tongue? Why don't you try responding?\Are you lookin' for a fight, you dumb bitch?!\Mi...mi... response:	Oh dear...
context: I lost it and said something I shouldn't have...\This is all your fault, you cow!\It's your fault that my life is falling apart!\What are you gonna do about it, eh?\Cat got your tongue? Why don't you try responding?\Are you lookin' for a fight, you dumb bitch?!\Mi...mi...\Oh dear... response:	She must be really down, now that you've seen her true colors.
context: This is all your fault, you cow!\It's your fault that my life is falling apart!\What are you gonna do about it, eh?\Cat got your tongue? Why don't you try responding?\Are you lookin' for a fight, you dumb bitch?!\Mi...mi...\Oh dear...\She must be really down, now that you've seen her true colors. response:	What do you mean by that?
context: It's your fault that my life is falling apart!\What are you gonna do about it, eh?\Cat got your tongue? Why don't you try responding?\Are you lookin' for a fight, you dumb bitch?!\Mi...mi...\Oh dear...\She must be really down, now that you've seen her true colors.\What do you mean by that? response:	Are you trying to tell me that the Mimi I know...
context: What are you gonna do about it, eh?\Cat got your tongue? Why don't you try responding?\Are you lookin' for a fight, you dumb bitch?!\Mi...mi...\Oh dear...\She must be really down, now that you've seen her true colors.\What do you mean by that?\Are you trying to tell me that the Mimi I know... response:	Of course she wants to act cute in front of the guy she likes.
context: Cat got your tongue? Why don't you try responding?\Are you lookin' for a fight, you dumb bitch?!\Mi...mi...\Oh dear...\She must be really down, now that you've seen her true colors.\What do you mean by that?\Are you trying to tell me that the Mimi I know...\Of course she wants to act cute in front of the guy she likes. response:	I do it too!
context: Are you lookin' for a fight, you dumb bitch?!\Mi...mi...\Oh dear...\She must be really down, now that you've seen her true colors.\What do you mean by that?\Are you trying to tell me that the Mimi I know...\Of course she wants to act cute in front of the guy she likes.\I do it too! response:	Gross, gross.
context: Mi...mi...\Oh dear...\She must be really down, now that you've seen her true colors.\What do you mean by that?\Are you trying to tell me that the Mimi I know...\Of course she wants to act cute in front of the guy she likes.\I do it too!\Gross, gross. response:	What do you mean, gross?
context: Oh dear...\She must be really down, now that you've seen her true colors.\What do you mean by that?\Are you trying to tell me that the Mimi I know...\Of course she wants to act cute in front of the guy she likes.\I do it too!\Gross, gross.\What do you mean, gross? response:	See, there you go.
context: She must be really down, now that you've seen her true colors.\What do you mean by that?\Are you trying to tell me that the Mimi I know...\Of course she wants to act cute in front of the guy she likes.\I do it too!\Gross, gross.\What do you mean, gross?\See, there you go. response:	How is that cute?
context: What do you mean by that?\Are you trying to tell me that the Mimi I know...\Of course she wants to act cute in front of the guy she likes.\I do it too!\Gross, gross.\What do you mean, gross?\See, there you go.\How is that cute? response:	This happens because you say pointless things...
context: Are you trying to tell me that the Mimi I know...\Of course she wants to act cute in front of the guy she likes.\I do it too!\Gross, gross.\What do you mean, gross?\See, there you go.\How is that cute?\This happens because you say pointless things... response:	Well, never mind that.
context: Of course she wants to act cute in front of the guy she likes.\I do it too!\Gross, gross.\What do you mean, gross?\See, there you go.\How is that cute?\This happens because you say pointless things...\Well, never mind that. response:	Has Mimi-chan contacted you?
context: I do it too!\Gross, gross.\What do you mean, gross?\See, there you go.\How is that cute?\This happens because you say pointless things...\Well, never mind that.\Has Mimi-chan contacted you? response:	Yeah.
context: Gross, gross.\What do you mean, gross?\See, there you go.\How is that cute?\This happens because you say pointless things...\Well, never mind that.\Has Mimi-chan contacted you?\Yeah. response:	She said the three of us should do something after school today.
context: What do you mean, gross?\See, there you go.\How is that cute?\This happens because you say pointless things...\Well, never mind that.\Has Mimi-chan contacted you?\Yeah.\She said the three of us should do something after school today. response:	W-Why?
context: See, there you go.\How is that cute?\This happens because you say pointless things...\Well, never mind that.\Has Mimi-chan contacted you?\Yeah.\She said the three of us should do something after school today.\W-Why? response:	Now that her cover's blown, Mimi-chan's going to get serious, right?
context: How is that cute?\This happens because you say pointless things...\Well, never mind that.\Has Mimi-chan contacted you?\Yeah.\She said the three of us should do something after school today.\W-Why?\Now that her cover's blown, Mimi-chan's going to get serious, right? response:	What do you mean by serious?
context: This happens because you say pointless things...\Well, never mind that.\Has Mimi-chan contacted you?\Yeah.\She said the three of us should do something after school today.\W-Why?\Now that her cover's blown, Mimi-chan's going to get serious, right?\What do you mean by serious? response:	What would happen to an idiot like Otani if a pretty girl like her got serious about him?
context: Well, never mind that.\Has Mimi-chan contacted you?\Yeah.\She said the three of us should do something after school today.\W-Why?\Now that her cover's blown, Mimi-chan's going to get serious, right?\What do you mean by serious?\What would happen to an idiot like Otani if a pretty girl like her got serious about him? response:	I'm not going to lose!
context: Has Mimi-chan contacted you?\Yeah.\She said the three of us should do something after school today.\W-Why?\Now that her cover's blown, Mimi-chan's going to get serious, right?\What do you mean by serious?\What would happen to an idiot like Otani if a pretty girl like her got serious about him?\I'm not going to lose! response:	I'm not going to let all of my efforts go to waste!
context: Yeah.\She said the three of us should do something after school today.\W-Why?\Now that her cover's blown, Mimi-chan's going to get serious, right?\What do you mean by serious?\What would happen to an idiot like Otani if a pretty girl like her got serious about him?\I'm not going to lose!\I'm not going to let all of my efforts go to waste! response:	We'll go wherever you want, A-chan.
context: She said the three of us should do something after school today.\W-Why?\Now that her cover's blown, Mimi-chan's going to get serious, right?\What do you mean by serious?\What would happen to an idiot like Otani if a pretty girl like her got serious about him?\I'm not going to lose!\I'm not going to let all of my efforts go to waste!\We'll go wherever you want, A-chan. response:	That's okay, right?
context: W-Why?\Now that her cover's blown, Mimi-chan's going to get serious, right?\What do you mean by serious?\What would happen to an idiot like Otani if a pretty girl like her got serious about him?\I'm not going to lose!\I'm not going to let all of my efforts go to waste!\We'll go wherever you want, A-chan.\That's okay, right? response:	It's fine.
context: Now that her cover's blown, Mimi-chan's going to get serious, right?\What do you mean by serious?\What would happen to an idiot like Otani if a pretty girl like her got serious about him?\I'm not going to lose!\I'm not going to let all of my efforts go to waste!\We'll go wherever you want, A-chan.\That's okay, right?\It's fine. response:	H-Hold on, you two...
context: What do you mean by serious?\What would happen to an idiot like Otani if a pretty girl like her got serious about him?\I'm not going to lose!\I'm not going to let all of my efforts go to waste!\We'll go wherever you want, A-chan.\That's okay, right?\It's fine.\H-Hold on, you two... response:	Let's go, A-chan.
context: What would happen to an idiot like Otani if a pretty girl like her got serious about him?\I'm not going to lose!\I'm not going to let all of my efforts go to waste!\We'll go wherever you want, A-chan.\That's okay, right?\It's fine.\H-Hold on, you two...\Let's go, A-chan. response:	Please, just go away, both of you.
context: I'm not going to lose!\I'm not going to let all of my efforts go to waste!\We'll go wherever you want, A-chan.\That's okay, right?\It's fine.\H-Hold on, you two...\Let's go, A-chan.\Please, just go away, both of you. response:	Sweet!
context: I'm not going to let all of my efforts go to waste!\We'll go wherever you want, A-chan.\That's okay, right?\It's fine.\H-Hold on, you two...\Let's go, A-chan.\Please, just go away, both of you.\Sweet! response:	What should we play? What should we play?
context: We'll go wherever you want, A-chan.\That's okay, right?\It's fine.\H-Hold on, you two...\Let's go, A-chan.\Please, just go away, both of you.\Sweet!\What should we play? What should we play? response:	Ah! That one's free. Let's go!
context: That's okay, right?\It's fine.\H-Hold on, you two...\Let's go, A-chan.\Please, just go away, both of you.\Sweet!\What should we play? What should we play?\Ah! That one's free. Let's go! response:	Awesome!
context: It's fine.\H-Hold on, you two...\Let's go, A-chan.\Please, just go away, both of you.\Sweet!\What should we play? What should we play?\Ah! That one's free. Let's go!\Awesome! response:	A-chan?
context: H-Hold on, you two...\Let's go, A-chan.\Please, just go away, both of you.\Sweet!\What should we play? What should we play?\Ah! That one's free. Let's go!\Awesome!\A-chan? response:	Huh? Where's Mimi-chan?
context: Let's go, A-chan.\Please, just go away, both of you.\Sweet!\What should we play? What should we play?\Ah! That one's free. Let's go!\Awesome!\A-chan?\Huh? Where's Mimi-chan? response:	Oh, there you are.
context: Please, just go away, both of you.\Sweet!\What should we play? What should we play?\Ah! That one's free. Let's go!\Awesome!\A-chan?\Huh? Where's Mimi-chan?\Oh, there you are. response:	Mimi-chan, come play with us.
context: Sweet!\What should we play? What should we play?\Ah! That one's free. Let's go!\Awesome!\A-chan?\Huh? Where's Mimi-chan?\Oh, there you are.\Mimi-chan, come play with us. response:	I'm going home.
context: What should we play? What should we play?\Ah! That one's free. Let's go!\Awesome!\A-chan?\Huh? Where's Mimi-chan?\Oh, there you are.\Mimi-chan, come play with us.\I'm going home. response:	I'm going home!
context: Ah! That one's free. Let's go!\Awesome!\A-chan?\Huh? Where's Mimi-chan?\Oh, there you are.\Mimi-chan, come play with us.\I'm going home.\I'm going home! response:	Mimi!
context: Awesome!\A-chan?\Huh? Where's Mimi-chan?\Oh, there you are.\Mimi-chan, come play with us.\I'm going home.\I'm going home!\Mimi! response:	There's something I need to say to you properly.
context: A-chan?\Huh? Where's Mimi-chan?\Oh, there you are.\Mimi-chan, come play with us.\I'm going home.\I'm going home!\Mimi!\There's something I need to say to you properly. response:	I don't want to hear it.
context: Huh? Where's Mimi-chan?\Oh, there you are.\Mimi-chan, come play with us.\I'm going home.\I'm going home!\Mimi!\There's something I need to say to you properly.\I don't want to hear it. response:	You're going to reject me, right?
context: Oh, there you are.\Mimi-chan, come play with us.\I'm going home.\I'm going home!\Mimi!\There's something I need to say to you properly.\I don't want to hear it.\You're going to reject me, right? response:	Mimi-chan...
context: Mimi-chan, come play with us.\I'm going home.\I'm going home!\Mimi!\There's something I need to say to you properly.\I don't want to hear it.\You're going to reject me, right?\Mimi-chan... response:	Mimi...
context: I'm going home.\I'm going home!\Mimi!\There's something I need to say to you properly.\I don't want to hear it.\You're going to reject me, right?\Mimi-chan...\Mimi... response:	No.
context: I'm going home!\Mimi!\There's something I need to say to you properly.\I don't want to hear it.\You're going to reject me, right?\Mimi-chan...\Mimi...\No. response:	Mimi.
context: Mimi!\There's something I need to say to you properly.\I don't want to hear it.\You're going to reject me, right?\Mimi-chan...\Mimi...\No.\Mimi. response:	I said, no!
context: There's something I need to say to you properly.\I don't want to hear it.\You're going to reject me, right?\Mimi-chan...\Mimi...\No.\Mimi.\I said, no! response:	Mimi! Listen to me!
context: I don't want to hear it.\You're going to reject me, right?\Mimi-chan...\Mimi...\No.\Mimi.\I said, no!\Mimi! Listen to me! response:	No! I don't want to hear it!
context: You're going to reject me, right?\Mimi-chan...\Mimi...\No.\Mimi.\I said, no!\Mimi! Listen to me!\No! I don't want to hear it! response:	About Koizumi, I...
context: Mimi-chan...\Mimi...\No.\Mimi.\I said, no!\Mimi! Listen to me!\No! I don't want to hear it!\About Koizumi, I... response:	No! No! Stop!
context: Mimi...\No.\Mimi.\I said, no!\Mimi! Listen to me!\No! I don't want to hear it!\About Koizumi, I...\No! No! Stop! response:	Mimi!
context: No.\Mimi.\I said, no!\Mimi! Listen to me!\No! I don't want to hear it!\About Koizumi, I...\No! No! Stop!\Mimi! response:	No!
context: Mimi.\I said, no!\Mimi! Listen to me!\No! I don't want to hear it!\About Koizumi, I...\No! No! Stop!\Mimi!\No! response:	Don't say it!
context: I said, no!\Mimi! Listen to me!\No! I don't want to hear it!\About Koizumi, I...\No! No! Stop!\Mimi!\No!\Don't say it! response:	Idiot!
context: Mimi! Listen to me!\No! I don't want to hear it!\About Koizumi, I...\No! No! Stop!\Mimi!\No!\Don't say it!\Idiot! response:	Wh-What the...
context: No! I don't want to hear it!\About Koizumi, I...\No! No! Stop!\Mimi!\No!\Don't say it!\Idiot!\Wh-What the... response:	I thought you liked Otani more than me!
context: About Koizumi, I...\No! No! Stop!\Mimi!\No!\Don't say it!\Idiot!\Wh-What the...\I thought you liked Otani more than me! response:	Was that all just talk?
context: No! No! Stop!\Mimi!\No!\Don't say it!\Idiot!\Wh-What the...\I thought you liked Otani more than me!\Was that all just talk? response:	You're his girlfriend. Like you'd know how it feels to be rejected!
context: Mimi!\No!\Don't say it!\Idiot!\Wh-What the...\I thought you liked Otani more than me!\Was that all just talk?\You're his girlfriend. Like you'd know how it feels to be rejected! response:	I do know how! I was rejected, too! Twice!
context: No!\Don't say it!\Idiot!\Wh-What the...\I thought you liked Otani more than me!\Was that all just talk?\You're his girlfriend. Like you'd know how it feels to be rejected!\I do know how! I was rejected, too! Twice! response:	I thought about giving up, too,
context: Don't say it!\Idiot!\Wh-What the...\I thought you liked Otani more than me!\Was that all just talk?\You're his girlfriend. Like you'd know how it feels to be rejected!\I do know how! I was rejected, too! Twice!\I thought about giving up, too, response:	No way.
context: Idiot!\Wh-What the...\I thought you liked Otani more than me!\Was that all just talk?\You're his girlfriend. Like you'd know how it feels to be rejected!\I do know how! I was rejected, too! Twice!\I thought about giving up, too,\No way. response:	I might be his girlfriend now,
context: Wh-What the...\I thought you liked Otani more than me!\Was that all just talk?\You're his girlfriend. Like you'd know how it feels to be rejected!\I do know how! I was rejected, too! Twice!\I thought about giving up, too,\No way.\I might be his girlfriend now, response:	I can hardly tell whether he actually likes me or not.
context: I thought you liked Otani more than me!\Was that all just talk?\You're his girlfriend. Like you'd know how it feels to be rejected!\I do know how! I was rejected, too! Twice!\I thought about giving up, too,\No way.\I might be his girlfriend now,\I can hardly tell whether he actually likes me or not. response:	Hey, what're you sayi
context: Was that all just talk?\You're his girlfriend. Like you'd know how it feels to be rejected!\I do know how! I was rejected, too! Twice!\I thought about giving up, too,\No way.\I might be his girlfriend now,\I can hardly tell whether he actually likes me or not.\Hey, what're you sayi response:	But I love him more than I can say, so it's fine.
context: You're his girlfriend. Like you'd know how it feels to be rejected!\I do know how! I was rejected, too! Twice!\I thought about giving up, too,\No way.\I might be his girlfriend now,\I can hardly tell whether he actually likes me or not.\Hey, what're you sayi\But I love him more than I can say, so it's fine. response:	I'm not going to give Otani up to someone who just runs away when she gets rejected.
context: I do know how! I was rejected, too! Twice!\I thought about giving up, too,\No way.\I might be his girlfriend now,\I can hardly tell whether he actually likes me or not.\Hey, what're you sayi\But I love him more than I can say, so it's fine.\I'm not going to give Otani up to someone who just runs away when she gets rejected. response:	So, did Mimi-chan storm off?
context: I thought about giving up, too,\No way.\I might be his girlfriend now,\I can hardly tell whether he actually likes me or not.\Hey, what're you sayi\But I love him more than I can say, so it's fine.\I'm not going to give Otani up to someone who just runs away when she gets rejected.\So, did Mimi-chan storm off? response:	No, no.
context: No way.\I might be his girlfriend now,\I can hardly tell whether he actually likes me or not.\Hey, what're you sayi\But I love him more than I can say, so it's fine.\I'm not going to give Otani up to someone who just runs away when she gets rejected.\So, did Mimi-chan storm off?\No, no. response:	She said she can't deal with an idiot like you, so she's giving up on me.
context: I might be his girlfriend now,\I can hardly tell whether he actually likes me or not.\Hey, what're you sayi\But I love him more than I can say, so it's fine.\I'm not going to give Otani up to someone who just runs away when she gets rejected.\So, did Mimi-chan storm off?\No, no.\She said she can't deal with an idiot like you, so she's giving up on me. response:	What's up with that?
context: I can hardly tell whether he actually likes me or not.\Hey, what're you sayi\But I love him more than I can say, so it's fine.\I'm not going to give Otani up to someone who just runs away when she gets rejected.\So, did Mimi-chan storm off?\No, no.\She said she can't deal with an idiot like you, so she's giving up on me.\What's up with that? response:	It must have hurt her a lot the first time you rejected her.
context: Hey, what're you sayi\But I love him more than I can say, so it's fine.\I'm not going to give Otani up to someone who just runs away when she gets rejected.\So, did Mimi-chan storm off?\No, no.\She said she can't deal with an idiot like you, so she's giving up on me.\What's up with that?\It must have hurt her a lot the first time you rejected her. response:	But she worked hard to win you over.
context: But I love him more than I can say, so it's fine.\I'm not going to give Otani up to someone who just runs away when she gets rejected.\So, did Mimi-chan storm off?\No, no.\She said she can't deal with an idiot like you, so she's giving up on me.\What's up with that?\It must have hurt her a lot the first time you rejected her.\But she worked hard to win you over. response:	She really is amazing, that girl.
context: I'm not going to give Otani up to someone who just runs away when she gets rejected.\So, did Mimi-chan storm off?\No, no.\She said she can't deal with an idiot like you, so she's giving up on me.\What's up with that?\It must have hurt her a lot the first time you rejected her.\But she worked hard to win you over.\She really is amazing, that girl. response:	What was that you were saying back there?
context: So, did Mimi-chan storm off?\No, no.\She said she can't deal with an idiot like you, so she's giving up on me.\What's up with that?\It must have hurt her a lot the first time you rejected her.\But she worked hard to win you over.\She really is amazing, that girl.\What was that you were saying back there? response:	Something about not being able to tell whether I actually like you or not, wasn't it?
context: No, no.\She said she can't deal with an idiot like you, so she's giving up on me.\What's up with that?\It must have hurt her a lot the first time you rejected her.\But she worked hard to win you over.\She really is amazing, that girl.\What was that you were saying back there?\Something about not being able to tell whether I actually like you or not, wasn't it? response:	Ahh, that was just...
context: She said she can't deal with an idiot like you, so she's giving up on me.\What's up with that?\It must have hurt her a lot the first time you rejected her.\But she worked hard to win you over.\She really is amazing, that girl.\What was that you were saying back there?\Something about not being able to tell whether I actually like you or not, wasn't it?\Ahh, that was just... response:	You deliberately stood on higher steps.
context: What's up with that?\It must have hurt her a lot the first time you rejected her.\But she worked hard to win you over.\She really is amazing, that girl.\What was that you were saying back there?\Something about not being able to tell whether I actually like you or not, wasn't it?\Ahh, that was just...\You deliberately stood on higher steps. response:	Well, I wouldn't have been as cool if we were standing on level ground.
context: It must have hurt her a lot the first time you rejected her.\But she worked hard to win you over.\She really is amazing, that girl.\What was that you were saying back there?\Something about not being able to tell whether I actually like you or not, wasn't it?\Ahh, that was just...\You deliberately stood on higher steps.\Well, I wouldn't have been as cool if we were standing on level ground. response:	Let's go.
context: But she worked hard to win you over.\She really is amazing, that girl.\What was that you were saying back there?\Something about not being able to tell whether I actually like you or not, wasn't it?\Ahh, that was just...\You deliberately stood on higher steps.\Well, I wouldn't have been as cool if we were standing on level ground.\Let's go. response:	A lot has happened,
context: She really is amazing, that girl.\What was that you were saying back there?\Something about not being able to tell whether I actually like you or not, wasn't it?\Ahh, that was just...\You deliberately stood on higher steps.\Well, I wouldn't have been as cool if we were standing on level ground.\Let's go.\A lot has happened, response:	Are you writing test questions?
context: What was that you were saying back there?\Something about not being able to tell whether I actually like you or not, wasn't it?\Ahh, that was just...\You deliberately stood on higher steps.\Well, I wouldn't have been as cool if we were standing on level ground.\Let's go.\A lot has happened,\Are you writing test questions? response:	Ah, no.
context: Something about not being able to tell whether I actually like you or not, wasn't it?\Ahh, that was just...\You deliberately stood on higher steps.\Well, I wouldn't have been as cool if we were standing on level ground.\Let's go.\A lot has happened,\Are you writing test questions?\Ah, no. response:	I was just looking over what the students aim to do in the future.
context: Ahh, that was just...\You deliberately stood on higher steps.\Well, I wouldn't have been as cool if we were standing on level ground.\Let's go.\A lot has happened,\Are you writing test questions?\Ah, no.\I was just looking over what the students aim to do in the future. response:	It's almost time for them to make their final decisions, isn't it?
context: You deliberately stood on higher steps.\Well, I wouldn't have been as cool if we were standing on level ground.\Let's go.\A lot has happened,\Are you writing test questions?\Ah, no.\I was just looking over what the students aim to do in the future.\It's almost time for them to make their final decisions, isn't it? response:	That is is.
context: Well, I wouldn't have been as cool if we were standing on level ground.\Let's go.\A lot has happened,\Are you writing test questions?\Ah, no.\I was just looking over what the students aim to do in the future.\It's almost time for them to make their final decisions, isn't it?\That is is. response:	It looks like All Hanshin-Kyojin will finally have to break up.
context: Let's go.\A lot has happened,\Are you writing test questions?\Ah, no.\I was just looking over what the students aim to do in the future.\It's almost time for them to make their final decisions, isn't it?\That is is.\It looks like All Hanshin-Kyojin will finally have to break up. response:	Career Guidance Questionnaire
context: A lot has happened,\Are you writing test questions?\Ah, no.\I was just looking over what the students aim to do in the future.\It's almost time for them to make their final decisions, isn't it?\That is is.\It looks like All Hanshin-Kyojin will finally have to break up.\Career Guidance Questionnaire response:	Otani Atsushi
context: Are you writing test questions?\Ah, no.\I was just looking over what the students aim to do in the future.\It's almost time for them to make their final decisions, isn't it?\That is is.\It looks like All Hanshin-Kyojin will finally have to break up.\Career Guidance Questionnaire\Otani Atsushi response:	University
context: Ah, no.\I was just looking over what the students aim to do in the future.\It's almost time for them to make their final decisions, isn't it?\That is is.\It looks like All Hanshin-Kyojin will finally have to break up.\Career Guidance Questionnaire\Otani Atsushi\University response:	Are you going to college?
context: I was just looking over what the students aim to do in the future.\It's almost time for them to make their final decisions, isn't it?\That is is.\It looks like All Hanshin-Kyojin will finally have to break up.\Career Guidance Questionnaire\Otani Atsushi\University\Are you going to college? response:	Impossible.
context: It's almost time for them to make their final decisions, isn't it?\That is is.\It looks like All Hanshin-Kyojin will finally have to break up.\Career Guidance Questionnaire\Otani Atsushi\University\Are you going to college?\Impossible. response:	Huh?!
context: That is is.\It looks like All Hanshin-Kyojin will finally have to break up.\Career Guidance Questionnaire\Otani Atsushi\University\Are you going to college?\Impossible.\Huh?! response:	What are we going to do while you're away, Otani?
context: It looks like All Hanshin-Kyojin will finally have to break up.\Career Guidance Questionnaire\Otani Atsushi\University\Are you going to college?\Impossible.\Huh?!\What are we going to do while you're away, Otani? response:	Lovely Complex Love Com.
context: Career Guidance Questionnaire\Otani Atsushi\University\Are you going to college?\Impossible.\Huh?!\What are we going to do while you're away, Otani?\Lovely Complex Love Com. response:	Next: Premonition of Separation?! The Different Paths Risa and Otani Will Walk.
context: Otani Atsushi\University\Are you going to college?\Impossible.\Huh?!\What are we going to do while you're away, Otani?\Lovely Complex Love Com.\Next: Premonition of Separation?! The Different Paths Risa and Otani Will Walk. response:	Premonition of Separation?! The Different Paths Risa and Otani Will Walk
context: University\Are you going to college?\Impossible.\Huh?!\What are we going to do while you're away, Otani?\Lovely Complex Love Com.\Next: Premonition of Separation?! The Different Paths Risa and Otani Will Walk.\Premonition of Separation?! The Different Paths Risa and Otani Will Walk response:	Be sure to watch!