context: One Bowl of Tea on Rice response:	One bowl of tea on rice...
context: One Bowl of Tea on Rice\One bowl of tea on rice... response:	Pickled plums, slivered nori,
context: One Bowl of Tea on Rice\One bowl of tea on rice...\Pickled plums, slivered nori, response:	and leftover chicken from dinner...
context: One Bowl of Tea on Rice\One bowl of tea on rice...\Pickled plums, slivered nori,\and leftover chicken from dinner... response:	All doused in piping-hot water,
context: One Bowl of Tea on Rice\One bowl of tea on rice...\Pickled plums, slivered nori,\and leftover chicken from dinner...\All doused in piping-hot water, response:	then shoveled in with salted kelp...
context: One Bowl of Tea on Rice\One bowl of tea on rice...\Pickled plums, slivered nori,\and leftover chicken from dinner...\All doused in piping-hot water,\then shoveled in with salted kelp... response:	That was so good...
context: One Bowl of Tea on Rice\One bowl of tea on rice...\Pickled plums, slivered nori,\and leftover chicken from dinner...\All doused in piping-hot water,\then shoveled in with salted kelp...\That was so good... response:	All those bowls of tea on rice I'd sneak into the kitchen to make at the orphanage...
context: One Bowl of Tea on Rice\One bowl of tea on rice...\Pickled plums, slivered nori,\and leftover chicken from dinner...\All doused in piping-hot water,\then shoveled in with salted kelp...\That was so good...\All those bowls of tea on rice I'd sneak into the kitchen to make at the orphanage... response:	Ow!
context: One bowl of tea on rice...\Pickled plums, slivered nori,\and leftover chicken from dinner...\All doused in piping-hot water,\then shoveled in with salted kelp...\That was so good...\All those bowls of tea on rice I'd sneak into the kitchen to make at the orphanage...\Ow! response:	Damn it...
context: Pickled plums, slivered nori,\and leftover chicken from dinner...\All doused in piping-hot water,\then shoveled in with salted kelp...\That was so good...\All those bowls of tea on rice I'd sneak into the kitchen to make at the orphanage...\Ow!\Damn it... response:	I'm gonna die of hunger.
context: and leftover chicken from dinner...\All doused in piping-hot water,\then shoveled in with salted kelp...\That was so good...\All those bowls of tea on rice I'd sneak into the kitchen to make at the orphanage...\Ow!\Damn it...\I'm gonna die of hunger. response:	My name is Atsushi.
context: All doused in piping-hot water,\then shoveled in with salted kelp...\That was so good...\All those bowls of tea on rice I'd sneak into the kitchen to make at the orphanage...\Ow!\Damn it...\I'm gonna die of hunger.\My name is Atsushi. response:	Episode 1: Fortune Is Unpredictable and Mutable
context: then shoveled in with salted kelp...\That was so good...\All those bowls of tea on rice I'd sneak into the kitchen to make at the orphanage...\Ow!\Damn it...\I'm gonna die of hunger.\My name is Atsushi.\Episode 1: Fortune Is Unpredictable and Mutable response:	Due to certain circumstances, I'm about to die from starvation.
context: That was so good...\All those bowls of tea on rice I'd sneak into the kitchen to make at the orphanage...\Ow!\Damn it...\I'm gonna die of hunger.\My name is Atsushi.\Episode 1: Fortune Is Unpredictable and Mutable\Due to certain circumstances, I'm about to die from starvation. response:	After being driven out of the orphanage,
context: All those bowls of tea on rice I'd sneak into the kitchen to make at the orphanage...\Ow!\Damn it...\I'm gonna die of hunger.\My name is Atsushi.\Episode 1: Fortune Is Unpredictable and Mutable\Due to certain circumstances, I'm about to die from starvation.\After being driven out of the orphanage, response:	I had nothing to eat, nowhere to sleep,
context: Ow!\Damn it...\I'm gonna die of hunger.\My name is Atsushi.\Episode 1: Fortune Is Unpredictable and Mutable\Due to certain circumstances, I'm about to die from starvation.\After being driven out of the orphanage,\I had nothing to eat, nowhere to sleep, response:	and, as one might expect, not a cent to my name.
context: Damn it...\I'm gonna die of hunger.\My name is Atsushi.\Episode 1: Fortune Is Unpredictable and Mutable\Due to certain circumstances, I'm about to die from starvation.\After being driven out of the orphanage,\I had nothing to eat, nowhere to sleep,\and, as one might expect, not a cent to my name. response:	Yet, I lack the courage to commit theft.
context: I'm gonna die of hunger.\My name is Atsushi.\Episode 1: Fortune Is Unpredictable and Mutable\Due to certain circumstances, I'm about to die from starvation.\After being driven out of the orphanage,\I had nothing to eat, nowhere to sleep,\and, as one might expect, not a cent to my name.\Yet, I lack the courage to commit theft. response:	That is how I've arrived at my current predicament...
context: My name is Atsushi.\Episode 1: Fortune Is Unpredictable and Mutable\Due to certain circumstances, I'm about to die from starvation.\After being driven out of the orphanage,\I had nothing to eat, nowhere to sleep,\and, as one might expect, not a cent to my name.\Yet, I lack the courage to commit theft.\That is how I've arrived at my current predicament... response:	However...
context: Episode 1: Fortune Is Unpredictable and Mutable\Due to certain circumstances, I'm about to die from starvation.\After being driven out of the orphanage,\I had nothing to eat, nowhere to sleep,\and, as one might expect, not a cent to my name.\Yet, I lack the courage to commit theft.\That is how I've arrived at my current predicament...\However... response:	If I wish to live,
context: Due to certain circumstances, I'm about to die from starvation.\After being driven out of the orphanage,\I had nothing to eat, nowhere to sleep,\and, as one might expect, not a cent to my name.\Yet, I lack the courage to commit theft.\That is how I've arrived at my current predicament...\However...\If I wish to live, response:	I have no choice but to steal and take from others!
context: After being driven out of the orphanage,\I had nothing to eat, nowhere to sleep,\and, as one might expect, not a cent to my name.\Yet, I lack the courage to commit theft.\That is how I've arrived at my current predicament...\However...\If I wish to live,\I have no choice but to steal and take from others! response:	Get out, you good-for-nothing!
context: I had nothing to eat, nowhere to sleep,\and, as one might expect, not a cent to my name.\Yet, I lack the courage to commit theft.\That is how I've arrived at my current predicament...\However...\If I wish to live,\I have no choice but to steal and take from others!\Get out, you good-for-nothing! response:	The world would be a better place
context: and, as one might expect, not a cent to my name.\Yet, I lack the courage to commit theft.\That is how I've arrived at my current predicament...\However...\If I wish to live,\I have no choice but to steal and take from others!\Get out, you good-for-nothing!\The world would be a better place response:	if you'd just die in a ditch somewhere!
context: Yet, I lack the courage to commit theft.\That is how I've arrived at my current predicament...\However...\If I wish to live,\I have no choice but to steal and take from others!\Get out, you good-for-nothing!\The world would be a better place\if you'd just die in a ditch somewhere! response:	Shut up...
context: That is how I've arrived at my current predicament...\However...\If I wish to live,\I have no choice but to steal and take from others!\Get out, you good-for-nothing!\The world would be a better place\if you'd just die in a ditch somewhere!\Shut up... response:	Shut up!
context: However...\If I wish to live,\I have no choice but to steal and take from others!\Get out, you good-for-nothing!\The world would be a better place\if you'd just die in a ditch somewhere!\Shut up...\Shut up! response:	Shut up!
context: If I wish to live,\I have no choice but to steal and take from others!\Get out, you good-for-nothing!\The world would be a better place\if you'd just die in a ditch somewhere!\Shut up...\Shut up!\Shut up! response:	Shut up!
context: I have no choice but to steal and take from others!\Get out, you good-for-nothing!\The world would be a better place\if you'd just die in a ditch somewhere!\Shut up...\Shut up!\Shut up!\Shut up! response:	Die in a ditch?
context: Get out, you good-for-nothing!\The world would be a better place\if you'd just die in a ditch somewhere!\Shut up...\Shut up!\Shut up!\Shut up!\Die in a ditch? response:	I'm not gonna die!
context: The world would be a better place\if you'd just die in a ditch somewhere!\Shut up...\Shut up!\Shut up!\Shut up!\Die in a ditch?\I'm not gonna die! response:	I'm gonna live, no matter what it takes!
context: if you'd just die in a ditch somewhere!\Shut up...\Shut up!\Shut up!\Shut up!\Die in a ditch?\I'm not gonna die!\I'm gonna live, no matter what it takes! response:	Okay...
context: Shut up...\Shut up!\Shut up!\Shut up!\Die in a ditch?\I'm not gonna die!\I'm gonna live, no matter what it takes!\Okay... response:	I'll rush the first person who comes along
context: Shut up!\Shut up!\Shut up!\Die in a ditch?\I'm not gonna die!\I'm gonna live, no matter what it takes!\Okay...\I'll rush the first person who comes along response:	and rob them of everything they've got!
context: Shut up!\Shut up!\Die in a ditch?\I'm not gonna die!\I'm gonna live, no matter what it takes!\Okay...\I'll rush the first person who comes along\and rob them of everything they've got! response:	Well, that was mission impossible.
context: Shut up!\Die in a ditch?\I'm not gonna die!\I'm gonna live, no matter what it takes!\Okay...\I'll rush the first person who comes along\and rob them of everything they've got!\Well, that was mission impossible. response:	I can't catch him on an empty stomach...
context: Die in a ditch?\I'm not gonna die!\I'm gonna live, no matter what it takes!\Okay...\I'll rush the first person who comes along\and rob them of everything they've got!\Well, that was mission impossible.\I can't catch him on an empty stomach... response:	Next!
context: I'm not gonna die!\I'm gonna live, no matter what it takes!\Okay...\I'll rush the first person who comes along\and rob them of everything they've got!\Well, that was mission impossible.\I can't catch him on an empty stomach...\Next! response:	One, two, three, four!
context: I'm gonna live, no matter what it takes!\Okay...\I'll rush the first person who comes along\and rob them of everything they've got!\Well, that was mission impossible.\I can't catch him on an empty stomach...\Next!\One, two, three, four! response:	One, two, three, four!
context: Okay...\I'll rush the first person who comes along\and rob them of everything they've got!\Well, that was mission impossible.\I can't catch him on an empty stomach...\Next!\One, two, three, four!\One, two, three, four! response:	But the next person who comes along... for sure!
context: I'll rush the first person who comes along\and rob them of everything they've got!\Well, that was mission impossible.\I can't catch him on an empty stomach...\Next!\One, two, three, four!\One, two, three, four!\But the next person who comes along... for sure! response:	I've got this!
context: and rob them of everything they've got!\Well, that was mission impossible.\I can't catch him on an empty stomach...\Next!\One, two, three, four!\One, two, three, four!\But the next person who comes along... for sure!\I've got this! response:	Well...
context: Well, that was mission impossible.\I can't catch him on an empty stomach...\Next!\One, two, three, four!\One, two, three, four!\But the next person who comes along... for sure!\I've got this!\Well... response:	I can't possibly count him.
context: I can't catch him on an empty stomach...\Next!\One, two, three, four!\One, two, three, four!\But the next person who comes along... for sure!\I've got this!\Well...\I can't possibly count him. response:	Y-Yeah, I'll pass, please.
context: Next!\One, two, three, four!\One, two, three, four!\But the next person who comes along... for sure!\I've got this!\Well...\I can't possibly count him.\Y-Yeah, I'll pass, please. response:	Fine!
context: One, two, three, four!\One, two, three, four!\But the next person who comes along... for sure!\I've got this!\Well...\I can't possibly count him.\Y-Yeah, I'll pass, please.\Fine! response:	In the end...
context: One, two, three, four!\But the next person who comes along... for sure!\I've got this!\Well...\I can't possibly count him.\Y-Yeah, I'll pass, please.\Fine!\In the end... response:	You were floating down the river...
context: But the next person who comes along... for sure!\I've got this!\Well...\I can't possibly count him.\Y-Yeah, I'll pass, please.\Fine!\In the end...\You were floating down the river... response:	Are you okay?
context: I've got this!\Well...\I can't possibly count him.\Y-Yeah, I'll pass, please.\Fine!\In the end...\You were floating down the river...\Are you okay? response:	I made it.
context: Well...\I can't possibly count him.\Y-Yeah, I'll pass, please.\Fine!\In the end...\You were floating down the river...\Are you okay?\I made it. response:	Damn.
context: I can't possibly count him.\Y-Yeah, I'll pass, please.\Fine!\In the end...\You were floating down the river...\Are you okay?\I made it.\Damn. response:	Damn?
context: Y-Yeah, I'll pass, please.\Fine!\In the end...\You were floating down the river...\Are you okay?\I made it.\Damn.\Damn? response:	Did he just say damn?
context: Fine!\In the end...\You were floating down the river...\Are you okay?\I made it.\Damn.\Damn?\Did he just say damn? response:	Are you the one who interrupted my submersion?
context: In the end...\You were floating down the river...\Are you okay?\I made it.\Damn.\Damn?\Did he just say damn?\Are you the one who interrupted my submersion? response:	I was just trying to help.
context: You were floating down the river...\Are you okay?\I made it.\Damn.\Damn?\Did he just say damn?\Are you the one who interrupted my submersion?\I was just trying to help. response:	Huh?
context: Are you okay?\I made it.\Damn.\Damn?\Did he just say damn?\Are you the one who interrupted my submersion?\I was just trying to help.\Huh? response:	Submersion?
context: I made it.\Damn.\Damn?\Did he just say damn?\Are you the one who interrupted my submersion?\I was just trying to help.\Huh?\Submersion? response:	Submersion...
context: Damn.\Damn?\Did he just say damn?\Are you the one who interrupted my submersion?\I was just trying to help.\Huh?\Submersion?\Submersion... response:	You don't know what I mean by that?
context: Damn?\Did he just say damn?\Are you the one who interrupted my submersion?\I was just trying to help.\Huh?\Submersion?\Submersion...\You don't know what I mean by that? response:	I was trying to commit suicide.
context: Did he just say damn?\Are you the one who interrupted my submersion?\I was just trying to help.\Huh?\Submersion?\Submersion...\You don't know what I mean by that?\I was trying to commit suicide. response:	S-Suicide?!
context: Are you the one who interrupted my submersion?\I was just trying to help.\Huh?\Submersion?\Submersion...\You don't know what I mean by that?\I was trying to commit suicide.\S-Suicide?! response:	That's right.
context: I was just trying to help.\Huh?\Submersion?\Submersion...\You don't know what I mean by that?\I was trying to commit suicide.\S-Suicide?!\That's right. response:	I was trying to kill myself.
context: Huh?\Submersion?\Submersion...\You don't know what I mean by that?\I was trying to commit suicide.\S-Suicide?!\That's right.\I was trying to kill myself. response:	But you just had to interfere...
context: Submersion?\Submersion...\You don't know what I mean by that?\I was trying to commit suicide.\S-Suicide?!\That's right.\I was trying to kill myself.\But you just had to interfere... response:	Why...
context: Submersion...\You don't know what I mean by that?\I was trying to commit suicide.\S-Suicide?!\That's right.\I was trying to kill myself.\But you just had to interfere...\Why... response:	Wait, is he scolding me for saving him?
context: You don't know what I mean by that?\I was trying to commit suicide.\S-Suicide?!\That's right.\I was trying to kill myself.\But you just had to interfere...\Why...\Wait, is he scolding me for saving him? response:	Still, my priority is to commit a clean suicide
context: I was trying to commit suicide.\S-Suicide?!\That's right.\I was trying to kill myself.\But you just had to interfere...\Why...\Wait, is he scolding me for saving him?\Still, my priority is to commit a clean suicide response:	without being a burden to anyone.
context: S-Suicide?!\That's right.\I was trying to kill myself.\But you just had to interfere...\Why...\Wait, is he scolding me for saving him?\Still, my priority is to commit a clean suicide\without being a burden to anyone. response:	Yet I did trouble you,
context: That's right.\I was trying to kill myself.\But you just had to interfere...\Why...\Wait, is he scolding me for saving him?\Still, my priority is to commit a clean suicide\without being a burden to anyone.\Yet I did trouble you, response:	so the fault lies with me at this point.
context: I was trying to kill myself.\But you just had to interfere...\Why...\Wait, is he scolding me for saving him?\Still, my priority is to commit a clean suicide\without being a burden to anyone.\Yet I did trouble you,\so the fault lies with me at this point. response:	I should apologize in some way.
context: But you just had to interfere...\Why...\Wait, is he scolding me for saving him?\Still, my priority is to commit a clean suicide\without being a burden to anyone.\Yet I did trouble you,\so the fault lies with me at this point.\I should apologize in some way. response:	Growl
context: Why...\Wait, is he scolding me for saving him?\Still, my priority is to commit a clean suicide\without being a burden to anyone.\Yet I did trouble you,\so the fault lies with me at this point.\I should apologize in some way.\Growl response:	Are you hungry, boy?
context: Wait, is he scolding me for saving him?\Still, my priority is to commit a clean suicide\without being a burden to anyone.\Yet I did trouble you,\so the fault lies with me at this point.\I should apologize in some way.\Growl\Are you hungry, boy? response:	Well..
context: Still, my priority is to commit a clean suicide\without being a burden to anyone.\Yet I did trouble you,\so the fault lies with me at this point.\I should apologize in some way.\Growl\Are you hungry, boy?\Well.. response:	I haven't eaten in several days.
context: without being a burden to anyone.\Yet I did trouble you,\so the fault lies with me at this point.\I should apologize in some way.\Growl\Are you hungry, boy?\Well..\I haven't eaten in several days. response:	Growl
context: Yet I did trouble you,\so the fault lies with me at this point.\I should apologize in some way.\Growl\Are you hungry, boy?\Well..\I haven't eaten in several days.\Growl response:	Ugh...
context: so the fault lies with me at this point.\I should apologize in some way.\Growl\Are you hungry, boy?\Well..\I haven't eaten in several days.\Growl\Ugh... response:	How odd.
context: I should apologize in some way.\Growl\Are you hungry, boy?\Well..\I haven't eaten in several days.\Growl\Ugh...\How odd. response:	I'm also hungry.
context: Growl\Are you hungry, boy?\Well..\I haven't eaten in several days.\Growl\Ugh...\How odd.\I'm also hungry. response:	Then...
context: Are you hungry, boy?\Well..\I haven't eaten in several days.\Growl\Ugh...\How odd.\I'm also hungry.\Then... response:	By the way, the river seems to have taken my wallet.
context: Well..\I haven't eaten in several days.\Growl\Ugh...\How odd.\I'm also hungry.\Then...\By the way, the river seems to have taken my wallet. response:	You've got to be kidding...
context: I haven't eaten in several days.\Growl\Ugh...\How odd.\I'm also hungry.\Then...\By the way, the river seems to have taken my wallet.\You've got to be kidding... response:	There you are, blockhead!
context: Growl\Ugh...\How odd.\I'm also hungry.\Then...\By the way, the river seems to have taken my wallet.\You've got to be kidding...\There you are, blockhead! response:	Oh, hey.
context: Ugh...\How odd.\I'm also hungry.\Then...\By the way, the river seems to have taken my wallet.\You've got to be kidding...\There you are, blockhead!\Oh, hey. response:	Nice work, Kunikida-kun.
context: How odd.\I'm also hungry.\Then...\By the way, the river seems to have taken my wallet.\You've got to be kidding...\There you are, blockhead!\Oh, hey.\Nice work, Kunikida-kun. response:	Nice work?
context: I'm also hungry.\Then...\By the way, the river seems to have taken my wallet.\You've got to be kidding...\There you are, blockhead!\Oh, hey.\Nice work, Kunikida-kun.\Nice work? response:	And just who caused all this work,
context: Then...\By the way, the river seems to have taken my wallet.\You've got to be kidding...\There you are, blockhead!\Oh, hey.\Nice work, Kunikida-kun.\Nice work?\And just who caused all this work, response:	you suicidal maniac?!
context: By the way, the river seems to have taken my wallet.\You've got to be kidding...\There you are, blockhead!\Oh, hey.\Nice work, Kunikida-kun.\Nice work?\And just who caused all this work,\you suicidal maniac?! response:	I've had enough of you disrupting my schedule!
context: You've got to be kidding...\There you are, blockhead!\Oh, hey.\Nice work, Kunikida-kun.\Nice work?\And just who caused all this work,\you suicidal maniac?!\I've had enough of you disrupting my schedule! response:	Oh, right!
context: There you are, blockhead!\Oh, hey.\Nice work, Kunikida-kun.\Nice work?\And just who caused all this work,\you suicidal maniac?!\I've had enough of you disrupting my schedule!\Oh, right! response:	I have a great idea.
context: Oh, hey.\Nice work, Kunikida-kun.\Nice work?\And just who caused all this work,\you suicidal maniac?!\I've had enough of you disrupting my schedule!\Oh, right!\I have a great idea. response:	He's a colleague of mine from work.
context: Nice work, Kunikida-kun.\Nice work?\And just who caused all this work,\you suicidal maniac?!\I've had enough of you disrupting my schedule!\Oh, right!\I have a great idea.\He's a colleague of mine from work. response:	Let's have him treat you to a meal.
context: Nice work?\And just who caused all this work,\you suicidal maniac?!\I've had enough of you disrupting my schedule!\Oh, right!\I have a great idea.\He's a colleague of mine from work.\Let's have him treat you to a meal. response:	Are you even listening to me?!
context: And just who caused all this work,\you suicidal maniac?!\I've had enough of you disrupting my schedule!\Oh, right!\I have a great idea.\He's a colleague of mine from work.\Let's have him treat you to a meal.\Are you even listening to me?! response:	What's your name?
context: you suicidal maniac?!\I've had enough of you disrupting my schedule!\Oh, right!\I have a great idea.\He's a colleague of mine from work.\Let's have him treat you to a meal.\Are you even listening to me?!\What's your name? response:	Huh?
context: I've had enough of you disrupting my schedule!\Oh, right!\I have a great idea.\He's a colleague of mine from work.\Let's have him treat you to a meal.\Are you even listening to me?!\What's your name?\Huh? response:	Nakajima... Atsushi.
context: Oh, right!\I have a great idea.\He's a colleague of mine from work.\Let's have him treat you to a meal.\Are you even listening to me?!\What's your name?\Huh?\Nakajima... Atsushi. response:	Well, come along, Atsushi-kun!
context: I have a great idea.\He's a colleague of mine from work.\Let's have him treat you to a meal.\Are you even listening to me?!\What's your name?\Huh?\Nakajima... Atsushi.\Well, come along, Atsushi-kun! response:	What would you like to eat?
context: He's a colleague of mine from work.\Let's have him treat you to a meal.\Are you even listening to me?!\What's your name?\Huh?\Nakajima... Atsushi.\Well, come along, Atsushi-kun!\What would you like to eat? response:	Um...
context: Let's have him treat you to a meal.\Are you even listening to me?!\What's your name?\Huh?\Nakajima... Atsushi.\Well, come along, Atsushi-kun!\What would you like to eat?\Um... response:	Well, if it's not too much trouble...
context: Are you even listening to me?!\What's your name?\Huh?\Nakajima... Atsushi.\Well, come along, Atsushi-kun!\What would you like to eat?\Um...\Well, if it's not too much trouble... response:	Oh, there's no need to hold back!
context: What's your name?\Huh?\Nakajima... Atsushi.\Well, come along, Atsushi-kun!\What would you like to eat?\Um...\Well, if it's not too much trouble...\Oh, there's no need to hold back! response:	I'd like to eat tea on rice...
context: Huh?\Nakajima... Atsushi.\Well, come along, Atsushi-kun!\What would you like to eat?\Um...\Well, if it's not too much trouble...\Oh, there's no need to hold back!\I'd like to eat tea on rice... response:	So a boy on the brink of starvation wants to eat tea on rice?
context: Nakajima... Atsushi.\Well, come along, Atsushi-kun!\What would you like to eat?\Um...\Well, if it's not too much trouble...\Oh, there's no need to hold back!\I'd like to eat tea on rice...\So a boy on the brink of starvation wants to eat tea on rice? response:	Very well, let's have Kunikida-kun treat you to thirty bowls of that!
context: Well, come along, Atsushi-kun!\What would you like to eat?\Um...\Well, if it's not too much trouble...\Oh, there's no need to hold back!\I'd like to eat tea on rice...\So a boy on the brink of starvation wants to eat tea on rice?\Very well, let's have Kunikida-kun treat you to thirty bowls of that! response:	Don't get all generous with my money, Dazai!
context: What would you like to eat?\Um...\Well, if it's not too much trouble...\Oh, there's no need to hold back!\I'd like to eat tea on rice...\So a boy on the brink of starvation wants to eat tea on rice?\Very well, let's have Kunikida-kun treat you to thirty bowls of that!\Don't get all generous with my money, Dazai! response:	Dazai?
context: Um...\Well, if it's not too much trouble...\Oh, there's no need to hold back!\I'd like to eat tea on rice...\So a boy on the brink of starvation wants to eat tea on rice?\Very well, let's have Kunikida-kun treat you to thirty bowls of that!\Don't get all generous with my money, Dazai!\Dazai? response:	Yeah, that's my name.
context: Well, if it's not too much trouble...\Oh, there's no need to hold back!\I'd like to eat tea on rice...\So a boy on the brink of starvation wants to eat tea on rice?\Very well, let's have Kunikida-kun treat you to thirty bowls of that!\Don't get all generous with my money, Dazai!\Dazai?\Yeah, that's my name. response:	I am Dazai.
context: Oh, there's no need to hold back!\I'd like to eat tea on rice...\So a boy on the brink of starvation wants to eat tea on rice?\Very well, let's have Kunikida-kun treat you to thirty bowls of that!\Don't get all generous with my money, Dazai!\Dazai?\Yeah, that's my name.\I am Dazai. response:	Dazai Osamu.
context: I'd like to eat tea on rice...\So a boy on the brink of starvation wants to eat tea on rice?\Very well, let's have Kunikida-kun treat you to thirty bowls of that!\Don't get all generous with my money, Dazai!\Dazai?\Yeah, that's my name.\I am Dazai.\Dazai Osamu. response:	You're unbelievable.
context: So a boy on the brink of starvation wants to eat tea on rice?\Very well, let's have Kunikida-kun treat you to thirty bowls of that!\Don't get all generous with my money, Dazai!\Dazai?\Yeah, that's my name.\I am Dazai.\Dazai Osamu.\You're unbelievable. response:	Who goes that's a nice river
context: Very well, let's have Kunikida-kun treat you to thirty bowls of that!\Don't get all generous with my money, Dazai!\Dazai?\Yeah, that's my name.\I am Dazai.\Dazai Osamu.\You're unbelievable.\Who goes that's a nice river response:	and jumps into it in the middle of a job?!
context: Don't get all generous with my money, Dazai!\Dazai?\Yeah, that's my name.\I am Dazai.\Dazai Osamu.\You're unbelievable.\Who goes that's a nice river\and jumps into it in the middle of a job?! response:	Thanks to you, look!
context: Dazai?\Yeah, that's my name.\I am Dazai.\Dazai Osamu.\You're unbelievable.\Who goes that's a nice river\and jumps into it in the middle of a job?!\Thanks to you, look! response:	Look how off-schedule we are now!
context: Yeah, that's my name.\I am Dazai.\Dazai Osamu.\You're unbelievable.\Who goes that's a nice river\and jumps into it in the middle of a job?!\Thanks to you, look!\Look how off-schedule we are now! response:	You sure like your schedules, Kunikida-kun.
context: I am Dazai.\Dazai Osamu.\You're unbelievable.\Who goes that's a nice river\and jumps into it in the middle of a job?!\Thanks to you, look!\Look how off-schedule we are now!\You sure like your schedules, Kunikida-kun. response:	Ideal
context: Dazai Osamu.\You're unbelievable.\Who goes that's a nice river\and jumps into it in the middle of a job?!\Thanks to you, look!\Look how off-schedule we are now!\You sure like your schedules, Kunikida-kun.\Ideal response:	This isn't a schedule!
context: You're unbelievable.\Who goes that's a nice river\and jumps into it in the middle of a job?!\Thanks to you, look!\Look how off-schedule we are now!\You sure like your schedules, Kunikida-kun.\Ideal\This isn't a schedule! response:	This is an ideal!
context: Who goes that's a nice river\and jumps into it in the middle of a job?!\Thanks to you, look!\Look how off-schedule we are now!\You sure like your schedules, Kunikida-kun.\Ideal\This isn't a schedule!\This is an ideal! response:	My guide in life!
context: and jumps into it in the middle of a job?!\Thanks to you, look!\Look how off-schedule we are now!\You sure like your schedules, Kunikida-kun.\Ideal\This isn't a schedule!\This is an ideal!\My guide in life! response:	And nowhere in this book
context: Thanks to you, look!\Look how off-schedule we are now!\You sure like your schedules, Kunikida-kun.\Ideal\This isn't a schedule!\This is an ideal!\My guide in life!\And nowhere in this book response:	is it written that my work partner is a suicidal maniac!
context: Look how off-schedule we are now!\You sure like your schedules, Kunikida-kun.\Ideal\This isn't a schedule!\This is an ideal!\My guide in life!\And nowhere in this book\is it written that my work partner is a suicidal maniac! response:	Shut up!
context: You sure like your schedules, Kunikida-kun.\Ideal\This isn't a schedule!\This is an ideal!\My guide in life!\And nowhere in this book\is it written that my work partner is a suicidal maniac!\Shut up! response:	Nowhere on my projected expenses page will you find written
context: Ideal\This isn't a schedule!\This is an ideal!\My guide in life!\And nowhere in this book\is it written that my work partner is a suicidal maniac!\Shut up!\Nowhere on my projected expenses page will you find written response:	that I will buy a million bowls of tea on rice for a snot-nosed brat!
context: This isn't a schedule!\This is an ideal!\My guide in life!\And nowhere in this book\is it written that my work partner is a suicidal maniac!\Shut up!\Nowhere on my projected expenses page will you find written\that I will buy a million bowls of tea on rice for a snot-nosed brat! response:	Like I said, it's a job!
context: This is an ideal!\My guide in life!\And nowhere in this book\is it written that my work partner is a suicidal maniac!\Shut up!\Nowhere on my projected expenses page will you find written\that I will buy a million bowls of tea on rice for a snot-nosed brat!\Like I said, it's a job! response:	Our job today?
context: My guide in life!\And nowhere in this book\is it written that my work partner is a suicidal maniac!\Shut up!\Nowhere on my projected expenses page will you find written\that I will buy a million bowls of tea on rice for a snot-nosed brat!\Like I said, it's a job!\Our job today? response:	It involves the military.
context: And nowhere in this book\is it written that my work partner is a suicidal maniac!\Shut up!\Nowhere on my projected expenses page will you find written\that I will buy a million bowls of tea on rice for a snot-nosed brat!\Like I said, it's a job!\Our job today?\It involves the military. response:	How are you two communicating, actually?
context: is it written that my work partner is a suicidal maniac!\Shut up!\Nowhere on my projected expenses page will you find written\that I will buy a million bowls of tea on rice for a snot-nosed brat!\Like I said, it's a job!\Our job today?\It involves the military.\How are you two communicating, actually? response:	I'm so full.
context: Shut up!\Nowhere on my projected expenses page will you find written\that I will buy a million bowls of tea on rice for a snot-nosed brat!\Like I said, it's a job!\Our job today?\It involves the military.\How are you two communicating, actually?\I'm so full. response:	I don't want to see another bowl of this for at least ten years.
context: Nowhere on my projected expenses page will you find written\that I will buy a million bowls of tea on rice for a snot-nosed brat!\Like I said, it's a job!\Our job today?\It involves the military.\How are you two communicating, actually?\I'm so full.\I don't want to see another bowl of this for at least ten years. response:	Why, you...
context: that I will buy a million bowls of tea on rice for a snot-nosed brat!\Like I said, it's a job!\Our job today?\It involves the military.\How are you two communicating, actually?\I'm so full.\I don't want to see another bowl of this for at least ten years.\Why, you... response:	How dare you be so shameless after eating on my dime?
context: Like I said, it's a job!\Our job today?\It involves the military.\How are you two communicating, actually?\I'm so full.\I don't want to see another bowl of this for at least ten years.\Why, you...\How dare you be so shameless after eating on my dime? response:	You're a real lifesaver.
context: Our job today?\It involves the military.\How are you two communicating, actually?\I'm so full.\I don't want to see another bowl of this for at least ten years.\Why, you...\How dare you be so shameless after eating on my dime?\You're a real lifesaver. response:	After leaving the orphanage and coming to Yokohama,
context: It involves the military.\How are you two communicating, actually?\I'm so full.\I don't want to see another bowl of this for at least ten years.\Why, you...\How dare you be so shameless after eating on my dime?\You're a real lifesaver.\After leaving the orphanage and coming to Yokohama, response:	I've had nothing to eat and nowhere to sleep.
context: How are you two communicating, actually?\I'm so full.\I don't want to see another bowl of this for at least ten years.\Why, you...\How dare you be so shameless after eating on my dime?\You're a real lifesaver.\After leaving the orphanage and coming to Yokohama,\I've had nothing to eat and nowhere to sleep. response:	I thought I'd die of starvation.
context: I'm so full.\I don't want to see another bowl of this for at least ten years.\Why, you...\How dare you be so shameless after eating on my dime?\You're a real lifesaver.\After leaving the orphanage and coming to Yokohama,\I've had nothing to eat and nowhere to sleep.\I thought I'd die of starvation. response:	You're from an orphanage?
context: I don't want to see another bowl of this for at least ten years.\Why, you...\How dare you be so shameless after eating on my dime?\You're a real lifesaver.\After leaving the orphanage and coming to Yokohama,\I've had nothing to eat and nowhere to sleep.\I thought I'd die of starvation.\You're from an orphanage? response:	Putting it one way, yes.
context: Why, you...\How dare you be so shameless after eating on my dime?\You're a real lifesaver.\After leaving the orphanage and coming to Yokohama,\I've had nothing to eat and nowhere to sleep.\I thought I'd die of starvation.\You're from an orphanage?\Putting it one way, yes. response:	But they kicked me out.
context: How dare you be so shameless after eating on my dime?\You're a real lifesaver.\After leaving the orphanage and coming to Yokohama,\I've had nothing to eat and nowhere to sleep.\I thought I'd die of starvation.\You're from an orphanage?\Putting it one way, yes.\But they kicked me out. response:	That's some non-profit there.
context: You're a real lifesaver.\After leaving the orphanage and coming to Yokohama,\I've had nothing to eat and nowhere to sleep.\I thought I'd die of starvation.\You're from an orphanage?\Putting it one way, yes.\But they kicked me out.\That's some non-profit there. response:	Hey, Dazai!
context: After leaving the orphanage and coming to Yokohama,\I've had nothing to eat and nowhere to sleep.\I thought I'd die of starvation.\You're from an orphanage?\Putting it one way, yes.\But they kicked me out.\That's some non-profit there.\Hey, Dazai! response:	We're not some philanthropists going around helping brats down on their luck, okay?
context: I've had nothing to eat and nowhere to sleep.\I thought I'd die of starvation.\You're from an orphanage?\Putting it one way, yes.\But they kicked me out.\That's some non-profit there.\Hey, Dazai!\We're not some philanthropists going around helping brats down on their luck, okay? response:	Let's get back to the job at hand.
context: I thought I'd die of starvation.\You're from an orphanage?\Putting it one way, yes.\But they kicked me out.\That's some non-profit there.\Hey, Dazai!\We're not some philanthropists going around helping brats down on their luck, okay?\Let's get back to the job at hand. response:	Ideal
context: You're from an orphanage?\Putting it one way, yes.\But they kicked me out.\That's some non-profit there.\Hey, Dazai!\We're not some philanthropists going around helping brats down on their luck, okay?\Let's get back to the job at hand.\Ideal response:	That reminds me, you said earlier that your current job involves the military.
context: Putting it one way, yes.\But they kicked me out.\That's some non-profit there.\Hey, Dazai!\We're not some philanthropists going around helping brats down on their luck, okay?\Let's get back to the job at hand.\Ideal\That reminds me, you said earlier that your current job involves the military. response:	What is your line of work, exactly?
context: But they kicked me out.\That's some non-profit there.\Hey, Dazai!\We're not some philanthropists going around helping brats down on their luck, okay?\Let's get back to the job at hand.\Ideal\That reminds me, you said earlier that your current job involves the military.\What is your line of work, exactly? response:	Oh, we're just private investigators.
context: That's some non-profit there.\Hey, Dazai!\We're not some philanthropists going around helping brats down on their luck, okay?\Let's get back to the job at hand.\Ideal\That reminds me, you said earlier that your current job involves the military.\What is your line of work, exactly?\Oh, we're just private investigators. response:	Private investigators...?
context: Hey, Dazai!\We're not some philanthropists going around helping brats down on their luck, okay?\Let's get back to the job at hand.\Ideal\That reminds me, you said earlier that your current job involves the military.\What is your line of work, exactly?\Oh, we're just private investigators.\Private investigators...? response:	That's not to say we only handle lost pets and alleged extramarital affairs.
context: We're not some philanthropists going around helping brats down on their luck, okay?\Let's get back to the job at hand.\Ideal\That reminds me, you said earlier that your current job involves the military.\What is your line of work, exactly?\Oh, we're just private investigators.\Private investigators...?\That's not to say we only handle lost pets and alleged extramarital affairs. response:	Perhaps you've heard of the Armed Detective Agency,
context: Let's get back to the job at hand.\Ideal\That reminds me, you said earlier that your current job involves the military.\What is your line of work, exactly?\Oh, we're just private investigators.\Private investigators...?\That's not to say we only handle lost pets and alleged extramarital affairs.\Perhaps you've heard of the Armed Detective Agency, response:	an organization with individuals possessing supernatural powers?
context: Ideal\That reminds me, you said earlier that your current job involves the military.\What is your line of work, exactly?\Oh, we're just private investigators.\Private investigators...?\That's not to say we only handle lost pets and alleged extramarital affairs.\Perhaps you've heard of the Armed Detective Agency,\an organization with individuals possessing supernatural powers? response:	What?
context: That reminds me, you said earlier that your current job involves the military.\What is your line of work, exactly?\Oh, we're just private investigators.\Private investigators...?\That's not to say we only handle lost pets and alleged extramarital affairs.\Perhaps you've heard of the Armed Detective Agency,\an organization with individuals possessing supernatural powers?\What? response:	I've heard of this Armed Detective Agency in rumors...
context: What is your line of work, exactly?\Oh, we're just private investigators.\Private investigators...?\That's not to say we only handle lost pets and alleged extramarital affairs.\Perhaps you've heard of the Armed Detective Agency,\an organization with individuals possessing supernatural powers?\What?\I've heard of this Armed Detective Agency in rumors... response:	Said to be an agency specializing in objectives
context: Oh, we're just private investigators.\Private investigators...?\That's not to say we only handle lost pets and alleged extramarital affairs.\Perhaps you've heard of the Armed Detective Agency,\an organization with individuals possessing supernatural powers?\What?\I've heard of this Armed Detective Agency in rumors...\Said to be an agency specializing in objectives response:	that cannot be entrusted to the likes of the police or the military...
context: Private investigators...?\That's not to say we only handle lost pets and alleged extramarital affairs.\Perhaps you've heard of the Armed Detective Agency,\an organization with individuals possessing supernatural powers?\What?\I've heard of this Armed Detective Agency in rumors...\Said to be an agency specializing in objectives\that cannot be entrusted to the likes of the police or the military... response:	A twilight armed force positioned between the world of night and day...
context: That's not to say we only handle lost pets and alleged extramarital affairs.\Perhaps you've heard of the Armed Detective Agency,\an organization with individuals possessing supernatural powers?\What?\I've heard of this Armed Detective Agency in rumors...\Said to be an agency specializing in objectives\that cannot be entrusted to the likes of the police or the military...\A twilight armed force positioned between the world of night and day... response:	I'm told many from the Agency possess supernatural powers...
context: Perhaps you've heard of the Armed Detective Agency,\an organization with individuals possessing supernatural powers?\What?\I've heard of this Armed Detective Agency in rumors...\Said to be an agency specializing in objectives\that cannot be entrusted to the likes of the police or the military...\A twilight armed force positioned between the world of night and day...\I'm told many from the Agency possess supernatural powers... response:	but does that also apply to these two?
context: an organization with individuals possessing supernatural powers?\What?\I've heard of this Armed Detective Agency in rumors...\Said to be an agency specializing in objectives\that cannot be entrusted to the likes of the police or the military...\A twilight armed force positioned between the world of night and day...\I'm told many from the Agency possess supernatural powers...\but does that also apply to these two? response:	Check out that nice beam up there.
context: What?\I've heard of this Armed Detective Agency in rumors...\Said to be an agency specializing in objectives\that cannot be entrusted to the likes of the police or the military...\A twilight armed force positioned between the world of night and day...\I'm told many from the Agency possess supernatural powers...\but does that also apply to these two?\Check out that nice beam up there. response:	Don't analyze whether you can hang yourself in a random teahouse we just stumbled into!
context: I've heard of this Armed Detective Agency in rumors...\Said to be an agency specializing in objectives\that cannot be entrusted to the likes of the police or the military...\A twilight armed force positioned between the world of night and day...\I'm told many from the Agency possess supernatural powers...\but does that also apply to these two?\Check out that nice beam up there.\Don't analyze whether you can hang yourself in a random teahouse we just stumbled into! response:	Don't get me wrong.
context: Said to be an agency specializing in objectives\that cannot be entrusted to the likes of the police or the military...\A twilight armed force positioned between the world of night and day...\I'm told many from the Agency possess supernatural powers...\but does that also apply to these two?\Check out that nice beam up there.\Don't analyze whether you can hang yourself in a random teahouse we just stumbled into!\Don't get me wrong. response:	We're talking the hanging health method.
context: that cannot be entrusted to the likes of the police or the military...\A twilight armed force positioned between the world of night and day...\I'm told many from the Agency possess supernatural powers...\but does that also apply to these two?\Check out that nice beam up there.\Don't analyze whether you can hang yourself in a random teahouse we just stumbled into!\Don't get me wrong.\We're talking the hanging health method. response:	What's that about?
context: A twilight armed force positioned between the world of night and day...\I'm told many from the Agency possess supernatural powers...\but does that also apply to these two?\Check out that nice beam up there.\Don't analyze whether you can hang yourself in a random teahouse we just stumbled into!\Don't get me wrong.\We're talking the hanging health method.\What's that about? response:	What, you don't know?!
context: I'm told many from the Agency possess supernatural powers...\but does that also apply to these two?\Check out that nice beam up there.\Don't analyze whether you can hang yourself in a random teahouse we just stumbled into!\Don't get me wrong.\We're talking the hanging health method.\What's that about?\What, you don't know?! response:	It's so good for shoulder cramps!
context: but does that also apply to these two?\Check out that nice beam up there.\Don't analyze whether you can hang yourself in a random teahouse we just stumbled into!\Don't get me wrong.\We're talking the hanging health method.\What's that about?\What, you don't know?!\It's so good for shoulder cramps! response:	What?!
context: Check out that nice beam up there.\Don't analyze whether you can hang yourself in a random teahouse we just stumbled into!\Don't get me wrong.\We're talking the hanging health method.\What's that about?\What, you don't know?!\It's so good for shoulder cramps!\What?! response:	Such a thing exists?!
context: Don't analyze whether you can hang yourself in a random teahouse we just stumbled into!\Don't get me wrong.\We're talking the hanging health method.\What's that about?\What, you don't know?!\It's so good for shoulder cramps!\What?!\Such a thing exists?! response:	Hey, write this all down!
context: Don't get me wrong.\We're talking the hanging health method.\What's that about?\What, you don't know?!\It's so good for shoulder cramps!\What?!\Such a thing exists?!\Hey, write this all down! response:	Hanging... health... method...
context: We're talking the hanging health method.\What's that about?\What, you don't know?!\It's so good for shoulder cramps!\What?!\Such a thing exists?!\Hey, write this all down!\Hanging... health... method... response:	I'm messing with you.
context: What's that about?\What, you don't know?!\It's so good for shoulder cramps!\What?!\Such a thing exists?!\Hey, write this all down!\Hanging... health... method...\I'm messing with you. response:	A-Are these two seriously with the Armed Detective Agency?
context: What, you don't know?!\It's so good for shoulder cramps!\What?!\Such a thing exists?!\Hey, write this all down!\Hanging... health... method...\I'm messing with you.\A-Are these two seriously with the Armed Detective Agency? response:	My partner gets himself washed up in a river,
context: It's so good for shoulder cramps!\What?!\Such a thing exists?!\Hey, write this all down!\Hanging... health... method...\I'm messing with you.\A-Are these two seriously with the Armed Detective Agency?\My partner gets himself washed up in a river, response:	and a brat on death's door just stuffs himself with no shame.
context: What?!\Such a thing exists?!\Hey, write this all down!\Hanging... health... method...\I'm messing with you.\A-Are these two seriously with the Armed Detective Agency?\My partner gets himself washed up in a river,\and a brat on death's door just stuffs himself with no shame. response:	My schedule for the day was just perfect,
context: Such a thing exists?!\Hey, write this all down!\Hanging... health... method...\I'm messing with you.\A-Are these two seriously with the Armed Detective Agency?\My partner gets himself washed up in a river,\and a brat on death's door just stuffs himself with no shame.\My schedule for the day was just perfect, response:	but I have to start over from square one!
context: Hey, write this all down!\Hanging... health... method...\I'm messing with you.\A-Are these two seriously with the Armed Detective Agency?\My partner gets himself washed up in a river,\and a brat on death's door just stuffs himself with no shame.\My schedule for the day was just perfect,\but I have to start over from square one! response:	So, about your job today...
context: Hanging... health... method...\I'm messing with you.\A-Are these two seriously with the Armed Detective Agency?\My partner gets himself washed up in a river,\and a brat on death's door just stuffs himself with no shame.\My schedule for the day was just perfect,\but I have to start over from square one!\So, about your job today... response:	I'll ensure that the job will be completed on schedule, if nothing else!
context: I'm messing with you.\A-Are these two seriously with the Armed Detective Agency?\My partner gets himself washed up in a river,\and a brat on death's door just stuffs himself with no shame.\My schedule for the day was just perfect,\but I have to start over from square one!\So, about your job today...\I'll ensure that the job will be completed on schedule, if nothing else! response:	Yeah?!
context: A-Are these two seriously with the Armed Detective Agency?\My partner gets himself washed up in a river,\and a brat on death's door just stuffs himself with no shame.\My schedule for the day was just perfect,\but I have to start over from square one!\So, about your job today...\I'll ensure that the job will be completed on schedule, if nothing else!\Yeah?! response:	Sorry, I shouldn't have asked!
context: My partner gets himself washed up in a river,\and a brat on death's door just stuffs himself with no shame.\My schedule for the day was just perfect,\but I have to start over from square one!\So, about your job today...\I'll ensure that the job will be completed on schedule, if nothing else!\Yeah?!\Sorry, I shouldn't have asked! response:	R-Right, of course your jobs are classified!
context: and a brat on death's door just stuffs himself with no shame.\My schedule for the day was just perfect,\but I have to start over from square one!\So, about your job today...\I'll ensure that the job will be completed on schedule, if nothing else!\Yeah?!\Sorry, I shouldn't have asked!\R-Right, of course your jobs are classified! response:	Today's job doesn't really require secrecy.
context: My schedule for the day was just perfect,\but I have to start over from square one!\So, about your job today...\I'll ensure that the job will be completed on schedule, if nothing else!\Yeah?!\Sorry, I shouldn't have asked!\R-Right, of course your jobs are classified!\Today's job doesn't really require secrecy. response:	We're looking for a certain tiger on behest of the military.
context: but I have to start over from square one!\So, about your job today...\I'll ensure that the job will be completed on schedule, if nothing else!\Yeah?!\Sorry, I shouldn't have asked!\R-Right, of course your jobs are classified!\Today's job doesn't really require secrecy.\We're looking for a certain tiger on behest of the military. response:	A tiger?
context: So, about your job today...\I'll ensure that the job will be completed on schedule, if nothing else!\Yeah?!\Sorry, I shouldn't have asked!\R-Right, of course your jobs are classified!\Today's job doesn't really require secrecy.\We're looking for a certain tiger on behest of the military.\A tiger? response:	A man-eater who's recently appeared in these parts.
context: I'll ensure that the job will be completed on schedule, if nothing else!\Yeah?!\Sorry, I shouldn't have asked!\R-Right, of course your jobs are classified!\Today's job doesn't really require secrecy.\We're looking for a certain tiger on behest of the military.\A tiger?\A man-eater who's recently appeared in these parts. response:	Well, not that we know for sure it's devoured anyone,
context: Yeah?!\Sorry, I shouldn't have asked!\R-Right, of course your jobs are classified!\Today's job doesn't really require secrecy.\We're looking for a certain tiger on behest of the military.\A tiger?\A man-eater who's recently appeared in these parts.\Well, not that we know for sure it's devoured anyone, response:	but it's ransacked warehouses and eaten farm produce and the like,
context: Sorry, I shouldn't have asked!\R-Right, of course your jobs are classified!\Today's job doesn't really require secrecy.\We're looking for a certain tiger on behest of the military.\A tiger?\A man-eater who's recently appeared in these parts.\Well, not that we know for sure it's devoured anyone,\but it's ransacked warehouses and eaten farm produce and the like, response:	doing whatever it wants.
context: R-Right, of course your jobs are classified!\Today's job doesn't really require secrecy.\We're looking for a certain tiger on behest of the military.\A tiger?\A man-eater who's recently appeared in these parts.\Well, not that we know for sure it's devoured anyone,\but it's ransacked warehouses and eaten farm produce and the like,\doing whatever it wants. response:	It's been spotted around here lately.
context: Today's job doesn't really require secrecy.\We're looking for a certain tiger on behest of the military.\A tiger?\A man-eater who's recently appeared in these parts.\Well, not that we know for sure it's devoured anyone,\but it's ransacked warehouses and eaten farm produce and the like,\doing whatever it wants.\It's been spotted around here lately. response:	What's wrong, Atsushi-kun?
context: We're looking for a certain tiger on behest of the military.\A tiger?\A man-eater who's recently appeared in these parts.\Well, not that we know for sure it's devoured anyone,\but it's ransacked warehouses and eaten farm produce and the like,\doing whatever it wants.\It's been spotted around here lately.\What's wrong, Atsushi-kun? response:	G-Good-bye.
context: A tiger?\A man-eater who's recently appeared in these parts.\Well, not that we know for sure it's devoured anyone,\but it's ransacked warehouses and eaten farm produce and the like,\doing whatever it wants.\It's been spotted around here lately.\What's wrong, Atsushi-kun?\G-Good-bye. response:	Wait, brat!
context: A man-eater who's recently appeared in these parts.\Well, not that we know for sure it's devoured anyone,\but it's ransacked warehouses and eaten farm produce and the like,\doing whatever it wants.\It's been spotted around here lately.\What's wrong, Atsushi-kun?\G-Good-bye.\Wait, brat! response:	You know something, don't you?
context: Well, not that we know for sure it's devoured anyone,\but it's ransacked warehouses and eaten farm produce and the like,\doing whatever it wants.\It's been spotted around here lately.\What's wrong, Atsushi-kun?\G-Good-bye.\Wait, brat!\You know something, don't you? response:	You can't.
context: but it's ransacked warehouses and eaten farm produce and the like,\doing whatever it wants.\It's been spotted around here lately.\What's wrong, Atsushi-kun?\G-Good-bye.\Wait, brat!\You know something, don't you?\You can't. response:	No one can take it on!
context: doing whatever it wants.\It's been spotted around here lately.\What's wrong, Atsushi-kun?\G-Good-bye.\Wait, brat!\You know something, don't you?\You can't.\No one can take it on! response:	You know the man-eating tiger?
context: It's been spotted around here lately.\What's wrong, Atsushi-kun?\G-Good-bye.\Wait, brat!\You know something, don't you?\You can't.\No one can take it on!\You know the man-eating tiger? response:	It's after me.
context: What's wrong, Atsushi-kun?\G-Good-bye.\Wait, brat!\You know something, don't you?\You can't.\No one can take it on!\You know the man-eating tiger?\It's after me. response:	It almost killed me!
context: G-Good-bye.\Wait, brat!\You know something, don't you?\You can't.\No one can take it on!\You know the man-eating tiger?\It's after me.\It almost killed me! response:	If it's been seen around here,
context: Wait, brat!\You know something, don't you?\You can't.\No one can take it on!\You know the man-eating tiger?\It's after me.\It almost killed me!\If it's been seen around here, response:	I have to run, now!
context: You know something, don't you?\You can't.\No one can take it on!\You know the man-eating tiger?\It's after me.\It almost killed me!\If it's been seen around here,\I have to run, now! response:	Hey, brat!
context: You can't.\No one can take it on!\You know the man-eating tiger?\It's after me.\It almost killed me!\If it's been seen around here,\I have to run, now!\Hey, brat! response:	You'll either pay for the food with your arm or by telling us everything.
context: No one can take it on!\You know the man-eating tiger?\It's after me.\It almost killed me!\If it's been seen around here,\I have to run, now!\Hey, brat!\You'll either pay for the food with your arm or by telling us everything. response:	Now, now, Kunikida-kun.
context: You know the man-eating tiger?\It's after me.\It almost killed me!\If it's been seen around here,\I have to run, now!\Hey, brat!\You'll either pay for the food with your arm or by telling us everything.\Now, now, Kunikida-kun. response:	Whenever you try to ask questions,
context: It's after me.\It almost killed me!\If it's been seen around here,\I have to run, now!\Hey, brat!\You'll either pay for the food with your arm or by telling us everything.\Now, now, Kunikida-kun.\Whenever you try to ask questions, response:	it becomes an interrogation.
context: It almost killed me!\If it's been seen around here,\I have to run, now!\Hey, brat!\You'll either pay for the food with your arm or by telling us everything.\Now, now, Kunikida-kun.\Whenever you try to ask questions,\it becomes an interrogation. response:	The CEO's been talking to you about this.
context: If it's been seen around here,\I have to run, now!\Hey, brat!\You'll either pay for the food with your arm or by telling us everything.\Now, now, Kunikida-kun.\Whenever you try to ask questions,\it becomes an interrogation.\The CEO's been talking to you about this. response:	And...
context: I have to run, now!\Hey, brat!\You'll either pay for the food with your arm or by telling us everything.\Now, now, Kunikida-kun.\Whenever you try to ask questions,\it becomes an interrogation.\The CEO's been talking to you about this.\And... response:	what do you know about this tiger?
context: Hey, brat!\You'll either pay for the food with your arm or by telling us everything.\Now, now, Kunikida-kun.\Whenever you try to ask questions,\it becomes an interrogation.\The CEO's been talking to you about this.\And...\what do you know about this tiger? response:	My orphanage was trashed by that tiger.
context: You'll either pay for the food with your arm or by telling us everything.\Now, now, Kunikida-kun.\Whenever you try to ask questions,\it becomes an interrogation.\The CEO's been talking to you about this.\And...\what do you know about this tiger?\My orphanage was trashed by that tiger. response:	It ravaged our fields,
context: Now, now, Kunikida-kun.\Whenever you try to ask questions,\it becomes an interrogation.\The CEO's been talking to you about this.\And...\what do you know about this tiger?\My orphanage was trashed by that tiger.\It ravaged our fields, response:	it ravaged our chicken coop,
context: Whenever you try to ask questions,\it becomes an interrogation.\The CEO's been talking to you about this.\And...\what do you know about this tiger?\My orphanage was trashed by that tiger.\It ravaged our fields,\it ravaged our chicken coop, response:	and even our warehouse.
context: it becomes an interrogation.\The CEO's been talking to you about this.\And...\what do you know about this tiger?\My orphanage was trashed by that tiger.\It ravaged our fields,\it ravaged our chicken coop,\and even our warehouse. response:	No one died, sure,
context: The CEO's been talking to you about this.\And...\what do you know about this tiger?\My orphanage was trashed by that tiger.\It ravaged our fields,\it ravaged our chicken coop,\and even our warehouse.\No one died, sure, response:	but the orphanage was already on a shoestring budget.
context: And...\what do you know about this tiger?\My orphanage was trashed by that tiger.\It ravaged our fields,\it ravaged our chicken coop,\and even our warehouse.\No one died, sure,\but the orphanage was already on a shoestring budget. response:	I got kicked out so that they had one less mouth to feed.
context: what do you know about this tiger?\My orphanage was trashed by that tiger.\It ravaged our fields,\it ravaged our chicken coop,\and even our warehouse.\No one died, sure,\but the orphanage was already on a shoestring budget.\I got kicked out so that they had one less mouth to feed. response:	Get out, you good-for-nothing!
context: My orphanage was trashed by that tiger.\It ravaged our fields,\it ravaged our chicken coop,\and even our warehouse.\No one died, sure,\but the orphanage was already on a shoestring budget.\I got kicked out so that they had one less mouth to feed.\Get out, you good-for-nothing! response:	The world would be a better place if you'd just die in a ditch somewhere!
context: It ravaged our fields,\it ravaged our chicken coop,\and even our warehouse.\No one died, sure,\but the orphanage was already on a shoestring budget.\I got kicked out so that they had one less mouth to feed.\Get out, you good-for-nothing!\The world would be a better place if you'd just die in a ditch somewhere! response:	Why me? I didn't do anything...
context: it ravaged our chicken coop,\and even our warehouse.\No one died, sure,\but the orphanage was already on a shoestring budget.\I got kicked out so that they had one less mouth to feed.\Get out, you good-for-nothing!\The world would be a better place if you'd just die in a ditch somewhere!\Why me? I didn't do anything... response:	We don't need worthless louts!
context: and even our warehouse.\No one died, sure,\but the orphanage was already on a shoestring budget.\I got kicked out so that they had one less mouth to feed.\Get out, you good-for-nothing!\The world would be a better place if you'd just die in a ditch somewhere!\Why me? I didn't do anything...\We don't need worthless louts! response:	You'll never find a place where you belong!
context: No one died, sure,\but the orphanage was already on a shoestring budget.\I got kicked out so that they had one less mouth to feed.\Get out, you good-for-nothing!\The world would be a better place if you'd just die in a ditch somewhere!\Why me? I didn't do anything...\We don't need worthless louts!\You'll never find a place where you belong! response:	Just go! I hope you rot in hell!
context: but the orphanage was already on a shoestring budget.\I got kicked out so that they had one less mouth to feed.\Get out, you good-for-nothing!\The world would be a better place if you'd just die in a ditch somewhere!\Why me? I didn't do anything...\We don't need worthless louts!\You'll never find a place where you belong!\Just go! I hope you rot in hell! response:	Well, that's tragic.
context: I got kicked out so that they had one less mouth to feed.\Get out, you good-for-nothing!\The world would be a better place if you'd just die in a ditch somewhere!\Why me? I didn't do anything...\We don't need worthless louts!\You'll never find a place where you belong!\Just go! I hope you rot in hell!\Well, that's tragic. response:	So, boy, what's this talk about the tiger almost killing you?
context: Get out, you good-for-nothing!\The world would be a better place if you'd just die in a ditch somewhere!\Why me? I didn't do anything...\We don't need worthless louts!\You'll never find a place where you belong!\Just go! I hope you rot in hell!\Well, that's tragic.\So, boy, what's this talk about the tiger almost killing you? response:	The man-eater always shows up wherever I go.
context: The world would be a better place if you'd just die in a ditch somewhere!\Why me? I didn't do anything...\We don't need worthless louts!\You'll never find a place where you belong!\Just go! I hope you rot in hell!\Well, that's tragic.\So, boy, what's this talk about the tiger almost killing you?\The man-eater always shows up wherever I go. response:	Just a while ago, when I was walking around Tsurumi...
context: Why me? I didn't do anything...\We don't need worthless louts!\You'll never find a place where you belong!\Just go! I hope you rot in hell!\Well, that's tragic.\So, boy, what's this talk about the tiger almost killing you?\The man-eater always shows up wherever I go.\Just a while ago, when I was walking around Tsurumi... response:	It's a tiger!
context: We don't need worthless louts!\You'll never find a place where you belong!\Just go! I hope you rot in hell!\Well, that's tragic.\So, boy, what's this talk about the tiger almost killing you?\The man-eater always shows up wherever I go.\Just a while ago, when I was walking around Tsurumi...\It's a tiger! response:	There's a tiger!
context: You'll never find a place where you belong!\Just go! I hope you rot in hell!\Well, that's tragic.\So, boy, what's this talk about the tiger almost killing you?\The man-eater always shows up wherever I go.\Just a while ago, when I was walking around Tsurumi...\It's a tiger!\There's a tiger! response:	I'd seen it out of the corner of my eyes many times,
context: Just go! I hope you rot in hell!\Well, that's tragic.\So, boy, what's this talk about the tiger almost killing you?\The man-eater always shows up wherever I go.\Just a while ago, when I was walking around Tsurumi...\It's a tiger!\There's a tiger!\I'd seen it out of the corner of my eyes many times, response:	starting two weeks before I was chased out of the orphanage.
context: Well, that's tragic.\So, boy, what's this talk about the tiger almost killing you?\The man-eater always shows up wherever I go.\Just a while ago, when I was walking around Tsurumi...\It's a tiger!\There's a tiger!\I'd seen it out of the corner of my eyes many times,\starting two weeks before I was chased out of the orphanage. response:	I'm sure it's come all the way to the city in search of me.
context: So, boy, what's this talk about the tiger almost killing you?\The man-eater always shows up wherever I go.\Just a while ago, when I was walking around Tsurumi...\It's a tiger!\There's a tiger!\I'd seen it out of the corner of my eyes many times,\starting two weeks before I was chased out of the orphanage.\I'm sure it's come all the way to the city in search of me. response:	When was the last time you saw the tiger?
context: The man-eater always shows up wherever I go.\Just a while ago, when I was walking around Tsurumi...\It's a tiger!\There's a tiger!\I'd seen it out of the corner of my eyes many times,\starting two weeks before I was chased out of the orphanage.\I'm sure it's come all the way to the city in search of me.\When was the last time you saw the tiger? response:	I think I saw it around Tsurumi
context: Just a while ago, when I was walking around Tsurumi...\It's a tiger!\There's a tiger!\I'd seen it out of the corner of my eyes many times,\starting two weeks before I was chased out of the orphanage.\I'm sure it's come all the way to the city in search of me.\When was the last time you saw the tiger?\I think I saw it around Tsurumi response:	about four days ago.
context: It's a tiger!\There's a tiger!\I'd seen it out of the corner of my eyes many times,\starting two weeks before I was chased out of the orphanage.\I'm sure it's come all the way to the city in search of me.\When was the last time you saw the tiger?\I think I saw it around Tsurumi\about four days ago. response:	It's true that its antics have been focused here for the past two weeks.
context: There's a tiger!\I'd seen it out of the corner of my eyes many times,\starting two weeks before I was chased out of the orphanage.\I'm sure it's come all the way to the city in search of me.\When was the last time you saw the tiger?\I think I saw it around Tsurumi\about four days ago.\It's true that its antics have been focused here for the past two weeks. response:	In addition, it was sighted around Tsurumi four days ago.
context: I'd seen it out of the corner of my eyes many times,\starting two weeks before I was chased out of the orphanage.\I'm sure it's come all the way to the city in search of me.\When was the last time you saw the tiger?\I think I saw it around Tsurumi\about four days ago.\It's true that its antics have been focused here for the past two weeks.\In addition, it was sighted around Tsurumi four days ago. response:	Atsushi-kun, are you free?
context: starting two weeks before I was chased out of the orphanage.\I'm sure it's come all the way to the city in search of me.\When was the last time you saw the tiger?\I think I saw it around Tsurumi\about four days ago.\It's true that its antics have been focused here for the past two weeks.\In addition, it was sighted around Tsurumi four days ago.\Atsushi-kun, are you free? response:	I have a really bad feeling about this...
context: I'm sure it's come all the way to the city in search of me.\When was the last time you saw the tiger?\I think I saw it around Tsurumi\about four days ago.\It's true that its antics have been focused here for the past two weeks.\In addition, it was sighted around Tsurumi four days ago.\Atsushi-kun, are you free?\I have a really bad feeling about this... response:	You being the man-eater's target presents an excellent opportunity.
context: When was the last time you saw the tiger?\I think I saw it around Tsurumi\about four days ago.\It's true that its antics have been focused here for the past two weeks.\In addition, it was sighted around Tsurumi four days ago.\Atsushi-kun, are you free?\I have a really bad feeling about this...\You being the man-eater's target presents an excellent opportunity. response:	Huh?
context: I think I saw it around Tsurumi\about four days ago.\It's true that its antics have been focused here for the past two weeks.\In addition, it was sighted around Tsurumi four days ago.\Atsushi-kun, are you free?\I have a really bad feeling about this...\You being the man-eater's target presents an excellent opportunity.\Huh? response:	Please help us find the tiger.
context: about four days ago.\It's true that its antics have been focused here for the past two weeks.\In addition, it was sighted around Tsurumi four days ago.\Atsushi-kun, are you free?\I have a really bad feeling about this...\You being the man-eater's target presents an excellent opportunity.\Huh?\Please help us find the tiger. response:	No way!
context: It's true that its antics have been focused here for the past two weeks.\In addition, it was sighted around Tsurumi four days ago.\Atsushi-kun, are you free?\I have a really bad feeling about this...\You being the man-eater's target presents an excellent opportunity.\Huh?\Please help us find the tiger.\No way! response:	Kunikida-kun, please go back to the Agency and give this to the president.
context: In addition, it was sighted around Tsurumi four days ago.\Atsushi-kun, are you free?\I have a really bad feeling about this...\You being the man-eater's target presents an excellent opportunity.\Huh?\Please help us find the tiger.\No way!\Kunikida-kun, please go back to the Agency and give this to the president. response:	Hey, don't tell me you plan to catch the tiger all alone with the two of you?
context: Atsushi-kun, are you free?\I have a really bad feeling about this...\You being the man-eater's target presents an excellent opportunity.\Huh?\Please help us find the tiger.\No way!\Kunikida-kun, please go back to the Agency and give this to the president.\Hey, don't tell me you plan to catch the tiger all alone with the two of you? response:	We should first confirm whether his information is accurate.
context: I have a really bad feeling about this...\You being the man-eater's target presents an excellent opportunity.\Huh?\Please help us find the tiger.\No way!\Kunikida-kun, please go back to the Agency and give this to the president.\Hey, don't tell me you plan to catch the tiger all alone with the two of you?\We should first confirm whether his information is accurate. response:	It's fine.
context: You being the man-eater's target presents an excellent opportunity.\Huh?\Please help us find the tiger.\No way!\Kunikida-kun, please go back to the Agency and give this to the president.\Hey, don't tell me you plan to catch the tiger all alone with the two of you?\We should first confirm whether his information is accurate.\It's fine. response:	I'm not doing this, okay?!
context: Huh?\Please help us find the tiger.\No way!\Kunikida-kun, please go back to the Agency and give this to the president.\Hey, don't tell me you plan to catch the tiger all alone with the two of you?\We should first confirm whether his information is accurate.\It's fine.\I'm not doing this, okay?! response:	This means you're going to use me as bait, right?
context: Please help us find the tiger.\No way!\Kunikida-kun, please go back to the Agency and give this to the president.\Hey, don't tell me you plan to catch the tiger all alone with the two of you?\We should first confirm whether his information is accurate.\It's fine.\I'm not doing this, okay?!\This means you're going to use me as bait, right? response:	Who in their right mind would agree to that
context: No way!\Kunikida-kun, please go back to the Agency and give this to the president.\Hey, don't tell me you plan to catch the tiger all alone with the two of you?\We should first confirm whether his information is accurate.\It's fine.\I'm not doing this, okay?!\This means you're going to use me as bait, right?\Who in their right mind would agree to that response:	There's a reward.
context: Kunikida-kun, please go back to the Agency and give this to the president.\Hey, don't tell me you plan to catch the tiger all alone with the two of you?\We should first confirm whether his information is accurate.\It's fine.\I'm not doing this, okay?!\This means you're going to use me as bait, right?\Who in their right mind would agree to that\There's a reward. response:	Currently penniless.
context: Hey, don't tell me you plan to catch the tiger all alone with the two of you?\We should first confirm whether his information is accurate.\It's fine.\I'm not doing this, okay?!\This means you're going to use me as bait, right?\Who in their right mind would agree to that\There's a reward.\Currently penniless. response:	What? Reward?
context: We should first confirm whether his information is accurate.\It's fine.\I'm not doing this, okay?!\This means you're going to use me as bait, right?\Who in their right mind would agree to that\There's a reward.\Currently penniless.\What? Reward? response:	A reward?
context: It's fine.\I'm not doing this, okay?!\This means you're going to use me as bait, right?\Who in their right mind would agree to that\There's a reward.\Currently penniless.\What? Reward?\A reward? response:	Nah...
context: I'm not doing this, okay?!\This means you're going to use me as bait, right?\Who in their right mind would agree to that\There's a reward.\Currently penniless.\What? Reward?\A reward?\Nah... response:	You're not gonna tempt me with that!
context: This means you're going to use me as bait, right?\Who in their right mind would agree to that\There's a reward.\Currently penniless.\What? Reward?\A reward?\Nah...\You're not gonna tempt me with that! response:	B-But just for reference,
context: Who in their right mind would agree to that\There's a reward.\Currently penniless.\What? Reward?\A reward?\Nah...\You're not gonna tempt me with that!\B-But just for reference, response:	how much would the reward be...?
context: There's a reward.\Currently penniless.\What? Reward?\A reward?\Nah...\You're not gonna tempt me with that!\B-But just for reference,\how much would the reward be...? response:	About this much.
context: Currently penniless.\What? Reward?\A reward?\Nah...\You're not gonna tempt me with that!\B-But just for reference,\how much would the reward be...?\About this much. response:	Dazai-san, what are you reading?
context: What? Reward?\A reward?\Nah...\You're not gonna tempt me with that!\B-But just for reference,\how much would the reward be...?\About this much.\Dazai-san, what are you reading? response:	A good book.
context: A reward?\Nah...\You're not gonna tempt me with that!\B-But just for reference,\how much would the reward be...?\About this much.\Dazai-san, what are you reading?\A good book. response:	I'm surprised you can read when it's this dark.
context: Nah...\You're not gonna tempt me with that!\B-But just for reference,\how much would the reward be...?\About this much.\Dazai-san, what are you reading?\A good book.\I'm surprised you can read when it's this dark. response:	I have good vision.
context: You're not gonna tempt me with that!\B-But just for reference,\how much would the reward be...?\About this much.\Dazai-san, what are you reading?\A good book.\I'm surprised you can read when it's this dark.\I have good vision. response:	Complete Guide to Suicide
context: B-But just for reference,\how much would the reward be...?\About this much.\Dazai-san, what are you reading?\A good book.\I'm surprised you can read when it's this dark.\I have good vision.\Complete Guide to Suicide response:	Besides, I already know everything that happens in this book.
context: how much would the reward be...?\About this much.\Dazai-san, what are you reading?\A good book.\I'm surprised you can read when it's this dark.\I have good vision.\Complete Guide to Suicide\Besides, I already know everything that happens in this book. response:	Why are you reading it, then?
context: About this much.\Dazai-san, what are you reading?\A good book.\I'm surprised you can read when it's this dark.\I have good vision.\Complete Guide to Suicide\Besides, I already know everything that happens in this book.\Why are you reading it, then? response:	A good book is always good, no matter how many times you've already read it.
context: Dazai-san, what are you reading?\A good book.\I'm surprised you can read when it's this dark.\I have good vision.\Complete Guide to Suicide\Besides, I already know everything that happens in this book.\Why are you reading it, then?\A good book is always good, no matter how many times you've already read it. response:	Will the tiger really show up here?
context: A good book.\I'm surprised you can read when it's this dark.\I have good vision.\Complete Guide to Suicide\Besides, I already know everything that happens in this book.\Why are you reading it, then?\A good book is always good, no matter how many times you've already read it.\Will the tiger really show up here? response:	It will.
context: I'm surprised you can read when it's this dark.\I have good vision.\Complete Guide to Suicide\Besides, I already know everything that happens in this book.\Why are you reading it, then?\A good book is always good, no matter how many times you've already read it.\Will the tiger really show up here?\It will. response:	Don't worry.
context: I have good vision.\Complete Guide to Suicide\Besides, I already know everything that happens in this book.\Why are you reading it, then?\A good book is always good, no matter how many times you've already read it.\Will the tiger really show up here?\It will.\Don't worry. response:	Even if it shows up, it's no match for me.
context: Complete Guide to Suicide\Besides, I already know everything that happens in this book.\Why are you reading it, then?\A good book is always good, no matter how many times you've already read it.\Will the tiger really show up here?\It will.\Don't worry.\Even if it shows up, it's no match for me. response:	I may not look like much,
context: Besides, I already know everything that happens in this book.\Why are you reading it, then?\A good book is always good, no matter how many times you've already read it.\Will the tiger really show up here?\It will.\Don't worry.\Even if it shows up, it's no match for me.\I may not look like much, response:	but I am an operative of the Armed Detective Agency.
context: Why are you reading it, then?\A good book is always good, no matter how many times you've already read it.\Will the tiger really show up here?\It will.\Don't worry.\Even if it shows up, it's no match for me.\I may not look like much,\but I am an operative of the Armed Detective Agency. response:	You're really confident.
context: A good book is always good, no matter how many times you've already read it.\Will the tiger really show up here?\It will.\Don't worry.\Even if it shows up, it's no match for me.\I may not look like much,\but I am an operative of the Armed Detective Agency.\You're really confident. response:	I'm kind of jealous.
context: Will the tiger really show up here?\It will.\Don't worry.\Even if it shows up, it's no match for me.\I may not look like much,\but I am an operative of the Armed Detective Agency.\You're really confident.\I'm kind of jealous. response:	They called me a good-for-nothing at the orphanage as far back as I can remember.
context: It will.\Don't worry.\Even if it shows up, it's no match for me.\I may not look like much,\but I am an operative of the Armed Detective Agency.\You're really confident.\I'm kind of jealous.\They called me a good-for-nothing at the orphanage as far back as I can remember. response:	And now, I don't even know where I'll sleep tonight or whether I'll be able to earn my keep tomorrow.
context: Don't worry.\Even if it shows up, it's no match for me.\I may not look like much,\but I am an operative of the Armed Detective Agency.\You're really confident.\I'm kind of jealous.\They called me a good-for-nothing at the orphanage as far back as I can remember.\And now, I don't even know where I'll sleep tonight or whether I'll be able to earn my keep tomorrow. response:	Get out, you good-for-nothing!
context: Even if it shows up, it's no match for me.\I may not look like much,\but I am an operative of the Armed Detective Agency.\You're really confident.\I'm kind of jealous.\They called me a good-for-nothing at the orphanage as far back as I can remember.\And now, I don't even know where I'll sleep tonight or whether I'll be able to earn my keep tomorrow.\Get out, you good-for-nothing! response:	You'll never find a place where you belong!
context: I may not look like much,\but I am an operative of the Armed Detective Agency.\You're really confident.\I'm kind of jealous.\They called me a good-for-nothing at the orphanage as far back as I can remember.\And now, I don't even know where I'll sleep tonight or whether I'll be able to earn my keep tomorrow.\Get out, you good-for-nothing!\You'll never find a place where you belong! response:	No one'd care if someone like me were to die in a ditch somewhere.
context: but I am an operative of the Armed Detective Agency.\You're really confident.\I'm kind of jealous.\They called me a good-for-nothing at the orphanage as far back as I can remember.\And now, I don't even know where I'll sleep tonight or whether I'll be able to earn my keep tomorrow.\Get out, you good-for-nothing!\You'll never find a place where you belong!\No one'd care if someone like me were to die in a ditch somewhere. response:	Yeah, I may be better off eaten by a tiger...
context: You're really confident.\I'm kind of jealous.\They called me a good-for-nothing at the orphanage as far back as I can remember.\And now, I don't even know where I'll sleep tonight or whether I'll be able to earn my keep tomorrow.\Get out, you good-for-nothing!\You'll never find a place where you belong!\No one'd care if someone like me were to die in a ditch somewhere.\Yeah, I may be better off eaten by a tiger... response:	Well, then...
context: I'm kind of jealous.\They called me a good-for-nothing at the orphanage as far back as I can remember.\And now, I don't even know where I'll sleep tonight or whether I'll be able to earn my keep tomorrow.\Get out, you good-for-nothing!\You'll never find a place where you belong!\No one'd care if someone like me were to die in a ditch somewhere.\Yeah, I may be better off eaten by a tiger...\Well, then... response:	I think it'll be soon.
context: They called me a good-for-nothing at the orphanage as far back as I can remember.\And now, I don't even know where I'll sleep tonight or whether I'll be able to earn my keep tomorrow.\Get out, you good-for-nothing!\You'll never find a place where you belong!\No one'd care if someone like me were to die in a ditch somewhere.\Yeah, I may be better off eaten by a tiger...\Well, then...\I think it'll be soon. response:	What?!
context: And now, I don't even know where I'll sleep tonight or whether I'll be able to earn my keep tomorrow.\Get out, you good-for-nothing!\You'll never find a place where you belong!\No one'd care if someone like me were to die in a ditch somewhere.\Yeah, I may be better off eaten by a tiger...\Well, then...\I think it'll be soon.\What?! response:	Yeah.
context: Get out, you good-for-nothing!\You'll never find a place where you belong!\No one'd care if someone like me were to die in a ditch somewhere.\Yeah, I may be better off eaten by a tiger...\Well, then...\I think it'll be soon.\What?!\Yeah. response:	I bet that's the tiger, Dazai-san!
context: You'll never find a place where you belong!\No one'd care if someone like me were to die in a ditch somewhere.\Yeah, I may be better off eaten by a tiger...\Well, then...\I think it'll be soon.\What?!\Yeah.\I bet that's the tiger, Dazai-san! response:	No, I think the wind just knocked something down.
context: No one'd care if someone like me were to die in a ditch somewhere.\Yeah, I may be better off eaten by a tiger...\Well, then...\I think it'll be soon.\What?!\Yeah.\I bet that's the tiger, Dazai-san!\No, I think the wind just knocked something down. response:	It's the man-eater!
context: Yeah, I may be better off eaten by a tiger...\Well, then...\I think it'll be soon.\What?!\Yeah.\I bet that's the tiger, Dazai-san!\No, I think the wind just knocked something down.\It's the man-eater! response:	It's come to eat me!
context: Well, then...\I think it'll be soon.\What?!\Yeah.\I bet that's the tiger, Dazai-san!\No, I think the wind just knocked something down.\It's the man-eater!\It's come to eat me! response:	Calm down, Atsushi-kun.
context: I think it'll be soon.\What?!\Yeah.\I bet that's the tiger, Dazai-san!\No, I think the wind just knocked something down.\It's the man-eater!\It's come to eat me!\Calm down, Atsushi-kun. response:	Tigers don't show up from places like that.
context: What?!\Yeah.\I bet that's the tiger, Dazai-san!\No, I think the wind just knocked something down.\It's the man-eater!\It's come to eat me!\Calm down, Atsushi-kun.\Tigers don't show up from places like that. response:	How do you know for sure?!
context: Yeah.\I bet that's the tiger, Dazai-san!\No, I think the wind just knocked something down.\It's the man-eater!\It's come to eat me!\Calm down, Atsushi-kun.\Tigers don't show up from places like that.\How do you know for sure?! response:	Something wasn't quite right to begin with.
context: I bet that's the tiger, Dazai-san!\No, I think the wind just knocked something down.\It's the man-eater!\It's come to eat me!\Calm down, Atsushi-kun.\Tigers don't show up from places like that.\How do you know for sure?!\Something wasn't quite right to begin with. response:	Just because their finances went south,
context: No, I think the wind just knocked something down.\It's the man-eater!\It's come to eat me!\Calm down, Atsushi-kun.\Tigers don't show up from places like that.\How do you know for sure?!\Something wasn't quite right to begin with.\Just because their finances went south, response:	why would an orphanage banish a child?
context: It's the man-eater!\It's come to eat me!\Calm down, Atsushi-kun.\Tigers don't show up from places like that.\How do you know for sure?!\Something wasn't quite right to begin with.\Just because their finances went south,\why would an orphanage banish a child? response:	It's not some farming village from a bygone era.
context: It's come to eat me!\Calm down, Atsushi-kun.\Tigers don't show up from places like that.\How do you know for sure?!\Something wasn't quite right to begin with.\Just because their finances went south,\why would an orphanage banish a child?\It's not some farming village from a bygone era. response:	Banishing one or two mouths to feed would hardly put a dent in their deficit.
context: Calm down, Atsushi-kun.\Tigers don't show up from places like that.\How do you know for sure?!\Something wasn't quite right to begin with.\Just because their finances went south,\why would an orphanage banish a child?\It's not some farming village from a bygone era.\Banishing one or two mouths to feed would hardly put a dent in their deficit. response:	It'd make more sense to downsize
context: Tigers don't show up from places like that.\How do you know for sure?!\Something wasn't quite right to begin with.\Just because their finances went south,\why would an orphanage banish a child?\It's not some farming village from a bygone era.\Banishing one or two mouths to feed would hardly put a dent in their deficit.\It'd make more sense to downsize response:	by transferring half of the kids to a different orphanage.
context: How do you know for sure?!\Something wasn't quite right to begin with.\Just because their finances went south,\why would an orphanage banish a child?\It's not some farming village from a bygone era.\Banishing one or two mouths to feed would hardly put a dent in their deficit.\It'd make more sense to downsize\by transferring half of the kids to a different orphanage. response:	What are you talking about, Dazai-san?
context: Something wasn't quite right to begin with.\Just because their finances went south,\why would an orphanage banish a child?\It's not some farming village from a bygone era.\Banishing one or two mouths to feed would hardly put a dent in their deficit.\It'd make more sense to downsize\by transferring half of the kids to a different orphanage.\What are you talking about, Dazai-san? response:	You came to this city two weeks ago...
context: Just because their finances went south,\why would an orphanage banish a child?\It's not some farming village from a bygone era.\Banishing one or two mouths to feed would hardly put a dent in their deficit.\It'd make more sense to downsize\by transferring half of the kids to a different orphanage.\What are you talking about, Dazai-san?\You came to this city two weeks ago... response:	The tiger also appeared in this city two weeks ago.
context: why would an orphanage banish a child?\It's not some farming village from a bygone era.\Banishing one or two mouths to feed would hardly put a dent in their deficit.\It'd make more sense to downsize\by transferring half of the kids to a different orphanage.\What are you talking about, Dazai-san?\You came to this city two weeks ago...\The tiger also appeared in this city two weeks ago. response:	You were in the Tsurumi area four days ago.
context: It's not some farming village from a bygone era.\Banishing one or two mouths to feed would hardly put a dent in their deficit.\It'd make more sense to downsize\by transferring half of the kids to a different orphanage.\What are you talking about, Dazai-san?\You came to this city two weeks ago...\The tiger also appeared in this city two weeks ago.\You were in the Tsurumi area four days ago. response:	The tiger was also sighted there four days ago.
context: Banishing one or two mouths to feed would hardly put a dent in their deficit.\It'd make more sense to downsize\by transferring half of the kids to a different orphanage.\What are you talking about, Dazai-san?\You came to this city two weeks ago...\The tiger also appeared in this city two weeks ago.\You were in the Tsurumi area four days ago.\The tiger was also sighted there four days ago. response:	Remember what Kunikida-kun said?
context: It'd make more sense to downsize\by transferring half of the kids to a different orphanage.\What are you talking about, Dazai-san?\You came to this city two weeks ago...\The tiger also appeared in this city two weeks ago.\You were in the Tsurumi area four days ago.\The tiger was also sighted there four days ago.\Remember what Kunikida-kun said? response:	The Armed Detective Agency is comprised of individuals with supernatural powers.
context: by transferring half of the kids to a different orphanage.\What are you talking about, Dazai-san?\You came to this city two weeks ago...\The tiger also appeared in this city two weeks ago.\You were in the Tsurumi area four days ago.\The tiger was also sighted there four days ago.\Remember what Kunikida-kun said?\The Armed Detective Agency is comprised of individuals with supernatural powers. response:	Though not a well-known fact,
context: What are you talking about, Dazai-san?\You came to this city two weeks ago...\The tiger also appeared in this city two weeks ago.\You were in the Tsurumi area four days ago.\The tiger was also sighted there four days ago.\Remember what Kunikida-kun said?\The Armed Detective Agency is comprised of individuals with supernatural powers.\Though not a well-known fact, response:	there are quite a few individuals who possess supernatural abilities in this world.
context: You came to this city two weeks ago...\The tiger also appeared in this city two weeks ago.\You were in the Tsurumi area four days ago.\The tiger was also sighted there four days ago.\Remember what Kunikida-kun said?\The Armed Detective Agency is comprised of individuals with supernatural powers.\Though not a well-known fact,\there are quite a few individuals who possess supernatural abilities in this world. response:	Some use their powers to achieve great success,
context: The tiger also appeared in this city two weeks ago.\You were in the Tsurumi area four days ago.\The tiger was also sighted there four days ago.\Remember what Kunikida-kun said?\The Armed Detective Agency is comprised of individuals with supernatural powers.\Though not a well-known fact,\there are quite a few individuals who possess supernatural abilities in this world.\Some use their powers to achieve great success, response:	while others fall into ruin as a result of being unable to control their powers.
context: You were in the Tsurumi area four days ago.\The tiger was also sighted there four days ago.\Remember what Kunikida-kun said?\The Armed Detective Agency is comprised of individuals with supernatural powers.\Though not a well-known fact,\there are quite a few individuals who possess supernatural abilities in this world.\Some use their powers to achieve great success,\while others fall into ruin as a result of being unable to control their powers. response:	I'm guessing that the orphanage staff knew who the tiger was,
context: The tiger was also sighted there four days ago.\Remember what Kunikida-kun said?\The Armed Detective Agency is comprised of individuals with supernatural powers.\Though not a well-known fact,\there are quite a few individuals who possess supernatural abilities in this world.\Some use their powers to achieve great success,\while others fall into ruin as a result of being unable to control their powers.\I'm guessing that the orphanage staff knew who the tiger was, response:	but declined to enlighten you.
context: Remember what Kunikida-kun said?\The Armed Detective Agency is comprised of individuals with supernatural powers.\Though not a well-known fact,\there are quite a few individuals who possess supernatural abilities in this world.\Some use their powers to achieve great success,\while others fall into ruin as a result of being unable to control their powers.\I'm guessing that the orphanage staff knew who the tiger was,\but declined to enlighten you. response:	You were the only one who remained ignorant.
context: The Armed Detective Agency is comprised of individuals with supernatural powers.\Though not a well-known fact,\there are quite a few individuals who possess supernatural abilities in this world.\Some use their powers to achieve great success,\while others fall into ruin as a result of being unable to control their powers.\I'm guessing that the orphanage staff knew who the tiger was,\but declined to enlighten you.\You were the only one who remained ignorant. response:	You also have supernatural powers.
context: Though not a well-known fact,\there are quite a few individuals who possess supernatural abilities in this world.\Some use their powers to achieve great success,\while others fall into ruin as a result of being unable to control their powers.\I'm guessing that the orphanage staff knew who the tiger was,\but declined to enlighten you.\You were the only one who remained ignorant.\You also have supernatural powers. response:	You have the ability to transform into a wild beast in the moonlight.
context: there are quite a few individuals who possess supernatural abilities in this world.\Some use their powers to achieve great success,\while others fall into ruin as a result of being unable to control their powers.\I'm guessing that the orphanage staff knew who the tiger was,\but declined to enlighten you.\You were the only one who remained ignorant.\You also have supernatural powers.\You have the ability to transform into a wild beast in the moonlight. response:	This is impressive.
context: Some use their powers to achieve great success,\while others fall into ruin as a result of being unable to control their powers.\I'm guessing that the orphanage staff knew who the tiger was,\but declined to enlighten you.\You were the only one who remained ignorant.\You also have supernatural powers.\You have the ability to transform into a wild beast in the moonlight.\This is impressive. response:	You could easily...
context: while others fall into ruin as a result of being unable to control their powers.\I'm guessing that the orphanage staff knew who the tiger was,\but declined to enlighten you.\You were the only one who remained ignorant.\You also have supernatural powers.\You have the ability to transform into a wild beast in the moonlight.\This is impressive.\You could easily... response:	snap a person's neck.
context: I'm guessing that the orphanage staff knew who the tiger was,\but declined to enlighten you.\You were the only one who remained ignorant.\You also have supernatural powers.\You have the ability to transform into a wild beast in the moonlight.\This is impressive.\You could easily...\snap a person's neck. response:	It wouldn't be so bad to meet one's end
context: but declined to enlighten you.\You were the only one who remained ignorant.\You also have supernatural powers.\You have the ability to transform into a wild beast in the moonlight.\This is impressive.\You could easily...\snap a person's neck.\It wouldn't be so bad to meet one's end response:	being eaten by a beast,
context: You were the only one who remained ignorant.\You also have supernatural powers.\You have the ability to transform into a wild beast in the moonlight.\This is impressive.\You could easily...\snap a person's neck.\It wouldn't be so bad to meet one's end\being eaten by a beast, response:	but you can't kill me.
context: You also have supernatural powers.\You have the ability to transform into a wild beast in the moonlight.\This is impressive.\You could easily...\snap a person's neck.\It wouldn't be so bad to meet one's end\being eaten by a beast,\but you can't kill me. response:	My ability is...
context: You have the ability to transform into a wild beast in the moonlight.\This is impressive.\You could easily...\snap a person's neck.\It wouldn't be so bad to meet one's end\being eaten by a beast,\but you can't kill me.\My ability is... response:	No Longer Human
context: This is impressive.\You could easily...\snap a person's neck.\It wouldn't be so bad to meet one's end\being eaten by a beast,\but you can't kill me.\My ability is...\No Longer Human response:	No Longer Human.
context: You could easily...\snap a person's neck.\It wouldn't be so bad to meet one's end\being eaten by a beast,\but you can't kill me.\My ability is...\No Longer Human\No Longer Human. response:	My ability allows me to render any other ability null
context: snap a person's neck.\It wouldn't be so bad to meet one's end\being eaten by a beast,\but you can't kill me.\My ability is...\No Longer Human\No Longer Human.\My ability allows me to render any other ability null response:	through simple touch.
context: It wouldn't be so bad to meet one's end\being eaten by a beast,\but you can't kill me.\My ability is...\No Longer Human\No Longer Human.\My ability allows me to render any other ability null\through simple touch. response:	I have no such tastes in men.
context: being eaten by a beast,\but you can't kill me.\My ability is...\No Longer Human\No Longer Human.\My ability allows me to render any other ability null\through simple touch.\I have no such tastes in men. response:	Thud
context: but you can't kill me.\My ability is...\No Longer Human\No Longer Human.\My ability allows me to render any other ability null\through simple touch.\I have no such tastes in men.\Thud response:	Hey, Dazai!
context: My ability is...\No Longer Human\No Longer Human.\My ability allows me to render any other ability null\through simple touch.\I have no such tastes in men.\Thud\Hey, Dazai! response:	Oh, you're late, Kunikida-kun.
context: No Longer Human\No Longer Human.\My ability allows me to render any other ability null\through simple touch.\I have no such tastes in men.\Thud\Hey, Dazai!\Oh, you're late, Kunikida-kun. response:	I've captured the tiger.
context: No Longer Human.\My ability allows me to render any other ability null\through simple touch.\I have no such tastes in men.\Thud\Hey, Dazai!\Oh, you're late, Kunikida-kun.\I've captured the tiger. response:	What, it's this boy?
context: My ability allows me to render any other ability null\through simple touch.\I have no such tastes in men.\Thud\Hey, Dazai!\Oh, you're late, Kunikida-kun.\I've captured the tiger.\What, it's this boy? response:	He has the ability to transform into a tiger.
context: through simple touch.\I have no such tastes in men.\Thud\Hey, Dazai!\Oh, you're late, Kunikida-kun.\I've captured the tiger.\What, it's this boy?\He has the ability to transform into a tiger. response:	Jeez.
context: I have no such tastes in men.\Thud\Hey, Dazai!\Oh, you're late, Kunikida-kun.\I've captured the tiger.\What, it's this boy?\He has the ability to transform into a tiger.\Jeez. response:	What was with this note?
context: Thud\Hey, Dazai!\Oh, you're late, Kunikida-kun.\I've captured the tiger.\What, it's this boy?\He has the ability to transform into a tiger.\Jeez.\What was with this note? response:	A tiger will appear in the warehouse in the fifteenth district.
context: Hey, Dazai!\Oh, you're late, Kunikida-kun.\I've captured the tiger.\What, it's this boy?\He has the ability to transform into a tiger.\Jeez.\What was with this note?\A tiger will appear in the warehouse in the fifteenth district. response:	Secure the perimeter so that it can't get away.
context: Oh, you're late, Kunikida-kun.\I've captured the tiger.\What, it's this boy?\He has the ability to transform into a tiger.\Jeez.\What was with this note?\A tiger will appear in the warehouse in the fifteenth district.\Secure the perimeter so that it can't get away. response:	It's an excellent, concise note.
context: I've captured the tiger.\What, it's this boy?\He has the ability to transform into a tiger.\Jeez.\What was with this note?\A tiger will appear in the warehouse in the fifteenth district.\Secure the perimeter so that it can't get away.\It's an excellent, concise note. response:	You've left out the most important detail!
context: What, it's this boy?\He has the ability to transform into a tiger.\Jeez.\What was with this note?\A tiger will appear in the warehouse in the fifteenth district.\Secure the perimeter so that it can't get away.\It's an excellent, concise note.\You've left out the most important detail! response:	Next time, explain in advance.
context: He has the ability to transform into a tiger.\Jeez.\What was with this note?\A tiger will appear in the warehouse in the fifteenth district.\Secure the perimeter so that it can't get away.\It's an excellent, concise note.\You've left out the most important detail!\Next time, explain in advance. response:	Thanks to you, I had to bring in guys who weren't even on call.
context: Jeez.\What was with this note?\A tiger will appear in the warehouse in the fifteenth district.\Secure the perimeter so that it can't get away.\It's an excellent, concise note.\You've left out the most important detail!\Next time, explain in advance.\Thanks to you, I had to bring in guys who weren't even on call. response:	Take them out for drinks later.
context: What was with this note?\A tiger will appear in the warehouse in the fifteenth district.\Secure the perimeter so that it can't get away.\It's an excellent, concise note.\You've left out the most important detail!\Next time, explain in advance.\Thanks to you, I had to bring in guys who weren't even on call.\Take them out for drinks later. response:	Hey!
context: A tiger will appear in the warehouse in the fifteenth district.\Secure the perimeter so that it can't get away.\It's an excellent, concise note.\You've left out the most important detail!\Next time, explain in advance.\Thanks to you, I had to bring in guys who weren't even on call.\Take them out for drinks later.\Hey! response:	Yosano Akiko
context: Secure the perimeter so that it can't get away.\It's an excellent, concise note.\You've left out the most important detail!\Next time, explain in advance.\Thanks to you, I had to bring in guys who weren't even on call.\Take them out for drinks later.\Hey!\Yosano Akiko response:	Ability: Thou Shalt Not Die
context: It's an excellent, concise note.\You've left out the most important detail!\Next time, explain in advance.\Thanks to you, I had to bring in guys who weren't even on call.\Take them out for drinks later.\Hey!\Yosano Akiko\Ability: Thou Shalt Not Die response:	What, no casualties?
context: You've left out the most important detail!\Next time, explain in advance.\Thanks to you, I had to bring in guys who weren't even on call.\Take them out for drinks later.\Hey!\Yosano Akiko\Ability: Thou Shalt Not Die\What, no casualties? response:	How boring.
context: Next time, explain in advance.\Thanks to you, I had to bring in guys who weren't even on call.\Take them out for drinks later.\Hey!\Yosano Akiko\Ability: Thou Shalt Not Die\What, no casualties?\How boring. response:	Edogawa Rampo
context: Thanks to you, I had to bring in guys who weren't even on call.\Take them out for drinks later.\Hey!\Yosano Akiko\Ability: Thou Shalt Not Die\What, no casualties?\How boring.\Edogawa Rampo response:	Ability: Ultra-Deduction
context: Take them out for drinks later.\Hey!\Yosano Akiko\Ability: Thou Shalt Not Die\What, no casualties?\How boring.\Edogawa Rampo\Ability: Ultra-Deduction response:	You've come a long way, Dazai.
context: Hey!\Yosano Akiko\Ability: Thou Shalt Not Die\What, no casualties?\How boring.\Edogawa Rampo\Ability: Ultra-Deduction\You've come a long way, Dazai. response:	Though you still have a ways to go before you even come close to me.
context: Yosano Akiko\Ability: Thou Shalt Not Die\What, no casualties?\How boring.\Edogawa Rampo\Ability: Ultra-Deduction\You've come a long way, Dazai.\Though you still have a ways to go before you even come close to me. response:	Miyazawa Kenji
context: Ability: Thou Shalt Not Die\What, no casualties?\How boring.\Edogawa Rampo\Ability: Ultra-Deduction\You've come a long way, Dazai.\Though you still have a ways to go before you even come close to me.\Miyazawa Kenji response:	Ability: Be Not Defeated by the Rain
context: What, no casualties?\How boring.\Edogawa Rampo\Ability: Ultra-Deduction\You've come a long way, Dazai.\Though you still have a ways to go before you even come close to me.\Miyazawa Kenji\Ability: Be Not Defeated by the Rain response:	But what are we going to do with him?
context: How boring.\Edogawa Rampo\Ability: Ultra-Deduction\You've come a long way, Dazai.\Though you still have a ways to go before you even come close to me.\Miyazawa Kenji\Ability: Be Not Defeated by the Rain\But what are we going to do with him? response:	He didn't know he was doing it, right?
context: Edogawa Rampo\Ability: Ultra-Deduction\You've come a long way, Dazai.\Though you still have a ways to go before you even come close to me.\Miyazawa Kenji\Ability: Be Not Defeated by the Rain\But what are we going to do with him?\He didn't know he was doing it, right? response:	Yeah, you're right.
context: Ability: Ultra-Deduction\You've come a long way, Dazai.\Though you still have a ways to go before you even come close to me.\Miyazawa Kenji\Ability: Be Not Defeated by the Rain\But what are we going to do with him?\He didn't know he was doing it, right?\Yeah, you're right. response:	Kunikida Doppo
context: You've come a long way, Dazai.\Though you still have a ways to go before you even come close to me.\Miyazawa Kenji\Ability: Be Not Defeated by the Rain\But what are we going to do with him?\He didn't know he was doing it, right?\Yeah, you're right.\Kunikida Doppo response:	Ability: Doppo Poet
context: Though you still have a ways to go before you even come close to me.\Miyazawa Kenji\Ability: Be Not Defeated by the Rain\But what are we going to do with him?\He didn't know he was doing it, right?\Yeah, you're right.\Kunikida Doppo\Ability: Doppo Poet response:	What do you think, Dazai?
context: Miyazawa Kenji\Ability: Be Not Defeated by the Rain\But what are we going to do with him?\He didn't know he was doing it, right?\Yeah, you're right.\Kunikida Doppo\Ability: Doppo Poet\What do you think, Dazai? response:	The ward's designated him as a major threat.
context: Ability: Be Not Defeated by the Rain\But what are we going to do with him?\He didn't know he was doing it, right?\Yeah, you're right.\Kunikida Doppo\Ability: Doppo Poet\What do you think, Dazai?\The ward's designated him as a major threat. response:	Dazai Osamu
context: But what are we going to do with him?\He didn't know he was doing it, right?\Yeah, you're right.\Kunikida Doppo\Ability: Doppo Poet\What do you think, Dazai?\The ward's designated him as a major threat.\Dazai Osamu response:	Ability: No Longer Human
context: He didn't know he was doing it, right?\Yeah, you're right.\Kunikida Doppo\Ability: Doppo Poet\What do you think, Dazai?\The ward's designated him as a major threat.\Dazai Osamu\Ability: No Longer Human response:	I've already made a decision.
context: Yeah, you're right.\Kunikida Doppo\Ability: Doppo Poet\What do you think, Dazai?\The ward's designated him as a major threat.\Dazai Osamu\Ability: No Longer Human\I've already made a decision. response:	They called me a good-for-nothing at the orphanage as far back as I can remember.
context: Kunikida Doppo\Ability: Doppo Poet\What do you think, Dazai?\The ward's designated him as a major threat.\Dazai Osamu\Ability: No Longer Human\I've already made a decision.\They called me a good-for-nothing at the orphanage as far back as I can remember. response:	And now, I don't even know where I'll sleep tonight or whether I'll be able to earn my keep tomorrow.
context: Ability: Doppo Poet\What do you think, Dazai?\The ward's designated him as a major threat.\Dazai Osamu\Ability: No Longer Human\I've already made a decision.\They called me a good-for-nothing at the orphanage as far back as I can remember.\And now, I don't even know where I'll sleep tonight or whether I'll be able to earn my keep tomorrow. response:	No one'd care if someone like me were to die in a ditch somewhere.
context: What do you think, Dazai?\The ward's designated him as a major threat.\Dazai Osamu\Ability: No Longer Human\I've already made a decision.\They called me a good-for-nothing at the orphanage as far back as I can remember.\And now, I don't even know where I'll sleep tonight or whether I'll be able to earn my keep tomorrow.\No one'd care if someone like me were to die in a ditch somewhere. response:	Yeah, I may be better off eaten by a tiger...
context: The ward's designated him as a major threat.\Dazai Osamu\Ability: No Longer Human\I've already made a decision.\They called me a good-for-nothing at the orphanage as far back as I can remember.\And now, I don't even know where I'll sleep tonight or whether I'll be able to earn my keep tomorrow.\No one'd care if someone like me were to die in a ditch somewhere.\Yeah, I may be better off eaten by a tiger... response:	We'll make him one of us.
context: Dazai Osamu\Ability: No Longer Human\I've already made a decision.\They called me a good-for-nothing at the orphanage as far back as I can remember.\And now, I don't even know where I'll sleep tonight or whether I'll be able to earn my keep tomorrow.\No one'd care if someone like me were to die in a ditch somewhere.\Yeah, I may be better off eaten by a tiger...\We'll make him one of us. response:	Nice!
context: Ability: No Longer Human\I've already made a decision.\They called me a good-for-nothing at the orphanage as far back as I can remember.\And now, I don't even know where I'll sleep tonight or whether I'll be able to earn my keep tomorrow.\No one'd care if someone like me were to die in a ditch somewhere.\Yeah, I may be better off eaten by a tiger...\We'll make him one of us.\Nice! response:	Are you serious?
context: I've already made a decision.\They called me a good-for-nothing at the orphanage as far back as I can remember.\And now, I don't even know where I'll sleep tonight or whether I'll be able to earn my keep tomorrow.\No one'd care if someone like me were to die in a ditch somewhere.\Yeah, I may be better off eaten by a tiger...\We'll make him one of us.\Nice!\Are you serious? response:	Dazai, you are an idiot.
context: They called me a good-for-nothing at the orphanage as far back as I can remember.\And now, I don't even know where I'll sleep tonight or whether I'll be able to earn my keep tomorrow.\No one'd care if someone like me were to die in a ditch somewhere.\Yeah, I may be better off eaten by a tiger...\We'll make him one of us.\Nice!\Are you serious?\Dazai, you are an idiot. response:	What gives you the right to decide that?
context: And now, I don't even know where I'll sleep tonight or whether I'll be able to earn my keep tomorrow.\No one'd care if someone like me were to die in a ditch somewhere.\Yeah, I may be better off eaten by a tiger...\We'll make him one of us.\Nice!\Are you serious?\Dazai, you are an idiot.\What gives you the right to decide that? response:	There, there.
context: No one'd care if someone like me were to die in a ditch somewhere.\Yeah, I may be better off eaten by a tiger...\We'll make him one of us.\Nice!\Are you serious?\Dazai, you are an idiot.\What gives you the right to decide that?\There, there. response:	Wake up, boy!
context: Yeah, I may be better off eaten by a tiger...\We'll make him one of us.\Nice!\Are you serious?\Dazai, you are an idiot.\What gives you the right to decide that?\There, there.\Wake up, boy! response:	Here, in a city teeming with the supernatural...
context: We'll make him one of us.\Nice!\Are you serious?\Dazai, you are an idiot.\What gives you the right to decide that?\There, there.\Wake up, boy!\Here, in a city teeming with the supernatural... response:	Here, in a detective agency teeming with eccentrics...
context: Nice!\Are you serious?\Dazai, you are an idiot.\What gives you the right to decide that?\There, there.\Wake up, boy!\Here, in a city teeming with the supernatural...\Here, in a detective agency teeming with eccentrics... response:	A strange tale is about to unfold.
context: Are you serious?\Dazai, you are an idiot.\What gives you the right to decide that?\There, there.\Wake up, boy!\Here, in a city teeming with the supernatural...\Here, in a detective agency teeming with eccentrics...\A strange tale is about to unfold. response:	This is only a sign of things to come... A premonition, if you will.
context: Dazai, you are an idiot.\What gives you the right to decide that?\There, there.\Wake up, boy!\Here, in a city teeming with the supernatural...\Here, in a detective agency teeming with eccentrics...\A strange tale is about to unfold.\This is only a sign of things to come... A premonition, if you will. response:	Now...
context: What gives you the right to decide that?\There, there.\Wake up, boy!\Here, in a city teeming with the supernatural...\Here, in a detective agency teeming with eccentrics...\A strange tale is about to unfold.\This is only a sign of things to come... A premonition, if you will.\Now... response:	Huh?
context: There, there.\Wake up, boy!\Here, in a city teeming with the supernatural...\Here, in a detective agency teeming with eccentrics...\A strange tale is about to unfold.\This is only a sign of things to come... A premonition, if you will.\Now...\Huh? response:	Atsushi-kun.
context: Wake up, boy!\Here, in a city teeming with the supernatural...\Here, in a detective agency teeming with eccentrics...\A strange tale is about to unfold.\This is only a sign of things to come... A premonition, if you will.\Now...\Huh?\Atsushi-kun. response:	Do you remember nothing at all from when you were transformed?
context: Here, in a city teeming with the supernatural...\Here, in a detective agency teeming with eccentrics...\A strange tale is about to unfold.\This is only a sign of things to come... A premonition, if you will.\Now...\Huh?\Atsushi-kun.\Do you remember nothing at all from when you were transformed? response:	What are you talking about?
context: Here, in a detective agency teeming with eccentrics...\A strange tale is about to unfold.\This is only a sign of things to come... A premonition, if you will.\Now...\Huh?\Atsushi-kun.\Do you remember nothing at all from when you were transformed?\What are you talking about? response:	Oh.
context: A strange tale is about to unfold.\This is only a sign of things to come... A premonition, if you will.\Now...\Huh?\Atsushi-kun.\Do you remember nothing at all from when you were transformed?\What are you talking about?\Oh. response:	But your right hand's still there.
context: This is only a sign of things to come... A premonition, if you will.\Now...\Huh?\Atsushi-kun.\Do you remember nothing at all from when you were transformed?\What are you talking about?\Oh.\But your right hand's still there. response:	Right hand?
context: Now...\Huh?\Atsushi-kun.\Do you remember nothing at all from when you were transformed?\What are you talking about?\Oh.\But your right hand's still there.\Right hand? response:	What?!
context: Huh?\Atsushi-kun.\Do you remember nothing at all from when you were transformed?\What are you talking about?\Oh.\But your right hand's still there.\Right hand?\What?! response:	Nakajima Atsushi
context: Atsushi-kun.\Do you remember nothing at all from when you were transformed?\What are you talking about?\Oh.\But your right hand's still there.\Right hand?\What?!\Nakajima Atsushi response:	Ability: Beast Beneath The Moonlight
context: Do you remember nothing at all from when you were transformed?\What are you talking about?\Oh.\But your right hand's still there.\Right hand?\What?!\Nakajima Atsushi\Ability: Beast Beneath The Moonlight response:	What the?
context: What are you talking about?\Oh.\But your right hand's still there.\Right hand?\What?!\Nakajima Atsushi\Ability: Beast Beneath The Moonlight\What the? response:	What's this?
context: Oh.\But your right hand's still there.\Right hand?\What?!\Nakajima Atsushi\Ability: Beast Beneath The Moonlight\What the?\What's this? response:	What the hell?!
context: But your right hand's still there.\Right hand?\What?!\Nakajima Atsushi\Ability: Beast Beneath The Moonlight\What the?\What's this?\What the hell?! response:	Nakajima Atsushi!
context: Right hand?\What?!\Nakajima Atsushi\Ability: Beast Beneath The Moonlight\What the?\What's this?\What the hell?!\Nakajima Atsushi! response:	You'll become one of us.
context: What?!\Nakajima Atsushi\Ability: Beast Beneath The Moonlight\What the?\What's this?\What the hell?!\Nakajima Atsushi!\You'll become one of us. response:	From this day forth, you'll be a member of the Armed Detective Agency.
context: Nakajima Atsushi\Ability: Beast Beneath The Moonlight\What the?\What's this?\What the hell?!\Nakajima Atsushi!\You'll become one of us.\From this day forth, you'll be a member of the Armed Detective Agency. response:	Huh?
context: Ability: Beast Beneath The Moonlight\What the?\What's this?\What the hell?!\Nakajima Atsushi!\You'll become one of us.\From this day forth, you'll be a member of the Armed Detective Agency.\Huh? response:	It's been a long time since I've slept on a futon.
context: What the?\What's this?\What the hell?!\Nakajima Atsushi!\You'll become one of us.\From this day forth, you'll be a member of the Armed Detective Agency.\Huh?\It's been a long time since I've slept on a futon. response:	I feel reborn...
context: What's this?\What the hell?!\Nakajima Atsushi!\You'll become one of us.\From this day forth, you'll be a member of the Armed Detective Agency.\Huh?\It's been a long time since I've slept on a futon.\I feel reborn... response:	Hey, brat.
context: What the hell?!\Nakajima Atsushi!\You'll become one of us.\From this day forth, you'll be a member of the Armed Detective Agency.\Huh?\It's been a long time since I've slept on a futon.\I feel reborn...\Hey, brat. response:	There's an emergency.
context: Nakajima Atsushi!\You'll become one of us.\From this day forth, you'll be a member of the Armed Detective Agency.\Huh?\It's been a long time since I've slept on a futon.\I feel reborn...\Hey, brat.\There's an emergency. response:	Hightail it over to the detective agency.
context: You'll become one of us.\From this day forth, you'll be a member of the Armed Detective Agency.\Huh?\It's been a long time since I've slept on a futon.\I feel reborn...\Hey, brat.\There's an emergency.\Hightail it over to the detective agency. response:	An emergency?
context: From this day forth, you'll be a member of the Armed Detective Agency.\Huh?\It's been a long time since I've slept on a futon.\I feel reborn...\Hey, brat.\There's an emergency.\Hightail it over to the detective agency.\An emergency? response:	A bomber's taken a hostage and holed himself up in our office.
context: Huh?\It's been a long time since I've slept on a futon.\I feel reborn...\Hey, brat.\There's an emergency.\Hightail it over to the detective agency.\An emergency?\A bomber's taken a hostage and holed himself up in our office. response:	I don't want to go!
context: It's been a long time since I've slept on a futon.\I feel reborn...\Hey, brat.\There's an emergency.\Hightail it over to the detective agency.\An emergency?\A bomber's taken a hostage and holed himself up in our office.\I don't want to go! response:	Episode 2: A Certain Bomb
context: I feel reborn...\Hey, brat.\There's an emergency.\Hightail it over to the detective agency.\An emergency?\A bomber's taken a hostage and holed himself up in our office.\I don't want to go!\Episode 2: A Certain Bomb response:	A Certain Bomb.
context: Hey, brat.\There's an emergency.\Hightail it over to the detective agency.\An emergency?\A bomber's taken a hostage and holed himself up in our office.\I don't want to go!\Episode 2: A Certain Bomb\A Certain Bomb. response:	Ability: Doppo Poet.
context: There's an emergency.\Hightail it over to the detective agency.\An emergency?\A bomber's taken a hostage and holed himself up in our office.\I don't want to go!\Episode 2: A Certain Bomb\A Certain Bomb.\Ability: Doppo Poet. response:	Wire Gun