context: And we broke response:	Everything that was right
context: And we broke\Everything that was right response:	We both enjoyed a good fight
context: And we broke\Everything that was right\We both enjoyed a good fight response:	And we sewed
context: And we broke\Everything that was right\We both enjoyed a good fight\And we sewed response:	All the holes we had to breathe
context: And we broke\Everything that was right\We both enjoyed a good fight\And we sewed\All the holes we had to breathe response:	To make the other one leave
context: And we broke\Everything that was right\We both enjoyed a good fight\And we sewed\All the holes we had to breathe\To make the other one leave response:	And I loved
context: And we broke\Everything that was right\We both enjoyed a good fight\And we sewed\All the holes we had to breathe\To make the other one leave\And I loved response:	The way you looked at me
context: And we broke\Everything that was right\We both enjoyed a good fight\And we sewed\All the holes we had to breathe\To make the other one leave\And I loved\The way you looked at me response:	And I miss
context: Everything that was right\We both enjoyed a good fight\And we sewed\All the holes we had to breathe\To make the other one leave\And I loved\The way you looked at me\And I miss response:	The way you made me feel
context: We both enjoyed a good fight\And we sewed\All the holes we had to breathe\To make the other one leave\And I loved\The way you looked at me\And I miss\The way you made me feel response:	When we were alone
context: And we sewed\All the holes we had to breathe\To make the other one leave\And I loved\The way you looked at me\And I miss\The way you made me feel\When we were alone response:	When we were alone
context: All the holes we had to breathe\To make the other one leave\And I loved\The way you looked at me\And I miss\The way you made me feel\When we were alone\When we were alone response:	And I'll shiver like I used to
context: To make the other one leave\And I loved\The way you looked at me\And I miss\The way you made me feel\When we were alone\When we were alone\And I'll shiver like I used to response:	And I'll leave him just for you
context: And I loved\The way you looked at me\And I miss\The way you made me feel\When we were alone\When we were alone\And I'll shiver like I used to\And I'll leave him just for you response:	And I'll shiver like I used to
context: The way you looked at me\And I miss\The way you made me feel\When we were alone\When we were alone\And I'll shiver like I used to\And I'll leave him just for you\And I'll shiver like I used to response:	Mushi-Shi
context: And I miss\The way you made me feel\When we were alone\When we were alone\And I'll shiver like I used to\And I'll leave him just for you\And I'll shiver like I used to\Mushi-Shi response:	Mushi-Shi
context: The way you made me feel\When we were alone\When we were alone\And I'll shiver like I used to\And I'll leave him just for you\And I'll shiver like I used to\Mushi-Shi\Mushi-Shi response:	Just for you
context: When we were alone\When we were alone\And I'll shiver like I used to\And I'll leave him just for you\And I'll shiver like I used to\Mushi-Shi\Mushi-Shi\Just for you response:	Like I used to
context: When we were alone\And I'll shiver like I used to\And I'll leave him just for you\And I'll shiver like I used to\Mushi-Shi\Mushi-Shi\Just for you\Like I used to response:	This doesn't look good.
context: And I'll shiver like I used to\And I'll leave him just for you\And I'll shiver like I used to\Mushi-Shi\Mushi-Shi\Just for you\Like I used to\This doesn't look good. response:	Put your backs into it, men!
context: And I'll leave him just for you\And I'll shiver like I used to\Mushi-Shi\Mushi-Shi\Just for you\Like I used to\This doesn't look good.\Put your backs into it, men! response:	Yes, sir!
context: And I'll shiver like I used to\Mushi-Shi\Mushi-Shi\Just for you\Like I used to\This doesn't look good.\Put your backs into it, men!\Yes, sir! response:	What's that whistling sound I keep hearing?
context: Mushi-Shi\Mushi-Shi\Just for you\Like I used to\This doesn't look good.\Put your backs into it, men!\Yes, sir!\What's that whistling sound I keep hearing? response:	It sounds like birds...
context: Mushi-Shi\Just for you\Like I used to\This doesn't look good.\Put your backs into it, men!\Yes, sir!\What's that whistling sound I keep hearing?\It sounds like birds... response:	Huh?
context: Just for you\Like I used to\This doesn't look good.\Put your backs into it, men!\Yes, sir!\What's that whistling sound I keep hearing?\It sounds like birds...\Huh? response:	Finally, a nice breeze is blowing.
context: Like I used to\This doesn't look good.\Put your backs into it, men!\Yes, sir!\What's that whistling sound I keep hearing?\It sounds like birds...\Huh?\Finally, a nice breeze is blowing. response:	The Wind Raiser
context: This doesn't look good.\Put your backs into it, men!\Yes, sir!\What's that whistling sound I keep hearing?\It sounds like birds...\Huh?\Finally, a nice breeze is blowing.\The Wind Raiser response:	Well, that's a neat trick.
context: Put your backs into it, men!\Yes, sir!\What's that whistling sound I keep hearing?\It sounds like birds...\Huh?\Finally, a nice breeze is blowing.\The Wind Raiser\Well, that's a neat trick. response:	You seem to have complete control over the wind.
context: Yes, sir!\What's that whistling sound I keep hearing?\It sounds like birds...\Huh?\Finally, a nice breeze is blowing.\The Wind Raiser\Well, that's a neat trick.\You seem to have complete control over the wind. response:	Are you a stowaway?
context: What's that whistling sound I keep hearing?\It sounds like birds...\Huh?\Finally, a nice breeze is blowing.\The Wind Raiser\Well, that's a neat trick.\You seem to have complete control over the wind.\Are you a stowaway? response:	Nah, not at all.
context: It sounds like birds...\Huh?\Finally, a nice breeze is blowing.\The Wind Raiser\Well, that's a neat trick.\You seem to have complete control over the wind.\Are you a stowaway?\Nah, not at all. response:	I made a deal with your captain at the last harbor.
context: Huh?\Finally, a nice breeze is blowing.\The Wind Raiser\Well, that's a neat trick.\You seem to have complete control over the wind.\Are you a stowaway?\Nah, not at all.\I made a deal with your captain at the last harbor. response:	I bartered some of this tonic in exchange for passage.
context: Finally, a nice breeze is blowing.\The Wind Raiser\Well, that's a neat trick.\You seem to have complete control over the wind.\Are you a stowaway?\Nah, not at all.\I made a deal with your captain at the last harbor.\I bartered some of this tonic in exchange for passage. response:	Traveling by ship is pretty nice, after all.
context: The Wind Raiser\Well, that's a neat trick.\You seem to have complete control over the wind.\Are you a stowaway?\Nah, not at all.\I made a deal with your captain at the last harbor.\I bartered some of this tonic in exchange for passage.\Traveling by ship is pretty nice, after all. response:	So you can see them too?
context: Well, that's a neat trick.\You seem to have complete control over the wind.\Are you a stowaway?\Nah, not at all.\I made a deal with your captain at the last harbor.\I bartered some of this tonic in exchange for passage.\Traveling by ship is pretty nice, after all.\So you can see them too? response:	Yeah.
context: You seem to have complete control over the wind.\Are you a stowaway?\Nah, not at all.\I made a deal with your captain at the last harbor.\I bartered some of this tonic in exchange for passage.\Traveling by ship is pretty nice, after all.\So you can see them too?\Yeah. response:	They're Torikaze, or Wind Bird mushi.
context: Are you a stowaway?\Nah, not at all.\I made a deal with your captain at the last harbor.\I bartered some of this tonic in exchange for passage.\Traveling by ship is pretty nice, after all.\So you can see them too?\Yeah.\They're Torikaze, or Wind Bird mushi. response:	We mushi-shi sometimes use a stone whistle like this to lure mushi to us.
context: Nah, not at all.\I made a deal with your captain at the last harbor.\I bartered some of this tonic in exchange for passage.\Traveling by ship is pretty nice, after all.\So you can see them too?\Yeah.\They're Torikaze, or Wind Bird mushi.\We mushi-shi sometimes use a stone whistle like this to lure mushi to us. response:	Did someone teach you how to whistle like that?
context: I made a deal with your captain at the last harbor.\I bartered some of this tonic in exchange for passage.\Traveling by ship is pretty nice, after all.\So you can see them too?\Yeah.\They're Torikaze, or Wind Bird mushi.\We mushi-shi sometimes use a stone whistle like this to lure mushi to us.\Did someone teach you how to whistle like that? response:	Nah.
context: I bartered some of this tonic in exchange for passage.\Traveling by ship is pretty nice, after all.\So you can see them too?\Yeah.\They're Torikaze, or Wind Bird mushi.\We mushi-shi sometimes use a stone whistle like this to lure mushi to us.\Did someone teach you how to whistle like that?\Nah. response:	I get bored, so I just whistle a lot.
context: Traveling by ship is pretty nice, after all.\So you can see them too?\Yeah.\They're Torikaze, or Wind Bird mushi.\We mushi-shi sometimes use a stone whistle like this to lure mushi to us.\Did someone teach you how to whistle like that?\Nah.\I get bored, so I just whistle a lot. response:	One day, these guys responded to me.
context: So you can see them too?\Yeah.\They're Torikaze, or Wind Bird mushi.\We mushi-shi sometimes use a stone whistle like this to lure mushi to us.\Did someone teach you how to whistle like that?\Nah.\I get bored, so I just whistle a lot.\One day, these guys responded to me. response:	Really? That's a bit impressive.
context: Yeah.\They're Torikaze, or Wind Bird mushi.\We mushi-shi sometimes use a stone whistle like this to lure mushi to us.\Did someone teach you how to whistle like that?\Nah.\I get bored, so I just whistle a lot.\One day, these guys responded to me.\Really? That's a bit impressive. response:	How do you do it?
context: They're Torikaze, or Wind Bird mushi.\We mushi-shi sometimes use a stone whistle like this to lure mushi to us.\Did someone teach you how to whistle like that?\Nah.\I get bored, so I just whistle a lot.\One day, these guys responded to me.\Really? That's a bit impressive.\How do you do it? response:	That one was Blow stronger.
context: We mushi-shi sometimes use a stone whistle like this to lure mushi to us.\Did someone teach you how to whistle like that?\Nah.\I get bored, so I just whistle a lot.\One day, these guys responded to me.\Really? That's a bit impressive.\How do you do it?\That one was Blow stronger. response:	Rest.
context: Did someone teach you how to whistle like that?\Nah.\I get bored, so I just whistle a lot.\One day, these guys responded to me.\Really? That's a bit impressive.\How do you do it?\That one was Blow stronger.\Rest. response:	Wow. That's amazing.
context: Nah.\I get bored, so I just whistle a lot.\One day, these guys responded to me.\Really? That's a bit impressive.\How do you do it?\That one was Blow stronger.\Rest.\Wow. That's amazing. response:	So, like this?
context: I get bored, so I just whistle a lot.\One day, these guys responded to me.\Really? That's a bit impressive.\How do you do it?\That one was Blow stronger.\Rest.\Wow. That's amazing.\So, like this? response:	Yours sounds a bit off.
context: One day, these guys responded to me.\Really? That's a bit impressive.\How do you do it?\That one was Blow stronger.\Rest.\Wow. That's amazing.\So, like this?\Yours sounds a bit off. response:	And anyway, they won't obey if it's completely against what the flock wants.
context: Really? That's a bit impressive.\How do you do it?\That one was Blow stronger.\Rest.\Wow. That's amazing.\So, like this?\Yours sounds a bit off.\And anyway, they won't obey if it's completely against what the flock wants. response:	They have their own needs and wants, after all.
context: How do you do it?\That one was Blow stronger.\Rest.\Wow. That's amazing.\So, like this?\Yours sounds a bit off.\And anyway, they won't obey if it's completely against what the flock wants.\They have their own needs and wants, after all. response:	Well, I'm in awe.
context: That one was Blow stronger.\Rest.\Wow. That's amazing.\So, like this?\Yours sounds a bit off.\And anyway, they won't obey if it's completely against what the flock wants.\They have their own needs and wants, after all.\Well, I'm in awe. response:	But you only whistle during the day, right?
context: Rest.\Wow. That's amazing.\So, like this?\Yours sounds a bit off.\And anyway, they won't obey if it's completely against what the flock wants.\They have their own needs and wants, after all.\Well, I'm in awe.\But you only whistle during the day, right? response:	Yeah.
context: Wow. That's amazing.\So, like this?\Yours sounds a bit off.\And anyway, they won't obey if it's completely against what the flock wants.\They have their own needs and wants, after all.\Well, I'm in awe.\But you only whistle during the day, right?\Yeah. response:	At night, these guys disappear back to their nests or something.
context: So, like this?\Yours sounds a bit off.\And anyway, they won't obey if it's completely against what the flock wants.\They have their own needs and wants, after all.\Well, I'm in awe.\But you only whistle during the day, right?\Yeah.\At night, these guys disappear back to their nests or something. response:	Good. You must never whistle like that at night.
context: Yours sounds a bit off.\And anyway, they won't obey if it's completely against what the flock wants.\They have their own needs and wants, after all.\Well, I'm in awe.\But you only whistle during the day, right?\Yeah.\At night, these guys disappear back to their nests or something.\Good. You must never whistle like that at night. response:	Why not?
context: And anyway, they won't obey if it's completely against what the flock wants.\They have their own needs and wants, after all.\Well, I'm in awe.\But you only whistle during the day, right?\Yeah.\At night, these guys disappear back to their nests or something.\Good. You must never whistle like that at night.\Why not? response:	It's likely something bad will happen if you do.
context: They have their own needs and wants, after all.\Well, I'm in awe.\But you only whistle during the day, right?\Yeah.\At night, these guys disappear back to their nests or something.\Good. You must never whistle like that at night.\Why not?\It's likely something bad will happen if you do. response:	A gift for someone?
context: Well, I'm in awe.\But you only whistle during the day, right?\Yeah.\At night, these guys disappear back to their nests or something.\Good. You must never whistle like that at night.\Why not?\It's likely something bad will happen if you do.\A gift for someone? response:	Yeah. But it looks really expensive, so I probably can't afford it.
context: But you only whistle during the day, right?\Yeah.\At night, these guys disappear back to their nests or something.\Good. You must never whistle like that at night.\Why not?\It's likely something bad will happen if you do.\A gift for someone?\Yeah. But it looks really expensive, so I probably can't afford it. response:	Well, you'll be able to eventually.
context: Yeah.\At night, these guys disappear back to their nests or something.\Good. You must never whistle like that at night.\Why not?\It's likely something bad will happen if you do.\A gift for someone?\Yeah. But it looks really expensive, so I probably can't afford it.\Well, you'll be able to eventually. response:	See ya.
context: At night, these guys disappear back to their nests or something.\Good. You must never whistle like that at night.\Why not?\It's likely something bad will happen if you do.\A gift for someone?\Yeah. But it looks really expensive, so I probably can't afford it.\Well, you'll be able to eventually.\See ya. response:	Take care.
context: Good. You must never whistle like that at night.\Why not?\It's likely something bad will happen if you do.\A gift for someone?\Yeah. But it looks really expensive, so I probably can't afford it.\Well, you'll be able to eventually.\See ya.\Take care. response:	Hey, Ibuki!
context: Why not?\It's likely something bad will happen if you do.\A gift for someone?\Yeah. But it looks really expensive, so I probably can't afford it.\Well, you'll be able to eventually.\See ya.\Take care.\Hey, Ibuki! response:	Come over here for a bit.
context: It's likely something bad will happen if you do.\A gift for someone?\Yeah. But it looks really expensive, so I probably can't afford it.\Well, you'll be able to eventually.\See ya.\Take care.\Hey, Ibuki!\Come over here for a bit. response:	You know, I got kind of worried out there today,
context: A gift for someone?\Yeah. But it looks really expensive, so I probably can't afford it.\Well, you'll be able to eventually.\See ya.\Take care.\Hey, Ibuki!\Come over here for a bit.\You know, I got kind of worried out there today, response:	but look at that. We got here long before everyone else.
context: Yeah. But it looks really expensive, so I probably can't afford it.\Well, you'll be able to eventually.\See ya.\Take care.\Hey, Ibuki!\Come over here for a bit.\You know, I got kind of worried out there today,\but look at that. We got here long before everyone else. response:	You're really starting to pull your weight around here.
context: Well, you'll be able to eventually.\See ya.\Take care.\Hey, Ibuki!\Come over here for a bit.\You know, I got kind of worried out there today,\but look at that. We got here long before everyone else.\You're really starting to pull your weight around here. response:	I plan to talk to the owner about bringing you on as a full-time sailor.
context: See ya.\Take care.\Hey, Ibuki!\Come over here for a bit.\You know, I got kind of worried out there today,\but look at that. We got here long before everyone else.\You're really starting to pull your weight around here.\I plan to talk to the owner about bringing you on as a full-time sailor. response:	Thank you, sir!
context: Take care.\Hey, Ibuki!\Come over here for a bit.\You know, I got kind of worried out there today,\but look at that. We got here long before everyone else.\You're really starting to pull your weight around here.\I plan to talk to the owner about bringing you on as a full-time sailor.\Thank you, sir! response:	Anyway, our next stop is near your hometown, right?
context: Hey, Ibuki!\Come over here for a bit.\You know, I got kind of worried out there today,\but look at that. We got here long before everyone else.\You're really starting to pull your weight around here.\I plan to talk to the owner about bringing you on as a full-time sailor.\Thank you, sir!\Anyway, our next stop is near your hometown, right? response:	If we get there early enough, you can go home and get some rest.
context: Come over here for a bit.\You know, I got kind of worried out there today,\but look at that. We got here long before everyone else.\You're really starting to pull your weight around here.\I plan to talk to the owner about bringing you on as a full-time sailor.\Thank you, sir!\Anyway, our next stop is near your hometown, right?\If we get there early enough, you can go home and get some rest. response:	Yes, sir!
context: You know, I got kind of worried out there today,\but look at that. We got here long before everyone else.\You're really starting to pull your weight around here.\I plan to talk to the owner about bringing you on as a full-time sailor.\Thank you, sir!\Anyway, our next stop is near your hometown, right?\If we get there early enough, you can go home and get some rest.\Yes, sir! response:	If I tell her I've become a full-fledged sailor,
context: but look at that. We got here long before everyone else.\You're really starting to pull your weight around here.\I plan to talk to the owner about bringing you on as a full-time sailor.\Thank you, sir!\Anyway, our next stop is near your hometown, right?\If we get there early enough, you can go home and get some rest.\Yes, sir!\If I tell her I've become a full-fledged sailor, response:	she'll be proud, won't she?
context: You're really starting to pull your weight around here.\I plan to talk to the owner about bringing you on as a full-time sailor.\Thank you, sir!\Anyway, our next stop is near your hometown, right?\If we get there early enough, you can go home and get some rest.\Yes, sir!\If I tell her I've become a full-fledged sailor,\she'll be proud, won't she? response:	Like I thought, they're not around.
context: I plan to talk to the owner about bringing you on as a full-time sailor.\Thank you, sir!\Anyway, our next stop is near your hometown, right?\If we get there early enough, you can go home and get some rest.\Yes, sir!\If I tell her I've become a full-fledged sailor,\she'll be proud, won't she?\Like I thought, they're not around. response:	Oh.
context: Thank you, sir!\Anyway, our next stop is near your hometown, right?\If we get there early enough, you can go home and get some rest.\Yes, sir!\If I tell her I've become a full-fledged sailor,\she'll be proud, won't she?\Like I thought, they're not around.\Oh. response:	Damn, I forgot.
context: Anyway, our next stop is near your hometown, right?\If we get there early enough, you can go home and get some rest.\Yes, sir!\If I tell her I've become a full-fledged sailor,\she'll be proud, won't she?\Like I thought, they're not around.\Oh.\Damn, I forgot. response:	Nothing's happening, though.
context: If we get there early enough, you can go home and get some rest.\Yes, sir!\If I tell her I've become a full-fledged sailor,\she'll be proud, won't she?\Like I thought, they're not around.\Oh.\Damn, I forgot.\Nothing's happening, though. response:	Keep it down, Ibuki!
context: Yes, sir!\If I tell her I've become a full-fledged sailor,\she'll be proud, won't she?\Like I thought, they're not around.\Oh.\Damn, I forgot.\Nothing's happening, though.\Keep it down, Ibuki! response:	It was you earlier too, wasn't it?!
context: If I tell her I've become a full-fledged sailor,\she'll be proud, won't she?\Like I thought, they're not around.\Oh.\Damn, I forgot.\Nothing's happening, though.\Keep it down, Ibuki!\It was you earlier too, wasn't it?! response:	Come on. Cut him some slack today.
context: she'll be proud, won't she?\Like I thought, they're not around.\Oh.\Damn, I forgot.\Nothing's happening, though.\Keep it down, Ibuki!\It was you earlier too, wasn't it?!\Come on. Cut him some slack today. response:	I'm sure he's just excited to be aboard.
context: Like I thought, they're not around.\Oh.\Damn, I forgot.\Nothing's happening, though.\Keep it down, Ibuki!\It was you earlier too, wasn't it?!\Come on. Cut him some slack today.\I'm sure he's just excited to be aboard. response:	Y-Yes, sir.
context: Oh.\Damn, I forgot.\Nothing's happening, though.\Keep it down, Ibuki!\It was you earlier too, wasn't it?!\Come on. Cut him some slack today.\I'm sure he's just excited to be aboard.\Y-Yes, sir. response:	Huh?
context: Damn, I forgot.\Nothing's happening, though.\Keep it down, Ibuki!\It was you earlier too, wasn't it?!\Come on. Cut him some slack today.\I'm sure he's just excited to be aboard.\Y-Yes, sir.\Huh? response:	What are those?
context: Nothing's happening, though.\Keep it down, Ibuki!\It was you earlier too, wasn't it?!\Come on. Cut him some slack today.\I'm sure he's just excited to be aboard.\Y-Yes, sir.\Huh?\What are those? response:	Hey, wake up!
context: Keep it down, Ibuki!\It was you earlier too, wasn't it?!\Come on. Cut him some slack today.\I'm sure he's just excited to be aboard.\Y-Yes, sir.\Huh?\What are those?\Hey, wake up! response:	The hold is getting flooded!
context: It was you earlier too, wasn't it?!\Come on. Cut him some slack today.\I'm sure he's just excited to be aboard.\Y-Yes, sir.\Huh?\What are those?\Hey, wake up!\The hold is getting flooded! response:	Where did all these holes come from?!
context: Come on. Cut him some slack today.\I'm sure he's just excited to be aboard.\Y-Yes, sir.\Huh?\What are those?\Hey, wake up!\The hold is getting flooded!\Where did all these holes come from?! response:	Hurry and plug them up!
context: I'm sure he's just excited to be aboard.\Y-Yes, sir.\Huh?\What are those?\Hey, wake up!\The hold is getting flooded!\Where did all these holes come from?!\Hurry and plug them up! response:	Scoop up the water and throw it overboard!
context: Y-Yes, sir.\Huh?\What are those?\Hey, wake up!\The hold is getting flooded!\Where did all these holes come from?!\Hurry and plug them up!\Scoop up the water and throw it overboard! response:	It's no use! There are too many holes!
context: Huh?\What are those?\Hey, wake up!\The hold is getting flooded!\Where did all these holes come from?!\Hurry and plug them up!\Scoop up the water and throw it overboard!\It's no use! There are too many holes! response:	Ibuki!
context: What are those?\Hey, wake up!\The hold is getting flooded!\Where did all these holes come from?!\Hurry and plug them up!\Scoop up the water and throw it overboard!\It's no use! There are too many holes!\Ibuki! response:	You made it back alive.
context: Hey, wake up!\The hold is getting flooded!\Where did all these holes come from?!\Hurry and plug them up!\Scoop up the water and throw it overboard!\It's no use! There are too many holes!\Ibuki!\You made it back alive. response:	So, we heard that the ship sank.
context: The hold is getting flooded!\Where did all these holes come from?!\Hurry and plug them up!\Scoop up the water and throw it overboard!\It's no use! There are too many holes!\Ibuki!\You made it back alive.\So, we heard that the ship sank. response:	Yes.
context: Where did all these holes come from?!\Hurry and plug them up!\Scoop up the water and throw it overboard!\It's no use! There are too many holes!\Ibuki!\You made it back alive.\So, we heard that the ship sank.\Yes. response:	We all managed to make it back on the lifeboat.
context: Hurry and plug them up!\Scoop up the water and throw it overboard!\It's no use! There are too many holes!\Ibuki!\You made it back alive.\So, we heard that the ship sank.\Yes.\We all managed to make it back on the lifeboat. response:	I see.
context: Scoop up the water and throw it overboard!\It's no use! There are too many holes!\Ibuki!\You made it back alive.\So, we heard that the ship sank.\Yes.\We all managed to make it back on the lifeboat.\I see. response:	But what will we do now that the ship's sunk?
context: It's no use! There are too many holes!\Ibuki!\You made it back alive.\So, we heard that the ship sank.\Yes.\We all managed to make it back on the lifeboat.\I see.\But what will we do now that the ship's sunk? response:	Were you able to get paid?
context: Ibuki!\You made it back alive.\So, we heard that the ship sank.\Yes.\We all managed to make it back on the lifeboat.\I see.\But what will we do now that the ship's sunk?\Were you able to get paid? response:	I only have this left.
context: You made it back alive.\So, we heard that the ship sank.\Yes.\We all managed to make it back on the lifeboat.\I see.\But what will we do now that the ship's sunk?\Were you able to get paid?\I only have this left. response:	What's this?
context: So, we heard that the ship sank.\Yes.\We all managed to make it back on the lifeboat.\I see.\But what will we do now that the ship's sunk?\Were you able to get paid?\I only have this left.\What's this? response:	Why would you waste money on something like this?
context: Yes.\We all managed to make it back on the lifeboat.\I see.\But what will we do now that the ship's sunk?\Were you able to get paid?\I only have this left.\What's this?\Why would you waste money on something like this? response:	You should take it to the pawnshop and sell it back.
context: We all managed to make it back on the lifeboat.\I see.\But what will we do now that the ship's sunk?\Were you able to get paid?\I only have this left.\What's this?\Why would you waste money on something like this?\You should take it to the pawnshop and sell it back. response:	My goodness, this is trouble.
context: I see.\But what will we do now that the ship's sunk?\Were you able to get paid?\I only have this left.\What's this?\Why would you waste money on something like this?\You should take it to the pawnshop and sell it back.\My goodness, this is trouble. response:	What am I going to feed the children?
context: But what will we do now that the ship's sunk?\Were you able to get paid?\I only have this left.\What's this?\Why would you waste money on something like this?\You should take it to the pawnshop and sell it back.\My goodness, this is trouble.\What am I going to feed the children? response:	Huh? What happened to this pot?
context: Were you able to get paid?\I only have this left.\What's this?\Why would you waste money on something like this?\You should take it to the pawnshop and sell it back.\My goodness, this is trouble.\What am I going to feed the children?\Huh? What happened to this pot? response:	Oh no...
context: I only have this left.\What's this?\Why would you waste money on something like this?\You should take it to the pawnshop and sell it back.\My goodness, this is trouble.\What am I going to feed the children?\Huh? What happened to this pot?\Oh no... response:	And it was fine just this morning, too.
context: What's this?\Why would you waste money on something like this?\You should take it to the pawnshop and sell it back.\My goodness, this is trouble.\What am I going to feed the children?\Huh? What happened to this pot?\Oh no...\And it was fine just this morning, too. response:	Huh?
context: Why would you waste money on something like this?\You should take it to the pawnshop and sell it back.\My goodness, this is trouble.\What am I going to feed the children?\Huh? What happened to this pot?\Oh no...\And it was fine just this morning, too.\Huh? response:	Hm?
context: You should take it to the pawnshop and sell it back.\My goodness, this is trouble.\What am I going to feed the children?\Huh? What happened to this pot?\Oh no...\And it was fine just this morning, too.\Huh?\Hm? response:	And just what do you think you're doing?
context: My goodness, this is trouble.\What am I going to feed the children?\Huh? What happened to this pot?\Oh no...\And it was fine just this morning, too.\Huh?\Hm?\And just what do you think you're doing? response:	Hey.
context: What am I going to feed the children?\Huh? What happened to this pot?\Oh no...\And it was fine just this morning, too.\Huh?\Hm?\And just what do you think you're doing?\Hey. response:	Don't act innocent now.
context: Huh? What happened to this pot?\Oh no...\And it was fine just this morning, too.\Huh?\Hm?\And just what do you think you're doing?\Hey.\Don't act innocent now. response:	Well...
context: Oh no...\And it was fine just this morning, too.\Huh?\Hm?\And just what do you think you're doing?\Hey.\Don't act innocent now.\Well... response:	the stuff you bring is always a hodgepodge in terms of quality.
context: And it was fine just this morning, too.\Huh?\Hm?\And just what do you think you're doing?\Hey.\Don't act innocent now.\Well...\the stuff you bring is always a hodgepodge in terms of quality. response:	So I figured you must have the really rare things tucked away somewhere.
context: Huh?\Hm?\And just what do you think you're doing?\Hey.\Don't act innocent now.\Well...\the stuff you bring is always a hodgepodge in terms of quality.\So I figured you must have the really rare things tucked away somewhere. response:	Those really rare things are the tools of my trade.
context: Hm?\And just what do you think you're doing?\Hey.\Don't act innocent now.\Well...\the stuff you bring is always a hodgepodge in terms of quality.\So I figured you must have the really rare things tucked away somewhere.\Those really rare things are the tools of my trade. response:	Of course I can't sell them.
context: And just what do you think you're doing?\Hey.\Don't act innocent now.\Well...\the stuff you bring is always a hodgepodge in terms of quality.\So I figured you must have the really rare things tucked away somewhere.\Those really rare things are the tools of my trade.\Of course I can't sell them. response:	He's gotten less trusting.
context: Hey.\Don't act innocent now.\Well...\the stuff you bring is always a hodgepodge in terms of quality.\So I figured you must have the really rare things tucked away somewhere.\Those really rare things are the tools of my trade.\Of course I can't sell them.\He's gotten less trusting. response:	I can at least take a look, can't I?
context: Don't act innocent now.\Well...\the stuff you bring is always a hodgepodge in terms of quality.\So I figured you must have the really rare things tucked away somewhere.\Those really rare things are the tools of my trade.\Of course I can't sell them.\He's gotten less trusting.\I can at least take a look, can't I? response:	That's not a good idea, Adashino!
context: Well...\the stuff you bring is always a hodgepodge in terms of quality.\So I figured you must have the really rare things tucked away somewhere.\Those really rare things are the tools of my trade.\Of course I can't sell them.\He's gotten less trusting.\I can at least take a look, can't I?\That's not a good idea, Adashino! response:	You're jumbling up all the contents!
context: the stuff you bring is always a hodgepodge in terms of quality.\So I figured you must have the really rare things tucked away somewhere.\Those really rare things are the tools of my trade.\Of course I can't sell them.\He's gotten less trusting.\I can at least take a look, can't I?\That's not a good idea, Adashino!\You're jumbling up all the contents! response:	Pardon me!
context: So I figured you must have the really rare things tucked away somewhere.\Those really rare things are the tools of my trade.\Of course I can't sell them.\He's gotten less trusting.\I can at least take a look, can't I?\That's not a good idea, Adashino!\You're jumbling up all the contents!\Pardon me! response:	Doctor! Are you in?
context: Those really rare things are the tools of my trade.\Of course I can't sell them.\He's gotten less trusting.\I can at least take a look, can't I?\That's not a good idea, Adashino!\You're jumbling up all the contents!\Pardon me!\Doctor! Are you in? response:	Doctor!
context: Of course I can't sell them.\He's gotten less trusting.\I can at least take a look, can't I?\That's not a good idea, Adashino!\You're jumbling up all the contents!\Pardon me!\Doctor! Are you in?\Doctor! response:	Please come take a look at my wife!
context: He's gotten less trusting.\I can at least take a look, can't I?\That's not a good idea, Adashino!\You're jumbling up all the contents!\Pardon me!\Doctor! Are you in?\Doctor!\Please come take a look at my wife! response:	She's fallen ill with a strange sickness.
context: I can at least take a look, can't I?\That's not a good idea, Adashino!\You're jumbling up all the contents!\Pardon me!\Doctor! Are you in?\Doctor!\Please come take a look at my wife!\She's fallen ill with a strange sickness. response:	The village doctor can't make heads or tails of it.
context: That's not a good idea, Adashino!\You're jumbling up all the contents!\Pardon me!\Doctor! Are you in?\Doctor!\Please come take a look at my wife!\She's fallen ill with a strange sickness.\The village doctor can't make heads or tails of it. response:	A strange sickness, you say?
context: You're jumbling up all the contents!\Pardon me!\Doctor! Are you in?\Doctor!\Please come take a look at my wife!\She's fallen ill with a strange sickness.\The village doctor can't make heads or tails of it.\A strange sickness, you say? response:	As you can see,
context: Pardon me!\Doctor! Are you in?\Doctor!\Please come take a look at my wife!\She's fallen ill with a strange sickness.\The village doctor can't make heads or tails of it.\A strange sickness, you say?\As you can see, response:	her skin turned darker yesterday,
context: Doctor! Are you in?\Doctor!\Please come take a look at my wife!\She's fallen ill with a strange sickness.\The village doctor can't make heads or tails of it.\A strange sickness, you say?\As you can see,\her skin turned darker yesterday, response:	and she's getting colder by the hour.
context: Doctor!\Please come take a look at my wife!\She's fallen ill with a strange sickness.\The village doctor can't make heads or tails of it.\A strange sickness, you say?\As you can see,\her skin turned darker yesterday,\and she's getting colder by the hour. response:	Hmm...
context: Please come take a look at my wife!\She's fallen ill with a strange sickness.\The village doctor can't make heads or tails of it.\A strange sickness, you say?\As you can see,\her skin turned darker yesterday,\and she's getting colder by the hour.\Hmm... response:	Hey, do you know what caused this?
context: She's fallen ill with a strange sickness.\The village doctor can't make heads or tails of it.\A strange sickness, you say?\As you can see,\her skin turned darker yesterday,\and she's getting colder by the hour.\Hmm...\Hey, do you know what caused this? response:	Yobiko, or Summoned mushi.
context: The village doctor can't make heads or tails of it.\A strange sickness, you say?\As you can see,\her skin turned darker yesterday,\and she's getting colder by the hour.\Hmm...\Hey, do you know what caused this?\Yobiko, or Summoned mushi. response:	Yobiko are mushi that bore holes in rocks along the seashore and live there.
context: A strange sickness, you say?\As you can see,\her skin turned darker yesterday,\and she's getting colder by the hour.\Hmm...\Hey, do you know what caused this?\Yobiko, or Summoned mushi.\Yobiko are mushi that bore holes in rocks along the seashore and live there. response:	Wind blows through these holes, creating whistle-like sounds,
context: As you can see,\her skin turned darker yesterday,\and she's getting colder by the hour.\Hmm...\Hey, do you know what caused this?\Yobiko, or Summoned mushi.\Yobiko are mushi that bore holes in rocks along the seashore and live there.\Wind blows through these holes, creating whistle-like sounds, response:	which cause Yobiko to gather and breed.
context: her skin turned darker yesterday,\and she's getting colder by the hour.\Hmm...\Hey, do you know what caused this?\Yobiko, or Summoned mushi.\Yobiko are mushi that bore holes in rocks along the seashore and live there.\Wind blows through these holes, creating whistle-like sounds,\which cause Yobiko to gather and breed. response:	If their numbers grow too large,
context: and she's getting colder by the hour.\Hmm...\Hey, do you know what caused this?\Yobiko, or Summoned mushi.\Yobiko are mushi that bore holes in rocks along the seashore and live there.\Wind blows through these holes, creating whistle-like sounds,\which cause Yobiko to gather and breed.\If their numbers grow too large, response:	they can become toxic to those with a weak constitution.
context: Hmm...\Hey, do you know what caused this?\Yobiko, or Summoned mushi.\Yobiko are mushi that bore holes in rocks along the seashore and live there.\Wind blows through these holes, creating whistle-like sounds,\which cause Yobiko to gather and breed.\If their numbers grow too large,\they can become toxic to those with a weak constitution. response:	But... why are they here, exactly?
context: Hey, do you know what caused this?\Yobiko, or Summoned mushi.\Yobiko are mushi that bore holes in rocks along the seashore and live there.\Wind blows through these holes, creating whistle-like sounds,\which cause Yobiko to gather and breed.\If their numbers grow too large,\they can become toxic to those with a weak constitution.\But... why are they here, exactly? response:	Now that I think about it,
context: Yobiko, or Summoned mushi.\Yobiko are mushi that bore holes in rocks along the seashore and live there.\Wind blows through these holes, creating whistle-like sounds,\which cause Yobiko to gather and breed.\If their numbers grow too large,\they can become toxic to those with a weak constitution.\But... why are they here, exactly?\Now that I think about it, response:	these holes started showing up everywhere when my son got back home.
context: Yobiko are mushi that bore holes in rocks along the seashore and live there.\Wind blows through these holes, creating whistle-like sounds,\which cause Yobiko to gather and breed.\If their numbers grow too large,\they can become toxic to those with a weak constitution.\But... why are they here, exactly?\Now that I think about it,\these holes started showing up everywhere when my son got back home. response:	Is your son a sailor?
context: Wind blows through these holes, creating whistle-like sounds,\which cause Yobiko to gather and breed.\If their numbers grow too large,\they can become toxic to those with a weak constitution.\But... why are they here, exactly?\Now that I think about it,\these holes started showing up everywhere when my son got back home.\Is your son a sailor? response:	Yes. The ship he crewed on sank, though.
context: which cause Yobiko to gather and breed.\If their numbers grow too large,\they can become toxic to those with a weak constitution.\But... why are they here, exactly?\Now that I think about it,\these holes started showing up everywhere when my son got back home.\Is your son a sailor?\Yes. The ship he crewed on sank, though. response:	Where is he now?
context: If their numbers grow too large,\they can become toxic to those with a weak constitution.\But... why are they here, exactly?\Now that I think about it,\these holes started showing up everywhere when my son got back home.\Is your son a sailor?\Yes. The ship he crewed on sank, though.\Where is he now? response:	Oh, he brought back some expensive gift, so he's gone to a pawnshop to sell it.
context: they can become toxic to those with a weak constitution.\But... why are they here, exactly?\Now that I think about it,\these holes started showing up everywhere when my son got back home.\Is your son a sailor?\Yes. The ship he crewed on sank, though.\Where is he now?\Oh, he brought back some expensive gift, so he's gone to a pawnshop to sell it. response:	Hey, Ginko,
context: But... why are they here, exactly?\Now that I think about it,\these holes started showing up everywhere when my son got back home.\Is your son a sailor?\Yes. The ship he crewed on sank, though.\Where is he now?\Oh, he brought back some expensive gift, so he's gone to a pawnshop to sell it.\Hey, Ginko, response:	is there a cure for it?
context: Now that I think about it,\these holes started showing up everywhere when my son got back home.\Is your son a sailor?\Yes. The ship he crewed on sank, though.\Where is he now?\Oh, he brought back some expensive gift, so he's gone to a pawnshop to sell it.\Hey, Ginko,\is there a cure for it? response:	First things first. We have to get the mushi away from her.
context: these holes started showing up everywhere when my son got back home.\Is your son a sailor?\Yes. The ship he crewed on sank, though.\Where is he now?\Oh, he brought back some expensive gift, so he's gone to a pawnshop to sell it.\Hey, Ginko,\is there a cure for it?\First things first. We have to get the mushi away from her. response:	I'll use this to lure them outside.
context: Is your son a sailor?\Yes. The ship he crewed on sank, though.\Where is he now?\Oh, he brought back some expensive gift, so he's gone to a pawnshop to sell it.\Hey, Ginko,\is there a cure for it?\First things first. We have to get the mushi away from her.\I'll use this to lure them outside. response:	Once I leave, plug every hole with soil.
context: Yes. The ship he crewed on sank, though.\Where is he now?\Oh, he brought back some expensive gift, so he's gone to a pawnshop to sell it.\Hey, Ginko,\is there a cure for it?\First things first. We have to get the mushi away from her.\I'll use this to lure them outside.\Once I leave, plug every hole with soil. response:	Here you are.
context: Where is he now?\Oh, he brought back some expensive gift, so he's gone to a pawnshop to sell it.\Hey, Ginko,\is there a cure for it?\First things first. We have to get the mushi away from her.\I'll use this to lure them outside.\Once I leave, plug every hole with soil.\Here you are. response:	This is where your home is.
context: Oh, he brought back some expensive gift, so he's gone to a pawnshop to sell it.\Hey, Ginko,\is there a cure for it?\First things first. We have to get the mushi away from her.\I'll use this to lure them outside.\Once I leave, plug every hole with soil.\Here you are.\This is where your home is. response:	I feel much better now.
context: Hey, Ginko,\is there a cure for it?\First things first. We have to get the mushi away from her.\I'll use this to lure them outside.\Once I leave, plug every hole with soil.\Here you are.\This is where your home is.\I feel much better now. response:	Yeah. You're looking better, too.
context: is there a cure for it?\First things first. We have to get the mushi away from her.\I'll use this to lure them outside.\Once I leave, plug every hole with soil.\Here you are.\This is where your home is.\I feel much better now.\Yeah. You're looking better, too. response:	Really, Doctor, thank you for all your help.
context: First things first. We have to get the mushi away from her.\I'll use this to lure them outside.\Once I leave, plug every hole with soil.\Here you are.\This is where your home is.\I feel much better now.\Yeah. You're looking better, too.\Really, Doctor, thank you for all your help. response:	Thank you very much.
context: I'll use this to lure them outside.\Once I leave, plug every hole with soil.\Here you are.\This is where your home is.\I feel much better now.\Yeah. You're looking better, too.\Really, Doctor, thank you for all your help.\Thank you very much. response:	I was so worried about her.
context: Once I leave, plug every hole with soil.\Here you are.\This is where your home is.\I feel much better now.\Yeah. You're looking better, too.\Really, Doctor, thank you for all your help.\Thank you very much.\I was so worried about her. response:	Oh, it was nothing.
context: Here you are.\This is where your home is.\I feel much better now.\Yeah. You're looking better, too.\Really, Doctor, thank you for all your help.\Thank you very much.\I was so worried about her.\Oh, it was nothing. response:	You don't need to thank me.
context: This is where your home is.\I feel much better now.\Yeah. You're looking better, too.\Really, Doctor, thank you for all your help.\Thank you very much.\I was so worried about her.\Oh, it was nothing.\You don't need to thank me. response:	I thought it might be you.
context: I feel much better now.\Yeah. You're looking better, too.\Really, Doctor, thank you for all your help.\Thank you very much.\I was so worried about her.\Oh, it was nothing.\You don't need to thank me.\I thought it might be you. response:	I told you something bad could happen, didn't I?
context: Yeah. You're looking better, too.\Really, Doctor, thank you for all your help.\Thank you very much.\I was so worried about her.\Oh, it was nothing.\You don't need to thank me.\I thought it might be you.\I told you something bad could happen, didn't I? response:	I was just... so excited.
context: Really, Doctor, thank you for all your help.\Thank you very much.\I was so worried about her.\Oh, it was nothing.\You don't need to thank me.\I thought it might be you.\I told you something bad could happen, didn't I?\I was just... so excited. response:	Don't do it again.
context: Thank you very much.\I was so worried about her.\Oh, it was nothing.\You don't need to thank me.\I thought it might be you.\I told you something bad could happen, didn't I?\I was just... so excited.\Don't do it again. response:	Okay.
context: I was so worried about her.\Oh, it was nothing.\You don't need to thank me.\I thought it might be you.\I told you something bad could happen, didn't I?\I was just... so excited.\Don't do it again.\Okay. response:	You know...
context: Oh, it was nothing.\You don't need to thank me.\I thought it might be you.\I told you something bad could happen, didn't I?\I was just... so excited.\Don't do it again.\Okay.\You know... response:	that stone whistle of yours is
context: You don't need to thank me.\I thought it might be you.\I told you something bad could happen, didn't I?\I was just... so excited.\Don't do it again.\Okay.\You know...\that stone whistle of yours is response:	Not for sale.
context: I thought it might be you.\I told you something bad could happen, didn't I?\I was just... so excited.\Don't do it again.\Okay.\You know...\that stone whistle of yours is\Not for sale. response:	The whistle's holes must be made by Yobiko.
context: I told you something bad could happen, didn't I?\I was just... so excited.\Don't do it again.\Okay.\You know...\that stone whistle of yours is\Not for sale.\The whistle's holes must be made by Yobiko. response:	And only a few are actually usable as a whistle.
context: I was just... so excited.\Don't do it again.\Okay.\You know...\that stone whistle of yours is\Not for sale.\The whistle's holes must be made by Yobiko.\And only a few are actually usable as a whistle. response:	That's exactly why they're so valuable.
context: Don't do it again.\Okay.\You know...\that stone whistle of yours is\Not for sale.\The whistle's holes must be made by Yobiko.\And only a few are actually usable as a whistle.\That's exactly why they're so valuable. response:	Find me one.
context: Okay.\You know...\that stone whistle of yours is\Not for sale.\The whistle's holes must be made by Yobiko.\And only a few are actually usable as a whistle.\That's exactly why they're so valuable.\Find me one. response:	It would be wasted on an amateur like you.
context: You know...\that stone whistle of yours is\Not for sale.\The whistle's holes must be made by Yobiko.\And only a few are actually usable as a whistle.\That's exactly why they're so valuable.\Find me one.\It would be wasted on an amateur like you. response:	What is it?
context: that stone whistle of yours is\Not for sale.\The whistle's holes must be made by Yobiko.\And only a few are actually usable as a whistle.\That's exactly why they're so valuable.\Find me one.\It would be wasted on an amateur like you.\What is it? response:	The Yobiko are going back to the house!
context: Not for sale.\The whistle's holes must be made by Yobiko.\And only a few are actually usable as a whistle.\That's exactly why they're so valuable.\Find me one.\It would be wasted on an amateur like you.\What is it?\The Yobiko are going back to the house! response:	What's happening?
context: The whistle's holes must be made by Yobiko.\And only a few are actually usable as a whistle.\That's exactly why they're so valuable.\Find me one.\It would be wasted on an amateur like you.\What is it?\The Yobiko are going back to the house!\What's happening? response:	Hey!
context: And only a few are actually usable as a whistle.\That's exactly why they're so valuable.\Find me one.\It would be wasted on an amateur like you.\What is it?\The Yobiko are going back to the house!\What's happening?\Hey! response:	What the...
context: That's exactly why they're so valuable.\Find me one.\It would be wasted on an amateur like you.\What is it?\The Yobiko are going back to the house!\What's happening?\Hey!\What the... response:	Hey, where are you going now?
context: Find me one.\It would be wasted on an amateur like you.\What is it?\The Yobiko are going back to the house!\What's happening?\Hey!\What the...\Hey, where are you going now? response:	Just why are you doing this?
context: It would be wasted on an amateur like you.\What is it?\The Yobiko are going back to the house!\What's happening?\Hey!\What the...\Hey, where are you going now?\Just why are you doing this? response:	It's just...
context: What is it?\The Yobiko are going back to the house!\What's happening?\Hey!\What the...\Hey, where are you going now?\Just why are you doing this?\It's just... response:	Don't you think it's unfair?
context: The Yobiko are going back to the house!\What's happening?\Hey!\What the...\Hey, where are you going now?\Just why are you doing this?\It's just...\Don't you think it's unfair? response:	That it's always my fault.
context: What's happening?\Hey!\What the...\Hey, where are you going now?\Just why are you doing this?\It's just...\Don't you think it's unfair?\That it's always my fault. response:	Your mother's going to die if you don't stop!
context: Hey!\What the...\Hey, where are you going now?\Just why are you doing this?\It's just...\Don't you think it's unfair?\That it's always my fault.\Your mother's going to die if you don't stop! response:	That woman... has never been a mother to me.
context: What the...\Hey, where are you going now?\Just why are you doing this?\It's just...\Don't you think it's unfair?\That it's always my fault.\Your mother's going to die if you don't stop!\That woman... has never been a mother to me. response:	Do you recall what I said on the ship about the stone whistle?
context: Hey, where are you going now?\Just why are you doing this?\It's just...\Don't you think it's unfair?\That it's always my fault.\Your mother's going to die if you don't stop!\That woman... has never been a mother to me.\Do you recall what I said on the ship about the stone whistle? response:	Mushi-shi usually use these whistles to return mushi to their proper homes.
context: Just why are you doing this?\It's just...\Don't you think it's unfair?\That it's always my fault.\Your mother's going to die if you don't stop!\That woman... has never been a mother to me.\Do you recall what I said on the ship about the stone whistle?\Mushi-shi usually use these whistles to return mushi to their proper homes. response:	However, every now and then, a mushi-shi uses one for other purposes.
context: It's just...\Don't you think it's unfair?\That it's always my fault.\Your mother's going to die if you don't stop!\That woman... has never been a mother to me.\Do you recall what I said on the ship about the stone whistle?\Mushi-shi usually use these whistles to return mushi to their proper homes.\However, every now and then, a mushi-shi uses one for other purposes. response:	Those who continued to use the whistle for selfish purposes all eventually destroyed themselves...
context: Don't you think it's unfair?\That it's always my fault.\Your mother's going to die if you don't stop!\That woman... has never been a mother to me.\Do you recall what I said on the ship about the stone whistle?\Mushi-shi usually use these whistles to return mushi to their proper homes.\However, every now and then, a mushi-shi uses one for other purposes.\Those who continued to use the whistle for selfish purposes all eventually destroyed themselves... response:	along with everyone around them.
context: That it's always my fault.\Your mother's going to die if you don't stop!\That woman... has never been a mother to me.\Do you recall what I said on the ship about the stone whistle?\Mushi-shi usually use these whistles to return mushi to their proper homes.\However, every now and then, a mushi-shi uses one for other purposes.\Those who continued to use the whistle for selfish purposes all eventually destroyed themselves...\along with everyone around them. response:	It'll be no different with you.
context: Your mother's going to die if you don't stop!\That woman... has never been a mother to me.\Do you recall what I said on the ship about the stone whistle?\Mushi-shi usually use these whistles to return mushi to their proper homes.\However, every now and then, a mushi-shi uses one for other purposes.\Those who continued to use the whistle for selfish purposes all eventually destroyed themselves...\along with everyone around them.\It'll be no different with you. response:	If you let your mother die like this, you'll end up just like them.
context: That woman... has never been a mother to me.\Do you recall what I said on the ship about the stone whistle?\Mushi-shi usually use these whistles to return mushi to their proper homes.\However, every now and then, a mushi-shi uses one for other purposes.\Those who continued to use the whistle for selfish purposes all eventually destroyed themselves...\along with everyone around them.\It'll be no different with you.\If you let your mother die like this, you'll end up just like them. response:	mushi have their own needs and wants.
context: Do you recall what I said on the ship about the stone whistle?\Mushi-shi usually use these whistles to return mushi to their proper homes.\However, every now and then, a mushi-shi uses one for other purposes.\Those who continued to use the whistle for selfish purposes all eventually destroyed themselves...\along with everyone around them.\It'll be no different with you.\If you let your mother die like this, you'll end up just like them.\mushi have their own needs and wants. response:	If you try to bend them to your needs and wants, there will be consequences.
context: Mushi-shi usually use these whistles to return mushi to their proper homes.\However, every now and then, a mushi-shi uses one for other purposes.\Those who continued to use the whistle for selfish purposes all eventually destroyed themselves...\along with everyone around them.\It'll be no different with you.\If you let your mother die like this, you'll end up just like them.\mushi have their own needs and wants.\If you try to bend them to your needs and wants, there will be consequences. response:	How you use your ability is your choice.
context: However, every now and then, a mushi-shi uses one for other purposes.\Those who continued to use the whistle for selfish purposes all eventually destroyed themselves...\along with everyone around them.\It'll be no different with you.\If you let your mother die like this, you'll end up just like them.\mushi have their own needs and wants.\If you try to bend them to your needs and wants, there will be consequences.\How you use your ability is your choice. response:	It's up to you what manner of man you will become.
context: Those who continued to use the whistle for selfish purposes all eventually destroyed themselves...\along with everyone around them.\It'll be no different with you.\If you let your mother die like this, you'll end up just like them.\mushi have their own needs and wants.\If you try to bend them to your needs and wants, there will be consequences.\How you use your ability is your choice.\It's up to you what manner of man you will become. response:	If you wait for dawn, you can call the Torikaze.
context: along with everyone around them.\It'll be no different with you.\If you let your mother die like this, you'll end up just like them.\mushi have their own needs and wants.\If you try to bend them to your needs and wants, there will be consequences.\How you use your ability is your choice.\It's up to you what manner of man you will become.\If you wait for dawn, you can call the Torikaze. response:	The reason the Torikaze respond to the same whistle
context: It'll be no different with you.\If you let your mother die like this, you'll end up just like them.\mushi have their own needs and wants.\If you try to bend them to your needs and wants, there will be consequences.\How you use your ability is your choice.\It's up to you what manner of man you will become.\If you wait for dawn, you can call the Torikaze.\The reason the Torikaze respond to the same whistle response:	is that they love eating Yobiko.
context: If you let your mother die like this, you'll end up just like them.\mushi have their own needs and wants.\If you try to bend them to your needs and wants, there will be consequences.\How you use your ability is your choice.\It's up to you what manner of man you will become.\If you wait for dawn, you can call the Torikaze.\The reason the Torikaze respond to the same whistle\is that they love eating Yobiko. response:	Do you think he'll follow your advice?
context: mushi have their own needs and wants.\If you try to bend them to your needs and wants, there will be consequences.\How you use your ability is your choice.\It's up to you what manner of man you will become.\If you wait for dawn, you can call the Torikaze.\The reason the Torikaze respond to the same whistle\is that they love eating Yobiko.\Do you think he'll follow your advice? response:	Who knows.
context: If you try to bend them to your needs and wants, there will be consequences.\How you use your ability is your choice.\It's up to you what manner of man you will become.\If you wait for dawn, you can call the Torikaze.\The reason the Torikaze respond to the same whistle\is that they love eating Yobiko.\Do you think he'll follow your advice?\Who knows. response:	Ibuki, why are you whistling at a time like this?
context: How you use your ability is your choice.\It's up to you what manner of man you will become.\If you wait for dawn, you can call the Torikaze.\The reason the Torikaze respond to the same whistle\is that they love eating Yobiko.\Do you think he'll follow your advice?\Who knows.\Ibuki, why are you whistling at a time like this? response:	Your mom's very sick, you know!
context: It's up to you what manner of man you will become.\If you wait for dawn, you can call the Torikaze.\The reason the Torikaze respond to the same whistle\is that they love eating Yobiko.\Do you think he'll follow your advice?\Who knows.\Ibuki, why are you whistling at a time like this?\Your mom's very sick, you know! response:	You ungrateful wretch!
context: If you wait for dawn, you can call the Torikaze.\The reason the Torikaze respond to the same whistle\is that they love eating Yobiko.\Do you think he'll follow your advice?\Who knows.\Ibuki, why are you whistling at a time like this?\Your mom's very sick, you know!\You ungrateful wretch! response:	Here they come!
context: The reason the Torikaze respond to the same whistle\is that they love eating Yobiko.\Do you think he'll follow your advice?\Who knows.\Ibuki, why are you whistling at a time like this?\Your mom's very sick, you know!\You ungrateful wretch!\Here they come! response:	What's going on?
context: is that they love eating Yobiko.\Do you think he'll follow your advice?\Who knows.\Ibuki, why are you whistling at a time like this?\Your mom's very sick, you know!\You ungrateful wretch!\Here they come!\What's going on? response:	Is it a tornado?!
context: Do you think he'll follow your advice?\Who knows.\Ibuki, why are you whistling at a time like this?\Your mom's very sick, you know!\You ungrateful wretch!\Here they come!\What's going on?\Is it a tornado?! response:	He's really done it now.
context: Who knows.\Ibuki, why are you whistling at a time like this?\Your mom's very sick, you know!\You ungrateful wretch!\Here they come!\What's going on?\Is it a tornado?!\He's really done it now. response:	After that, the boy was never seen in the village again.
context: Ibuki, why are you whistling at a time like this?\Your mom's very sick, you know!\You ungrateful wretch!\Here they come!\What's going on?\Is it a tornado?!\He's really done it now.\After that, the boy was never seen in the village again. response:	You're waiting for the wind to pick up, aren't you, mister?
context: Your mom's very sick, you know!\You ungrateful wretch!\Here they come!\What's going on?\Is it a tornado?!\He's really done it now.\After that, the boy was never seen in the village again.\You're waiting for the wind to pick up, aren't you, mister? response:	Why not come by in the meanwhile?
context: You ungrateful wretch!\Here they come!\What's going on?\Is it a tornado?!\He's really done it now.\After that, the boy was never seen in the village again.\You're waiting for the wind to pick up, aren't you, mister?\Why not come by in the meanwhile? response:	Huh?
context: Here they come!\What's going on?\Is it a tornado?!\He's really done it now.\After that, the boy was never seen in the village again.\You're waiting for the wind to pick up, aren't you, mister?\Why not come by in the meanwhile?\Huh? response:	How's that ship out there?
context: What's going on?\Is it a tornado?!\He's really done it now.\After that, the boy was never seen in the village again.\You're waiting for the wind to pick up, aren't you, mister?\Why not come by in the meanwhile?\Huh?\How's that ship out there? response:	Oh, that one again?
context: Is it a tornado?!\He's really done it now.\After that, the boy was never seen in the village again.\You're waiting for the wind to pick up, aren't you, mister?\Why not come by in the meanwhile?\Huh?\How's that ship out there?\Oh, that one again? response:	I have no idea how they're managing to sail...
context: He's really done it now.\After that, the boy was never seen in the village again.\You're waiting for the wind to pick up, aren't you, mister?\Why not come by in the meanwhile?\Huh?\How's that ship out there?\Oh, that one again?\I have no idea how they're managing to sail... response:	in a dead calm like this one.
context: After that, the boy was never seen in the village again.\You're waiting for the wind to pick up, aren't you, mister?\Why not come by in the meanwhile?\Huh?\How's that ship out there?\Oh, that one again?\I have no idea how they're managing to sail...\in a dead calm like this one. response:	Who knows?
context: You're waiting for the wind to pick up, aren't you, mister?\Why not come by in the meanwhile?\Huh?\How's that ship out there?\Oh, that one again?\I have no idea how they're managing to sail...\in a dead calm like this one.\Who knows? response:	Maybe they're using some fancy device or something.
context: Why not come by in the meanwhile?\Huh?\How's that ship out there?\Oh, that one again?\I have no idea how they're managing to sail...\in a dead calm like this one.\Who knows?\Maybe they're using some fancy device or something. response:	The Wind Raiser
context: Huh?\How's that ship out there?\Oh, that one again?\I have no idea how they're managing to sail...\in a dead calm like this one.\Who knows?\Maybe they're using some fancy device or something.\The Wind Raiser response:	The Valley of the Welling Tide
context: How's that ship out there?\Oh, that one again?\I have no idea how they're managing to sail...\in a dead calm like this one.\Who knows?\Maybe they're using some fancy device or something.\The Wind Raiser\The Valley of the Welling Tide response:	The Valley of the Welling Tide.