context: Staff Room response:	Goodbye.
context: Staff Room\Goodbye. response:	Huh? Where's my bag?
context: Staff Room\Goodbye.\Huh? Where's my bag? response:	Wait...
context: Staff Room\Goodbye.\Huh? Where's my bag?\Wait... response:	What was that noise?
context: Staff Room\Goodbye.\Huh? Where's my bag?\Wait...\What was that noise? response:	Overlap
context: Staff Room\Goodbye.\Huh? Where's my bag?\Wait...\What was that noise?\Overlap response:	You're awake?
context: Staff Room\Goodbye.\Huh? Where's my bag?\Wait...\What was that noise?\Overlap\You're awake? response:	This is the nurse's office.
context: Staff Room\Goodbye.\Huh? Where's my bag?\Wait...\What was that noise?\Overlap\You're awake?\This is the nurse's office. response:	You two were found collapsed by the stairs.
context: Goodbye.\Huh? Where's my bag?\Wait...\What was that noise?\Overlap\You're awake?\This is the nurse's office.\You two were found collapsed by the stairs. response:	What happened?
context: Huh? Where's my bag?\Wait...\What was that noise?\Overlap\You're awake?\This is the nurse's office.\You two were found collapsed by the stairs.\What happened? response:	Did you miss your step?
context: Wait...\What was that noise?\Overlap\You're awake?\This is the nurse's office.\You two were found collapsed by the stairs.\What happened?\Did you miss your step? response:	Yeah.
context: What was that noise?\Overlap\You're awake?\This is the nurse's office.\You two were found collapsed by the stairs.\What happened?\Did you miss your step?\Yeah. response:	I guess I sorta slipped.
context: Overlap\You're awake?\This is the nurse's office.\You two were found collapsed by the stairs.\What happened?\Did you miss your step?\Yeah.\I guess I sorta slipped. response:	Kaizaki-kun, you shielded Kariu-san from the fall.
context: You're awake?\This is the nurse's office.\You two were found collapsed by the stairs.\What happened?\Did you miss your step?\Yeah.\I guess I sorta slipped.\Kaizaki-kun, you shielded Kariu-san from the fall. response:	Nicely done.
context: This is the nurse's office.\You two were found collapsed by the stairs.\What happened?\Did you miss your step?\Yeah.\I guess I sorta slipped.\Kaizaki-kun, you shielded Kariu-san from the fall.\Nicely done. response:	Good boy.
context: You two were found collapsed by the stairs.\What happened?\Did you miss your step?\Yeah.\I guess I sorta slipped.\Kaizaki-kun, you shielded Kariu-san from the fall.\Nicely done.\Good boy. response:	* Actually 27
context: What happened?\Did you miss your step?\Yeah.\I guess I sorta slipped.\Kaizaki-kun, you shielded Kariu-san from the fall.\Nicely done.\Good boy.\* Actually 27 response:	Boy?
context: Did you miss your step?\Yeah.\I guess I sorta slipped.\Kaizaki-kun, you shielded Kariu-san from the fall.\Nicely done.\Good boy.\* Actually 27\Boy? response:	Inukai-sensei, Inukai-sensei, please come to the staff room.
context: Yeah.\I guess I sorta slipped.\Kaizaki-kun, you shielded Kariu-san from the fall.\Nicely done.\Good boy.\* Actually 27\Boy?\Inukai-sensei, Inukai-sensei, please come to the staff room. response:	Oh, sorry.
context: I guess I sorta slipped.\Kaizaki-kun, you shielded Kariu-san from the fall.\Nicely done.\Good boy.\* Actually 27\Boy?\Inukai-sensei, Inukai-sensei, please come to the staff room.\Oh, sorry. response:	I'll be back in a minute. Can you stay with her?
context: Kaizaki-kun, you shielded Kariu-san from the fall.\Nicely done.\Good boy.\* Actually 27\Boy?\Inukai-sensei, Inukai-sensei, please come to the staff room.\Oh, sorry.\I'll be back in a minute. Can you stay with her? response:	Sure thing.
context: Nicely done.\Good boy.\* Actually 27\Boy?\Inukai-sensei, Inukai-sensei, please come to the staff room.\Oh, sorry.\I'll be back in a minute. Can you stay with her?\Sure thing. response:	Oh, right.
context: Good boy.\* Actually 27\Boy?\Inukai-sensei, Inukai-sensei, please come to the staff room.\Oh, sorry.\I'll be back in a minute. Can you stay with her?\Sure thing.\Oh, right. response:	Your classmate, Hishiro-san, let us know.
context: * Actually 27\Boy?\Inukai-sensei, Inukai-sensei, please come to the staff room.\Oh, sorry.\I'll be back in a minute. Can you stay with her?\Sure thing.\Oh, right.\Your classmate, Hishiro-san, let us know. response:	She carried your stuff here, too.
context: Boy?\Inukai-sensei, Inukai-sensei, please come to the staff room.\Oh, sorry.\I'll be back in a minute. Can you stay with her?\Sure thing.\Oh, right.\Your classmate, Hishiro-san, let us know.\She carried your stuff here, too. response:	Thank her later, okay?
context: Inukai-sensei, Inukai-sensei, please come to the staff room.\Oh, sorry.\I'll be back in a minute. Can you stay with her?\Sure thing.\Oh, right.\Your classmate, Hishiro-san, let us know.\She carried your stuff here, too.\Thank her later, okay? response:	Hishiro-san...
context: Oh, sorry.\I'll be back in a minute. Can you stay with her?\Sure thing.\Oh, right.\Your classmate, Hishiro-san, let us know.\She carried your stuff here, too.\Thank her later, okay?\Hishiro-san... response:	I knew it... that was Hishiro-san's.
context: I'll be back in a minute. Can you stay with her?\Sure thing.\Oh, right.\Your classmate, Hishiro-san, let us know.\She carried your stuff here, too.\Thank her later, okay?\Hishiro-san...\I knew it... that was Hishiro-san's. response:	Why did Kariu have it?
context: Sure thing.\Oh, right.\Your classmate, Hishiro-san, let us know.\She carried your stuff here, too.\Thank her later, okay?\Hishiro-san...\I knew it... that was Hishiro-san's.\Why did Kariu have it? response:	What was she trying to do?
context: Oh, right.\Your classmate, Hishiro-san, let us know.\She carried your stuff here, too.\Thank her later, okay?\Hishiro-san...\I knew it... that was Hishiro-san's.\Why did Kariu have it?\What was she trying to do? response:	She's got top sales again.
context: Your classmate, Hishiro-san, let us know.\She carried your stuff here, too.\Thank her later, okay?\Hishiro-san...\I knew it... that was Hishiro-san's.\Why did Kariu have it?\What was she trying to do?\She's got top sales again. response:	We'll lose face if we let a woman trounce us like this.
context: She carried your stuff here, too.\Thank her later, okay?\Hishiro-san...\I knew it... that was Hishiro-san's.\Why did Kariu have it?\What was she trying to do?\She's got top sales again.\We'll lose face if we let a woman trounce us like this. response:	Why won't she just quit?
context: Thank her later, okay?\Hishiro-san...\I knew it... that was Hishiro-san's.\Why did Kariu have it?\What was she trying to do?\She's got top sales again.\We'll lose face if we let a woman trounce us like this.\Why won't she just quit? response:	Hasn't she worked it out yet?
context: Hishiro-san...\I knew it... that was Hishiro-san's.\Why did Kariu have it?\What was she trying to do?\She's got top sales again.\We'll lose face if we let a woman trounce us like this.\Why won't she just quit?\Hasn't she worked it out yet? response:	With all we've done? She knows.
context: I knew it... that was Hishiro-san's.\Why did Kariu have it?\What was she trying to do?\She's got top sales again.\We'll lose face if we let a woman trounce us like this.\Why won't she just quit?\Hasn't she worked it out yet?\With all we've done? She knows. response:	Knock it off. The new guy's here.
context: Why did Kariu have it?\What was she trying to do?\She's got top sales again.\We'll lose face if we let a woman trounce us like this.\Why won't she just quit?\Hasn't she worked it out yet?\With all we've done? She knows.\Knock it off. The new guy's here. response:	Oh.
context: What was she trying to do?\She's got top sales again.\We'll lose face if we let a woman trounce us like this.\Why won't she just quit?\Hasn't she worked it out yet?\With all we've done? She knows.\Knock it off. The new guy's here.\Oh. response:	She's in charge of his training, right?
context: She's got top sales again.\We'll lose face if we let a woman trounce us like this.\Why won't she just quit?\Hasn't she worked it out yet?\With all we've done? She knows.\Knock it off. The new guy's here.\Oh.\She's in charge of his training, right? response:	Don't rat us out, Kaizaki.
context: We'll lose face if we let a woman trounce us like this.\Why won't she just quit?\Hasn't she worked it out yet?\With all we've done? She knows.\Knock it off. The new guy's here.\Oh.\She's in charge of his training, right?\Don't rat us out, Kaizaki. response:	I apologize.
context: Why won't she just quit?\Hasn't she worked it out yet?\With all we've done? She knows.\Knock it off. The new guy's here.\Oh.\She's in charge of his training, right?\Don't rat us out, Kaizaki.\I apologize. response:	We'll make absolutely sure nothing like this happens again.
context: Hasn't she worked it out yet?\With all we've done? She knows.\Knock it off. The new guy's here.\Oh.\She's in charge of his training, right?\Don't rat us out, Kaizaki.\I apologize.\We'll make absolutely sure nothing like this happens again. response:	Please, let us make it up to you.
context: With all we've done? She knows.\Knock it off. The new guy's here.\Oh.\She's in charge of his training, right?\Don't rat us out, Kaizaki.\I apologize.\We'll make absolutely sure nothing like this happens again.\Please, let us make it up to you. response:	You know this mess wasn't your fault!
context: Knock it off. The new guy's here.\Oh.\She's in charge of his training, right?\Don't rat us out, Kaizaki.\I apologize.\We'll make absolutely sure nothing like this happens again.\Please, let us make it up to you.\You know this mess wasn't your fault! response:	We went over the order several times
context: Oh.\She's in charge of his training, right?\Don't rat us out, Kaizaki.\I apologize.\We'll make absolutely sure nothing like this happens again.\Please, let us make it up to you.\You know this mess wasn't your fault!\We went over the order several times response:	while you were showing me the ropes!
context: She's in charge of his training, right?\Don't rat us out, Kaizaki.\I apologize.\We'll make absolutely sure nothing like this happens again.\Please, let us make it up to you.\You know this mess wasn't your fault!\We went over the order several times\while you were showing me the ropes! response:	Someone must've...
context: Don't rat us out, Kaizaki.\I apologize.\We'll make absolutely sure nothing like this happens again.\Please, let us make it up to you.\You know this mess wasn't your fault!\We went over the order several times\while you were showing me the ropes!\Someone must've... response:	I know.
context: I apologize.\We'll make absolutely sure nothing like this happens again.\Please, let us make it up to you.\You know this mess wasn't your fault!\We went over the order several times\while you were showing me the ropes!\Someone must've...\I know. response:	Doesn't it make you mad?
context: We'll make absolutely sure nothing like this happens again.\Please, let us make it up to you.\You know this mess wasn't your fault!\We went over the order several times\while you were showing me the ropes!\Someone must've...\I know.\Doesn't it make you mad? response:	Knocking others down to gain an advantage is a fruitless endeavor.
context: Please, let us make it up to you.\You know this mess wasn't your fault!\We went over the order several times\while you were showing me the ropes!\Someone must've...\I know.\Doesn't it make you mad?\Knocking others down to gain an advantage is a fruitless endeavor. response:	It means they've given up on winning any other way.
context: You know this mess wasn't your fault!\We went over the order several times\while you were showing me the ropes!\Someone must've...\I know.\Doesn't it make you mad?\Knocking others down to gain an advantage is a fruitless endeavor.\It means they've given up on winning any other way. response:	At first,
context: We went over the order several times\while you were showing me the ropes!\Someone must've...\I know.\Doesn't it make you mad?\Knocking others down to gain an advantage is a fruitless endeavor.\It means they've given up on winning any other way.\At first, response:	we all competed fair and square. It was really fun.
context: while you were showing me the ropes!\Someone must've...\I know.\Doesn't it make you mad?\Knocking others down to gain an advantage is a fruitless endeavor.\It means they've given up on winning any other way.\At first,\we all competed fair and square. It was really fun. response:	But then,
context: Someone must've...\I know.\Doesn't it make you mad?\Knocking others down to gain an advantage is a fruitless endeavor.\It means they've given up on winning any other way.\At first,\we all competed fair and square. It was really fun.\But then, response:	somehow we went from rivals to enemies.
context: I know.\Doesn't it make you mad?\Knocking others down to gain an advantage is a fruitless endeavor.\It means they've given up on winning any other way.\At first,\we all competed fair and square. It was really fun.\But then,\somehow we went from rivals to enemies. response:	Seeing hard workers turn out like that doesn't make me mad.
context: Doesn't it make you mad?\Knocking others down to gain an advantage is a fruitless endeavor.\It means they've given up on winning any other way.\At first,\we all competed fair and square. It was really fun.\But then,\somehow we went from rivals to enemies.\Seeing hard workers turn out like that doesn't make me mad. response:	Just...
context: Knocking others down to gain an advantage is a fruitless endeavor.\It means they've given up on winning any other way.\At first,\we all competed fair and square. It was really fun.\But then,\somehow we went from rivals to enemies.\Seeing hard workers turn out like that doesn't make me mad.\Just... response:	Were you trying to bully her?
context: It means they've given up on winning any other way.\At first,\we all competed fair and square. It was really fun.\But then,\somehow we went from rivals to enemies.\Seeing hard workers turn out like that doesn't make me mad.\Just...\Were you trying to bully her? response:	A hard worker like you?
context: At first,\we all competed fair and square. It was really fun.\But then,\somehow we went from rivals to enemies.\Seeing hard workers turn out like that doesn't make me mad.\Just...\Were you trying to bully her?\A hard worker like you? response:	Oh. Are you awake, Kariu?
context: we all competed fair and square. It was really fun.\But then,\somehow we went from rivals to enemies.\Seeing hard workers turn out like that doesn't make me mad.\Just...\Were you trying to bully her?\A hard worker like you?\Oh. Are you awake, Kariu? response:	Hey, no sudden movements.
context: But then,\somehow we went from rivals to enemies.\Seeing hard workers turn out like that doesn't make me mad.\Just...\Were you trying to bully her?\A hard worker like you?\Oh. Are you awake, Kariu?\Hey, no sudden movements. response:	Apparently, Hishiro-san found us and let the teachers know.
context: somehow we went from rivals to enemies.\Seeing hard workers turn out like that doesn't make me mad.\Just...\Were you trying to bully her?\A hard worker like you?\Oh. Are you awake, Kariu?\Hey, no sudden movements.\Apparently, Hishiro-san found us and let the teachers know. response:	I'm pretty sure she took that green bag home with her.
context: Seeing hard workers turn out like that doesn't make me mad.\Just...\Were you trying to bully her?\A hard worker like you?\Oh. Are you awake, Kariu?\Hey, no sudden movements.\Apparently, Hishiro-san found us and let the teachers know.\I'm pretty sure she took that green bag home with her. response:	That bag...
context: Just...\Were you trying to bully her?\A hard worker like you?\Oh. Are you awake, Kariu?\Hey, no sudden movements.\Apparently, Hishiro-san found us and let the teachers know.\I'm pretty sure she took that green bag home with her.\That bag... response:	It was Hishiro-san's, right?
context: Were you trying to bully her?\A hard worker like you?\Oh. Are you awake, Kariu?\Hey, no sudden movements.\Apparently, Hishiro-san found us and let the teachers know.\I'm pretty sure she took that green bag home with her.\That bag...\It was Hishiro-san's, right? response:	Why did you have it?
context: A hard worker like you?\Oh. Are you awake, Kariu?\Hey, no sudden movements.\Apparently, Hishiro-san found us and let the teachers know.\I'm pretty sure she took that green bag home with her.\That bag...\It was Hishiro-san's, right?\Why did you have it? response:	Don't run.
context: Oh. Are you awake, Kariu?\Hey, no sudden movements.\Apparently, Hishiro-san found us and let the teachers know.\I'm pretty sure she took that green bag home with her.\That bag...\It was Hishiro-san's, right?\Why did you have it?\Don't run. response:	Answer me, Kariu.
context: Hey, no sudden movements.\Apparently, Hishiro-san found us and let the teachers know.\I'm pretty sure she took that green bag home with her.\That bag...\It was Hishiro-san's, right?\Why did you have it?\Don't run.\Answer me, Kariu. response:	You steal anything?
context: Apparently, Hishiro-san found us and let the teachers know.\I'm pretty sure she took that green bag home with her.\That bag...\It was Hishiro-san's, right?\Why did you have it?\Don't run.\Answer me, Kariu.\You steal anything? response:	No!
context: I'm pretty sure she took that green bag home with her.\That bag...\It was Hishiro-san's, right?\Why did you have it?\Don't run.\Answer me, Kariu.\You steal anything?\No! response:	No...
context: That bag...\It was Hishiro-san's, right?\Why did you have it?\Don't run.\Answer me, Kariu.\You steal anything?\No!\No... response:	I just wanted to trouble her a bit...
context: It was Hishiro-san's, right?\Why did you have it?\Don't run.\Answer me, Kariu.\You steal anything?\No!\No...\I just wanted to trouble her a bit... response:	I was gonna hide it somewhere.
context: Why did you have it?\Don't run.\Answer me, Kariu.\You steal anything?\No!\No...\I just wanted to trouble her a bit...\I was gonna hide it somewhere. response:	Why?
context: Don't run.\Answer me, Kariu.\You steal anything?\No!\No...\I just wanted to trouble her a bit...\I was gonna hide it somewhere.\Why? response:	Why?
context: Answer me, Kariu.\You steal anything?\No!\No...\I just wanted to trouble her a bit...\I was gonna hide it somewhere.\Why?\Why? response:	Have you given up?
context: You steal anything?\No!\No...\I just wanted to trouble her a bit...\I was gonna hide it somewhere.\Why?\Why?\Have you given up? response:	Do you think harassing her is the only way you'll beat her?
context: No!\No...\I just wanted to trouble her a bit...\I was gonna hide it somewhere.\Why?\Why?\Have you given up?\Do you think harassing her is the only way you'll beat her? response:	So...
context: No...\I just wanted to trouble her a bit...\I was gonna hide it somewhere.\Why?\Why?\Have you given up?\Do you think harassing her is the only way you'll beat her?\So... response:	Are you gonna tell her I tried to harass her because I was jealous?
context: I just wanted to trouble her a bit...\I was gonna hide it somewhere.\Why?\Why?\Have you given up?\Do you think harassing her is the only way you'll beat her?\So...\Are you gonna tell her I tried to harass her because I was jealous? response:	You're close to her.
context: I was gonna hide it somewhere.\Why?\Why?\Have you given up?\Do you think harassing her is the only way you'll beat her?\So...\Are you gonna tell her I tried to harass her because I was jealous?\You're close to her. response:	That's why you knew it was her bag,
context: Why?\Why?\Have you given up?\Do you think harassing her is the only way you'll beat her?\So...\Are you gonna tell her I tried to harass her because I was jealous?\You're close to her.\That's why you knew it was her bag, response:	and that's why you're mad at me.
context: Why?\Have you given up?\Do you think harassing her is the only way you'll beat her?\So...\Are you gonna tell her I tried to harass her because I was jealous?\You're close to her.\That's why you knew it was her bag,\and that's why you're mad at me. response:	I bet I could hurt you more if I told Oga.
context: Have you given up?\Do you think harassing her is the only way you'll beat her?\So...\Are you gonna tell her I tried to harass her because I was jealous?\You're close to her.\That's why you knew it was her bag,\and that's why you're mad at me.\I bet I could hurt you more if I told Oga. response:	I'm kidding.
context: Do you think harassing her is the only way you'll beat her?\So...\Are you gonna tell her I tried to harass her because I was jealous?\You're close to her.\That's why you knew it was her bag,\and that's why you're mad at me.\I bet I could hurt you more if I told Oga.\I'm kidding. response:	I won't do that.
context: So...\Are you gonna tell her I tried to harass her because I was jealous?\You're close to her.\That's why you knew it was her bag,\and that's why you're mad at me.\I bet I could hurt you more if I told Oga.\I'm kidding.\I won't do that. response:	But... that is what I think.
context: Are you gonna tell her I tried to harass her because I was jealous?\You're close to her.\That's why you knew it was her bag,\and that's why you're mad at me.\I bet I could hurt you more if I told Oga.\I'm kidding.\I won't do that.\But... that is what I think. response:	Trying to knock others down a peg just means lowering yourself.
context: You're close to her.\That's why you knew it was her bag,\and that's why you're mad at me.\I bet I could hurt you more if I told Oga.\I'm kidding.\I won't do that.\But... that is what I think.\Trying to knock others down a peg just means lowering yourself. response:	Don't go trampling all the hard work and trust you've built up.
context: That's why you knew it was her bag,\and that's why you're mad at me.\I bet I could hurt you more if I told Oga.\I'm kidding.\I won't do that.\But... that is what I think.\Trying to knock others down a peg just means lowering yourself.\Don't go trampling all the hard work and trust you've built up. response:	It insults the effort you put in.
context: and that's why you're mad at me.\I bet I could hurt you more if I told Oga.\I'm kidding.\I won't do that.\But... that is what I think.\Trying to knock others down a peg just means lowering yourself.\Don't go trampling all the hard work and trust you've built up.\It insults the effort you put in. response:	The only way that would make you happy
context: I bet I could hurt you more if I told Oga.\I'm kidding.\I won't do that.\But... that is what I think.\Trying to knock others down a peg just means lowering yourself.\Don't go trampling all the hard work and trust you've built up.\It insults the effort you put in.\The only way that would make you happy response:	is if you were a loser who'd given up on trying.
context: I'm kidding.\I won't do that.\But... that is what I think.\Trying to knock others down a peg just means lowering yourself.\Don't go trampling all the hard work and trust you've built up.\It insults the effort you put in.\The only way that would make you happy\is if you were a loser who'd given up on trying. response:	But I don't think that describes you.
context: I won't do that.\But... that is what I think.\Trying to knock others down a peg just means lowering yourself.\Don't go trampling all the hard work and trust you've built up.\It insults the effort you put in.\The only way that would make you happy\is if you were a loser who'd given up on trying.\But I don't think that describes you. response:	The Kariu I know hates losing,
context: But... that is what I think.\Trying to knock others down a peg just means lowering yourself.\Don't go trampling all the hard work and trust you've built up.\It insults the effort you put in.\The only way that would make you happy\is if you were a loser who'd given up on trying.\But I don't think that describes you.\The Kariu I know hates losing, response:	is curt but kind,
context: Trying to knock others down a peg just means lowering yourself.\Don't go trampling all the hard work and trust you've built up.\It insults the effort you put in.\The only way that would make you happy\is if you were a loser who'd given up on trying.\But I don't think that describes you.\The Kariu I know hates losing,\is curt but kind, response:	and is a hard worker with a strong heart.
context: Don't go trampling all the hard work and trust you've built up.\It insults the effort you put in.\The only way that would make you happy\is if you were a loser who'd given up on trying.\But I don't think that describes you.\The Kariu I know hates losing,\is curt but kind,\and is a hard worker with a strong heart. response:	Because I know how hard you've worked,
context: It insults the effort you put in.\The only way that would make you happy\is if you were a loser who'd given up on trying.\But I don't think that describes you.\The Kariu I know hates losing,\is curt but kind,\and is a hard worker with a strong heart.\Because I know how hard you've worked, response:	I'm not really mad. Just very, very sad.
context: The only way that would make you happy\is if you were a loser who'd given up on trying.\But I don't think that describes you.\The Kariu I know hates losing,\is curt but kind,\and is a hard worker with a strong heart.\Because I know how hard you've worked,\I'm not really mad. Just very, very sad. response:	Don't act like some filthy adult.
context: is if you were a loser who'd given up on trying.\But I don't think that describes you.\The Kariu I know hates losing,\is curt but kind,\and is a hard worker with a strong heart.\Because I know how hard you've worked,\I'm not really mad. Just very, very sad.\Don't act like some filthy adult. response:	You're still young!
context: But I don't think that describes you.\The Kariu I know hates losing,\is curt but kind,\and is a hard worker with a strong heart.\Because I know how hard you've worked,\I'm not really mad. Just very, very sad.\Don't act like some filthy adult.\You're still young! response:	Don't give up on try
context: The Kariu I know hates losing,\is curt but kind,\and is a hard worker with a strong heart.\Because I know how hard you've worked,\I'm not really mad. Just very, very sad.\Don't act like some filthy adult.\You're still young!\Don't give up on try response:	What would you know?!
context: is curt but kind,\and is a hard worker with a strong heart.\Because I know how hard you've worked,\I'm not really mad. Just very, very sad.\Don't act like some filthy adult.\You're still young!\Don't give up on try\What would you know?! response:	What the hell are you lecturing me for?
context: and is a hard worker with a strong heart.\Because I know how hard you've worked,\I'm not really mad. Just very, very sad.\Don't act like some filthy adult.\You're still young!\Don't give up on try\What would you know?!\What the hell are you lecturing me for? response:	We're the same age!
context: Because I know how hard you've worked,\I'm not really mad. Just very, very sad.\Don't act like some filthy adult.\You're still young!\Don't give up on try\What would you know?!\What the hell are you lecturing me for?\We're the same age! response:	I did try!
context: I'm not really mad. Just very, very sad.\Don't act like some filthy adult.\You're still young!\Don't give up on try\What would you know?!\What the hell are you lecturing me for?\We're the same age!\I did try! response:	But I couldn't win.
context: Don't act like some filthy adult.\You're still young!\Don't give up on try\What would you know?!\What the hell are you lecturing me for?\We're the same age!\I did try!\But I couldn't win. response:	Not only that, they don't even see me as a rival!
context: You're still young!\Don't give up on try\What would you know?!\What the hell are you lecturing me for?\We're the same age!\I did try!\But I couldn't win.\Not only that, they don't even see me as a rival! response:	Honoka for sports, Hishiro for studies...
context: Don't give up on try\What would you know?!\What the hell are you lecturing me for?\We're the same age!\I did try!\But I couldn't win.\Not only that, they don't even see me as a rival!\Honoka for sports, Hishiro for studies... response:	I'm trying desperately to beat them!
context: What would you know?!\What the hell are you lecturing me for?\We're the same age!\I did try!\But I couldn't win.\Not only that, they don't even see me as a rival!\Honoka for sports, Hishiro for studies...\I'm trying desperately to beat them! response:	So why do they act like I'm no threat at all?!
context: What the hell are you lecturing me for?\We're the same age!\I did try!\But I couldn't win.\Not only that, they don't even see me as a rival!\Honoka for sports, Hishiro for studies...\I'm trying desperately to beat them!\So why do they act like I'm no threat at all?! response:	Why am I the only one with problems?!
context: We're the same age!\I did try!\But I couldn't win.\Not only that, they don't even see me as a rival!\Honoka for sports, Hishiro for studies...\I'm trying desperately to beat them!\So why do they act like I'm no threat at all?!\Why am I the only one with problems?! response:	I try and try and try and...
context: I did try!\But I couldn't win.\Not only that, they don't even see me as a rival!\Honoka for sports, Hishiro for studies...\I'm trying desperately to beat them!\So why do they act like I'm no threat at all?!\Why am I the only one with problems?!\I try and try and try and... response:	No matter how hard I try, I get nothing in return.
context: But I couldn't win.\Not only that, they don't even see me as a rival!\Honoka for sports, Hishiro for studies...\I'm trying desperately to beat them!\So why do they act like I'm no threat at all?!\Why am I the only one with problems?!\I try and try and try and...\No matter how hard I try, I get nothing in return. response:	It's all pointless.
context: Not only that, they don't even see me as a rival!\Honoka for sports, Hishiro for studies...\I'm trying desperately to beat them!\So why do they act like I'm no threat at all?!\Why am I the only one with problems?!\I try and try and try and...\No matter how hard I try, I get nothing in return.\It's all pointless. response:	That's not true.
context: Honoka for sports, Hishiro for studies...\I'm trying desperately to beat them!\So why do they act like I'm no threat at all?!\Why am I the only one with problems?!\I try and try and try and...\No matter how hard I try, I get nothing in return.\It's all pointless.\That's not true. response:	You're just too busy comparing yourself to others to see.
context: I'm trying desperately to beat them!\So why do they act like I'm no threat at all?!\Why am I the only one with problems?!\I try and try and try and...\No matter how hard I try, I get nothing in return.\It's all pointless.\That's not true.\You're just too busy comparing yourself to others to see. response:	Those comparisons aren't the only measure.
context: So why do they act like I'm no threat at all?!\Why am I the only one with problems?!\I try and try and try and...\No matter how hard I try, I get nothing in return.\It's all pointless.\That's not true.\You're just too busy comparing yourself to others to see.\Those comparisons aren't the only measure. response:	Don't say it's all pointless.
context: Why am I the only one with problems?!\I try and try and try and...\No matter how hard I try, I get nothing in return.\It's all pointless.\That's not true.\You're just too busy comparing yourself to others to see.\Those comparisons aren't the only measure.\Don't say it's all pointless. response:	You've worked hard and made yourself better.
context: I try and try and try and...\No matter how hard I try, I get nothing in return.\It's all pointless.\That's not true.\You're just too busy comparing yourself to others to see.\Those comparisons aren't the only measure.\Don't say it's all pointless.\You've worked hard and made yourself better. response:	That's what you got in return.
context: No matter how hard I try, I get nothing in return.\It's all pointless.\That's not true.\You're just too busy comparing yourself to others to see.\Those comparisons aren't the only measure.\Don't say it's all pointless.\You've worked hard and made yourself better.\That's what you got in return. response:	So don't...
context: It's all pointless.\That's not true.\You're just too busy comparing yourself to others to see.\Those comparisons aren't the only measure.\Don't say it's all pointless.\You've worked hard and made yourself better.\That's what you got in return.\So don't... response:	Oh...
context: That's not true.\You're just too busy comparing yourself to others to see.\Those comparisons aren't the only measure.\Don't say it's all pointless.\You've worked hard and made yourself better.\That's what you got in return.\So don't...\Oh... response:	I guess...
context: You're just too busy comparing yourself to others to see.\Those comparisons aren't the only measure.\Don't say it's all pointless.\You've worked hard and made yourself better.\That's what you got in return.\So don't...\Oh...\I guess... response:	Nurse's Office
context: Those comparisons aren't the only measure.\Don't say it's all pointless.\You've worked hard and made yourself better.\That's what you got in return.\So don't...\Oh...\I guess...\Nurse's Office response:	Feeling better?
context: Don't say it's all pointless.\You've worked hard and made yourself better.\That's what you got in return.\So don't...\Oh...\I guess...\Nurse's Office\Feeling better? response:	Huh? About what?
context: You've worked hard and made yourself better.\That's what you got in return.\So don't...\Oh...\I guess...\Nurse's Office\Feeling better?\Huh? About what? response:	Always gotta act tough, huh?
context: That's what you got in return.\So don't...\Oh...\I guess...\Nurse's Office\Feeling better?\Huh? About what?\Always gotta act tough, huh? response:	You said no matter how hard you tried...
context: So don't...\Oh...\I guess...\Nurse's Office\Feeling better?\Huh? About what?\Always gotta act tough, huh?\You said no matter how hard you tried... response:	Stop talking about that!
context: Oh...\I guess...\Nurse's Office\Feeling better?\Huh? About what?\Always gotta act tough, huh?\You said no matter how hard you tried...\Stop talking about that! response:	But Hishiro-san's trying, too.
context: I guess...\Nurse's Office\Feeling better?\Huh? About what?\Always gotta act tough, huh?\You said no matter how hard you tried...\Stop talking about that!\But Hishiro-san's trying, too. response:	She was in the staff room this late...
context: Nurse's Office\Feeling better?\Huh? About what?\Always gotta act tough, huh?\You said no matter how hard you tried...\Stop talking about that!\But Hishiro-san's trying, too.\She was in the staff room this late... response:	I bet she had questions for the teachers.
context: Feeling better?\Huh? About what?\Always gotta act tough, huh?\You said no matter how hard you tried...\Stop talking about that!\But Hishiro-san's trying, too.\She was in the staff room this late...\I bet she had questions for the teachers. response:	There are things even she doesn't find easy.
context: Huh? About what?\Always gotta act tough, huh?\You said no matter how hard you tried...\Stop talking about that!\But Hishiro-san's trying, too.\She was in the staff room this late...\I bet she had questions for the teachers.\There are things even she doesn't find easy. response:	She's really awkward, after all.
context: Always gotta act tough, huh?\You said no matter how hard you tried...\Stop talking about that!\But Hishiro-san's trying, too.\She was in the staff room this late...\I bet she had questions for the teachers.\There are things even she doesn't find easy.\She's really awkward, after all. response:	I think you've got the wrong idea about her, too.
context: You said no matter how hard you tried...\Stop talking about that!\But Hishiro-san's trying, too.\She was in the staff room this late...\I bet she had questions for the teachers.\There are things even she doesn't find easy.\She's really awkward, after all.\I think you've got the wrong idea about her, too. response:	You've never really talked to her.
context: Stop talking about that!\But Hishiro-san's trying, too.\She was in the staff room this late...\I bet she had questions for the teachers.\There are things even she doesn't find easy.\She's really awkward, after all.\I think you've got the wrong idea about her, too.\You've never really talked to her. response:	Oh, right!
context: But Hishiro-san's trying, too.\She was in the staff room this late...\I bet she had questions for the teachers.\There are things even she doesn't find easy.\She's really awkward, after all.\I think you've got the wrong idea about her, too.\You've never really talked to her.\Oh, right! response:	Next time you get a chance, ask her to smile for you.
context: She was in the staff room this late...\I bet she had questions for the teachers.\There are things even she doesn't find easy.\She's really awkward, after all.\I think you've got the wrong idea about her, too.\You've never really talked to her.\Oh, right!\Next time you get a chance, ask her to smile for you. response:	Smile?
context: I bet she had questions for the teachers.\There are things even she doesn't find easy.\She's really awkward, after all.\I think you've got the wrong idea about her, too.\You've never really talked to her.\Oh, right!\Next time you get a chance, ask her to smile for you.\Smile? response:	It's really something.
context: There are things even she doesn't find easy.\She's really awkward, after all.\I think you've got the wrong idea about her, too.\You've never really talked to her.\Oh, right!\Next time you get a chance, ask her to smile for you.\Smile?\It's really something. response:	I just lectured her like an old man!
context: She's really awkward, after all.\I think you've got the wrong idea about her, too.\You've never really talked to her.\Oh, right!\Next time you get a chance, ask her to smile for you.\Smile?\It's really something.\I just lectured her like an old man! response:	Don't give up on trying.
context: I think you've got the wrong idea about her, too.\You've never really talked to her.\Oh, right!\Next time you get a chance, ask her to smile for you.\Smile?\It's really something.\I just lectured her like an old man!\Don't give up on trying. response:	Talk about pot calling the kettle black.
context: You've never really talked to her.\Oh, right!\Next time you get a chance, ask her to smile for you.\Smile?\It's really something.\I just lectured her like an old man!\Don't give up on trying.\Talk about pot calling the kettle black. response:	I'm one to talk, considering I gave up.
context: Oh, right!\Next time you get a chance, ask her to smile for you.\Smile?\It's really something.\I just lectured her like an old man!\Don't give up on trying.\Talk about pot calling the kettle black.\I'm one to talk, considering I gave up. response:	Wh-What's up, Hishiro-san?
context: Next time you get a chance, ask her to smile for you.\Smile?\It's really something.\I just lectured her like an old man!\Don't give up on trying.\Talk about pot calling the kettle black.\I'm one to talk, considering I gave up.\Wh-What's up, Hishiro-san? response:	I was waiting for you.
context: Smile?\It's really something.\I just lectured her like an old man!\Don't give up on trying.\Talk about pot calling the kettle black.\I'm one to talk, considering I gave up.\Wh-What's up, Hishiro-san?\I was waiting for you. response:	There's something bothering me.
context: It's really something.\I just lectured her like an old man!\Don't give up on trying.\Talk about pot calling the kettle black.\I'm one to talk, considering I gave up.\Wh-What's up, Hishiro-san?\I was waiting for you.\There's something bothering me. response:	Thinking about it didn't get me anywhere, so I waited to ask you.
context: I just lectured her like an old man!\Don't give up on trying.\Talk about pot calling the kettle black.\I'm one to talk, considering I gave up.\Wh-What's up, Hishiro-san?\I was waiting for you.\There's something bothering me.\Thinking about it didn't get me anywhere, so I waited to ask you. response:	Why did Kariu-san have my bag?
context: Don't give up on trying.\Talk about pot calling the kettle black.\I'm one to talk, considering I gave up.\Wh-What's up, Hishiro-san?\I was waiting for you.\There's something bothering me.\Thinking about it didn't get me anywhere, so I waited to ask you.\Why did Kariu-san have my bag? response:	I've thought about it a lot,
context: Talk about pot calling the kettle black.\I'm one to talk, considering I gave up.\Wh-What's up, Hishiro-san?\I was waiting for you.\There's something bothering me.\Thinking about it didn't get me anywhere, so I waited to ask you.\Why did Kariu-san have my bag?\I've thought about it a lot, response:	but all I can think of is that she stole it, so I'm confused.
context: I'm one to talk, considering I gave up.\Wh-What's up, Hishiro-san?\I was waiting for you.\There's something bothering me.\Thinking about it didn't get me anywhere, so I waited to ask you.\Why did Kariu-san have my bag?\I've thought about it a lot,\but all I can think of is that she stole it, so I'm confused. response:	Uh...
context: Wh-What's up, Hishiro-san?\I was waiting for you.\There's something bothering me.\Thinking about it didn't get me anywhere, so I waited to ask you.\Why did Kariu-san have my bag?\I've thought about it a lot,\but all I can think of is that she stole it, so I'm confused.\Uh... response:	Kariu-san and my eyes have been meeting often lately,
context: I was waiting for you.\There's something bothering me.\Thinking about it didn't get me anywhere, so I waited to ask you.\Why did Kariu-san have my bag?\I've thought about it a lot,\but all I can think of is that she stole it, so I'm confused.\Uh...\Kariu-san and my eyes have been meeting often lately, response:	and every time, I've made sure to smile.
context: There's something bothering me.\Thinking about it didn't get me anywhere, so I waited to ask you.\Why did Kariu-san have my bag?\I've thought about it a lot,\but all I can think of is that she stole it, so I'm confused.\Uh...\Kariu-san and my eyes have been meeting often lately,\and every time, I've made sure to smile. response:	So I thought we were friendly.
context: Thinking about it didn't get me anywhere, so I waited to ask you.\Why did Kariu-san have my bag?\I've thought about it a lot,\but all I can think of is that she stole it, so I'm confused.\Uh...\Kariu-san and my eyes have been meeting often lately,\and every time, I've made sure to smile.\So I thought we were friendly. response:	Th-Think!
context: Why did Kariu-san have my bag?\I've thought about it a lot,\but all I can think of is that she stole it, so I'm confused.\Uh...\Kariu-san and my eyes have been meeting often lately,\and every time, I've made sure to smile.\So I thought we were friendly.\Th-Think! response:	What the hell should I tell this malice-free tone-deaf communicator?!
context: I've thought about it a lot,\but all I can think of is that she stole it, so I'm confused.\Uh...\Kariu-san and my eyes have been meeting often lately,\and every time, I've made sure to smile.\So I thought we were friendly.\Th-Think!\What the hell should I tell this malice-free tone-deaf communicator?! response:	Sh-She thought it was dangerous to leave the bag lying in the hall.
context: but all I can think of is that she stole it, so I'm confused.\Uh...\Kariu-san and my eyes have been meeting often lately,\and every time, I've made sure to smile.\So I thought we were friendly.\Th-Think!\What the hell should I tell this malice-free tone-deaf communicator?!\Sh-She thought it was dangerous to leave the bag lying in the hall. response:	So she thought she'd take care of it for you.
context: Uh...\Kariu-san and my eyes have been meeting often lately,\and every time, I've made sure to smile.\So I thought we were friendly.\Th-Think!\What the hell should I tell this malice-free tone-deaf communicator?!\Sh-She thought it was dangerous to leave the bag lying in the hall.\So she thought she'd take care of it for you. response:	Oh...
context: Kariu-san and my eyes have been meeting often lately,\and every time, I've made sure to smile.\So I thought we were friendly.\Th-Think!\What the hell should I tell this malice-free tone-deaf communicator?!\Sh-She thought it was dangerous to leave the bag lying in the hall.\So she thought she'd take care of it for you.\Oh... response:	That's a relief.
context: and every time, I've made sure to smile.\So I thought we were friendly.\Th-Think!\What the hell should I tell this malice-free tone-deaf communicator?!\Sh-She thought it was dangerous to leave the bag lying in the hall.\So she thought she'd take care of it for you.\Oh...\That's a relief. response:	Now that I know the reason, I feel a lot better.
context: So I thought we were friendly.\Th-Think!\What the hell should I tell this malice-free tone-deaf communicator?!\Sh-She thought it was dangerous to leave the bag lying in the hall.\So she thought she'd take care of it for you.\Oh...\That's a relief.\Now that I know the reason, I feel a lot better. response:	I knew she couldn't have tried to steal it.
context: Th-Think!\What the hell should I tell this malice-free tone-deaf communicator?!\Sh-She thought it was dangerous to leave the bag lying in the hall.\So she thought she'd take care of it for you.\Oh...\That's a relief.\Now that I know the reason, I feel a lot better.\I knew she couldn't have tried to steal it. response:	But I couldn't think of anything else. I'm ashamed of myself.
context: What the hell should I tell this malice-free tone-deaf communicator?!\Sh-She thought it was dangerous to leave the bag lying in the hall.\So she thought she'd take care of it for you.\Oh...\That's a relief.\Now that I know the reason, I feel a lot better.\I knew she couldn't have tried to steal it.\But I couldn't think of anything else. I'm ashamed of myself. response:	Is getting rid of all the thorns in someone's path really what's best for them?
context: Sh-She thought it was dangerous to leave the bag lying in the hall.\So she thought she'd take care of it for you.\Oh...\That's a relief.\Now that I know the reason, I feel a lot better.\I knew she couldn't have tried to steal it.\But I couldn't think of anything else. I'm ashamed of myself.\Is getting rid of all the thorns in someone's path really what's best for them? response:	Sorry.
context: So she thought she'd take care of it for you.\Oh...\That's a relief.\Now that I know the reason, I feel a lot better.\I knew she couldn't have tried to steal it.\But I couldn't think of anything else. I'm ashamed of myself.\Is getting rid of all the thorns in someone's path really what's best for them?\Sorry. response:	That was a lie.
context: Oh...\That's a relief.\Now that I know the reason, I feel a lot better.\I knew she couldn't have tried to steal it.\But I couldn't think of anything else. I'm ashamed of myself.\Is getting rid of all the thorns in someone's path really what's best for them?\Sorry.\That was a lie. response:	Kariu took your bag to cause problems for you.
context: That's a relief.\Now that I know the reason, I feel a lot better.\I knew she couldn't have tried to steal it.\But I couldn't think of anything else. I'm ashamed of myself.\Is getting rid of all the thorns in someone's path really what's best for them?\Sorry.\That was a lie.\Kariu took your bag to cause problems for you. response:	Why would she...
context: Now that I know the reason, I feel a lot better.\I knew she couldn't have tried to steal it.\But I couldn't think of anything else. I'm ashamed of myself.\Is getting rid of all the thorns in someone's path really what's best for them?\Sorry.\That was a lie.\Kariu took your bag to cause problems for you.\Why would she... response:	She wanted the silver pin,
context: I knew she couldn't have tried to steal it.\But I couldn't think of anything else. I'm ashamed of myself.\Is getting rid of all the thorns in someone's path really what's best for them?\Sorry.\That was a lie.\Kariu took your bag to cause problems for you.\Why would she...\She wanted the silver pin, response:	so she was jealous and frustrated.
context: But I couldn't think of anything else. I'm ashamed of myself.\Is getting rid of all the thorns in someone's path really what's best for them?\Sorry.\That was a lie.\Kariu took your bag to cause problems for you.\Why would she...\She wanted the silver pin,\so she was jealous and frustrated. response:	Kariu-san wants this?
context: Is getting rid of all the thorns in someone's path really what's best for them?\Sorry.\That was a lie.\Kariu took your bag to cause problems for you.\Why would she...\She wanted the silver pin,\so she was jealous and frustrated.\Kariu-san wants this? response:	Holy crap.
context: Sorry.\That was a lie.\Kariu took your bag to cause problems for you.\Why would she...\She wanted the silver pin,\so she was jealous and frustrated.\Kariu-san wants this?\Holy crap. response:	She's even denser than Oga.
context: That was a lie.\Kariu took your bag to cause problems for you.\Why would she...\She wanted the silver pin,\so she was jealous and frustrated.\Kariu-san wants this?\Holy crap.\She's even denser than Oga. response:	Then if I give her this, can we be friends?
context: Kariu took your bag to cause problems for you.\Why would she...\She wanted the silver pin,\so she was jealous and frustrated.\Kariu-san wants this?\Holy crap.\She's even denser than Oga.\Then if I give her this, can we be friends? response:	No way.
context: Why would she...\She wanted the silver pin,\so she was jealous and frustrated.\Kariu-san wants this?\Holy crap.\She's even denser than Oga.\Then if I give her this, can we be friends?\No way. response:	I don't understand.
context: She wanted the silver pin,\so she was jealous and frustrated.\Kariu-san wants this?\Holy crap.\She's even denser than Oga.\Then if I give her this, can we be friends?\No way.\I don't understand. response:	Does Kariu-san hate me?
context: so she was jealous and frustrated.\Kariu-san wants this?\Holy crap.\She's even denser than Oga.\Then if I give her this, can we be friends?\No way.\I don't understand.\Does Kariu-san hate me? response:	Yeah, I guess you wouldn't get it.
context: Kariu-san wants this?\Holy crap.\She's even denser than Oga.\Then if I give her this, can we be friends?\No way.\I don't understand.\Does Kariu-san hate me?\Yeah, I guess you wouldn't get it. response:	Hishiro-san,
context: Holy crap.\She's even denser than Oga.\Then if I give her this, can we be friends?\No way.\I don't understand.\Does Kariu-san hate me?\Yeah, I guess you wouldn't get it.\Hishiro-san, response:	for someone so smart, you can be really dense.
context: She's even denser than Oga.\Then if I give her this, can we be friends?\No way.\I don't understand.\Does Kariu-san hate me?\Yeah, I guess you wouldn't get it.\Hishiro-san,\for someone so smart, you can be really dense. response:	You haven't noticed that everyone's mad at you, have you?
context: Then if I give her this, can we be friends?\No way.\I don't understand.\Does Kariu-san hate me?\Yeah, I guess you wouldn't get it.\Hishiro-san,\for someone so smart, you can be really dense.\You haven't noticed that everyone's mad at you, have you? response:	I don't understand what I say that makes people so mad.
context: No way.\I don't understand.\Does Kariu-san hate me?\Yeah, I guess you wouldn't get it.\Hishiro-san,\for someone so smart, you can be really dense.\You haven't noticed that everyone's mad at you, have you?\I don't understand what I say that makes people so mad. response:	I don't understand how they feel.
context: I don't understand.\Does Kariu-san hate me?\Yeah, I guess you wouldn't get it.\Hishiro-san,\for someone so smart, you can be really dense.\You haven't noticed that everyone's mad at you, have you?\I don't understand what I say that makes people so mad.\I don't understand how they feel. response:	I know that's because I haven't properly socialized.
context: Does Kariu-san hate me?\Yeah, I guess you wouldn't get it.\Hishiro-san,\for someone so smart, you can be really dense.\You haven't noticed that everyone's mad at you, have you?\I don't understand what I say that makes people so mad.\I don't understand how they feel.\I know that's because I haven't properly socialized. response:	I've tried to learn.
context: Yeah, I guess you wouldn't get it.\Hishiro-san,\for someone so smart, you can be really dense.\You haven't noticed that everyone's mad at you, have you?\I don't understand what I say that makes people so mad.\I don't understand how they feel.\I know that's because I haven't properly socialized.\I've tried to learn. response:	I've tried to study up on it,
context: Hishiro-san,\for someone so smart, you can be really dense.\You haven't noticed that everyone's mad at you, have you?\I don't understand what I say that makes people so mad.\I don't understand how they feel.\I know that's because I haven't properly socialized.\I've tried to learn.\I've tried to study up on it, response:	but I just don't know what's right.
context: for someone so smart, you can be really dense.\You haven't noticed that everyone's mad at you, have you?\I don't understand what I say that makes people so mad.\I don't understand how they feel.\I know that's because I haven't properly socialized.\I've tried to learn.\I've tried to study up on it,\but I just don't know what's right. response:	That's a tough one.
context: You haven't noticed that everyone's mad at you, have you?\I don't understand what I say that makes people so mad.\I don't understand how they feel.\I know that's because I haven't properly socialized.\I've tried to learn.\I've tried to study up on it,\but I just don't know what's right.\That's a tough one. response:	There is no right answer for getting along.
context: I don't understand what I say that makes people so mad.\I don't understand how they feel.\I know that's because I haven't properly socialized.\I've tried to learn.\I've tried to study up on it,\but I just don't know what's right.\That's a tough one.\There is no right answer for getting along. response:	Different people require different answers.
context: I don't understand how they feel.\I know that's because I haven't properly socialized.\I've tried to learn.\I've tried to study up on it,\but I just don't know what's right.\That's a tough one.\There is no right answer for getting along.\Different people require different answers. response:	Different people... require different answers?
context: I know that's because I haven't properly socialized.\I've tried to learn.\I've tried to study up on it,\but I just don't know what's right.\That's a tough one.\There is no right answer for getting along.\Different people require different answers.\Different people... require different answers? response:	Sorry, I didn't mean to overload you.
context: I've tried to learn.\I've tried to study up on it,\but I just don't know what's right.\That's a tough one.\There is no right answer for getting along.\Different people require different answers.\Different people... require different answers?\Sorry, I didn't mean to overload you. response:	I'm going to wait for Kariu-san.
context: I've tried to study up on it,\but I just don't know what's right.\That's a tough one.\There is no right answer for getting along.\Different people require different answers.\Different people... require different answers?\Sorry, I didn't mean to overload you.\I'm going to wait for Kariu-san. response:	I can't leave this be.
context: but I just don't know what's right.\That's a tough one.\There is no right answer for getting along.\Different people require different answers.\Different people... require different answers?\Sorry, I didn't mean to overload you.\I'm going to wait for Kariu-san.\I can't leave this be. response:	I want to be her friend for real.
context: That's a tough one.\There is no right answer for getting along.\Different people require different answers.\Different people... require different answers?\Sorry, I didn't mean to overload you.\I'm going to wait for Kariu-san.\I can't leave this be.\I want to be her friend for real. response:	But I don't know how.
context: There is no right answer for getting along.\Different people require different answers.\Different people... require different answers?\Sorry, I didn't mean to overload you.\I'm going to wait for Kariu-san.\I can't leave this be.\I want to be her friend for real.\But I don't know how. response:	If I don't know the right answer... I'll just ask her.
context: Different people require different answers.\Different people... require different answers?\Sorry, I didn't mean to overload you.\I'm going to wait for Kariu-san.\I can't leave this be.\I want to be her friend for real.\But I don't know how.\If I don't know the right answer... I'll just ask her. response:	Like you're asking a teacher?
context: Different people... require different answers?\Sorry, I didn't mean to overload you.\I'm going to wait for Kariu-san.\I can't leave this be.\I want to be her friend for real.\But I don't know how.\If I don't know the right answer... I'll just ask her.\Like you're asking a teacher? response:	One more question.
context: Sorry, I didn't mean to overload you.\I'm going to wait for Kariu-san.\I can't leave this be.\I want to be her friend for real.\But I don't know how.\If I don't know the right answer... I'll just ask her.\Like you're asking a teacher?\One more question. response:	When I saw your hands wrapped protectively around her,
context: I'm going to wait for Kariu-san.\I can't leave this be.\I want to be her friend for real.\But I don't know how.\If I don't know the right answer... I'll just ask her.\Like you're asking a teacher?\One more question.\When I saw your hands wrapped protectively around her, response:	why did I feel a pang?
context: I can't leave this be.\I want to be her friend for real.\But I don't know how.\If I don't know the right answer... I'll just ask her.\Like you're asking a teacher?\One more question.\When I saw your hands wrapped protectively around her,\why did I feel a pang? response:	No, never mind.
context: I want to be her friend for real.\But I don't know how.\If I don't know the right answer... I'll just ask her.\Like you're asking a teacher?\One more question.\When I saw your hands wrapped protectively around her,\why did I feel a pang?\No, never mind. response:	It's ineffective to deal with many problems at once.
context: But I don't know how.\If I don't know the right answer... I'll just ask her.\Like you're asking a teacher?\One more question.\When I saw your hands wrapped protectively around her,\why did I feel a pang?\No, never mind.\It's ineffective to deal with many problems at once. response:	One at a time.
context: If I don't know the right answer... I'll just ask her.\Like you're asking a teacher?\One more question.\When I saw your hands wrapped protectively around her,\why did I feel a pang?\No, never mind.\It's ineffective to deal with many problems at once.\One at a time. response:	Please go home.
context: Like you're asking a teacher?\One more question.\When I saw your hands wrapped protectively around her,\why did I feel a pang?\No, never mind.\It's ineffective to deal with many problems at once.\One at a time.\Please go home. response:	I think I have to take care of this myself.
context: One more question.\When I saw your hands wrapped protectively around her,\why did I feel a pang?\No, never mind.\It's ineffective to deal with many problems at once.\One at a time.\Please go home.\I think I have to take care of this myself. response:	G-Got it.
context: When I saw your hands wrapped protectively around her,\why did I feel a pang?\No, never mind.\It's ineffective to deal with many problems at once.\One at a time.\Please go home.\I think I have to take care of this myself.\G-Got it. response:	See you later, then.
context: why did I feel a pang?\No, never mind.\It's ineffective to deal with many problems at once.\One at a time.\Please go home.\I think I have to take care of this myself.\G-Got it.\See you later, then. response:	As if!
context: No, never mind.\It's ineffective to deal with many problems at once.\One at a time.\Please go home.\I think I have to take care of this myself.\G-Got it.\See you later, then.\As if! response:	Like I can possibly just leave!
context: It's ineffective to deal with many problems at once.\One at a time.\Please go home.\I think I have to take care of this myself.\G-Got it.\See you later, then.\As if!\Like I can possibly just leave! response:	Will she be okay?
context: One at a time.\Please go home.\I think I have to take care of this myself.\G-Got it.\See you later, then.\As if!\Like I can possibly just leave!\Will she be okay? response:	I dunno, will she?
context: Please go home.\I think I have to take care of this myself.\G-Got it.\See you later, then.\As if!\Like I can possibly just leave!\Will she be okay?\I dunno, will she? response:	Why are you here?!
context: I think I have to take care of this myself.\G-Got it.\See you later, then.\As if!\Like I can possibly just leave!\Will she be okay?\I dunno, will she?\Why are you here?! response:	You should be used to this by now.
context: G-Got it.\See you later, then.\As if!\Like I can possibly just leave!\Will she be okay?\I dunno, will she?\Why are you here?!\You should be used to this by now. response:	Wherever you go, I go with you.
context: See you later, then.\As if!\Like I can possibly just leave!\Will she be okay?\I dunno, will she?\Why are you here?!\You should be used to this by now.\Wherever you go, I go with you. response:	Creepy!
context: As if!\Like I can possibly just leave!\Will she be okay?\I dunno, will she?\Why are you here?!\You should be used to this by now.\Wherever you go, I go with you.\Creepy! response:	Keep your voice down!
context: Like I can possibly just leave!\Will she be okay?\I dunno, will she?\Why are you here?!\You should be used to this by now.\Wherever you go, I go with you.\Creepy!\Keep your voice down! response:	And don't be mean.
context: Will she be okay?\I dunno, will she?\Why are you here?!\You should be used to this by now.\Wherever you go, I go with you.\Creepy!\Keep your voice down!\And don't be mean. response:	You're supposed to be watching me, not Hishiro.
context: I dunno, will she?\Why are you here?!\You should be used to this by now.\Wherever you go, I go with you.\Creepy!\Keep your voice down!\And don't be mean.\You're supposed to be watching me, not Hishiro. response:	The influence your choices have on those around you
context: Why are you here?!\You should be used to this by now.\Wherever you go, I go with you.\Creepy!\Keep your voice down!\And don't be mean.\You're supposed to be watching me, not Hishiro.\The influence your choices have on those around you response:	is also a target of my observations.
context: You should be used to this by now.\Wherever you go, I go with you.\Creepy!\Keep your voice down!\And don't be mean.\You're supposed to be watching me, not Hishiro.\The influence your choices have on those around you\is also a target of my observations. response:	Kariu-san.
context: Wherever you go, I go with you.\Creepy!\Keep your voice down!\And don't be mean.\You're supposed to be watching me, not Hishiro.\The influence your choices have on those around you\is also a target of my observations.\Kariu-san. response:	I've been waiting for you.
context: Creepy!\Keep your voice down!\And don't be mean.\You're supposed to be watching me, not Hishiro.\The influence your choices have on those around you\is also a target of my observations.\Kariu-san.\I've been waiting for you. response:	An ambush?
context: Keep your voice down!\And don't be mean.\You're supposed to be watching me, not Hishiro.\The influence your choices have on those around you\is also a target of my observations.\Kariu-san.\I've been waiting for you.\An ambush? response:	Oh. that's right.
context: And don't be mean.\You're supposed to be watching me, not Hishiro.\The influence your choices have on those around you\is also a target of my observations.\Kariu-san.\I've been waiting for you.\An ambush?\Oh. that's right. response:	She knows I had her bag.
context: You're supposed to be watching me, not Hishiro.\The influence your choices have on those around you\is also a target of my observations.\Kariu-san.\I've been waiting for you.\An ambush?\Oh. that's right.\She knows I had her bag. response:	So this is an interrogation.
context: The influence your choices have on those around you\is also a target of my observations.\Kariu-san.\I've been waiting for you.\An ambush?\Oh. that's right.\She knows I had her bag.\So this is an interrogation. response:	Kariu-san.
context: is also a target of my observations.\Kariu-san.\I've been waiting for you.\An ambush?\Oh. that's right.\She knows I had her bag.\So this is an interrogation.\Kariu-san. response:	Do you want this silver pin that badly?
context: Kariu-san.\I've been waiting for you.\An ambush?\Oh. that's right.\She knows I had her bag.\So this is an interrogation.\Kariu-san.\Do you want this silver pin that badly? response:	Right for the jugular!
context: I've been waiting for you.\An ambush?\Oh. that's right.\She knows I had her bag.\So this is an interrogation.\Kariu-san.\Do you want this silver pin that badly?\Right for the jugular! response:	I heard you tried to run off with my bag.
context: An ambush?\Oh. that's right.\She knows I had her bag.\So this is an interrogation.\Kariu-san.\Do you want this silver pin that badly?\Right for the jugular!\I heard you tried to run off with my bag. response:	Kaizaki-san told me.
context: Oh. that's right.\She knows I had her bag.\So this is an interrogation.\Kariu-san.\Do you want this silver pin that badly?\Right for the jugular!\I heard you tried to run off with my bag.\Kaizaki-san told me. response:	That jerk!
context: She knows I had her bag.\So this is an interrogation.\Kariu-san.\Do you want this silver pin that badly?\Right for the jugular!\I heard you tried to run off with my bag.\Kaizaki-san told me.\That jerk! response:	She ratted me out for ratting Kariu out!
context: So this is an interrogation.\Kariu-san.\Do you want this silver pin that badly?\Right for the jugular!\I heard you tried to run off with my bag.\Kaizaki-san told me.\That jerk!\She ratted me out for ratting Kariu out! response:	When I asked why you would do that,
context: Kariu-san.\Do you want this silver pin that badly?\Right for the jugular!\I heard you tried to run off with my bag.\Kaizaki-san told me.\That jerk!\She ratted me out for ratting Kariu out!\When I asked why you would do that, response:	he said your motive was this silver pin.
context: Do you want this silver pin that badly?\Right for the jugular!\I heard you tried to run off with my bag.\Kaizaki-san told me.\That jerk!\She ratted me out for ratting Kariu out!\When I asked why you would do that,\he said your motive was this silver pin. response:	So I asked if we could be friends if I gave you this,
context: Right for the jugular!\I heard you tried to run off with my bag.\Kaizaki-san told me.\That jerk!\She ratted me out for ratting Kariu out!\When I asked why you would do that,\he said your motive was this silver pin.\So I asked if we could be friends if I gave you this, response:	and he said no way.
context: I heard you tried to run off with my bag.\Kaizaki-san told me.\That jerk!\She ratted me out for ratting Kariu out!\When I asked why you would do that,\he said your motive was this silver pin.\So I asked if we could be friends if I gave you this,\and he said no way. response:	Yeah, no way.
context: Kaizaki-san told me.\That jerk!\She ratted me out for ratting Kariu out!\When I asked why you would do that,\he said your motive was this silver pin.\So I asked if we could be friends if I gave you this,\and he said no way.\Yeah, no way. response:	Kariu-san.
context: That jerk!\She ratted me out for ratting Kariu out!\When I asked why you would do that,\he said your motive was this silver pin.\So I asked if we could be friends if I gave you this,\and he said no way.\Yeah, no way.\Kariu-san. response:	Do you hate me?
context: She ratted me out for ratting Kariu out!\When I asked why you would do that,\he said your motive was this silver pin.\So I asked if we could be friends if I gave you this,\and he said no way.\Yeah, no way.\Kariu-san.\Do you hate me? response:	Not really...
context: When I asked why you would do that,\he said your motive was this silver pin.\So I asked if we could be friends if I gave you this,\and he said no way.\Yeah, no way.\Kariu-san.\Do you hate me?\Not really... response:	Then why did you take my bag?
context: he said your motive was this silver pin.\So I asked if we could be friends if I gave you this,\and he said no way.\Yeah, no way.\Kariu-san.\Do you hate me?\Not really...\Then why did you take my bag? response:	Why would you do that to someone you don't hate?
context: So I asked if we could be friends if I gave you this,\and he said no way.\Yeah, no way.\Kariu-san.\Do you hate me?\Not really...\Then why did you take my bag?\Why would you do that to someone you don't hate? response:	She straight up asked.
context: and he said no way.\Yeah, no way.\Kariu-san.\Do you hate me?\Not really...\Then why did you take my bag?\Why would you do that to someone you don't hate?\She straight up asked. response:	I dunno how she can keep asking this stuff.
context: Yeah, no way.\Kariu-san.\Do you hate me?\Not really...\Then why did you take my bag?\Why would you do that to someone you don't hate?\She straight up asked.\I dunno how she can keep asking this stuff. response:	Doesn't it hurt her?
context: Kariu-san.\Do you hate me?\Not really...\Then why did you take my bag?\Why would you do that to someone you don't hate?\She straight up asked.\I dunno how she can keep asking this stuff.\Doesn't it hurt her? response:	Well, it is Hishiro-san.
context: Do you hate me?\Not really...\Then why did you take my bag?\Why would you do that to someone you don't hate?\She straight up asked.\I dunno how she can keep asking this stuff.\Doesn't it hurt her?\Well, it is Hishiro-san. response:	No, I...
context: Not really...\Then why did you take my bag?\Why would you do that to someone you don't hate?\She straight up asked.\I dunno how she can keep asking this stuff.\Doesn't it hurt her?\Well, it is Hishiro-san.\No, I... response:	Don't run.
context: Then why did you take my bag?\Why would you do that to someone you don't hate?\She straight up asked.\I dunno how she can keep asking this stuff.\Doesn't it hurt her?\Well, it is Hishiro-san.\No, I...\Don't run. response:	Answer, Kariu.
context: Why would you do that to someone you don't hate?\She straight up asked.\I dunno how she can keep asking this stuff.\Doesn't it hurt her?\Well, it is Hishiro-san.\No, I...\Don't run.\Answer, Kariu. response:	I'm not...
context: She straight up asked.\I dunno how she can keep asking this stuff.\Doesn't it hurt her?\Well, it is Hishiro-san.\No, I...\Don't run.\Answer, Kariu.\I'm not... response:	I hate you.
context: I dunno how she can keep asking this stuff.\Doesn't it hurt her?\Well, it is Hishiro-san.\No, I...\Don't run.\Answer, Kariu.\I'm not...\I hate you. response:	No matter how hard I try, I can't win.
context: Doesn't it hurt her?\Well, it is Hishiro-san.\No, I...\Don't run.\Answer, Kariu.\I'm not...\I hate you.\No matter how hard I try, I can't win. response:	You took what I wanted.
context: Well, it is Hishiro-san.\No, I...\Don't run.\Answer, Kariu.\I'm not...\I hate you.\No matter how hard I try, I can't win.\You took what I wanted. response:	You stood where I wanted to.
context: No, I...\Don't run.\Answer, Kariu.\I'm not...\I hate you.\No matter how hard I try, I can't win.\You took what I wanted.\You stood where I wanted to. response:	And ever since you won, you've always,
context: Don't run.\Answer, Kariu.\I'm not...\I hate you.\No matter how hard I try, I can't win.\You took what I wanted.\You stood where I wanted to.\And ever since you won, you've always, response:	always flashed that mocking smile, so of course I hate you!
context: Answer, Kariu.\I'm not...\I hate you.\No matter how hard I try, I can't win.\You took what I wanted.\You stood where I wanted to.\And ever since you won, you've always,\always flashed that mocking smile, so of course I hate you! response:	I've never mocked you.
context: I'm not...\I hate you.\No matter how hard I try, I can't win.\You took what I wanted.\You stood where I wanted to.\And ever since you won, you've always,\always flashed that mocking smile, so of course I hate you!\I've never mocked you. response:	You do! Every time our eyes meet!
context: I hate you.\No matter how hard I try, I can't win.\You took what I wanted.\You stood where I wanted to.\And ever since you won, you've always,\always flashed that mocking smile, so of course I hate you!\I've never mocked you.\You do! Every time our eyes meet! response:	I don't.
context: No matter how hard I try, I can't win.\You took what I wanted.\You stood where I wanted to.\And ever since you won, you've always,\always flashed that mocking smile, so of course I hate you!\I've never mocked you.\You do! Every time our eyes meet!\I don't. response:	You do!
context: You took what I wanted.\You stood where I wanted to.\And ever since you won, you've always,\always flashed that mocking smile, so of course I hate you!\I've never mocked you.\You do! Every time our eyes meet!\I don't.\You do! response:	Why would I ever do that?
context: You stood where I wanted to.\And ever since you won, you've always,\always flashed that mocking smile, so of course I hate you!\I've never mocked you.\You do! Every time our eyes meet!\I don't.\You do!\Why would I ever do that? response:	Don't ask me!
context: And ever since you won, you've always,\always flashed that mocking smile, so of course I hate you!\I've never mocked you.\You do! Every time our eyes meet!\I don't.\You do!\Why would I ever do that?\Don't ask me! response:	How can you deny it?!
context: always flashed that mocking smile, so of course I hate you!\I've never mocked you.\You do! Every time our eyes meet!\I don't.\You do!\Why would I ever do that?\Don't ask me!\How can you deny it?! response:	That constant stream of sneers...
context: I've never mocked you.\You do! Every time our eyes meet!\I don't.\You do!\Why would I ever do that?\Don't ask me!\How can you deny it?!\That constant stream of sneers... response:	Every time our eyes meet, every time we speak!
context: You do! Every time our eyes meet!\I don't.\You do!\Why would I ever do that?\Don't ask me!\How can you deny it?!\That constant stream of sneers...\Every time our eyes meet, every time we speak! response:	Next time you get a chance, ask her to smile for you.
context: I don't.\You do!\Why would I ever do that?\Don't ask me!\How can you deny it?!\That constant stream of sneers...\Every time our eyes meet, every time we speak!\Next time you get a chance, ask her to smile for you. response:	Wait...
context: You do!\Why would I ever do that?\Don't ask me!\How can you deny it?!\That constant stream of sneers...\Every time our eyes meet, every time we speak!\Next time you get a chance, ask her to smile for you.\Wait... response:	Hishiro...
context: Why would I ever do that?\Don't ask me!\How can you deny it?!\That constant stream of sneers...\Every time our eyes meet, every time we speak!\Next time you get a chance, ask her to smile for you.\Wait...\Hishiro... response:	Smile for me.
context: Don't ask me!\How can you deny it?!\That constant stream of sneers...\Every time our eyes meet, every time we speak!\Next time you get a chance, ask her to smile for you.\Wait...\Hishiro...\Smile for me. response:	Where did that come from?
context: How can you deny it?!\That constant stream of sneers...\Every time our eyes meet, every time we speak!\Next time you get a chance, ask her to smile for you.\Wait...\Hishiro...\Smile for me.\Where did that come from? response:	Hold on. I'm trying to think of a reason I'd mock
context: That constant stream of sneers...\Every time our eyes meet, every time we speak!\Next time you get a chance, ask her to smile for you.\Wait...\Hishiro...\Smile for me.\Where did that come from?\Hold on. I'm trying to think of a reason I'd mock response:	Just do it!
context: Every time our eyes meet, every time we speak!\Next time you get a chance, ask her to smile for you.\Wait...\Hishiro...\Smile for me.\Where did that come from?\Hold on. I'm trying to think of a reason I'd mock\Just do it! response:	A normal smile, like you'd do if your eyes met someone's!
context: Next time you get a chance, ask her to smile for you.\Wait...\Hishiro...\Smile for me.\Where did that come from?\Hold on. I'm trying to think of a reason I'd mock\Just do it!\A normal smile, like you'd do if your eyes met someone's! response:	Like this?
context: Wait...\Hishiro...\Smile for me.\Where did that come from?\Hold on. I'm trying to think of a reason I'd mock\Just do it!\A normal smile, like you'd do if your eyes met someone's!\Like this? response:	You just freaked out.
context: Hishiro...\Smile for me.\Where did that come from?\Hold on. I'm trying to think of a reason I'd mock\Just do it!\A normal smile, like you'd do if your eyes met someone's!\Like this?\You just freaked out. response:	Huh?
context: Smile for me.\Where did that come from?\Hold on. I'm trying to think of a reason I'd mock\Just do it!\A normal smile, like you'd do if your eyes met someone's!\Like this?\You just freaked out.\Huh? response:	Er... wait... let me get this straight.
context: Where did that come from?\Hold on. I'm trying to think of a reason I'd mock\Just do it!\A normal smile, like you'd do if your eyes met someone's!\Like this?\You just freaked out.\Huh?\Er... wait... let me get this straight. response:	Huh? Huh?
context: Hold on. I'm trying to think of a reason I'd mock\Just do it!\A normal smile, like you'd do if your eyes met someone's!\Like this?\You just freaked out.\Huh?\Er... wait... let me get this straight.\Huh? Huh? response:	Hishiro thinks that's a smile?!
context: Just do it!\A normal smile, like you'd do if your eyes met someone's!\Like this?\You just freaked out.\Huh?\Er... wait... let me get this straight.\Huh? Huh?\Hishiro thinks that's a smile?! response:	She was trying for a friendly smile.
context: A normal smile, like you'd do if your eyes met someone's!\Like this?\You just freaked out.\Huh?\Er... wait... let me get this straight.\Huh? Huh?\Hishiro thinks that's a smile?!\She was trying for a friendly smile. response:	I thought Kaizaki was lying.
context: Like this?\You just freaked out.\Huh?\Er... wait... let me get this straight.\Huh? Huh?\Hishiro thinks that's a smile?!\She was trying for a friendly smile.\I thought Kaizaki was lying. response:	Smile again.
context: You just freaked out.\Huh?\Er... wait... let me get this straight.\Huh? Huh?\Hishiro thinks that's a smile?!\She was trying for a friendly smile.\I thought Kaizaki was lying.\Smile again. response:	Stop.
context: Huh?\Er... wait... let me get this straight.\Huh? Huh?\Hishiro thinks that's a smile?!\She was trying for a friendly smile.\I thought Kaizaki was lying.\Smile again.\Stop. response:	Again.
context: Er... wait... let me get this straight.\Huh? Huh?\Hishiro thinks that's a smile?!\She was trying for a friendly smile.\I thought Kaizaki was lying.\Smile again.\Stop.\Again. response:	Oh my god, you suck!
context: Huh? Huh?\Hishiro thinks that's a smile?!\She was trying for a friendly smile.\I thought Kaizaki was lying.\Smile again.\Stop.\Again.\Oh my god, you suck! response:	How is that a smile?!
context: Hishiro thinks that's a smile?!\She was trying for a friendly smile.\I thought Kaizaki was lying.\Smile again.\Stop.\Again.\Oh my god, you suck!\How is that a smile?! response:	Have you even looked in a mirror?!
context: She was trying for a friendly smile.\I thought Kaizaki was lying.\Smile again.\Stop.\Again.\Oh my god, you suck!\How is that a smile?!\Have you even looked in a mirror?! response:	Do you have any idea how it makes people feel?!
context: I thought Kaizaki was lying.\Smile again.\Stop.\Again.\Oh my god, you suck!\How is that a smile?!\Have you even looked in a mirror?!\Do you have any idea how it makes people feel?! response:	I thought you were mocking me this whole time!
context: Smile again.\Stop.\Again.\Oh my god, you suck!\How is that a smile?!\Have you even looked in a mirror?!\Do you have any idea how it makes people feel?!\I thought you were mocking me this whole time! response:	I have been smiling in the hope that we could be friends.
context: Stop.\Again.\Oh my god, you suck!\How is that a smile?!\Have you even looked in a mirror?!\Do you have any idea how it makes people feel?!\I thought you were mocking me this whole time!\I have been smiling in the hope that we could be friends. response:	Wow, this girl...
context: Again.\Oh my god, you suck!\How is that a smile?!\Have you even looked in a mirror?!\Do you have any idea how it makes people feel?!\I thought you were mocking me this whole time!\I have been smiling in the hope that we could be friends.\Wow, this girl... response:	How awkward can you be?
context: Oh my god, you suck!\How is that a smile?!\Have you even looked in a mirror?!\Do you have any idea how it makes people feel?!\I thought you were mocking me this whole time!\I have been smiling in the hope that we could be friends.\Wow, this girl...\How awkward can you be? response:	My strong point is I'm smart.
context: How is that a smile?!\Have you even looked in a mirror?!\Do you have any idea how it makes people feel?!\I thought you were mocking me this whole time!\I have been smiling in the hope that we could be friends.\Wow, this girl...\How awkward can you be?\My strong point is I'm smart. response:	If I don't understand something,
context: Have you even looked in a mirror?!\Do you have any idea how it makes people feel?!\I thought you were mocking me this whole time!\I have been smiling in the hope that we could be friends.\Wow, this girl...\How awkward can you be?\My strong point is I'm smart.\If I don't understand something, response:	I look into it on my own, and if I still don't get it, I ask until I do.
context: Do you have any idea how it makes people feel?!\I thought you were mocking me this whole time!\I have been smiling in the hope that we could be friends.\Wow, this girl...\How awkward can you be?\My strong point is I'm smart.\If I don't understand something,\I look into it on my own, and if I still don't get it, I ask until I do. response:	My weak point is that I'm not interested in other people.
context: I thought you were mocking me this whole time!\I have been smiling in the hope that we could be friends.\Wow, this girl...\How awkward can you be?\My strong point is I'm smart.\If I don't understand something,\I look into it on my own, and if I still don't get it, I ask until I do.\My weak point is that I'm not interested in other people. response:	She said it!
context: I have been smiling in the hope that we could be friends.\Wow, this girl...\How awkward can you be?\My strong point is I'm smart.\If I don't understand something,\I look into it on my own, and if I still don't get it, I ask until I do.\My weak point is that I'm not interested in other people.\She said it! response:	Because of that, I don't know how to interact with anyone,
context: Wow, this girl...\How awkward can you be?\My strong point is I'm smart.\If I don't understand something,\I look into it on my own, and if I still don't get it, I ask until I do.\My weak point is that I'm not interested in other people.\She said it!\Because of that, I don't know how to interact with anyone, response:	and I must have caused lots of problems for people.
context: How awkward can you be?\My strong point is I'm smart.\If I don't understand something,\I look into it on my own, and if I still don't get it, I ask until I do.\My weak point is that I'm not interested in other people.\She said it!\Because of that, I don't know how to interact with anyone,\and I must have caused lots of problems for people. response:	But right now, I'm trying to change myself.
context: My strong point is I'm smart.\If I don't understand something,\I look into it on my own, and if I still don't get it, I ask until I do.\My weak point is that I'm not interested in other people.\She said it!\Because of that, I don't know how to interact with anyone,\and I must have caused lots of problems for people.\But right now, I'm trying to change myself. response:	Kariu-san, that's who I am.
context: If I don't understand something,\I look into it on my own, and if I still don't get it, I ask until I do.\My weak point is that I'm not interested in other people.\She said it!\Because of that, I don't know how to interact with anyone,\and I must have caused lots of problems for people.\But right now, I'm trying to change myself.\Kariu-san, that's who I am. response:	But would you be my friend?
context: I look into it on my own, and if I still don't get it, I ask until I do.\My weak point is that I'm not interested in other people.\She said it!\Because of that, I don't know how to interact with anyone,\and I must have caused lots of problems for people.\But right now, I'm trying to change myself.\Kariu-san, that's who I am.\But would you be my friend? response:	It's my pleasure, Hishiro Chizuru-san.
context: My weak point is that I'm not interested in other people.\She said it!\Because of that, I don't know how to interact with anyone,\and I must have caused lots of problems for people.\But right now, I'm trying to change myself.\Kariu-san, that's who I am.\But would you be my friend?\It's my pleasure, Hishiro Chizuru-san. response:	That day,
context: She said it!\Because of that, I don't know how to interact with anyone,\and I must have caused lots of problems for people.\But right now, I'm trying to change myself.\Kariu-san, that's who I am.\But would you be my friend?\It's my pleasure, Hishiro Chizuru-san.\That day, response:	she wasn't intentionally ignoring the handshake.
context: Because of that, I don't know how to interact with anyone,\and I must have caused lots of problems for people.\But right now, I'm trying to change myself.\Kariu-san, that's who I am.\But would you be my friend?\It's my pleasure, Hishiro Chizuru-san.\That day,\she wasn't intentionally ignoring the handshake. response:	Okay, Hishiro Chizuru-san.
context: and I must have caused lots of problems for people.\But right now, I'm trying to change myself.\Kariu-san, that's who I am.\But would you be my friend?\It's my pleasure, Hishiro Chizuru-san.\That day,\she wasn't intentionally ignoring the handshake.\Okay, Hishiro Chizuru-san. response:	But in return, recognize me as your rival!
context: But right now, I'm trying to change myself.\Kariu-san, that's who I am.\But would you be my friend?\It's my pleasure, Hishiro Chizuru-san.\That day,\she wasn't intentionally ignoring the handshake.\Okay, Hishiro Chizuru-san.\But in return, recognize me as your rival! response:	I won't lose next time!
context: Kariu-san, that's who I am.\But would you be my friend?\It's my pleasure, Hishiro Chizuru-san.\That day,\she wasn't intentionally ignoring the handshake.\Okay, Hishiro Chizuru-san.\But in return, recognize me as your rival!\I won't lose next time! response:	I'll definitely take that silver pin from you!
context: But would you be my friend?\It's my pleasure, Hishiro Chizuru-san.\That day,\she wasn't intentionally ignoring the handshake.\Okay, Hishiro Chizuru-san.\But in return, recognize me as your rival!\I won't lose next time!\I'll definitely take that silver pin from you! response:	If you want it, you can have it next test...
context: It's my pleasure, Hishiro Chizuru-san.\That day,\she wasn't intentionally ignoring the handshake.\Okay, Hishiro Chizuru-san.\But in return, recognize me as your rival!\I won't lose next time!\I'll definitely take that silver pin from you!\If you want it, you can have it next test... response:	Don't you dare! I want it, but not like that!
context: That day,\she wasn't intentionally ignoring the handshake.\Okay, Hishiro Chizuru-san.\But in return, recognize me as your rival!\I won't lose next time!\I'll definitely take that silver pin from you!\If you want it, you can have it next test...\Don't you dare! I want it, but not like that! response:	If you hold back, we're not friends!
context: she wasn't intentionally ignoring the handshake.\Okay, Hishiro Chizuru-san.\But in return, recognize me as your rival!\I won't lose next time!\I'll definitely take that silver pin from you!\If you want it, you can have it next test...\Don't you dare! I want it, but not like that!\If you hold back, we're not friends! response:	Not Friends
context: Okay, Hishiro Chizuru-san.\But in return, recognize me as your rival!\I won't lose next time!\I'll definitely take that silver pin from you!\If you want it, you can have it next test...\Don't you dare! I want it, but not like that!\If you hold back, we're not friends!\Not Friends response:	And...
context: But in return, recognize me as your rival!\I won't lose next time!\I'll definitely take that silver pin from you!\If you want it, you can have it next test...\Don't you dare! I want it, but not like that!\If you hold back, we're not friends!\Not Friends\And... response:	I'm really sorry about all this.
context: I won't lose next time!\I'll definitely take that silver pin from you!\If you want it, you can have it next test...\Don't you dare! I want it, but not like that!\If you hold back, we're not friends!\Not Friends\And...\I'm really sorry about all this. response:	I won't do it again.
context: I'll definitely take that silver pin from you!\If you want it, you can have it next test...\Don't you dare! I want it, but not like that!\If you hold back, we're not friends!\Not Friends\And...\I'm really sorry about all this.\I won't do it again. response:	Sorry.
context: If you want it, you can have it next test...\Don't you dare! I want it, but not like that!\If you hold back, we're not friends!\Not Friends\And...\I'm really sorry about all this.\I won't do it again.\Sorry. response:	I forgive you.
context: Don't you dare! I want it, but not like that!\If you hold back, we're not friends!\Not Friends\And...\I'm really sorry about all this.\I won't do it again.\Sorry.\I forgive you. response:	After all, we're friends.
context: If you hold back, we're not friends!\Not Friends\And...\I'm really sorry about all this.\I won't do it again.\Sorry.\I forgive you.\After all, we're friends. response:	Whoa, so you can actually smile.
context: Not Friends\And...\I'm really sorry about all this.\I won't do it again.\Sorry.\I forgive you.\After all, we're friends.\Whoa, so you can actually smile. response:	But I smile all the time.
context: And...\I'm really sorry about all this.\I won't do it again.\Sorry.\I forgive you.\After all, we're friends.\Whoa, so you can actually smile.\But I smile all the time. response:	Yeah, right!
context: I'm really sorry about all this.\I won't do it again.\Sorry.\I forgive you.\After all, we're friends.\Whoa, so you can actually smile.\But I smile all the time.\Yeah, right! response:	You told Hishiro about me.
context: I won't do it again.\Sorry.\I forgive you.\After all, we're friends.\Whoa, so you can actually smile.\But I smile all the time.\Yeah, right!\You told Hishiro about me. response:	But thanks.
context: Sorry.\I forgive you.\After all, we're friends.\Whoa, so you can actually smile.\But I smile all the time.\Yeah, right!\You told Hishiro about me.\But thanks. response:	What'd you take a picture for?
context: I forgive you.\After all, we're friends.\Whoa, so you can actually smile.\But I smile all the time.\Yeah, right!\You told Hishiro about me.\But thanks.\What'd you take a picture for? response:	A test subject grinning because a high school girl LIMEd him.
context: After all, we're friends.\Whoa, so you can actually smile.\But I smile all the time.\Yeah, right!\You told Hishiro about me.\But thanks.\What'd you take a picture for?\A test subject grinning because a high school girl LIMEd him. response:	For my report.
context: Whoa, so you can actually smile.\But I smile all the time.\Yeah, right!\You told Hishiro about me.\But thanks.\What'd you take a picture for?\A test subject grinning because a high school girl LIMEd him.\For my report. response:	Delete it!
context: But I smile all the time.\Yeah, right!\You told Hishiro about me.\But thanks.\What'd you take a picture for?\A test subject grinning because a high school girl LIMEd him.\For my report.\Delete it! response:	Why are we drinking at my place, anyway?
context: Yeah, right!\You told Hishiro about me.\But thanks.\What'd you take a picture for?\A test subject grinning because a high school girl LIMEd him.\For my report.\Delete it!\Why are we drinking at my place, anyway? response:	What is all this?!
context: You told Hishiro about me.\But thanks.\What'd you take a picture for?\A test subject grinning because a high school girl LIMEd him.\For my report.\Delete it!\Why are we drinking at my place, anyway?\What is all this?! response:	What's the big deal?
context: But thanks.\What'd you take a picture for?\A test subject grinning because a high school girl LIMEd him.\For my report.\Delete it!\Why are we drinking at my place, anyway?\What is all this?!\What's the big deal? response:	You helped them become friends. Let's celebrate!
context: What'd you take a picture for?\A test subject grinning because a high school girl LIMEd him.\For my report.\Delete it!\Why are we drinking at my place, anyway?\What is all this?!\What's the big deal?\You helped them become friends. Let's celebrate! response:	We've got school tomorrow.
context: A test subject grinning because a high school girl LIMEd him.\For my report.\Delete it!\Why are we drinking at my place, anyway?\What is all this?!\What's the big deal?\You helped them become friends. Let's celebrate!\We've got school tomorrow. response:	For an ex-NEET, you sure are serious.
context: For my report.\Delete it!\Why are we drinking at my place, anyway?\What is all this?!\What's the big deal?\You helped them become friends. Let's celebrate!\We've got school tomorrow.\For an ex-NEET, you sure are serious. response:	Not NEET! I was a part-timer!
context: Delete it!\Why are we drinking at my place, anyway?\What is all this?!\What's the big deal?\You helped them become friends. Let's celebrate!\We've got school tomorrow.\For an ex-NEET, you sure are serious.\Not NEET! I was a part-timer! response:	Yoake-san...
context: Why are we drinking at my place, anyway?\What is all this?!\What's the big deal?\You helped them become friends. Let's celebrate!\We've got school tomorrow.\For an ex-NEET, you sure are serious.\Not NEET! I was a part-timer!\Yoake-san... response:	Was what I told Kariu really the right thing to say?
context: What is all this?!\What's the big deal?\You helped them become friends. Let's celebrate!\We've got school tomorrow.\For an ex-NEET, you sure are serious.\Not NEET! I was a part-timer!\Yoake-san...\Was what I told Kariu really the right thing to say? response:	Resignation
context: What's the big deal?\You helped them become friends. Let's celebrate!\We've got school tomorrow.\For an ex-NEET, you sure are serious.\Not NEET! I was a part-timer!\Yoake-san...\Was what I told Kariu really the right thing to say?\Resignation response:	In reality, I couldn't grow up, and became a NEET.
context: You helped them become friends. Let's celebrate!\We've got school tomorrow.\For an ex-NEET, you sure are serious.\Not NEET! I was a part-timer!\Yoake-san...\Was what I told Kariu really the right thing to say?\Resignation\In reality, I couldn't grow up, and became a NEET. response:	And those awful bullies probably still have their jobs.
context: We've got school tomorrow.\For an ex-NEET, you sure are serious.\Not NEET! I was a part-timer!\Yoake-san...\Was what I told Kariu really the right thing to say?\Resignation\In reality, I couldn't grow up, and became a NEET.\And those awful bullies probably still have their jobs. response:	I know the real truth is uglier.
context: For an ex-NEET, you sure are serious.\Not NEET! I was a part-timer!\Yoake-san...\Was what I told Kariu really the right thing to say?\Resignation\In reality, I couldn't grow up, and became a NEET.\And those awful bullies probably still have their jobs.\I know the real truth is uglier. response:	Maybe it wasn't the ugly truth.
context: Not NEET! I was a part-timer!\Yoake-san...\Was what I told Kariu really the right thing to say?\Resignation\In reality, I couldn't grow up, and became a NEET.\And those awful bullies probably still have their jobs.\I know the real truth is uglier.\Maybe it wasn't the ugly truth. response:	But it wasn't a lie.
context: Yoake-san...\Was what I told Kariu really the right thing to say?\Resignation\In reality, I couldn't grow up, and became a NEET.\And those awful bullies probably still have their jobs.\I know the real truth is uglier.\Maybe it wasn't the ugly truth.\But it wasn't a lie. response:	It's what you really meant, so isn't that enough?
context: Was what I told Kariu really the right thing to say?\Resignation\In reality, I couldn't grow up, and became a NEET.\And those awful bullies probably still have their jobs.\I know the real truth is uglier.\Maybe it wasn't the ugly truth.\But it wasn't a lie.\It's what you really meant, so isn't that enough? response:	When she's out in the real world and stumbles,
context: Resignation\In reality, I couldn't grow up, and became a NEET.\And those awful bullies probably still have their jobs.\I know the real truth is uglier.\Maybe it wasn't the ugly truth.\But it wasn't a lie.\It's what you really meant, so isn't that enough?\When she's out in the real world and stumbles, response:	she'll remember someone yelling at her, if not who.
context: In reality, I couldn't grow up, and became a NEET.\And those awful bullies probably still have their jobs.\I know the real truth is uglier.\Maybe it wasn't the ugly truth.\But it wasn't a lie.\It's what you really meant, so isn't that enough?\When she's out in the real world and stumbles,\she'll remember someone yelling at her, if not who. response:	I think what happened today will stay with her.
context: And those awful bullies probably still have their jobs.\I know the real truth is uglier.\Maybe it wasn't the ugly truth.\But it wasn't a lie.\It's what you really meant, so isn't that enough?\When she's out in the real world and stumbles,\she'll remember someone yelling at her, if not who.\I think what happened today will stay with her. response:	Oh.
context: I know the real truth is uglier.\Maybe it wasn't the ugly truth.\But it wasn't a lie.\It's what you really meant, so isn't that enough?\When she's out in the real world and stumbles,\she'll remember someone yelling at her, if not who.\I think what happened today will stay with her.\Oh. response:	Though, really, it was the pot calling the kettle black!
context: Maybe it wasn't the ugly truth.\But it wasn't a lie.\It's what you really meant, so isn't that enough?\When she's out in the real world and stumbles,\she'll remember someone yelling at her, if not who.\I think what happened today will stay with her.\Oh.\Though, really, it was the pot calling the kettle black! response:	Yelling at her for comparing herself to others!
context: But it wasn't a lie.\It's what you really meant, so isn't that enough?\When she's out in the real world and stumbles,\she'll remember someone yelling at her, if not who.\I think what happened today will stay with her.\Oh.\Though, really, it was the pot calling the kettle black!\Yelling at her for comparing herself to others! response:	Says the man so worried about appearances, he pretended he still had a job!
context: It's what you really meant, so isn't that enough?\When she's out in the real world and stumbles,\she'll remember someone yelling at her, if not who.\I think what happened today will stay with her.\Oh.\Though, really, it was the pot calling the kettle black!\Yelling at her for comparing herself to others!\Says the man so worried about appearances, he pretended he still had a job! response:	Shut up! I thought the same thing!
context: When she's out in the real world and stumbles,\she'll remember someone yelling at her, if not who.\I think what happened today will stay with her.\Oh.\Though, really, it was the pot calling the kettle black!\Yelling at her for comparing herself to others!\Says the man so worried about appearances, he pretended he still had a job!\Shut up! I thought the same thing! response:	So? Are you liking ReLIFE?
context: she'll remember someone yelling at her, if not who.\I think what happened today will stay with her.\Oh.\Though, really, it was the pot calling the kettle black!\Yelling at her for comparing herself to others!\Says the man so worried about appearances, he pretended he still had a job!\Shut up! I thought the same thing!\So? Are you liking ReLIFE? response:	Is it letting you take a long, hard look at yourself?
context: I think what happened today will stay with her.\Oh.\Though, really, it was the pot calling the kettle black!\Yelling at her for comparing herself to others!\Says the man so worried about appearances, he pretended he still had a job!\Shut up! I thought the same thing!\So? Are you liking ReLIFE?\Is it letting you take a long, hard look at yourself? response:	The way you see through everything is seriously driving me nuts!
context: Oh.\Though, really, it was the pot calling the kettle black!\Yelling at her for comparing herself to others!\Says the man so worried about appearances, he pretended he still had a job!\Shut up! I thought the same thing!\So? Are you liking ReLIFE?\Is it letting you take a long, hard look at yourself?\The way you see through everything is seriously driving me nuts! response:	Rena, see any empty seats?
context: Though, really, it was the pot calling the kettle black!\Yelling at her for comparing herself to others!\Says the man so worried about appearances, he pretended he still had a job!\Shut up! I thought the same thing!\So? Are you liking ReLIFE?\Is it letting you take a long, hard look at yourself?\The way you see through everything is seriously driving me nuts!\Rena, see any empty seats? response:	Say, Honoka...
context: Yelling at her for comparing herself to others!\Says the man so worried about appearances, he pretended he still had a job!\Shut up! I thought the same thing!\So? Are you liking ReLIFE?\Is it letting you take a long, hard look at yourself?\The way you see through everything is seriously driving me nuts!\Rena, see any empty seats?\Say, Honoka... response:	Thanks for the food.
context: Says the man so worried about appearances, he pretended he still had a job!\Shut up! I thought the same thing!\So? Are you liking ReLIFE?\Is it letting you take a long, hard look at yourself?\The way you see through everything is seriously driving me nuts!\Rena, see any empty seats?\Say, Honoka...\Thanks for the food. response:	I-I don't mind eating lunch with you.
context: Shut up! I thought the same thing!\So? Are you liking ReLIFE?\Is it letting you take a long, hard look at yourself?\The way you see through everything is seriously driving me nuts!\Rena, see any empty seats?\Say, Honoka...\Thanks for the food.\I-I don't mind eating lunch with you. response:	I'm fine like this.
context: So? Are you liking ReLIFE?\Is it letting you take a long, hard look at yourself?\The way you see through everything is seriously driving me nuts!\Rena, see any empty seats?\Say, Honoka...\Thanks for the food.\I-I don't mind eating lunch with you.\I'm fine like this. response:	I like being alone.
context: Is it letting you take a long, hard look at yourself?\The way you see through everything is seriously driving me nuts!\Rena, see any empty seats?\Say, Honoka...\Thanks for the food.\I-I don't mind eating lunch with you.\I'm fine like this.\I like being alone. response:	Isn't that the problem?!
context: The way you see through everything is seriously driving me nuts!\Rena, see any empty seats?\Say, Honoka...\Thanks for the food.\I-I don't mind eating lunch with you.\I'm fine like this.\I like being alone.\Isn't that the problem?! response:	Don't you want to change?!
context: Rena, see any empty seats?\Say, Honoka...\Thanks for the food.\I-I don't mind eating lunch with you.\I'm fine like this.\I like being alone.\Isn't that the problem?!\Don't you want to change?! response:	That's right.
context: Say, Honoka...\Thanks for the food.\I-I don't mind eating lunch with you.\I'm fine like this.\I like being alone.\Isn't that the problem?!\Don't you want to change?!\That's right. response:	Then, please.
context: Thanks for the food.\I-I don't mind eating lunch with you.\I'm fine like this.\I like being alone.\Isn't that the problem?!\Don't you want to change?!\That's right.\Then, please. response:	Thank you.
context: I-I don't mind eating lunch with you.\I'm fine like this.\I like being alone.\Isn't that the problem?!\Don't you want to change?!\That's right.\Then, please.\Thank you. response:	D-Don't thank me!
context: I'm fine like this.\I like being alone.\Isn't that the problem?!\Don't you want to change?!\That's right.\Then, please.\Thank you.\D-Don't thank me! response:	We're friends!
context: I like being alone.\Isn't that the problem?!\Don't you want to change?!\That's right.\Then, please.\Thank you.\D-Don't thank me!\We're friends! response:	This is normal!
context: Isn't that the problem?!\Don't you want to change?!\That's right.\Then, please.\Thank you.\D-Don't thank me!\We're friends!\This is normal! response:	NEXT EPISODE
context: Don't you want to change?!\That's right.\Then, please.\Thank you.\D-Don't thank me!\We're friends!\This is normal!\NEXT EPISODE response:	Hishiro, you need to first practice how to smile.
context: That's right.\Then, please.\Thank you.\D-Don't thank me!\We're friends!\This is normal!\NEXT EPISODE\Hishiro, you need to first practice how to smile. response:	Grin.
context: Then, please.\Thank you.\D-Don't thank me!\We're friends!\This is normal!\NEXT EPISODE\Hishiro, you need to first practice how to smile.\Grin. response:	Not like that.
context: Thank you.\D-Don't thank me!\We're friends!\This is normal!\NEXT EPISODE\Hishiro, you need to first practice how to smile.\Grin.\Not like that. response:	But I thought I was doing it right.
context: D-Don't thank me!\We're friends!\This is normal!\NEXT EPISODE\Hishiro, you need to first practice how to smile.\Grin.\Not like that.\But I thought I was doing it right. response:	Show me how it's done, Kariu-san.
context: We're friends!\This is normal!\NEXT EPISODE\Hishiro, you need to first practice how to smile.\Grin.\Not like that.\But I thought I was doing it right.\Show me how it's done, Kariu-san. response:	Huh? Oh, all right.
context: This is normal!\NEXT EPISODE\Hishiro, you need to first practice how to smile.\Grin.\Not like that.\But I thought I was doing it right.\Show me how it's done, Kariu-san.\Huh? Oh, all right. response:	This Isn't the First Time
context: NEXT EPISODE\Hishiro, you need to first practice how to smile.\Grin.\Not like that.\But I thought I was doing it right.\Show me how it's done, Kariu-san.\Huh? Oh, all right.\This Isn't the First Time response:	H-Heh.
context: Hishiro, you need to first practice how to smile.\Grin.\Not like that.\But I thought I was doing it right.\Show me how it's done, Kariu-san.\Huh? Oh, all right.\This Isn't the First Time\H-Heh. response:	How stiff.
context: Grin.\Not like that.\But I thought I was doing it right.\Show me how it's done, Kariu-san.\Huh? Oh, all right.\This Isn't the First Time\H-Heh.\How stiff. response:	I don't wanna hear that from you!