context: Biology Prep Room response:	Sensei, um...
context: Biology Prep Room\Sensei, um... response:	Thank you for your help the other day.
context: Biology Prep Room\Sensei, um...\Thank you for your help the other day. response:	O-Oh, no problem.
context: Biology Prep Room\Sensei, um...\Thank you for your help the other day.\O-Oh, no problem. response:	Is your cold better now?
context: Biology Prep Room\Sensei, um...\Thank you for your help the other day.\O-Oh, no problem.\Is your cold better now? response:	Yes, thank you. I'm all better.
context: Biology Prep Room\Sensei, um...\Thank you for your help the other day.\O-Oh, no problem.\Is your cold better now?\Yes, thank you. I'm all better. response:	Oh, good.
context: Biology Prep Room\Sensei, um...\Thank you for your help the other day.\O-Oh, no problem.\Is your cold better now?\Yes, thank you. I'm all better.\Oh, good. response:	Sensei?
context: Biology Prep Room\Sensei, um...\Thank you for your help the other day.\O-Oh, no problem.\Is your cold better now?\Yes, thank you. I'm all better.\Oh, good.\Sensei? response:	Er, sorry. I was just...
context: Sensei, um...\Thank you for your help the other day.\O-Oh, no problem.\Is your cold better now?\Yes, thank you. I'm all better.\Oh, good.\Sensei?\Er, sorry. I was just... response:	thinking about what an odd sight this is.
context: Thank you for your help the other day.\O-Oh, no problem.\Is your cold better now?\Yes, thank you. I'm all better.\Oh, good.\Sensei?\Er, sorry. I was just...\thinking about what an odd sight this is. response:	Interviews with Monster Girls
context: O-Oh, no problem.\Is your cold better now?\Yes, thank you. I'm all better.\Oh, good.\Sensei?\Er, sorry. I was just...\thinking about what an odd sight this is.\Interviews with Monster Girls response:	Machi Kyouko.
context: Is your cold better now?\Yes, thank you. I'm all better.\Oh, good.\Sensei?\Er, sorry. I was just...\thinking about what an odd sight this is.\Interviews with Monster Girls\Machi Kyouko. response:	She's a dullahan,
context: Yes, thank you. I'm all better.\Oh, good.\Sensei?\Er, sorry. I was just...\thinking about what an odd sight this is.\Interviews with Monster Girls\Machi Kyouko.\She's a dullahan, response:	an Irish demi, whose legend is rooted in fairies,
context: Oh, good.\Sensei?\Er, sorry. I was just...\thinking about what an odd sight this is.\Interviews with Monster Girls\Machi Kyouko.\She's a dullahan,\an Irish demi, whose legend is rooted in fairies, response:	and whose head and body are separate.
context: Sensei?\Er, sorry. I was just...\thinking about what an odd sight this is.\Interviews with Monster Girls\Machi Kyouko.\She's a dullahan,\an Irish demi, whose legend is rooted in fairies,\and whose head and body are separate. response:	Dullahan-chan Wants to Be Coddled
context: Er, sorry. I was just...\thinking about what an odd sight this is.\Interviews with Monster Girls\Machi Kyouko.\She's a dullahan,\an Irish demi, whose legend is rooted in fairies,\and whose head and body are separate.\Dullahan-chan Wants to Be Coddled response:	Is it safe to touch the flame coming from your neck?
context: thinking about what an odd sight this is.\Interviews with Monster Girls\Machi Kyouko.\She's a dullahan,\an Irish demi, whose legend is rooted in fairies,\and whose head and body are separate.\Dullahan-chan Wants to Be Coddled\Is it safe to touch the flame coming from your neck? response:	Huh?
context: Interviews with Monster Girls\Machi Kyouko.\She's a dullahan,\an Irish demi, whose legend is rooted in fairies,\and whose head and body are separate.\Dullahan-chan Wants to Be Coddled\Is it safe to touch the flame coming from your neck?\Huh? response:	It's not hot?
context: Machi Kyouko.\She's a dullahan,\an Irish demi, whose legend is rooted in fairies,\and whose head and body are separate.\Dullahan-chan Wants to Be Coddled\Is it safe to touch the flame coming from your neck?\Huh?\It's not hot? response:	N-No... Would you like to touch it?
context: She's a dullahan,\an Irish demi, whose legend is rooted in fairies,\and whose head and body are separate.\Dullahan-chan Wants to Be Coddled\Is it safe to touch the flame coming from your neck?\Huh?\It's not hot?\N-No... Would you like to touch it? response:	You're right. It doesn't feel hot at all.
context: an Irish demi, whose legend is rooted in fairies,\and whose head and body are separate.\Dullahan-chan Wants to Be Coddled\Is it safe to touch the flame coming from your neck?\Huh?\It's not hot?\N-No... Would you like to touch it?\You're right. It doesn't feel hot at all. response:	It's like grabbing air.
context: and whose head and body are separate.\Dullahan-chan Wants to Be Coddled\Is it safe to touch the flame coming from your neck?\Huh?\It's not hot?\N-No... Would you like to touch it?\You're right. It doesn't feel hot at all.\It's like grabbing air. response:	Feels strange, like something not of this world.
context: Dullahan-chan Wants to Be Coddled\Is it safe to touch the flame coming from your neck?\Huh?\It's not hot?\N-No... Would you like to touch it?\You're right. It doesn't feel hot at all.\It's like grabbing air.\Feels strange, like something not of this world. response:	Wh-What's wrong?
context: Is it safe to touch the flame coming from your neck?\Huh?\It's not hot?\N-No... Would you like to touch it?\You're right. It doesn't feel hot at all.\It's like grabbing air.\Feels strange, like something not of this world.\Wh-What's wrong? response:	Touching it puts pressure on my nerves.
context: Huh?\It's not hot?\N-No... Would you like to touch it?\You're right. It doesn't feel hot at all.\It's like grabbing air.\Feels strange, like something not of this world.\Wh-What's wrong?\Touching it puts pressure on my nerves. response:	It's very uncomfortable!
context: It's not hot?\N-No... Would you like to touch it?\You're right. It doesn't feel hot at all.\It's like grabbing air.\Feels strange, like something not of this world.\Wh-What's wrong?\Touching it puts pressure on my nerves.\It's very uncomfortable! response:	S-Sorry... If you just tell me, I'll understand.
context: N-No... Would you like to touch it?\You're right. It doesn't feel hot at all.\It's like grabbing air.\Feels strange, like something not of this world.\Wh-What's wrong?\Touching it puts pressure on my nerves.\It's very uncomfortable!\S-Sorry... If you just tell me, I'll understand. response:	Your body isn't a separate being, right?
context: You're right. It doesn't feel hot at all.\It's like grabbing air.\Feels strange, like something not of this world.\Wh-What's wrong?\Touching it puts pressure on my nerves.\It's very uncomfortable!\S-Sorry... If you just tell me, I'll understand.\Your body isn't a separate being, right? response:	No, it's my body.
context: It's like grabbing air.\Feels strange, like something not of this world.\Wh-What's wrong?\Touching it puts pressure on my nerves.\It's very uncomfortable!\S-Sorry... If you just tell me, I'll understand.\Your body isn't a separate being, right?\No, it's my body. response:	See? See? See?
context: Feels strange, like something not of this world.\Wh-What's wrong?\Touching it puts pressure on my nerves.\It's very uncomfortable!\S-Sorry... If you just tell me, I'll understand.\Your body isn't a separate being, right?\No, it's my body.\See? See? See? response:	Whoa, you're right!
context: Wh-What's wrong?\Touching it puts pressure on my nerves.\It's very uncomfortable!\S-Sorry... If you just tell me, I'll understand.\Your body isn't a separate being, right?\No, it's my body.\See? See? See?\Whoa, you're right! response:	See?
context: Touching it puts pressure on my nerves.\It's very uncomfortable!\S-Sorry... If you just tell me, I'll understand.\Your body isn't a separate being, right?\No, it's my body.\See? See? See?\Whoa, you're right!\See? response:	What's the matter?
context: It's very uncomfortable!\S-Sorry... If you just tell me, I'll understand.\Your body isn't a separate being, right?\No, it's my body.\See? See? See?\Whoa, you're right!\See?\What's the matter? response:	Nothing. Uh...
context: S-Sorry... If you just tell me, I'll understand.\Your body isn't a separate being, right?\No, it's my body.\See? See? See?\Whoa, you're right!\See?\What's the matter?\Nothing. Uh... response:	By the way, when you collapsed,
context: Your body isn't a separate being, right?\No, it's my body.\See? See? See?\Whoa, you're right!\See?\What's the matter?\Nothing. Uh...\By the way, when you collapsed, response:	was it all right to carry your head and body separately?
context: No, it's my body.\See? See? See?\Whoa, you're right!\See?\What's the matter?\Nothing. Uh...\By the way, when you collapsed,\was it all right to carry your head and body separately? response:	Yes.
context: See? See? See?\Whoa, you're right!\See?\What's the matter?\Nothing. Uh...\By the way, when you collapsed,\was it all right to carry your head and body separately?\Yes. response:	They've been as far apart as Tokyo and Okayama.
context: Whoa, you're right!\See?\What's the matter?\Nothing. Uh...\By the way, when you collapsed,\was it all right to carry your head and body separately?\Yes.\They've been as far apart as Tokyo and Okayama. response:	Okayama?! That's really far!
context: See?\What's the matter?\Nothing. Uh...\By the way, when you collapsed,\was it all right to carry your head and body separately?\Yes.\They've been as far apart as Tokyo and Okayama.\Okayama?! That's really far! response:	What happened?
context: What's the matter?\Nothing. Uh...\By the way, when you collapsed,\was it all right to carry your head and body separately?\Yes.\They've been as far apart as Tokyo and Okayama.\Okayama?! That's really far!\What happened? response:	My mother's parents live in Okayama,
context: Nothing. Uh...\By the way, when you collapsed,\was it all right to carry your head and body separately?\Yes.\They've been as far apart as Tokyo and Okayama.\Okayama?! That's really far!\What happened?\My mother's parents live in Okayama, response:	so I visit them every year.
context: By the way, when you collapsed,\was it all right to carry your head and body separately?\Yes.\They've been as far apart as Tokyo and Okayama.\Okayama?! That's really far!\What happened?\My mother's parents live in Okayama,\so I visit them every year. response:	But saying goodbye on the train platform was so hard,
context: was it all right to carry your head and body separately?\Yes.\They've been as far apart as Tokyo and Okayama.\Okayama?! That's really far!\What happened?\My mother's parents live in Okayama,\so I visit them every year.\But saying goodbye on the train platform was so hard, response:	my body took off on the bullet train without my head.
context: Yes.\They've been as far apart as Tokyo and Okayama.\Okayama?! That's really far!\What happened?\My mother's parents live in Okayama,\so I visit them every year.\But saying goodbye on the train platform was so hard,\my body took off on the bullet train without my head. response:	I see...
context: They've been as far apart as Tokyo and Okayama.\Okayama?! That's really far!\What happened?\My mother's parents live in Okayama,\so I visit them every year.\But saying goodbye on the train platform was so hard,\my body took off on the bullet train without my head.\I see... response:	This is pretty crazy.
context: Okayama?! That's really far!\What happened?\My mother's parents live in Okayama,\so I visit them every year.\But saying goodbye on the train platform was so hard,\my body took off on the bullet train without my head.\I see...\This is pretty crazy. response:	I'm sure it must be troublesome in daily life.
context: What happened?\My mother's parents live in Okayama,\so I visit them every year.\But saying goodbye on the train platform was so hard,\my body took off on the bullet train without my head.\I see...\This is pretty crazy.\I'm sure it must be troublesome in daily life. response:	I work through those issues with my family, using trial and error.
context: My mother's parents live in Okayama,\so I visit them every year.\But saying goodbye on the train platform was so hard,\my body took off on the bullet train without my head.\I see...\This is pretty crazy.\I'm sure it must be troublesome in daily life.\I work through those issues with my family, using trial and error. response:	It's all about experience and ingenuity!
context: so I visit them every year.\But saying goodbye on the train platform was so hard,\my body took off on the bullet train without my head.\I see...\This is pretty crazy.\I'm sure it must be troublesome in daily life.\I work through those issues with my family, using trial and error.\It's all about experience and ingenuity! response:	Ah...
context: But saying goodbye on the train platform was so hard,\my body took off on the bullet train without my head.\I see...\This is pretty crazy.\I'm sure it must be troublesome in daily life.\I work through those issues with my family, using trial and error.\It's all about experience and ingenuity!\Ah... response:	For instance, when I eat,
context: my body took off on the bullet train without my head.\I see...\This is pretty crazy.\I'm sure it must be troublesome in daily life.\I work through those issues with my family, using trial and error.\It's all about experience and ingenuity!\Ah...\For instance, when I eat, response:	I hold it in place, like this.
context: I see...\This is pretty crazy.\I'm sure it must be troublesome in daily life.\I work through those issues with my family, using trial and error.\It's all about experience and ingenuity!\Ah...\For instance, when I eat,\I hold it in place, like this. response:	When I use the bath or toilet,
context: This is pretty crazy.\I'm sure it must be troublesome in daily life.\I work through those issues with my family, using trial and error.\It's all about experience and ingenuity!\Ah...\For instance, when I eat,\I hold it in place, like this.\When I use the bath or toilet, response:	I hang it like this, so there's no problem.
context: I'm sure it must be troublesome in daily life.\I work through those issues with my family, using trial and error.\It's all about experience and ingenuity!\Ah...\For instance, when I eat,\I hold it in place, like this.\When I use the bath or toilet,\I hang it like this, so there's no problem. response:	This is very informative...
context: I work through those issues with my family, using trial and error.\It's all about experience and ingenuity!\Ah...\For instance, when I eat,\I hold it in place, like this.\When I use the bath or toilet,\I hang it like this, so there's no problem.\This is very informative... response:	Thankfully, I'm able to handle most things on my own.
context: It's all about experience and ingenuity!\Ah...\For instance, when I eat,\I hold it in place, like this.\When I use the bath or toilet,\I hang it like this, so there's no problem.\This is very informative...\Thankfully, I'm able to handle most things on my own. response:	But interacting with others is what I still struggle with.
context: Ah...\For instance, when I eat,\I hold it in place, like this.\When I use the bath or toilet,\I hang it like this, so there's no problem.\This is very informative...\Thankfully, I'm able to handle most things on my own.\But interacting with others is what I still struggle with. response:	Interacting?
context: For instance, when I eat,\I hold it in place, like this.\When I use the bath or toilet,\I hang it like this, so there's no problem.\This is very informative...\Thankfully, I'm able to handle most things on my own.\But interacting with others is what I still struggle with.\Interacting? response:	Yes, when people see me for the first time, they're startled.
context: I hold it in place, like this.\When I use the bath or toilet,\I hang it like this, so there's no problem.\This is very informative...\Thankfully, I'm able to handle most things on my own.\But interacting with others is what I still struggle with.\Interacting?\Yes, when people see me for the first time, they're startled. response:	So getting comfortable with one another takes time.
context: When I use the bath or toilet,\I hang it like this, so there's no problem.\This is very informative...\Thankfully, I'm able to handle most things on my own.\But interacting with others is what I still struggle with.\Interacting?\Yes, when people see me for the first time, they're startled.\So getting comfortable with one another takes time. response:	Especially at this time of year...
context: I hang it like this, so there's no problem.\This is very informative...\Thankfully, I'm able to handle most things on my own.\But interacting with others is what I still struggle with.\Interacting?\Yes, when people see me for the first time, they're startled.\So getting comfortable with one another takes time.\Especially at this time of year... response:	Right, since you just joined this school.
context: This is very informative...\Thankfully, I'm able to handle most things on my own.\But interacting with others is what I still struggle with.\Interacting?\Yes, when people see me for the first time, they're startled.\So getting comfortable with one another takes time.\Especially at this time of year...\Right, since you just joined this school. response:	But I got sick and missed the entrance ceremony.
context: Thankfully, I'm able to handle most things on my own.\But interacting with others is what I still struggle with.\Interacting?\Yes, when people see me for the first time, they're startled.\So getting comfortable with one another takes time.\Especially at this time of year...\Right, since you just joined this school.\But I got sick and missed the entrance ceremony. response:	Then I missed three days.
context: But interacting with others is what I still struggle with.\Interacting?\Yes, when people see me for the first time, they're startled.\So getting comfortable with one another takes time.\Especially at this time of year...\Right, since you just joined this school.\But I got sick and missed the entrance ceremony.\Then I missed three days. response:	I forced myself to come to school,
context: Interacting?\Yes, when people see me for the first time, they're startled.\So getting comfortable with one another takes time.\Especially at this time of year...\Right, since you just joined this school.\But I got sick and missed the entrance ceremony.\Then I missed three days.\I forced myself to come to school, response:	but I ended up collapsing.
context: Yes, when people see me for the first time, they're startled.\So getting comfortable with one another takes time.\Especially at this time of year...\Right, since you just joined this school.\But I got sick and missed the entrance ceremony.\Then I missed three days.\I forced myself to come to school,\but I ended up collapsing. response:	No wonder I hadn't seen you around.
context: So getting comfortable with one another takes time.\Especially at this time of year...\Right, since you just joined this school.\But I got sick and missed the entrance ceremony.\Then I missed three days.\I forced myself to come to school,\but I ended up collapsing.\No wonder I hadn't seen you around. response:	Hikari-chan is different,
context: Especially at this time of year...\Right, since you just joined this school.\But I got sick and missed the entrance ceremony.\Then I missed three days.\I forced myself to come to school,\but I ended up collapsing.\No wonder I hadn't seen you around.\Hikari-chan is different, response:	but I feel like there's some distance between my classmates and me.
context: Right, since you just joined this school.\But I got sick and missed the entrance ceremony.\Then I missed three days.\I forced myself to come to school,\but I ended up collapsing.\No wonder I hadn't seen you around.\Hikari-chan is different,\but I feel like there's some distance between my classmates and me. response:	It isn't as if we don't talk,
context: But I got sick and missed the entrance ceremony.\Then I missed three days.\I forced myself to come to school,\but I ended up collapsing.\No wonder I hadn't seen you around.\Hikari-chan is different,\but I feel like there's some distance between my classmates and me.\It isn't as if we don't talk, response:	but they seem to avoid discussing anything about dullahans.
context: Then I missed three days.\I forced myself to come to school,\but I ended up collapsing.\No wonder I hadn't seen you around.\Hikari-chan is different,\but I feel like there's some distance between my classmates and me.\It isn't as if we don't talk,\but they seem to avoid discussing anything about dullahans. response:	I would feel better if I could joke with them
context: I forced myself to come to school,\but I ended up collapsing.\No wonder I hadn't seen you around.\Hikari-chan is different,\but I feel like there's some distance between my classmates and me.\It isn't as if we don't talk,\but they seem to avoid discussing anything about dullahans.\I would feel better if I could joke with them response:	about my dullahan aspects.
context: but I ended up collapsing.\No wonder I hadn't seen you around.\Hikari-chan is different,\but I feel like there's some distance between my classmates and me.\It isn't as if we don't talk,\but they seem to avoid discussing anything about dullahans.\I would feel better if I could joke with them\about my dullahan aspects. response:	I see...
context: No wonder I hadn't seen you around.\Hikari-chan is different,\but I feel like there's some distance between my classmates and me.\It isn't as if we don't talk,\but they seem to avoid discussing anything about dullahans.\I would feel better if I could joke with them\about my dullahan aspects.\I see... response:	Machi.
context: Hikari-chan is different,\but I feel like there's some distance between my classmates and me.\It isn't as if we don't talk,\but they seem to avoid discussing anything about dullahans.\I would feel better if I could joke with them\about my dullahan aspects.\I see...\Machi. response:	Y-Yes?
context: but I feel like there's some distance between my classmates and me.\It isn't as if we don't talk,\but they seem to avoid discussing anything about dullahans.\I would feel better if I could joke with them\about my dullahan aspects.\I see...\Machi.\Y-Yes? response:	Do you ever make jokes like that yourself?
context: It isn't as if we don't talk,\but they seem to avoid discussing anything about dullahans.\I would feel better if I could joke with them\about my dullahan aspects.\I see...\Machi.\Y-Yes?\Do you ever make jokes like that yourself? response:	Huh? No, I don't.
context: but they seem to avoid discussing anything about dullahans.\I would feel better if I could joke with them\about my dullahan aspects.\I see...\Machi.\Y-Yes?\Do you ever make jokes like that yourself?\Huh? No, I don't. response:	You don't?
context: I would feel better if I could joke with them\about my dullahan aspects.\I see...\Machi.\Y-Yes?\Do you ever make jokes like that yourself?\Huh? No, I don't.\You don't? response:	Then, maybe that's where you should start.
context: about my dullahan aspects.\I see...\Machi.\Y-Yes?\Do you ever make jokes like that yourself?\Huh? No, I don't.\You don't?\Then, maybe that's where you should start. response:	I should?
context: I see...\Machi.\Y-Yes?\Do you ever make jokes like that yourself?\Huh? No, I don't.\You don't?\Then, maybe that's where you should start.\I should? response:	If that's the sort of friendship you want,
context: Machi.\Y-Yes?\Do you ever make jokes like that yourself?\Huh? No, I don't.\You don't?\Then, maybe that's where you should start.\I should?\If that's the sort of friendship you want, response:	you should tell some jokes to set a tone,
context: Y-Yes?\Do you ever make jokes like that yourself?\Huh? No, I don't.\You don't?\Then, maybe that's where you should start.\I should?\If that's the sort of friendship you want,\you should tell some jokes to set a tone, response:	so they'll know what kinds of jokes you can share with them.
context: Do you ever make jokes like that yourself?\Huh? No, I don't.\You don't?\Then, maybe that's where you should start.\I should?\If that's the sort of friendship you want,\you should tell some jokes to set a tone,\so they'll know what kinds of jokes you can share with them. response:	I see. Jokes, huh?
context: Huh? No, I don't.\You don't?\Then, maybe that's where you should start.\I should?\If that's the sort of friendship you want,\you should tell some jokes to set a tone,\so they'll know what kinds of jokes you can share with them.\I see. Jokes, huh? response:	In short, it's all about who takes the first step.
context: You don't?\Then, maybe that's where you should start.\I should?\If that's the sort of friendship you want,\you should tell some jokes to set a tone,\so they'll know what kinds of jokes you can share with them.\I see. Jokes, huh?\In short, it's all about who takes the first step. response:	Thinking of it that way, your classmates have the higher hurdle to clear.
context: Then, maybe that's where you should start.\I should?\If that's the sort of friendship you want,\you should tell some jokes to set a tone,\so they'll know what kinds of jokes you can share with them.\I see. Jokes, huh?\In short, it's all about who takes the first step.\Thinking of it that way, your classmates have the higher hurdle to clear. response:	Right, since I'm a dullahan!
context: I should?\If that's the sort of friendship you want,\you should tell some jokes to set a tone,\so they'll know what kinds of jokes you can share with them.\I see. Jokes, huh?\In short, it's all about who takes the first step.\Thinking of it that way, your classmates have the higher hurdle to clear.\Right, since I'm a dullahan! response:	You're probably the first real, live dullahan they've seen...
context: If that's the sort of friendship you want,\you should tell some jokes to set a tone,\so they'll know what kinds of jokes you can share with them.\I see. Jokes, huh?\In short, it's all about who takes the first step.\Thinking of it that way, your classmates have the higher hurdle to clear.\Right, since I'm a dullahan!\You're probably the first real, live dullahan they've seen... response:	Aren't there only three in the whole world?
context: you should tell some jokes to set a tone,\so they'll know what kinds of jokes you can share with them.\I see. Jokes, huh?\In short, it's all about who takes the first step.\Thinking of it that way, your classmates have the higher hurdle to clear.\Right, since I'm a dullahan!\You're probably the first real, live dullahan they've seen...\Aren't there only three in the whole world? response:	Huh? Yes, that's right.
context: so they'll know what kinds of jokes you can share with them.\I see. Jokes, huh?\In short, it's all about who takes the first step.\Thinking of it that way, your classmates have the higher hurdle to clear.\Right, since I'm a dullahan!\You're probably the first real, live dullahan they've seen...\Aren't there only three in the whole world?\Huh? Yes, that's right. response:	I'm impressed you know that.
context: I see. Jokes, huh?\In short, it's all about who takes the first step.\Thinking of it that way, your classmates have the higher hurdle to clear.\Right, since I'm a dullahan!\You're probably the first real, live dullahan they've seen...\Aren't there only three in the whole world?\Huh? Yes, that's right.\I'm impressed you know that. response:	Well, I've done my research.
context: In short, it's all about who takes the first step.\Thinking of it that way, your classmates have the higher hurdle to clear.\Right, since I'm a dullahan!\You're probably the first real, live dullahan they've seen...\Aren't there only three in the whole world?\Huh? Yes, that's right.\I'm impressed you know that.\Well, I've done my research. response:	All for my precious students.
context: Thinking of it that way, your classmates have the higher hurdle to clear.\Right, since I'm a dullahan!\You're probably the first real, live dullahan they've seen...\Aren't there only three in the whole world?\Huh? Yes, that's right.\I'm impressed you know that.\Well, I've done my research.\All for my precious students. response:	Sensei, um...
context: Right, since I'm a dullahan!\You're probably the first real, live dullahan they've seen...\Aren't there only three in the whole world?\Huh? Yes, that's right.\I'm impressed you know that.\Well, I've done my research.\All for my precious students.\Sensei, um... response:	W-Well...
context: You're probably the first real, live dullahan they've seen...\Aren't there only three in the whole world?\Huh? Yes, that's right.\I'm impressed you know that.\Well, I've done my research.\All for my precious students.\Sensei, um...\W-Well... response:	If you don't want to, feel free to refuse, but...
context: Aren't there only three in the whole world?\Huh? Yes, that's right.\I'm impressed you know that.\Well, I've done my research.\All for my precious students.\Sensei, um...\W-Well...\If you don't want to, feel free to refuse, but... response:	Um...
context: Huh? Yes, that's right.\I'm impressed you know that.\Well, I've done my research.\All for my precious students.\Sensei, um...\W-Well...\If you don't want to, feel free to refuse, but...\Um... response:	W-Would you please hug me?!
context: I'm impressed you know that.\Well, I've done my research.\All for my precious students.\Sensei, um...\W-Well...\If you don't want to, feel free to refuse, but...\Um...\W-Would you please hug me?! response:	Was that a joke?
context: Well, I've done my research.\All for my precious students.\Sensei, um...\W-Well...\If you don't want to, feel free to refuse, but...\Um...\W-Would you please hug me?!\Was that a joke? response:	No... Only my head.
context: All for my precious students.\Sensei, um...\W-Well...\If you don't want to, feel free to refuse, but...\Um...\W-Would you please hug me?!\Was that a joke?\No... Only my head. response:	Your head?
context: Sensei, um...\W-Well...\If you don't want to, feel free to refuse, but...\Um...\W-Would you please hug me?!\Was that a joke?\No... Only my head.\Your head? response:	Like this?
context: W-Well...\If you don't want to, feel free to refuse, but...\Um...\W-Would you please hug me?!\Was that a joke?\No... Only my head.\Your head?\Like this? response:	Y-Yes! Like that...
context: If you don't want to, feel free to refuse, but...\Um...\W-Would you please hug me?!\Was that a joke?\No... Only my head.\Your head?\Like this?\Y-Yes! Like that... response:	so my parents often used to do it.
context: Um...\W-Would you please hug me?!\Was that a joke?\No... Only my head.\Your head?\Like this?\Y-Yes! Like that...\so my parents often used to do it. response:	But now that I'm in high school, they told me to get over it.
context: W-Would you please hug me?!\Was that a joke?\No... Only my head.\Your head?\Like this?\Y-Yes! Like that...\so my parents often used to do it.\But now that I'm in high school, they told me to get over it. response:	But I just can't,
context: Was that a joke?\No... Only my head.\Your head?\Like this?\Y-Yes! Like that...\so my parents often used to do it.\But now that I'm in high school, they told me to get over it.\But I just can't, response:	and there's no one else I can ask...
context: No... Only my head.\Your head?\Like this?\Y-Yes! Like that...\so my parents often used to do it.\But now that I'm in high school, they told me to get over it.\But I just can't,\and there's no one else I can ask... response:	Okay.
context: Your head?\Like this?\Y-Yes! Like that...\so my parents often used to do it.\But now that I'm in high school, they told me to get over it.\But I just can't,\and there's no one else I can ask...\Okay. response:	Alone, a dullahan's head can't do anything.
context: Like this?\Y-Yes! Like that...\so my parents often used to do it.\But now that I'm in high school, they told me to get over it.\But I just can't,\and there's no one else I can ask...\Okay.\Alone, a dullahan's head can't do anything. response:	To get around,
context: Y-Yes! Like that...\so my parents often used to do it.\But now that I'm in high school, they told me to get over it.\But I just can't,\and there's no one else I can ask...\Okay.\Alone, a dullahan's head can't do anything.\To get around, response:	it needs contact with others, even if that's its own body.
context: so my parents often used to do it.\But now that I'm in high school, they told me to get over it.\But I just can't,\and there's no one else I can ask...\Okay.\Alone, a dullahan's head can't do anything.\To get around,\it needs contact with others, even if that's its own body. response:	In other words, hating solitude is part of a dullahan's nature.
context: But now that I'm in high school, they told me to get over it.\But I just can't,\and there's no one else I can ask...\Okay.\Alone, a dullahan's head can't do anything.\To get around,\it needs contact with others, even if that's its own body.\In other words, hating solitude is part of a dullahan's nature. response:	Biology Prep Room
context: But I just can't,\and there's no one else I can ask...\Okay.\Alone, a dullahan's head can't do anything.\To get around,\it needs contact with others, even if that's its own body.\In other words, hating solitude is part of a dullahan's nature.\Biology Prep Room response:	Put another way, they get lonely easily.
context: and there's no one else I can ask...\Okay.\Alone, a dullahan's head can't do anything.\To get around,\it needs contact with others, even if that's its own body.\In other words, hating solitude is part of a dullahan's nature.\Biology Prep Room\Put another way, they get lonely easily. response:	This dullahan-chan still wants to be coddled.
context: Okay.\Alone, a dullahan's head can't do anything.\To get around,\it needs contact with others, even if that's its own body.\In other words, hating solitude is part of a dullahan's nature.\Biology Prep Room\Put another way, they get lonely easily.\This dullahan-chan still wants to be coddled. response:	But you know,
context: Alone, a dullahan's head can't do anything.\To get around,\it needs contact with others, even if that's its own body.\In other words, hating solitude is part of a dullahan's nature.\Biology Prep Room\Put another way, they get lonely easily.\This dullahan-chan still wants to be coddled.\But you know, response:	considering that I'm a teacher, this might look inappropriate.
context: To get around,\it needs contact with others, even if that's its own body.\In other words, hating solitude is part of a dullahan's nature.\Biology Prep Room\Put another way, they get lonely easily.\This dullahan-chan still wants to be coddled.\But you know,\considering that I'm a teacher, this might look inappropriate. response:	R-Really?
context: it needs contact with others, even if that's its own body.\In other words, hating solitude is part of a dullahan's nature.\Biology Prep Room\Put another way, they get lonely easily.\This dullahan-chan still wants to be coddled.\But you know,\considering that I'm a teacher, this might look inappropriate.\R-Really? response:	Well, as long as no troublesome pests see us, it should be fine.
context: In other words, hating solitude is part of a dullahan's nature.\Biology Prep Room\Put another way, they get lonely easily.\This dullahan-chan still wants to be coddled.\But you know,\considering that I'm a teacher, this might look inappropriate.\R-Really?\Well, as long as no troublesome pests see us, it should be fine. response:	Like stubborn higher-ups
context: Biology Prep Room\Put another way, they get lonely easily.\This dullahan-chan still wants to be coddled.\But you know,\considering that I'm a teacher, this might look inappropriate.\R-Really?\Well, as long as no troublesome pests see us, it should be fine.\Like stubborn higher-ups response:	or that chatty vampire...
context: Put another way, they get lonely easily.\This dullahan-chan still wants to be coddled.\But you know,\considering that I'm a teacher, this might look inappropriate.\R-Really?\Well, as long as no troublesome pests see us, it should be fine.\Like stubborn higher-ups\or that chatty vampire... response:	Or anyone... like that...
context: This dullahan-chan still wants to be coddled.\But you know,\considering that I'm a teacher, this might look inappropriate.\R-Really?\Well, as long as no troublesome pests see us, it should be fine.\Like stubborn higher-ups\or that chatty vampire...\Or anyone... like that... response:	Everyone!
context: But you know,\considering that I'm a teacher, this might look inappropriate.\R-Really?\Well, as long as no troublesome pests see us, it should be fine.\Like stubborn higher-ups\or that chatty vampire...\Or anyone... like that...\Everyone! response:	Listen to this!
context: considering that I'm a teacher, this might look inappropriate.\R-Really?\Well, as long as no troublesome pests see us, it should be fine.\Like stubborn higher-ups\or that chatty vampire...\Or anyone... like that...\Everyone!\Listen to this! response:	Hey! Hey! This is big!
context: R-Really?\Well, as long as no troublesome pests see us, it should be fine.\Like stubborn higher-ups\or that chatty vampire...\Or anyone... like that...\Everyone!\Listen to this!\Hey! Hey! This is big! response:	I guess this means you're one of the dullahans now.
context: Well, as long as no troublesome pests see us, it should be fine.\Like stubborn higher-ups\or that chatty vampire...\Or anyone... like that...\Everyone!\Listen to this!\Hey! Hey! This is big!\I guess this means you're one of the dullahans now. response:	Gather around, people!
context: Like stubborn higher-ups\or that chatty vampire...\Or anyone... like that...\Everyone!\Listen to this!\Hey! Hey! This is big!\I guess this means you're one of the dullahans now.\Gather around, people! response:	Eh?
context: or that chatty vampire...\Or anyone... like that...\Everyone!\Listen to this!\Hey! Hey! This is big!\I guess this means you're one of the dullahans now.\Gather around, people!\Eh? response:	Because your head's going to roll, right?
context: Or anyone... like that...\Everyone!\Listen to this!\Hey! Hey! This is big!\I guess this means you're one of the dullahans now.\Gather around, people!\Eh?\Because your head's going to roll, right? response:	That's a joke I can't laugh at!
context: Everyone!\Listen to this!\Hey! Hey! This is big!\I guess this means you're one of the dullahans now.\Gather around, people!\Eh?\Because your head's going to roll, right?\That's a joke I can't laugh at! response:	Wait! Hikari!
context: Listen to this!\Hey! Hey! This is big!\I guess this means you're one of the dullahans now.\Gather around, people!\Eh?\Because your head's going to roll, right?\That's a joke I can't laugh at!\Wait! Hikari! response:	Hey, listen! Takahashi-sensei was...
context: Hey! Hey! This is big!\I guess this means you're one of the dullahans now.\Gather around, people!\Eh?\Because your head's going to roll, right?\That's a joke I can't laugh at!\Wait! Hikari!\Hey, listen! Takahashi-sensei was... response:	Wait, wait, wait!
context: I guess this means you're one of the dullahans now.\Gather around, people!\Eh?\Because your head's going to roll, right?\That's a joke I can't laugh at!\Wait! Hikari!\Hey, listen! Takahashi-sensei was...\Wait, wait, wait! response:	Thanks, Hikari-chan.
context: Gather around, people!\Eh?\Because your head's going to roll, right?\That's a joke I can't laugh at!\Wait! Hikari!\Hey, listen! Takahashi-sensei was...\Wait, wait, wait!\Thanks, Hikari-chan. response:	For what?
context: Eh?\Because your head's going to roll, right?\That's a joke I can't laugh at!\Wait! Hikari!\Hey, listen! Takahashi-sensei was...\Wait, wait, wait!\Thanks, Hikari-chan.\For what? response:	I'm really glad I was able to talk to Takahashi-sensei.
context: Because your head's going to roll, right?\That's a joke I can't laugh at!\Wait! Hikari!\Hey, listen! Takahashi-sensei was...\Wait, wait, wait!\Thanks, Hikari-chan.\For what?\I'm really glad I was able to talk to Takahashi-sensei. response:	Oh, just seeing the panicked look on his face was enough for me!
context: That's a joke I can't laugh at!\Wait! Hikari!\Hey, listen! Takahashi-sensei was...\Wait, wait, wait!\Thanks, Hikari-chan.\For what?\I'm really glad I was able to talk to Takahashi-sensei.\Oh, just seeing the panicked look on his face was enough for me! response:	Yukki!
context: Wait! Hikari!\Hey, listen! Takahashi-sensei was...\Wait, wait, wait!\Thanks, Hikari-chan.\For what?\I'm really glad I was able to talk to Takahashi-sensei.\Oh, just seeing the panicked look on his face was enough for me!\Yukki! response:	Takanashi-san...
context: Hey, listen! Takahashi-sensei was...\Wait, wait, wait!\Thanks, Hikari-chan.\For what?\I'm really glad I was able to talk to Takahashi-sensei.\Oh, just seeing the panicked look on his face was enough for me!\Yukki!\Takanashi-san... response:	Ah, you feel so cool! It feels great!
context: Wait, wait, wait!\Thanks, Hikari-chan.\For what?\I'm really glad I was able to talk to Takahashi-sensei.\Oh, just seeing the panicked look on his face was enough for me!\Yukki!\Takanashi-san...\Ah, you feel so cool! It feels great! response:	Do you live in this direction, too?
context: Thanks, Hikari-chan.\For what?\I'm really glad I was able to talk to Takahashi-sensei.\Oh, just seeing the panicked look on his face was enough for me!\Yukki!\Takanashi-san...\Ah, you feel so cool! It feels great!\Do you live in this direction, too? response:	Yeah.
context: For what?\I'm really glad I was able to talk to Takahashi-sensei.\Oh, just seeing the panicked look on his face was enough for me!\Yukki!\Takanashi-san...\Ah, you feel so cool! It feels great!\Do you live in this direction, too?\Yeah. response:	Then, let's walk home together!
context: I'm really glad I was able to talk to Takahashi-sensei.\Oh, just seeing the panicked look on his face was enough for me!\Yukki!\Takanashi-san...\Ah, you feel so cool! It feels great!\Do you live in this direction, too?\Yeah.\Then, let's walk home together! response:	Oh, this is Macchi.
context: Oh, just seeing the panicked look on his face was enough for me!\Yukki!\Takanashi-san...\Ah, you feel so cool! It feels great!\Do you live in this direction, too?\Yeah.\Then, let's walk home together!\Oh, this is Macchi. response:	Macchi-san?
context: Yukki!\Takanashi-san...\Ah, you feel so cool! It feels great!\Do you live in this direction, too?\Yeah.\Then, let's walk home together!\Oh, this is Macchi.\Macchi-san? response:	I need to stop somewhere on the way.
context: Takanashi-san...\Ah, you feel so cool! It feels great!\Do you live in this direction, too?\Yeah.\Then, let's walk home together!\Oh, this is Macchi.\Macchi-san?\I need to stop somewhere on the way. response:	Really? Can't help that, I guess...
context: Ah, you feel so cool! It feels great!\Do you live in this direction, too?\Yeah.\Then, let's walk home together!\Oh, this is Macchi.\Macchi-san?\I need to stop somewhere on the way.\Really? Can't help that, I guess... response:	I'm really sorry. Bye.
context: Do you live in this direction, too?\Yeah.\Then, let's walk home together!\Oh, this is Macchi.\Macchi-san?\I need to stop somewhere on the way.\Really? Can't help that, I guess...\I'm really sorry. Bye. response:	Bye-bye!
context: Yeah.\Then, let's walk home together!\Oh, this is Macchi.\Macchi-san?\I need to stop somewhere on the way.\Really? Can't help that, I guess...\I'm really sorry. Bye.\Bye-bye! response:	Isn't that Kusakabe-san, from class A?
context: Then, let's walk home together!\Oh, this is Macchi.\Macchi-san?\I need to stop somewhere on the way.\Really? Can't help that, I guess...\I'm really sorry. Bye.\Bye-bye!\Isn't that Kusakabe-san, from class A? response:	The snow woman?
context: Oh, this is Macchi.\Macchi-san?\I need to stop somewhere on the way.\Really? Can't help that, I guess...\I'm really sorry. Bye.\Bye-bye!\Isn't that Kusakabe-san, from class A?\The snow woman? response:	Yep, that's Yukki.
context: Macchi-san?\I need to stop somewhere on the way.\Really? Can't help that, I guess...\I'm really sorry. Bye.\Bye-bye!\Isn't that Kusakabe-san, from class A?\The snow woman?\Yep, that's Yukki. response:	She's a little shy, but she's nice.
context: I need to stop somewhere on the way.\Really? Can't help that, I guess...\I'm really sorry. Bye.\Bye-bye!\Isn't that Kusakabe-san, from class A?\The snow woman?\Yep, that's Yukki.\She's a little shy, but she's nice. response:	Oh...
context: Really? Can't help that, I guess...\I'm really sorry. Bye.\Bye-bye!\Isn't that Kusakabe-san, from class A?\The snow woman?\Yep, that's Yukki.\She's a little shy, but she's nice.\Oh... response:	And her body is so cold!
context: I'm really sorry. Bye.\Bye-bye!\Isn't that Kusakabe-san, from class A?\The snow woman?\Yep, that's Yukki.\She's a little shy, but she's nice.\Oh...\And her body is so cold! response:	She feels so nice to hug!
context: Bye-bye!\Isn't that Kusakabe-san, from class A?\The snow woman?\Yep, that's Yukki.\She's a little shy, but she's nice.\Oh...\And her body is so cold!\She feels so nice to hug! response:	So that's why you suddenly hugged her like that.
context: Isn't that Kusakabe-san, from class A?\The snow woman?\Yep, that's Yukki.\She's a little shy, but she's nice.\Oh...\And her body is so cold!\She feels so nice to hug!\So that's why you suddenly hugged her like that. response:	My house is that way. Want to stop by?
context: The snow woman?\Yep, that's Yukki.\She's a little shy, but she's nice.\Oh...\And her body is so cold!\She feels so nice to hug!\So that's why you suddenly hugged her like that.\My house is that way. Want to stop by? response:	Hmm... Well, it's already pretty late.
context: Yep, that's Yukki.\She's a little shy, but she's nice.\Oh...\And her body is so cold!\She feels so nice to hug!\So that's why you suddenly hugged her like that.\My house is that way. Want to stop by?\Hmm... Well, it's already pretty late. response:	Yeah, that's true.
context: She's a little shy, but she's nice.\Oh...\And her body is so cold!\She feels so nice to hug!\So that's why you suddenly hugged her like that.\My house is that way. Want to stop by?\Hmm... Well, it's already pretty late.\Yeah, that's true. response:	I bet your parents would worry.
context: Oh...\And her body is so cold!\She feels so nice to hug!\So that's why you suddenly hugged her like that.\My house is that way. Want to stop by?\Hmm... Well, it's already pretty late.\Yeah, that's true.\I bet your parents would worry. response:	Well, come over again when you have time to visit.
context: And her body is so cold!\She feels so nice to hug!\So that's why you suddenly hugged her like that.\My house is that way. Want to stop by?\Hmm... Well, it's already pretty late.\Yeah, that's true.\I bet your parents would worry.\Well, come over again when you have time to visit. response:	Sure.
context: She feels so nice to hug!\So that's why you suddenly hugged her like that.\My house is that way. Want to stop by?\Hmm... Well, it's already pretty late.\Yeah, that's true.\I bet your parents would worry.\Well, come over again when you have time to visit.\Sure. response:	Take care!
context: So that's why you suddenly hugged her like that.\My house is that way. Want to stop by?\Hmm... Well, it's already pretty late.\Yeah, that's true.\I bet your parents would worry.\Well, come over again when you have time to visit.\Sure.\Take care! response:	Mom
context: My house is that way. Want to stop by?\Hmm... Well, it's already pretty late.\Yeah, that's true.\I bet your parents would worry.\Well, come over again when you have time to visit.\Sure.\Take care!\Mom response:	Hi, Mom?
context: Hmm... Well, it's already pretty late.\Yeah, that's true.\I bet your parents would worry.\Well, come over again when you have time to visit.\Sure.\Take care!\Mom\Hi, Mom? response:	I'm on my way home now.
context: Yeah, that's true.\I bet your parents would worry.\Well, come over again when you have time to visit.\Sure.\Take care!\Mom\Hi, Mom?\I'm on my way home now. response:	Sorry, I was talking to my teacher...
context: I bet your parents would worry.\Well, come over again when you have time to visit.\Sure.\Take care!\Mom\Hi, Mom?\I'm on my way home now.\Sorry, I was talking to my teacher... response:	No, it isn't anything like that.
context: Well, come over again when you have time to visit.\Sure.\Take care!\Mom\Hi, Mom?\I'm on my way home now.\Sorry, I was talking to my teacher...\No, it isn't anything like that. response:	Okay, I will. Bye.
context: Sure.\Take care!\Mom\Hi, Mom?\I'm on my way home now.\Sorry, I was talking to my teacher...\No, it isn't anything like that.\Okay, I will. Bye. response:	There. That should do it.
context: Take care!\Mom\Hi, Mom?\I'm on my way home now.\Sorry, I was talking to my teacher...\No, it isn't anything like that.\Okay, I will. Bye.\There. That should do it. response:	Now that I'm in high school,
context: Mom\Hi, Mom?\I'm on my way home now.\Sorry, I was talking to my teacher...\No, it isn't anything like that.\Okay, I will. Bye.\There. That should do it.\Now that I'm in high school, response:	it seems that both studying and exercising will be a lot harder.
context: Hi, Mom?\I'm on my way home now.\Sorry, I was talking to my teacher...\No, it isn't anything like that.\Okay, I will. Bye.\There. That should do it.\Now that I'm in high school,\it seems that both studying and exercising will be a lot harder. response:	My head... My head can't keep
context: I'm on my way home now.\Sorry, I was talking to my teacher...\No, it isn't anything like that.\Okay, I will. Bye.\There. That should do it.\Now that I'm in high school,\it seems that both studying and exercising will be a lot harder.\My head... My head can't keep response:	My head can't keep up Use when I'm really busy
context: Sorry, I was talking to my teacher...\No, it isn't anything like that.\Okay, I will. Bye.\There. That should do it.\Now that I'm in high school,\it seems that both studying and exercising will be a lot harder.\My head... My head can't keep\My head can't keep up Use when I'm really busy response:	Takahashi-sensei was so nice.
context: No, it isn't anything like that.\Okay, I will. Bye.\There. That should do it.\Now that I'm in high school,\it seems that both studying and exercising will be a lot harder.\My head... My head can't keep\My head can't keep up Use when I'm really busy\Takahashi-sensei was so nice. response:	Interviews with Monster Girls
context: Okay, I will. Bye.\There. That should do it.\Now that I'm in high school,\it seems that both studying and exercising will be a lot harder.\My head... My head can't keep\My head can't keep up Use when I'm really busy\Takahashi-sensei was so nice.\Interviews with Monster Girls response:	I hope I can talk to him again.
context: There. That should do it.\Now that I'm in high school,\it seems that both studying and exercising will be a lot harder.\My head... My head can't keep\My head can't keep up Use when I'm really busy\Takahashi-sensei was so nice.\Interviews with Monster Girls\I hope I can talk to him again. response:	You want to go on a date with a guy?!
context: Now that I'm in high school,\it seems that both studying and exercising will be a lot harder.\My head... My head can't keep\My head can't keep up Use when I'm really busy\Takahashi-sensei was so nice.\Interviews with Monster Girls\I hope I can talk to him again.\You want to go on a date with a guy?! response:	That sounds great!
context: it seems that both studying and exercising will be a lot harder.\My head... My head can't keep\My head can't keep up Use when I'm really busy\Takahashi-sensei was so nice.\Interviews with Monster Girls\I hope I can talk to him again.\You want to go on a date with a guy?!\That sounds great! response:	Let's do it, let's go! Let's attack right now!
context: My head... My head can't keep\My head can't keep up Use when I'm really busy\Takahashi-sensei was so nice.\Interviews with Monster Girls\I hope I can talk to him again.\You want to go on a date with a guy?!\That sounds great!\Let's do it, let's go! Let's attack right now! response:	B-But I'm not sure how he feels...
context: My head can't keep up Use when I'm really busy\Takahashi-sensei was so nice.\Interviews with Monster Girls\I hope I can talk to him again.\You want to go on a date with a guy?!\That sounds great!\Let's do it, let's go! Let's attack right now!\B-But I'm not sure how he feels... response:	It'll be fine! You're really pretty!
context: Takahashi-sensei was so nice.\Interviews with Monster Girls\I hope I can talk to him again.\You want to go on a date with a guy?!\That sounds great!\Let's do it, let's go! Let's attack right now!\B-But I'm not sure how he feels...\It'll be fine! You're really pretty! response:	You have a nice figure, so just flash your boobs, and he's yours.
context: Interviews with Monster Girls\I hope I can talk to him again.\You want to go on a date with a guy?!\That sounds great!\Let's do it, let's go! Let's attack right now!\B-But I'm not sure how he feels...\It'll be fine! You're really pretty!\You have a nice figure, so just flash your boobs, and he's yours. response:	You think so?
context: I hope I can talk to him again.\You want to go on a date with a guy?!\That sounds great!\Let's do it, let's go! Let's attack right now!\B-But I'm not sure how he feels...\It'll be fine! You're really pretty!\You have a nice figure, so just flash your boobs, and he's yours.\You think so? response:	You're so indecisive!
context: You want to go on a date with a guy?!\That sounds great!\Let's do it, let's go! Let's attack right now!\B-But I'm not sure how he feels...\It'll be fine! You're really pretty!\You have a nice figure, so just flash your boobs, and he's yours.\You think so?\You're so indecisive! response:	Something weighing on your conscience?
context: That sounds great!\Let's do it, let's go! Let's attack right now!\B-But I'm not sure how he feels...\It'll be fine! You're really pretty!\You have a nice figure, so just flash your boobs, and he's yours.\You think so?\You're so indecisive!\Something weighing on your conscience? response:	Well, but I'm...
context: Let's do it, let's go! Let's attack right now!\B-But I'm not sure how he feels...\It'll be fine! You're really pretty!\You have a nice figure, so just flash your boobs, and he's yours.\You think so?\You're so indecisive!\Something weighing on your conscience?\Well, but I'm... response:	a dullahan...
context: B-But I'm not sure how he feels...\It'll be fine! You're really pretty!\You have a nice figure, so just flash your boobs, and he's yours.\You think so?\You're so indecisive!\Something weighing on your conscience?\Well, but I'm...\a dullahan... response:	Why does being a dullahan put you at a romantic disadvantage?
context: It'll be fine! You're really pretty!\You have a nice figure, so just flash your boobs, and he's yours.\You think so?\You're so indecisive!\Something weighing on your conscience?\Well, but I'm...\a dullahan...\Why does being a dullahan put you at a romantic disadvantage? response:	Well?
context: You have a nice figure, so just flash your boobs, and he's yours.\You think so?\You're so indecisive!\Something weighing on your conscience?\Well, but I'm...\a dullahan...\Why does being a dullahan put you at a romantic disadvantage?\Well? response:	Th-There are statistics to indicate such...
context: You think so?\You're so indecisive!\Something weighing on your conscience?\Well, but I'm...\a dullahan...\Why does being a dullahan put you at a romantic disadvantage?\Well?\Th-There are statistics to indicate such... response:	I heard there are only three dullahans in the world.
context: You're so indecisive!\Something weighing on your conscience?\Well, but I'm...\a dullahan...\Why does being a dullahan put you at a romantic disadvantage?\Well?\Th-There are statistics to indicate such...\I heard there are only three dullahans in the world. response:	Didn't think that through, did you?
context: Something weighing on your conscience?\Well, but I'm...\a dullahan...\Why does being a dullahan put you at a romantic disadvantage?\Well?\Th-There are statistics to indicate such...\I heard there are only three dullahans in the world.\Didn't think that through, did you? response:	Using made-up excuses to run away makes you look pathetic!
context: Well, but I'm...\a dullahan...\Why does being a dullahan put you at a romantic disadvantage?\Well?\Th-There are statistics to indicate such...\I heard there are only three dullahans in the world.\Didn't think that through, did you?\Using made-up excuses to run away makes you look pathetic! response:	Well, maybe it wouldn't put me at a disadvantage,
context: a dullahan...\Why does being a dullahan put you at a romantic disadvantage?\Well?\Th-There are statistics to indicate such...\I heard there are only three dullahans in the world.\Didn't think that through, did you?\Using made-up excuses to run away makes you look pathetic!\Well, maybe it wouldn't put me at a disadvantage, response:	but it isn't exactly an advantage
context: Why does being a dullahan put you at a romantic disadvantage?\Well?\Th-There are statistics to indicate such...\I heard there are only three dullahans in the world.\Didn't think that through, did you?\Using made-up excuses to run away makes you look pathetic!\Well, maybe it wouldn't put me at a disadvantage,\but it isn't exactly an advantage response:	Sure, it is!
context: Well?\Th-There are statistics to indicate such...\I heard there are only three dullahans in the world.\Didn't think that through, did you?\Using made-up excuses to run away makes you look pathetic!\Well, maybe it wouldn't put me at a disadvantage,\but it isn't exactly an advantage\Sure, it is! response:	It's no exaggeration to say you stand atop the romantic pyramid.
context: Th-There are statistics to indicate such...\I heard there are only three dullahans in the world.\Didn't think that through, did you?\Using made-up excuses to run away makes you look pathetic!\Well, maybe it wouldn't put me at a disadvantage,\but it isn't exactly an advantage\Sure, it is!\It's no exaggeration to say you stand atop the romantic pyramid. response:	Yes, for instance...
context: I heard there are only three dullahans in the world.\Didn't think that through, did you?\Using made-up excuses to run away makes you look pathetic!\Well, maybe it wouldn't put me at a disadvantage,\but it isn't exactly an advantage\Sure, it is!\It's no exaggeration to say you stand atop the romantic pyramid.\Yes, for instance... response:	When it comes to naughty things,
context: Didn't think that through, did you?\Using made-up excuses to run away makes you look pathetic!\Well, maybe it wouldn't put me at a disadvantage,\but it isn't exactly an advantage\Sure, it is!\It's no exaggeration to say you stand atop the romantic pyramid.\Yes, for instance...\When it comes to naughty things, response:	you're capable of some special techniques.
context: Using made-up excuses to run away makes you look pathetic!\Well, maybe it wouldn't put me at a disadvantage,\but it isn't exactly an advantage\Sure, it is!\It's no exaggeration to say you stand atop the romantic pyramid.\Yes, for instance...\When it comes to naughty things,\you're capable of some special techniques. response:	You're amazing, Hikari-chan!
context: Well, maybe it wouldn't put me at a disadvantage,\but it isn't exactly an advantage\Sure, it is!\It's no exaggeration to say you stand atop the romantic pyramid.\Yes, for instance...\When it comes to naughty things,\you're capable of some special techniques.\You're amazing, Hikari-chan! response:	Do you know a lot about that sort of thing?
context: but it isn't exactly an advantage\Sure, it is!\It's no exaggeration to say you stand atop the romantic pyramid.\Yes, for instance...\When it comes to naughty things,\you're capable of some special techniques.\You're amazing, Hikari-chan!\Do you know a lot about that sort of thing? response:	Yeah, well...
context: Sure, it is!\It's no exaggeration to say you stand atop the romantic pyramid.\Yes, for instance...\When it comes to naughty things,\you're capable of some special techniques.\You're amazing, Hikari-chan!\Do you know a lot about that sort of thing?\Yeah, well... response:	I don't actually know much.
context: It's no exaggeration to say you stand atop the romantic pyramid.\Yes, for instance...\When it comes to naughty things,\you're capable of some special techniques.\You're amazing, Hikari-chan!\Do you know a lot about that sort of thing?\Yeah, well...\I don't actually know much. response:	Anyway, anyway...
context: Yes, for instance...\When it comes to naughty things,\you're capable of some special techniques.\You're amazing, Hikari-chan!\Do you know a lot about that sort of thing?\Yeah, well...\I don't actually know much.\Anyway, anyway... response:	What kind of date would you like?
context: When it comes to naughty things,\you're capable of some special techniques.\You're amazing, Hikari-chan!\Do you know a lot about that sort of thing?\Yeah, well...\I don't actually know much.\Anyway, anyway...\What kind of date would you like? response:	Huh?
context: you're capable of some special techniques.\You're amazing, Hikari-chan!\Do you know a lot about that sort of thing?\Yeah, well...\I don't actually know much.\Anyway, anyway...\What kind of date would you like?\Huh? response:	You must have some kind of plan for your ideal date, right?
context: You're amazing, Hikari-chan!\Do you know a lot about that sort of thing?\Yeah, well...\I don't actually know much.\Anyway, anyway...\What kind of date would you like?\Huh?\You must have some kind of plan for your ideal date, right? response:	W-Well, I guess...
context: Do you know a lot about that sort of thing?\Yeah, well...\I don't actually know much.\Anyway, anyway...\What kind of date would you like?\Huh?\You must have some kind of plan for your ideal date, right?\W-Well, I guess... response:	Since I'm a dullahan,
context: Yeah, well...\I don't actually know much.\Anyway, anyway...\What kind of date would you like?\Huh?\You must have some kind of plan for your ideal date, right?\W-Well, I guess...\Since I'm a dullahan, response:	I feel most at ease when my head is being held securely, like this...
context: I don't actually know much.\Anyway, anyway...\What kind of date would you like?\Huh?\You must have some kind of plan for your ideal date, right?\W-Well, I guess...\Since I'm a dullahan,\I feel most at ease when my head is being held securely, like this... response:	And I like it.
context: Anyway, anyway...\What kind of date would you like?\Huh?\You must have some kind of plan for your ideal date, right?\W-Well, I guess...\Since I'm a dullahan,\I feel most at ease when my head is being held securely, like this...\And I like it. response:	Uh-huh.
context: What kind of date would you like?\Huh?\You must have some kind of plan for your ideal date, right?\W-Well, I guess...\Since I'm a dullahan,\I feel most at ease when my head is being held securely, like this...\And I like it.\Uh-huh. response:	So, well...
context: Huh?\You must have some kind of plan for your ideal date, right?\W-Well, I guess...\Since I'm a dullahan,\I feel most at ease when my head is being held securely, like this...\And I like it.\Uh-huh.\So, well... response:	It'd be nice to walk around with the one I like as he carries my head.
context: You must have some kind of plan for your ideal date, right?\W-Well, I guess...\Since I'm a dullahan,\I feel most at ease when my head is being held securely, like this...\And I like it.\Uh-huh.\So, well...\It'd be nice to walk around with the one I like as he carries my head. response:	Walk around?
context: W-Well, I guess...\Since I'm a dullahan,\I feel most at ease when my head is being held securely, like this...\And I like it.\Uh-huh.\So, well...\It'd be nice to walk around with the one I like as he carries my head.\Walk around? response:	He can decide where we go.
context: Since I'm a dullahan,\I feel most at ease when my head is being held securely, like this...\And I like it.\Uh-huh.\So, well...\It'd be nice to walk around with the one I like as he carries my head.\Walk around?\He can decide where we go. response:	And when I look up, I can see his face.
context: I feel most at ease when my head is being held securely, like this...\And I like it.\Uh-huh.\So, well...\It'd be nice to walk around with the one I like as he carries my head.\Walk around?\He can decide where we go.\And when I look up, I can see his face. response:	Little movements could bring our faces closer together.
context: And I like it.\Uh-huh.\So, well...\It'd be nice to walk around with the one I like as he carries my head.\Walk around?\He can decide where we go.\And when I look up, I can see his face.\Little movements could bring our faces closer together. response:	Uh-huh.
context: Uh-huh.\So, well...\It'd be nice to walk around with the one I like as he carries my head.\Walk around?\He can decide where we go.\And when I look up, I can see his face.\Little movements could bring our faces closer together.\Uh-huh. response:	I-It would be fun to be able to do that.
context: So, well...\It'd be nice to walk around with the one I like as he carries my head.\Walk around?\He can decide where we go.\And when I look up, I can see his face.\Little movements could bring our faces closer together.\Uh-huh.\I-It would be fun to be able to do that. response:	I guess that's about it.
context: It'd be nice to walk around with the one I like as he carries my head.\Walk around?\He can decide where we go.\And when I look up, I can see his face.\Little movements could bring our faces closer together.\Uh-huh.\I-It would be fun to be able to do that.\I guess that's about it. response:	You're such a maiden...
context: Walk around?\He can decide where we go.\And when I look up, I can see his face.\Little movements could bring our faces closer together.\Uh-huh.\I-It would be fun to be able to do that.\I guess that's about it.\You're such a maiden... response:	And? And? Who is this prince who's captured your heart?
context: He can decide where we go.\And when I look up, I can see his face.\Little movements could bring our faces closer together.\Uh-huh.\I-It would be fun to be able to do that.\I guess that's about it.\You're such a maiden...\And? And? Who is this prince who's captured your heart? response:	Oh, uh...
context: And when I look up, I can see his face.\Little movements could bring our faces closer together.\Uh-huh.\I-It would be fun to be able to do that.\I guess that's about it.\You're such a maiden...\And? And? Who is this prince who's captured your heart?\Oh, uh... response:	Come on,'fess up!
context: Little movements could bring our faces closer together.\Uh-huh.\I-It would be fun to be able to do that.\I guess that's about it.\You're such a maiden...\And? And? Who is this prince who's captured your heart?\Oh, uh...\Come on,'fess up! response:	It'll be a weight off your shoulders!
context: Uh-huh.\I-It would be fun to be able to do that.\I guess that's about it.\You're such a maiden...\And? And? Who is this prince who's captured your heart?\Oh, uh...\Come on,'fess up!\It'll be a weight off your shoulders! response:	Ta...
context: I-It would be fun to be able to do that.\I guess that's about it.\You're such a maiden...\And? And? Who is this prince who's captured your heart?\Oh, uh...\Come on,'fess up!\It'll be a weight off your shoulders!\Ta... response:	Ta?
context: I guess that's about it.\You're such a maiden...\And? And? Who is this prince who's captured your heart?\Oh, uh...\Come on,'fess up!\It'll be a weight off your shoulders!\Ta...\Ta? response:	Takahashi-sensei!
context: You're such a maiden...\And? And? Who is this prince who's captured your heart?\Oh, uh...\Come on,'fess up!\It'll be a weight off your shoulders!\Ta...\Ta?\Takahashi-sensei! response:	Hey... Hikari-chan?
context: And? And? Who is this prince who's captured your heart?\Oh, uh...\Come on,'fess up!\It'll be a weight off your shoulders!\Ta...\Ta?\Takahashi-sensei!\Hey... Hikari-chan? response:	Who are you calli
context: Oh, uh...\Come on,'fess up!\It'll be a weight off your shoulders!\Ta...\Ta?\Takahashi-sensei!\Hey... Hikari-chan?\Who are you calli response:	Wait! Why are you making that face?!
context: Come on,'fess up!\It'll be a weight off your shoulders!\Ta...\Ta?\Takahashi-sensei!\Hey... Hikari-chan?\Who are you calli\Wait! Why are you making that face?! response:	Hikari-chan!
context: It'll be a weight off your shoulders!\Ta...\Ta?\Takahashi-sensei!\Hey... Hikari-chan?\Who are you calli\Wait! Why are you making that face?!\Hikari-chan! response:	Good! You're both here!
context: Ta...\Ta?\Takahashi-sensei!\Hey... Hikari-chan?\Who are you calli\Wait! Why are you making that face?!\Hikari-chan!\Good! You're both here! response:	Takanashi
context: Ta?\Takahashi-sensei!\Hey... Hikari-chan?\Who are you calli\Wait! Why are you making that face?!\Hikari-chan!\Good! You're both here!\Takanashi response:	We're doing an experiment!
context: Takahashi-sensei!\Hey... Hikari-chan?\Who are you calli\Wait! Why are you making that face?!\Hikari-chan!\Good! You're both here!\Takanashi\We're doing an experiment! response:	You two will go shopping!
context: Hey... Hikari-chan?\Who are you calli\Wait! Why are you making that face?!\Hikari-chan!\Good! You're both here!\Takanashi\We're doing an experiment!\You two will go shopping! response:	And you can't return until sunset, even if you finish!
context: Who are you calli\Wait! Why are you making that face?!\Hikari-chan!\Good! You're both here!\Takanashi\We're doing an experiment!\You two will go shopping!\And you can't return until sunset, even if you finish! response:	Got that?!
context: Wait! Why are you making that face?!\Hikari-chan!\Good! You're both here!\Takanashi\We're doing an experiment!\You two will go shopping!\And you can't return until sunset, even if you finish!\Got that?! response:	Yes.
context: Hikari-chan!\Good! You're both here!\Takanashi\We're doing an experiment!\You two will go shopping!\And you can't return until sunset, even if you finish!\Got that?!\Yes. response:	Anyway, Macchi,
context: Good! You're both here!\Takanashi\We're doing an experiment!\You two will go shopping!\And you can't return until sunset, even if you finish!\Got that?!\Yes.\Anyway, Macchi, response:	you really went all-out, didn't you?
context: Takanashi\We're doing an experiment!\You two will go shopping!\And you can't return until sunset, even if you finish!\Got that?!\Yes.\Anyway, Macchi,\you really went all-out, didn't you? response:	Huh?
context: We're doing an experiment!\You two will go shopping!\And you can't return until sunset, even if you finish!\Got that?!\Yes.\Anyway, Macchi,\you really went all-out, didn't you?\Huh? response:	That looks too normal.
context: You two will go shopping!\And you can't return until sunset, even if you finish!\Got that?!\Yes.\Anyway, Macchi,\you really went all-out, didn't you?\Huh?\That looks too normal. response:	That's too childish.
context: And you can't return until sunset, even if you finish!\Got that?!\Yes.\Anyway, Macchi,\you really went all-out, didn't you?\Huh?\That looks too normal.\That's too childish. response:	That's a bit much...
context: Got that?!\Yes.\Anyway, Macchi,\you really went all-out, didn't you?\Huh?\That looks too normal.\That's too childish.\That's a bit much... response:	I know!
context: Yes.\Anyway, Macchi,\you really went all-out, didn't you?\Huh?\That looks too normal.\That's too childish.\That's a bit much...\I know! response:	Y-You think so?
context: Anyway, Macchi,\you really went all-out, didn't you?\Huh?\That looks too normal.\That's too childish.\That's a bit much...\I know!\Y-You think so? response:	Your body will be staying here with me, though.
context: you really went all-out, didn't you?\Huh?\That looks too normal.\That's too childish.\That's a bit much...\I know!\Y-You think so?\Your body will be staying here with me, though. response:	What?!
context: Huh?\That looks too normal.\That's too childish.\That's a bit much...\I know!\Y-You think so?\Your body will be staying here with me, though.\What?! response:	I'll take responsibility for keeping an eye on Macchi's body.
context: That looks too normal.\That's too childish.\That's a bit much...\I know!\Y-You think so?\Your body will be staying here with me, though.\What?!\I'll take responsibility for keeping an eye on Macchi's body. response:	Off you go, then!
context: That's too childish.\That's a bit much...\I know!\Y-You think so?\Your body will be staying here with me, though.\What?!\I'll take responsibility for keeping an eye on Macchi's body.\Off you go, then! response:	I forgot about that...
context: That's a bit much...\I know!\Y-You think so?\Your body will be staying here with me, though.\What?!\I'll take responsibility for keeping an eye on Macchi's body.\Off you go, then!\I forgot about that... response:	Okay, you and I will go to the living room!
context: I know!\Y-You think so?\Your body will be staying here with me, though.\What?!\I'll take responsibility for keeping an eye on Macchi's body.\Off you go, then!\I forgot about that...\Okay, you and I will go to the living room! response:	With just your body, I guess you can't hear me.
context: Y-You think so?\Your body will be staying here with me, though.\What?!\I'll take responsibility for keeping an eye on Macchi's body.\Off you go, then!\I forgot about that...\Okay, you and I will go to the living room!\With just your body, I guess you can't hear me. response:	So what kind of experiment is this?
context: Your body will be staying here with me, though.\What?!\I'll take responsibility for keeping an eye on Macchi's body.\Off you go, then!\I forgot about that...\Okay, you and I will go to the living room!\With just your body, I guess you can't hear me.\So what kind of experiment is this? response:	Oh, um...
context: What?!\I'll take responsibility for keeping an eye on Macchi's body.\Off you go, then!\I forgot about that...\Okay, you and I will go to the living room!\With just your body, I guess you can't hear me.\So what kind of experiment is this?\Oh, um... response:	I-If I ever find someone I like,
context: I'll take responsibility for keeping an eye on Macchi's body.\Off you go, then!\I forgot about that...\Okay, you and I will go to the living room!\With just your body, I guess you can't hear me.\So what kind of experiment is this?\Oh, um...\I-If I ever find someone I like, response:	there might be chances for just my head to go out and do things.
context: Off you go, then!\I forgot about that...\Okay, you and I will go to the living room!\With just your body, I guess you can't hear me.\So what kind of experiment is this?\Oh, um...\I-If I ever find someone I like,\there might be chances for just my head to go out and do things. response:	So I thought I should work out any problems in advance.
context: I forgot about that...\Okay, you and I will go to the living room!\With just your body, I guess you can't hear me.\So what kind of experiment is this?\Oh, um...\I-If I ever find someone I like,\there might be chances for just my head to go out and do things.\So I thought I should work out any problems in advance. response:	Hmm, I get it. That's a great idea.
context: Okay, you and I will go to the living room!\With just your body, I guess you can't hear me.\So what kind of experiment is this?\Oh, um...\I-If I ever find someone I like,\there might be chances for just my head to go out and do things.\So I thought I should work out any problems in advance.\Hmm, I get it. That's a great idea. response:	She seems fidgety.
context: With just your body, I guess you can't hear me.\So what kind of experiment is this?\Oh, um...\I-If I ever find someone I like,\there might be chances for just my head to go out and do things.\So I thought I should work out any problems in advance.\Hmm, I get it. That's a great idea.\She seems fidgety. response:	She's gesturing.
context: So what kind of experiment is this?\Oh, um...\I-If I ever find someone I like,\there might be chances for just my head to go out and do things.\So I thought I should work out any problems in advance.\Hmm, I get it. That's a great idea.\She seems fidgety.\She's gesturing. response:	Showing me this won't do much good...
context: Oh, um...\I-If I ever find someone I like,\there might be chances for just my head to go out and do things.\So I thought I should work out any problems in advance.\Hmm, I get it. That's a great idea.\She seems fidgety.\She's gesturing.\Showing me this won't do much good... response:	What are they talking about?
context: I-If I ever find someone I like,\there might be chances for just my head to go out and do things.\So I thought I should work out any problems in advance.\Hmm, I get it. That's a great idea.\She seems fidgety.\She's gesturing.\Showing me this won't do much good...\What are they talking about? response:	Not long ago, the cherry trees here were in full bloom.
context: there might be chances for just my head to go out and do things.\So I thought I should work out any problems in advance.\Hmm, I get it. That's a great idea.\She seems fidgety.\She's gesturing.\Showing me this won't do much good...\What are they talking about?\Not long ago, the cherry trees here were in full bloom. response:	It's all green now.
context: So I thought I should work out any problems in advance.\Hmm, I get it. That's a great idea.\She seems fidgety.\She's gesturing.\Showing me this won't do much good...\What are they talking about?\Not long ago, the cherry trees here were in full bloom.\It's all green now. response:	I wish I could've seen them blooming.
context: Hmm, I get it. That's a great idea.\She seems fidgety.\She's gesturing.\Showing me this won't do much good...\What are they talking about?\Not long ago, the cherry trees here were in full bloom.\It's all green now.\I wish I could've seen them blooming. response:	Looks like it's going pretty well!
context: She seems fidgety.\She's gesturing.\Showing me this won't do much good...\What are they talking about?\Not long ago, the cherry trees here were in full bloom.\It's all green now.\I wish I could've seen them blooming.\Looks like it's going pretty well! response:	A notebook?
context: She's gesturing.\Showing me this won't do much good...\What are they talking about?\Not long ago, the cherry trees here were in full bloom.\It's all green now.\I wish I could've seen them blooming.\Looks like it's going pretty well!\A notebook? response:	You can write without seeing? That takes skill.
context: Showing me this won't do much good...\What are they talking about?\Not long ago, the cherry trees here were in full bloom.\It's all green now.\I wish I could've seen them blooming.\Looks like it's going pretty well!\A notebook?\You can write without seeing? That takes skill. response:	I'm having a great time. Thank you, Hikari-chan.
context: What are they talking about?\Not long ago, the cherry trees here were in full bloom.\It's all green now.\I wish I could've seen them blooming.\Looks like it's going pretty well!\A notebook?\You can write without seeing? That takes skill.\I'm having a great time. Thank you, Hikari-chan. response:	I'm having a great time. Thank you.
context: Not long ago, the cherry trees here were in full bloom.\It's all green now.\I wish I could've seen them blooming.\Looks like it's going pretty well!\A notebook?\You can write without seeing? That takes skill.\I'm having a great time. Thank you, Hikari-chan.\I'm having a great time. Thank you. response:	But it might be going too well.
context: It's all green now.\I wish I could've seen them blooming.\Looks like it's going pretty well!\A notebook?\You can write without seeing? That takes skill.\I'm having a great time. Thank you, Hikari-chan.\I'm having a great time. Thank you.\But it might be going too well. response:	And that kinda ticks me off!
context: I wish I could've seen them blooming.\Looks like it's going pretty well!\A notebook?\You can write without seeing? That takes skill.\I'm having a great time. Thank you, Hikari-chan.\I'm having a great time. Thank you.\But it might be going too well.\And that kinda ticks me off! response:	Wh-What's wrong?
context: Looks like it's going pretty well!\A notebook?\You can write without seeing? That takes skill.\I'm having a great time. Thank you, Hikari-chan.\I'm having a great time. Thank you.\But it might be going too well.\And that kinda ticks me off!\Wh-What's wrong? response:	Oh... N-Nothing.
context: A notebook?\You can write without seeing? That takes skill.\I'm having a great time. Thank you, Hikari-chan.\I'm having a great time. Thank you.\But it might be going too well.\And that kinda ticks me off!\Wh-What's wrong?\Oh... N-Nothing. response:	I just remembered something funny...
context: You can write without seeing? That takes skill.\I'm having a great time. Thank you, Hikari-chan.\I'm having a great time. Thank you.\But it might be going too well.\And that kinda ticks me off!\Wh-What's wrong?\Oh... N-Nothing.\I just remembered something funny... response:	Something funny?
context: I'm having a great time. Thank you, Hikari-chan.\I'm having a great time. Thank you.\But it might be going too well.\And that kinda ticks me off!\Wh-What's wrong?\Oh... N-Nothing.\I just remembered something funny...\Something funny? response:	She's mad! She's mad!
context: I'm having a great time. Thank you.\But it might be going too well.\And that kinda ticks me off!\Wh-What's wrong?\Oh... N-Nothing.\I just remembered something funny...\Something funny?\She's mad! She's mad! response:	Well?
context: But it might be going too well.\And that kinda ticks me off!\Wh-What's wrong?\Oh... N-Nothing.\I just remembered something funny...\Something funny?\She's mad! She's mad!\Well? response:	Y-Yes?
context: And that kinda ticks me off!\Wh-What's wrong?\Oh... N-Nothing.\I just remembered something funny...\Something funny?\She's mad! She's mad!\Well?\Y-Yes? response:	Have you found any problems yet?
context: Wh-What's wrong?\Oh... N-Nothing.\I just remembered something funny...\Something funny?\She's mad! She's mad!\Well?\Y-Yes?\Have you found any problems yet? response:	S-Sort of...
context: Oh... N-Nothing.\I just remembered something funny...\Something funny?\She's mad! She's mad!\Well?\Y-Yes?\Have you found any problems yet?\S-Sort of... response:	What's wrong?
context: I just remembered something funny...\Something funny?\She's mad! She's mad!\Well?\Y-Yes?\Have you found any problems yet?\S-Sort of...\What's wrong? response:	You don't look so good.
context: Something funny?\She's mad! She's mad!\Well?\Y-Yes?\Have you found any problems yet?\S-Sort of...\What's wrong?\You don't look so good. response:	Uh, no.
context: She's mad! She's mad!\Well?\Y-Yes?\Have you found any problems yet?\S-Sort of...\What's wrong?\You don't look so good.\Uh, no. response:	Just a bit of motion sickness...
context: Well?\Y-Yes?\Have you found any problems yet?\S-Sort of...\What's wrong?\You don't look so good.\Uh, no.\Just a bit of motion sickness... response:	You okay?
context: Y-Yes?\Have you found any problems yet?\S-Sort of...\What's wrong?\You don't look so good.\Uh, no.\Just a bit of motion sickness...\You okay? response:	Yes, I'm fine now.
context: Have you found any problems yet?\S-Sort of...\What's wrong?\You don't look so good.\Uh, no.\Just a bit of motion sickness...\You okay?\Yes, I'm fine now. response:	Sorry about that. This is new to me.
context: S-Sort of...\What's wrong?\You don't look so good.\Uh, no.\Just a bit of motion sickness...\You okay?\Yes, I'm fine now.\Sorry about that. This is new to me. response:	It's all right.
context: What's wrong?\You don't look so good.\Uh, no.\Just a bit of motion sickness...\You okay?\Yes, I'm fine now.\Sorry about that. This is new to me.\It's all right. response:	Um, this is a first for me, too.
context: You don't look so good.\Uh, no.\Just a bit of motion sickness...\You okay?\Yes, I'm fine now.\Sorry about that. This is new to me.\It's all right.\Um, this is a first for me, too. response:	B-Being on a d-date with a guy, I mean...
context: Uh, no.\Just a bit of motion sickness...\You okay?\Yes, I'm fine now.\Sorry about that. This is new to me.\It's all right.\Um, this is a first for me, too.\B-Being on a d-date with a guy, I mean... response:	But that means the experiment did produce results, huh?
context: Just a bit of motion sickness...\You okay?\Yes, I'm fine now.\Sorry about that. This is new to me.\It's all right.\Um, this is a first for me, too.\B-Being on a d-date with a guy, I mean...\But that means the experiment did produce results, huh? response:	Y-Yes! The experiment!
context: You okay?\Yes, I'm fine now.\Sorry about that. This is new to me.\It's all right.\Um, this is a first for me, too.\B-Being on a d-date with a guy, I mean...\But that means the experiment did produce results, huh?\Y-Yes! The experiment! response:	This is an experiment!
context: Yes, I'm fine now.\Sorry about that. This is new to me.\It's all right.\Um, this is a first for me, too.\B-Being on a d-date with a guy, I mean...\But that means the experiment did produce results, huh?\Y-Yes! The experiment!\This is an experiment! response:	I'm so glad I did this experiment!
context: Sorry about that. This is new to me.\It's all right.\Um, this is a first for me, too.\B-Being on a d-date with a guy, I mean...\But that means the experiment did produce results, huh?\Y-Yes! The experiment!\This is an experiment!\I'm so glad I did this experiment! response:	Class A's Kusakabe?
context: It's all right.\Um, this is a first for me, too.\B-Being on a d-date with a guy, I mean...\But that means the experiment did produce results, huh?\Y-Yes! The experiment!\This is an experiment!\I'm so glad I did this experiment!\Class A's Kusakabe? response:	Yes, she's a snow woman demi.
context: Um, this is a first for me, too.\B-Being on a d-date with a guy, I mean...\But that means the experiment did produce results, huh?\Y-Yes! The experiment!\This is an experiment!\I'm so glad I did this experiment!\Class A's Kusakabe?\Yes, she's a snow woman demi. response:	Of course I know her,
context: B-Being on a d-date with a guy, I mean...\But that means the experiment did produce results, huh?\Y-Yes! The experiment!\This is an experiment!\I'm so glad I did this experiment!\Class A's Kusakabe?\Yes, she's a snow woman demi.\Of course I know her, response:	but I haven't spoken to her.
context: But that means the experiment did produce results, huh?\Y-Yes! The experiment!\This is an experiment!\I'm so glad I did this experiment!\Class A's Kusakabe?\Yes, she's a snow woman demi.\Of course I know her,\but I haven't spoken to her. response:	What about her?
context: Y-Yes! The experiment!\This is an experiment!\I'm so glad I did this experiment!\Class A's Kusakabe?\Yes, she's a snow woman demi.\Of course I know her,\but I haven't spoken to her.\What about her? response:	Wh-When Hikari-chan and I were walking home together, we bumped into her,
context: This is an experiment!\I'm so glad I did this experiment!\Class A's Kusakabe?\Yes, she's a snow woman demi.\Of course I know her,\but I haven't spoken to her.\What about her?\Wh-When Hikari-chan and I were walking home together, we bumped into her, response:	and Hikari-chan suddenly hugged her.
context: I'm so glad I did this experiment!\Class A's Kusakabe?\Yes, she's a snow woman demi.\Of course I know her,\but I haven't spoken to her.\What about her?\Wh-When Hikari-chan and I were walking home together, we bumped into her,\and Hikari-chan suddenly hugged her. response:	Yeah, Hikari did say she clings to her a lot.
context: Class A's Kusakabe?\Yes, she's a snow woman demi.\Of course I know her,\but I haven't spoken to her.\What about her?\Wh-When Hikari-chan and I were walking home together, we bumped into her,\and Hikari-chan suddenly hugged her.\Yeah, Hikari did say she clings to her a lot. response:	And when she did, Kusakabe-san...
context: Yes, she's a snow woman demi.\Of course I know her,\but I haven't spoken to her.\What about her?\Wh-When Hikari-chan and I were walking home together, we bumped into her,\and Hikari-chan suddenly hugged her.\Yeah, Hikari did say she clings to her a lot.\And when she did, Kusakabe-san... response:	Did something happen?
context: Of course I know her,\but I haven't spoken to her.\What about her?\Wh-When Hikari-chan and I were walking home together, we bumped into her,\and Hikari-chan suddenly hugged her.\Yeah, Hikari did say she clings to her a lot.\And when she did, Kusakabe-san...\Did something happen? response:	I don't think it was that she disliked it, but...
context: but I haven't spoken to her.\What about her?\Wh-When Hikari-chan and I were walking home together, we bumped into her,\and Hikari-chan suddenly hugged her.\Yeah, Hikari did say she clings to her a lot.\And when she did, Kusakabe-san...\Did something happen?\I don't think it was that she disliked it, but... response:	She seemed almost scared.
context: What about her?\Wh-When Hikari-chan and I were walking home together, we bumped into her,\and Hikari-chan suddenly hugged her.\Yeah, Hikari did say she clings to her a lot.\And when she did, Kusakabe-san...\Did something happen?\I don't think it was that she disliked it, but...\She seemed almost scared. response:	Of Hikari?
context: Wh-When Hikari-chan and I were walking home together, we bumped into her,\and Hikari-chan suddenly hugged her.\Yeah, Hikari did say she clings to her a lot.\And when she did, Kusakabe-san...\Did something happen?\I don't think it was that she disliked it, but...\She seemed almost scared.\Of Hikari? response:	No, not that.
context: and Hikari-chan suddenly hugged her.\Yeah, Hikari did say she clings to her a lot.\And when she did, Kusakabe-san...\Did something happen?\I don't think it was that she disliked it, but...\She seemed almost scared.\Of Hikari?\No, not that. response:	I don't know how to put it.
context: Yeah, Hikari did say she clings to her a lot.\And when she did, Kusakabe-san...\Did something happen?\I don't think it was that she disliked it, but...\She seemed almost scared.\Of Hikari?\No, not that.\I don't know how to put it. response:	But it just bothered me a little.
context: And when she did, Kusakabe-san...\Did something happen?\I don't think it was that she disliked it, but...\She seemed almost scared.\Of Hikari?\No, not that.\I don't know how to put it.\But it just bothered me a little. response:	Should I try talking to her sometime?
context: Did something happen?\I don't think it was that she disliked it, but...\She seemed almost scared.\Of Hikari?\No, not that.\I don't know how to put it.\But it just bothered me a little.\Should I try talking to her sometime? response:	I can't hold it any longer...
context: I don't think it was that she disliked it, but...\She seemed almost scared.\Of Hikari?\No, not that.\I don't know how to put it.\But it just bothered me a little.\Should I try talking to her sometime?\I can't hold it any longer... response:	Ow!
context: She seemed almost scared.\Of Hikari?\No, not that.\I don't know how to put it.\But it just bothered me a little.\Should I try talking to her sometime?\I can't hold it any longer...\Ow! response:	What's wrong?
context: Of Hikari?\No, not that.\I don't know how to put it.\But it just bothered me a little.\Should I try talking to her sometime?\I can't hold it any longer...\Ow!\What's wrong? response:	N-Nothing, really.
context: No, not that.\I don't know how to put it.\But it just bothered me a little.\Should I try talking to her sometime?\I can't hold it any longer...\Ow!\What's wrong?\N-Nothing, really. response:	What's wrong, Macchi?
context: I don't know how to put it.\But it just bothered me a little.\Should I try talking to her sometime?\I can't hold it any longer...\Ow!\What's wrong?\N-Nothing, really.\What's wrong, Macchi? response:	M-Macchi...
context: But it just bothered me a little.\Should I try talking to her sometime?\I can't hold it any longer...\Ow!\What's wrong?\N-Nothing, really.\What's wrong, Macchi?\M-Macchi... response:	Macchi, here. Write it down.
context: Should I try talking to her sometime?\I can't hold it any longer...\Ow!\What's wrong?\N-Nothing, really.\What's wrong, Macchi?\M-Macchi...\Macchi, here. Write it down. response:	Bathroom
context: I can't hold it any longer...\Ow!\What's wrong?\N-Nothing, really.\What's wrong, Macchi?\M-Macchi...\Macchi, here. Write it down.\Bathroom response:	Bathroom...
context: Ow!\What's wrong?\N-Nothing, really.\What's wrong, Macchi?\M-Macchi...\Macchi, here. Write it down.\Bathroom\Bathroom... response:	Oh! You just need the bathroom?
context: What's wrong?\N-Nothing, really.\What's wrong, Macchi?\M-Macchi...\Macchi, here. Write it down.\Bathroom\Bathroom...\Oh! You just need the bathroom? response:	You really spooked me!
context: N-Nothing, really.\What's wrong, Macchi?\M-Macchi...\Macchi, here. Write it down.\Bathroom\Bathroom...\Oh! You just need the bathroom?\You really spooked me! response:	I'm home.
context: What's wrong, Macchi?\M-Macchi...\Macchi, here. Write it down.\Bathroom\Bathroom...\Oh! You just need the bathroom?\You really spooked me!\I'm home. response:	Onee-chan, is someone visiti
context: M-Macchi...\Macchi, here. Write it down.\Bathroom\Bathroom...\Oh! You just need the bathroom?\You really spooked me!\I'm home.\Onee-chan, is someone visiti response:	There we go, there we go...
context: Macchi, here. Write it down.\Bathroom\Bathroom...\Oh! You just need the bathroom?\You really spooked me!\I'm home.\Onee-chan, is someone visiti\There we go, there we go... response:	There we go, there we go...
context: Bathroom\Bathroom...\Oh! You just need the bathroom?\You really spooked me!\I'm home.\Onee-chan, is someone visiti\There we go, there we go...\There we go, there we go... response:	Huh? Something's here!
context: Bathroom...\Oh! You just need the bathroom?\You really spooked me!\I'm home.\Onee-chan, is someone visiti\There we go, there we go...\There we go, there we go...\Huh? Something's here! response:	There we go, there we go...
context: Oh! You just need the bathroom?\You really spooked me!\I'm home.\Onee-chan, is someone visiti\There we go, there we go...\There we go, there we go...\Huh? Something's here!\There we go, there we go... response:	Take your time...
context: You really spooked me!\I'm home.\Onee-chan, is someone visiti\There we go, there we go...\There we go, there we go...\Huh? Something's here!\There we go, there we go...\Take your time... response:	Whew, that was exhausting.
context: I'm home.\Onee-chan, is someone visiti\There we go, there we go...\There we go, there we go...\Huh? Something's here!\There we go, there we go...\Take your time...\Whew, that was exhausting. response:	Onee-chan?
context: Onee-chan, is someone visiti\There we go, there we go...\There we go, there we go...\Huh? Something's here!\There we go, there we go...\Take your time...\Whew, that was exhausting.\Onee-chan? response:	Who was that... person?
context: There we go, there we go...\There we go, there we go...\Huh? Something's here!\There we go, there we go...\Take your time...\Whew, that was exhausting.\Onee-chan?\Who was that... person? response:	My friend Macchi. She's a dullahan.
context: There we go, there we go...\Huh? Something's here!\There we go, there we go...\Take your time...\Whew, that was exhausting.\Onee-chan?\Who was that... person?\My friend Macchi. She's a dullahan. response:	Where'd you put her head?!
context: Huh? Something's here!\There we go, there we go...\Take your time...\Whew, that was exhausting.\Onee-chan?\Who was that... person?\My friend Macchi. She's a dullahan.\Where'd you put her head?! response:	Next time I see her, I'll just call out to her.
context: There we go, there we go...\Take your time...\Whew, that was exhausting.\Onee-chan?\Who was that... person?\My friend Macchi. She's a dullahan.\Where'd you put her head?!\Next time I see her, I'll just call out to her. response:	I shouldn't have had that juice.
context: Take your time...\Whew, that was exhausting.\Onee-chan?\Who was that... person?\My friend Macchi. She's a dullahan.\Where'd you put her head?!\Next time I see her, I'll just call out to her.\I shouldn't have had that juice. response:	Do you feel sick again?
context: Whew, that was exhausting.\Onee-chan?\Who was that... person?\My friend Macchi. She's a dullahan.\Where'd you put her head?!\Next time I see her, I'll just call out to her.\I shouldn't have had that juice.\Do you feel sick again? response:	Er, no, it isn't that.
context: Onee-chan?\Who was that... person?\My friend Macchi. She's a dullahan.\Where'd you put her head?!\Next time I see her, I'll just call out to her.\I shouldn't have had that juice.\Do you feel sick again?\Er, no, it isn't that. response:	I-It's nothing...
context: Who was that... person?\My friend Macchi. She's a dullahan.\Where'd you put her head?!\Next time I see her, I'll just call out to her.\I shouldn't have had that juice.\Do you feel sick again?\Er, no, it isn't that.\I-It's nothing... response:	How's this? Do you feel all right?
context: My friend Macchi. She's a dullahan.\Where'd you put her head?!\Next time I see her, I'll just call out to her.\I shouldn't have had that juice.\Do you feel sick again?\Er, no, it isn't that.\I-It's nothing...\How's this? Do you feel all right? response:	Yes, this is much better than before.
context: Where'd you put her head?!\Next time I see her, I'll just call out to her.\I shouldn't have had that juice.\Do you feel sick again?\Er, no, it isn't that.\I-It's nothing...\How's this? Do you feel all right?\Yes, this is much better than before. response:	You're amazing, Sensei.
context: Next time I see her, I'll just call out to her.\I shouldn't have had that juice.\Do you feel sick again?\Er, no, it isn't that.\I-It's nothing...\How's this? Do you feel all right?\Yes, this is much better than before.\You're amazing, Sensei. response:	I just remembered something I learned in school...
context: I shouldn't have had that juice.\Do you feel sick again?\Er, no, it isn't that.\I-It's nothing...\How's this? Do you feel all right?\Yes, this is much better than before.\You're amazing, Sensei.\I just remembered something I learned in school... response:	When people walk, their bodies move up and down.
context: Do you feel sick again?\Er, no, it isn't that.\I-It's nothing...\How's this? Do you feel all right?\Yes, this is much better than before.\You're amazing, Sensei.\I just remembered something I learned in school...\When people walk, their bodies move up and down. response:	But they don't feel it because they unconsciously move their necks
context: Er, no, it isn't that.\I-It's nothing...\How's this? Do you feel all right?\Yes, this is much better than before.\You're amazing, Sensei.\I just remembered something I learned in school...\When people walk, their bodies move up and down.\But they don't feel it because they unconsciously move their necks response:	and eyes to balance it out.
context: I-It's nothing...\How's this? Do you feel all right?\Yes, this is much better than before.\You're amazing, Sensei.\I just remembered something I learned in school...\When people walk, their bodies move up and down.\But they don't feel it because they unconsciously move their necks\and eyes to balance it out. response:	But for you, your arms function as your neck.
context: How's this? Do you feel all right?\Yes, this is much better than before.\You're amazing, Sensei.\I just remembered something I learned in school...\When people walk, their bodies move up and down.\But they don't feel it because they unconsciously move their necks\and eyes to balance it out.\But for you, your arms function as your neck. response:	I see... I'd never thought about that.
context: Yes, this is much better than before.\You're amazing, Sensei.\I just remembered something I learned in school...\When people walk, their bodies move up and down.\But they don't feel it because they unconsciously move their necks\and eyes to balance it out.\But for you, your arms function as your neck.\I see... I'd never thought about that. response:	So you need to find a dynamic balance.
context: You're amazing, Sensei.\I just remembered something I learned in school...\When people walk, their bodies move up and down.\But they don't feel it because they unconsciously move their necks\and eyes to balance it out.\But for you, your arms function as your neck.\I see... I'd never thought about that.\So you need to find a dynamic balance. response:	Or, in simpler terms, be like one of those balancing toys.
context: I just remembered something I learned in school...\When people walk, their bodies move up and down.\But they don't feel it because they unconsciously move their necks\and eyes to balance it out.\But for you, your arms function as your neck.\I see... I'd never thought about that.\So you need to find a dynamic balance.\Or, in simpler terms, be like one of those balancing toys. response:	Balancing toys?
context: When people walk, their bodies move up and down.\But they don't feel it because they unconsciously move their necks\and eyes to balance it out.\But for you, your arms function as your neck.\I see... I'd never thought about that.\So you need to find a dynamic balance.\Or, in simpler terms, be like one of those balancing toys.\Balancing toys? response:	Yeah, like using this arm to correct camera blur...
context: But they don't feel it because they unconsciously move their necks\and eyes to balance it out.\But for you, your arms function as your neck.\I see... I'd never thought about that.\So you need to find a dynamic balance.\Or, in simpler terms, be like one of those balancing toys.\Balancing toys?\Yeah, like using this arm to correct camera blur... response:	Takanashi
context: and eyes to balance it out.\But for you, your arms function as your neck.\I see... I'd never thought about that.\So you need to find a dynamic balance.\Or, in simpler terms, be like one of those balancing toys.\Balancing toys?\Yeah, like using this arm to correct camera blur...\Takanashi response:	Thanks for all your help today, Hikari-chan.
context: But for you, your arms function as your neck.\I see... I'd never thought about that.\So you need to find a dynamic balance.\Or, in simpler terms, be like one of those balancing toys.\Balancing toys?\Yeah, like using this arm to correct camera blur...\Takanashi\Thanks for all your help today, Hikari-chan. response:	Yeah, I really freaked out that one time, though!
context: I see... I'd never thought about that.\So you need to find a dynamic balance.\Or, in simpler terms, be like one of those balancing toys.\Balancing toys?\Yeah, like using this arm to correct camera blur...\Takanashi\Thanks for all your help today, Hikari-chan.\Yeah, I really freaked out that one time, though! response:	That one time?
context: So you need to find a dynamic balance.\Or, in simpler terms, be like one of those balancing toys.\Balancing toys?\Yeah, like using this arm to correct camera blur...\Takanashi\Thanks for all your help today, Hikari-chan.\Yeah, I really freaked out that one time, though!\That one time? response:	Nothing! It's nothing!
context: Or, in simpler terms, be like one of those balancing toys.\Balancing toys?\Yeah, like using this arm to correct camera blur...\Takanashi\Thanks for all your help today, Hikari-chan.\Yeah, I really freaked out that one time, though!\That one time?\Nothing! It's nothing! response:	Um, thank you for doing this with me, Sensei!
context: Balancing toys?\Yeah, like using this arm to correct camera blur...\Takanashi\Thanks for all your help today, Hikari-chan.\Yeah, I really freaked out that one time, though!\That one time?\Nothing! It's nothing!\Um, thank you for doing this with me, Sensei! response:	No, I should thank you.
context: Yeah, like using this arm to correct camera blur...\Takanashi\Thanks for all your help today, Hikari-chan.\Yeah, I really freaked out that one time, though!\That one time?\Nothing! It's nothing!\Um, thank you for doing this with me, Sensei!\No, I should thank you. response:	I learned a lot today.
context: Takanashi\Thanks for all your help today, Hikari-chan.\Yeah, I really freaked out that one time, though!\That one time?\Nothing! It's nothing!\Um, thank you for doing this with me, Sensei!\No, I should thank you.\I learned a lot today. response:	Then the experiment was a success.
context: Thanks for all your help today, Hikari-chan.\Yeah, I really freaked out that one time, though!\That one time?\Nothing! It's nothing!\Um, thank you for doing this with me, Sensei!\No, I should thank you.\I learned a lot today.\Then the experiment was a success. response:	Yep. A great success.
context: Yeah, I really freaked out that one time, though!\That one time?\Nothing! It's nothing!\Um, thank you for doing this with me, Sensei!\No, I should thank you.\I learned a lot today.\Then the experiment was a success.\Yep. A great success. response:	Grmff sffsmfs!
context: That one time?\Nothing! It's nothing!\Um, thank you for doing this with me, Sensei!\No, I should thank you.\I learned a lot today.\Then the experiment was a success.\Yep. A great success.\Grmff sffsmfs! response:	Bye-bye!
context: Nothing! It's nothing!\Um, thank you for doing this with me, Sensei!\No, I should thank you.\I learned a lot today.\Then the experiment was a success.\Yep. A great success.\Grmff sffsmfs!\Bye-bye! response:	See you later!
context: Um, thank you for doing this with me, Sensei!\No, I should thank you.\I learned a lot today.\Then the experiment was a success.\Yep. A great success.\Grmff sffsmfs!\Bye-bye!\See you later! response:	Hey, Sensei.
context: No, I should thank you.\I learned a lot today.\Then the experiment was a success.\Yep. A great success.\Grmff sffsmfs!\Bye-bye!\See you later!\Hey, Sensei. response:	What?
context: I learned a lot today.\Then the experiment was a success.\Yep. A great success.\Grmff sffsmfs!\Bye-bye!\See you later!\Hey, Sensei.\What? response:	About Macchi...
context: Then the experiment was a success.\Yep. A great success.\Grmff sffsmfs!\Bye-bye!\See you later!\Hey, Sensei.\What?\About Macchi... response:	What about her?
context: Yep. A great success.\Grmff sffsmfs!\Bye-bye!\See you later!\Hey, Sensei.\What?\About Macchi...\What about her? response:	Principal, dullahans need to always carry their heads.
context: Grmff sffsmfs!\Bye-bye!\See you later!\Hey, Sensei.\What?\About Macchi...\What about her?\Principal, dullahans need to always carry their heads. response:	So carrying a regulation bag takes up one hand.
context: Bye-bye!\See you later!\Hey, Sensei.\What?\About Macchi...\What about her?\Principal, dullahans need to always carry their heads.\So carrying a regulation bag takes up one hand. response:	It's inconvenient. Worse, it's dangerous.
context: See you later!\Hey, Sensei.\What?\About Macchi...\What about her?\Principal, dullahans need to always carry their heads.\So carrying a regulation bag takes up one hand.\It's inconvenient. Worse, it's dangerous. response:	For class 1-B's Machi Kyouko, couldn't you give permission
context: Hey, Sensei.\What?\About Macchi...\What about her?\Principal, dullahans need to always carry their heads.\So carrying a regulation bag takes up one hand.\It's inconvenient. Worse, it's dangerous.\For class 1-B's Machi Kyouko, couldn't you give permission response:	to use a backpack instead of the regulation bag?
context: What?\About Macchi...\What about her?\Principal, dullahans need to always carry their heads.\So carrying a regulation bag takes up one hand.\It's inconvenient. Worse, it's dangerous.\For class 1-B's Machi Kyouko, couldn't you give permission\to use a backpack instead of the regulation bag? response:	That's a good point. I didn't give that enough thought.
context: About Macchi...\What about her?\Principal, dullahans need to always carry their heads.\So carrying a regulation bag takes up one hand.\It's inconvenient. Worse, it's dangerous.\For class 1-B's Machi Kyouko, couldn't you give permission\to use a backpack instead of the regulation bag?\That's a good point. I didn't give that enough thought. response:	Of course I'll grant permission.
context: What about her?\Principal, dullahans need to always carry their heads.\So carrying a regulation bag takes up one hand.\It's inconvenient. Worse, it's dangerous.\For class 1-B's Machi Kyouko, couldn't you give permission\to use a backpack instead of the regulation bag?\That's a good point. I didn't give that enough thought.\Of course I'll grant permission. response:	Thank you.
context: Principal, dullahans need to always carry their heads.\So carrying a regulation bag takes up one hand.\It's inconvenient. Worse, it's dangerous.\For class 1-B's Machi Kyouko, couldn't you give permission\to use a backpack instead of the regulation bag?\That's a good point. I didn't give that enough thought.\Of course I'll grant permission.\Thank you. response:	I have one other favor to ask.
context: So carrying a regulation bag takes up one hand.\It's inconvenient. Worse, it's dangerous.\For class 1-B's Machi Kyouko, couldn't you give permission\to use a backpack instead of the regulation bag?\That's a good point. I didn't give that enough thought.\Of course I'll grant permission.\Thank you.\I have one other favor to ask. response:	What is it?
context: It's inconvenient. Worse, it's dangerous.\For class 1-B's Machi Kyouko, couldn't you give permission\to use a backpack instead of the regulation bag?\That's a good point. I didn't give that enough thought.\Of course I'll grant permission.\Thank you.\I have one other favor to ask.\What is it? response:	We should also consider her homeroom teacher's position.
context: For class 1-B's Machi Kyouko, couldn't you give permission\to use a backpack instead of the regulation bag?\That's a good point. I didn't give that enough thought.\Of course I'll grant permission.\Thank you.\I have one other favor to ask.\What is it?\We should also consider her homeroom teacher's position. response:	So could we just say this was your order?
context: to use a backpack instead of the regulation bag?\That's a good point. I didn't give that enough thought.\Of course I'll grant permission.\Thank you.\I have one other favor to ask.\What is it?\We should also consider her homeroom teacher's position.\So could we just say this was your order? response:	I see. Very well.
context: That's a good point. I didn't give that enough thought.\Of course I'll grant permission.\Thank you.\I have one other favor to ask.\What is it?\We should also consider her homeroom teacher's position.\So could we just say this was your order?\I see. Very well. response:	Morning, Sensei!
context: Of course I'll grant permission.\Thank you.\I have one other favor to ask.\What is it?\We should also consider her homeroom teacher's position.\So could we just say this was your order?\I see. Very well.\Morning, Sensei! response:	Good morning.
context: Thank you.\I have one other favor to ask.\What is it?\We should also consider her homeroom teacher's position.\So could we just say this was your order?\I see. Very well.\Morning, Sensei!\Good morning. response:	Hey. Oh, a backpack?
context: I have one other favor to ask.\What is it?\We should also consider her homeroom teacher's position.\So could we just say this was your order?\I see. Very well.\Morning, Sensei!\Good morning.\Hey. Oh, a backpack? response:	Yes. Yesterday, my homeroom teacher told me I could use this instead.
context: What is it?\We should also consider her homeroom teacher's position.\So could we just say this was your order?\I see. Very well.\Morning, Sensei!\Good morning.\Hey. Oh, a backpack?\Yes. Yesterday, my homeroom teacher told me I could use this instead. response:	You're looking good, Macchi!
context: We should also consider her homeroom teacher's position.\So could we just say this was your order?\I see. Very well.\Morning, Sensei!\Good morning.\Hey. Oh, a backpack?\Yes. Yesterday, my homeroom teacher told me I could use this instead.\You're looking good, Macchi! response:	Right, Sensei?
context: So could we just say this was your order?\I see. Very well.\Morning, Sensei!\Good morning.\Hey. Oh, a backpack?\Yes. Yesterday, my homeroom teacher told me I could use this instead.\You're looking good, Macchi!\Right, Sensei? response:	Yeah, it suits you.
context: I see. Very well.\Morning, Sensei!\Good morning.\Hey. Oh, a backpack?\Yes. Yesterday, my homeroom teacher told me I could use this instead.\You're looking good, Macchi!\Right, Sensei?\Yeah, it suits you. response:	Next Time Succubus-san is a Good Adult
context: Morning, Sensei!\Good morning.\Hey. Oh, a backpack?\Yes. Yesterday, my homeroom teacher told me I could use this instead.\You're looking good, Macchi!\Right, Sensei?\Yeah, it suits you.\Next Time Succubus-san is a Good Adult response:	Succubus-san is a Good Adult.