context: It was great! response:	Here.
context: It was great!\Here. response:	Let's go up to the roof.
context: It was great!\Here.\Let's go up to the roof. response:	I'm sorry...
context: It was great!\Here.\Let's go up to the roof.\I'm sorry... response:	Huh?
context: It was great!\Here.\Let's go up to the roof.\I'm sorry...\Huh? response:	I'm sorry... I didn't stop her.
context: It was great!\Here.\Let's go up to the roof.\I'm sorry...\Huh?\I'm sorry... I didn't stop her. response:	Sometimes snow isn't a bad thing at all.
context: It was great!\Here.\Let's go up to the roof.\I'm sorry...\Huh?\I'm sorry... I didn't stop her.\Sometimes snow isn't a bad thing at all. response:	Because of the snow, all she had is a broken bone.
context: It was great!\Here.\Let's go up to the roof.\I'm sorry...\Huh?\I'm sorry... I didn't stop her.\Sometimes snow isn't a bad thing at all.\Because of the snow, all she had is a broken bone. response:	Put that aside, it's beautiful.
context: Here.\Let's go up to the roof.\I'm sorry...\Huh?\I'm sorry... I didn't stop her.\Sometimes snow isn't a bad thing at all.\Because of the snow, all she had is a broken bone.\Put that aside, it's beautiful. response:	She's really pretty.
context: Let's go up to the roof.\I'm sorry...\Huh?\I'm sorry... I didn't stop her.\Sometimes snow isn't a bad thing at all.\Because of the snow, all she had is a broken bone.\Put that aside, it's beautiful.\She's really pretty. response:	Why couldn't she cry?
context: I'm sorry...\Huh?\I'm sorry... I didn't stop her.\Sometimes snow isn't a bad thing at all.\Because of the snow, all she had is a broken bone.\Put that aside, it's beautiful.\She's really pretty.\Why couldn't she cry? response:	Perhaps she has a strong mind?
context: Huh?\I'm sorry... I didn't stop her.\Sometimes snow isn't a bad thing at all.\Because of the snow, all she had is a broken bone.\Put that aside, it's beautiful.\She's really pretty.\Why couldn't she cry?\Perhaps she has a strong mind? response:	Is that all of it?
context: I'm sorry... I didn't stop her.\Sometimes snow isn't a bad thing at all.\Because of the snow, all she had is a broken bone.\Put that aside, it's beautiful.\She's really pretty.\Why couldn't she cry?\Perhaps she has a strong mind?\Is that all of it? response:	Go away.
context: Sometimes snow isn't a bad thing at all.\Because of the snow, all she had is a broken bone.\Put that aside, it's beautiful.\She's really pretty.\Why couldn't she cry?\Perhaps she has a strong mind?\Is that all of it?\Go away. response:	I can never forgive you.
context: Because of the snow, all she had is a broken bone.\Put that aside, it's beautiful.\She's really pretty.\Why couldn't she cry?\Perhaps she has a strong mind?\Is that all of it?\Go away.\I can never forgive you. response:	Are you awake?
context: Put that aside, it's beautiful.\She's really pretty.\Why couldn't she cry?\Perhaps she has a strong mind?\Is that all of it?\Go away.\I can never forgive you.\Are you awake? response:	Are you thristy, perhaps?
context: She's really pretty.\Why couldn't she cry?\Perhaps she has a strong mind?\Is that all of it?\Go away.\I can never forgive you.\Are you awake?\Are you thristy, perhaps? response:	Oh yeah, I've some coffee...
context: Why couldn't she cry?\Perhaps she has a strong mind?\Is that all of it?\Go away.\I can never forgive you.\Are you awake?\Are you thristy, perhaps?\Oh yeah, I've some coffee... response:	I'm sorry.
context: Perhaps she has a strong mind?\Is that all of it?\Go away.\I can never forgive you.\Are you awake?\Are you thristy, perhaps?\Oh yeah, I've some coffee...\I'm sorry. response:	I was wondering if I can do it too after I saw Shinichirou's dance.
context: Is that all of it?\Go away.\I can never forgive you.\Are you awake?\Are you thristy, perhaps?\Oh yeah, I've some coffee...\I'm sorry.\I was wondering if I can do it too after I saw Shinichirou's dance. response:	Onii-chan worried about me again...
context: Go away.\I can never forgive you.\Are you awake?\Are you thristy, perhaps?\Oh yeah, I've some coffee...\I'm sorry.\I was wondering if I can do it too after I saw Shinichirou's dance.\Onii-chan worried about me again... response:	And I also hurted your feelings...
context: I can never forgive you.\Are you awake?\Are you thristy, perhaps?\Oh yeah, I've some coffee...\I'm sorry.\I was wondering if I can do it too after I saw Shinichirou's dance.\Onii-chan worried about me again...\And I also hurted your feelings... response:	You didn't do anything wrong.
context: Are you awake?\Are you thristy, perhaps?\Oh yeah, I've some coffee...\I'm sorry.\I was wondering if I can do it too after I saw Shinichirou's dance.\Onii-chan worried about me again...\And I also hurted your feelings...\You didn't do anything wrong. response:	I was determined to do it, and you knew nothing about it.
context: Are you thristy, perhaps?\Oh yeah, I've some coffee...\I'm sorry.\I was wondering if I can do it too after I saw Shinichirou's dance.\Onii-chan worried about me again...\And I also hurted your feelings...\You didn't do anything wrong.\I was determined to do it, and you knew nothing about it. response:	It's wrong because I know nothing about it...
context: Oh yeah, I've some coffee...\I'm sorry.\I was wondering if I can do it too after I saw Shinichirou's dance.\Onii-chan worried about me again...\And I also hurted your feelings...\You didn't do anything wrong.\I was determined to do it, and you knew nothing about it.\It's wrong because I know nothing about it... response:	You were only hurt because I know nothing about it.
context: I'm sorry.\I was wondering if I can do it too after I saw Shinichirou's dance.\Onii-chan worried about me again...\And I also hurted your feelings...\You didn't do anything wrong.\I was determined to do it, and you knew nothing about it.\It's wrong because I know nothing about it...\You were only hurt because I know nothing about it. response:	If I knew, then I could have avoided getting you hurt...
context: I was wondering if I can do it too after I saw Shinichirou's dance.\Onii-chan worried about me again...\And I also hurted your feelings...\You didn't do anything wrong.\I was determined to do it, and you knew nothing about it.\It's wrong because I know nothing about it...\You were only hurt because I know nothing about it.\If I knew, then I could have avoided getting you hurt... response:	Did you see that yesterday?
context: Onii-chan worried about me again...\And I also hurted your feelings...\You didn't do anything wrong.\I was determined to do it, and you knew nothing about it.\It's wrong because I know nothing about it...\You were only hurt because I know nothing about it.\If I knew, then I could have avoided getting you hurt...\Did you see that yesterday? response:	Of course I did!
context: And I also hurted your feelings...\You didn't do anything wrong.\I was determined to do it, and you knew nothing about it.\It's wrong because I know nothing about it...\You were only hurt because I know nothing about it.\If I knew, then I could have avoided getting you hurt...\Did you see that yesterday?\Of course I did! response:	Hey, put that over there.
context: You didn't do anything wrong.\I was determined to do it, and you knew nothing about it.\It's wrong because I know nothing about it...\You were only hurt because I know nothing about it.\If I knew, then I could have avoided getting you hurt...\Did you see that yesterday?\Of course I did!\Hey, put that over there. response:	Got it!
context: I was determined to do it, and you knew nothing about it.\It's wrong because I know nothing about it...\You were only hurt because I know nothing about it.\If I knew, then I could have avoided getting you hurt...\Did you see that yesterday?\Of course I did!\Hey, put that over there.\Got it! response:	It's all my fault...
context: It's wrong because I know nothing about it...\You were only hurt because I know nothing about it.\If I knew, then I could have avoided getting you hurt...\Did you see that yesterday?\Of course I did!\Hey, put that over there.\Got it!\It's all my fault... response:	Things are ought to be less troublesome if everybody thinks it's their fault.
context: You were only hurt because I know nothing about it.\If I knew, then I could have avoided getting you hurt...\Did you see that yesterday?\Of course I did!\Hey, put that over there.\Got it!\It's all my fault...\Things are ought to be less troublesome if everybody thinks it's their fault. response:	It's fine, you have nothing to do with it.
context: If I knew, then I could have avoided getting you hurt...\Did you see that yesterday?\Of course I did!\Hey, put that over there.\Got it!\It's all my fault...\Things are ought to be less troublesome if everybody thinks it's their fault.\It's fine, you have nothing to do with it. response:	I've nothing to do with it?
context: Did you see that yesterday?\Of course I did!\Hey, put that over there.\Got it!\It's all my fault...\Things are ought to be less troublesome if everybody thinks it's their fault.\It's fine, you have nothing to do with it.\I've nothing to do with it? response:	You don't like that?
context: Of course I did!\Hey, put that over there.\Got it!\It's all my fault...\Things are ought to be less troublesome if everybody thinks it's their fault.\It's fine, you have nothing to do with it.\I've nothing to do with it?\You don't like that? response:	Is that some trash from the festival?
context: Hey, put that over there.\Got it!\It's all my fault...\Things are ought to be less troublesome if everybody thinks it's their fault.\It's fine, you have nothing to do with it.\I've nothing to do with it?\You don't like that?\Is that some trash from the festival? response:	Did you see it?
context: Got it!\It's all my fault...\Things are ought to be less troublesome if everybody thinks it's their fault.\It's fine, you have nothing to do with it.\I've nothing to do with it?\You don't like that?\Is that some trash from the festival?\Did you see it? response:	Nah, I was working.
context: It's all my fault...\Things are ought to be less troublesome if everybody thinks it's their fault.\It's fine, you have nothing to do with it.\I've nothing to do with it?\You don't like that?\Is that some trash from the festival?\Did you see it?\Nah, I was working. response:	You probably did, right?
context: Things are ought to be less troublesome if everybody thinks it's their fault.\It's fine, you have nothing to do with it.\I've nothing to do with it?\You don't like that?\Is that some trash from the festival?\Did you see it?\Nah, I was working.\You probably did, right? response:	Yup, it's was really spectacular.
context: It's fine, you have nothing to do with it.\I've nothing to do with it?\You don't like that?\Is that some trash from the festival?\Did you see it?\Nah, I was working.\You probably did, right?\Yup, it's was really spectacular. response:	I see...
context: I've nothing to do with it?\You don't like that?\Is that some trash from the festival?\Did you see it?\Nah, I was working.\You probably did, right?\Yup, it's was really spectacular.\I see... response:	I'm sorry...
context: You don't like that?\Is that some trash from the festival?\Did you see it?\Nah, I was working.\You probably did, right?\Yup, it's was really spectacular.\I see...\I'm sorry... response:	It's fine.
context: Is that some trash from the festival?\Did you see it?\Nah, I was working.\You probably did, right?\Yup, it's was really spectacular.\I see...\I'm sorry...\It's fine. response:	Just as you said, I don't like you.
context: Did you see it?\Nah, I was working.\You probably did, right?\Yup, it's was really spectacular.\I see...\I'm sorry...\It's fine.\Just as you said, I don't like you. response:	Not even a tiny bit.
context: Nah, I was working.\You probably did, right?\Yup, it's was really spectacular.\I see...\I'm sorry...\It's fine.\Just as you said, I don't like you.\Not even a tiny bit. response:	Nakagami-kun, that was really cool!
context: You probably did, right?\Yup, it's was really spectacular.\I see...\I'm sorry...\It's fine.\Just as you said, I don't like you.\Not even a tiny bit.\Nakagami-kun, that was really cool! response:	That was awesome!
context: Yup, it's was really spectacular.\I see...\I'm sorry...\It's fine.\Just as you said, I don't like you.\Not even a tiny bit.\Nakagami-kun, that was really cool!\That was awesome! response:	You're everybody's hero, Shinichirou-kun.
context: I see...\I'm sorry...\It's fine.\Just as you said, I don't like you.\Not even a tiny bit.\Nakagami-kun, that was really cool!\That was awesome!\You're everybody's hero, Shinichirou-kun. response:	Shut up!
context: I'm sorry...\It's fine.\Just as you said, I don't like you.\Not even a tiny bit.\Nakagami-kun, that was really cool!\That was awesome!\You're everybody's hero, Shinichirou-kun.\Shut up! response:	Can you stop by my apartment after school?
context: It's fine.\Just as you said, I don't like you.\Not even a tiny bit.\Nakagami-kun, that was really cool!\That was awesome!\You're everybody's hero, Shinichirou-kun.\Shut up!\Can you stop by my apartment after school? response:	Hey!
context: Just as you said, I don't like you.\Not even a tiny bit.\Nakagami-kun, that was really cool!\That was awesome!\You're everybody's hero, Shinichirou-kun.\Shut up!\Can you stop by my apartment after school?\Hey! response:	Shinichirou-kun.
context: Not even a tiny bit.\Nakagami-kun, that was really cool!\That was awesome!\You're everybody's hero, Shinichirou-kun.\Shut up!\Can you stop by my apartment after school?\Hey!\Shinichirou-kun. response:	Here.
context: Nakagami-kun, that was really cool!\That was awesome!\You're everybody's hero, Shinichirou-kun.\Shut up!\Can you stop by my apartment after school?\Hey!\Shinichirou-kun.\Here. response:	Huh, where's your coffee?
context: That was awesome!\You're everybody's hero, Shinichirou-kun.\Shut up!\Can you stop by my apartment after school?\Hey!\Shinichirou-kun.\Here.\Huh, where's your coffee? response:	I broke one of the cups.
context: You're everybody's hero, Shinichirou-kun.\Shut up!\Can you stop by my apartment after school?\Hey!\Shinichirou-kun.\Here.\Huh, where's your coffee?\I broke one of the cups. response:	It's fine...
context: Shut up!\Can you stop by my apartment after school?\Hey!\Shinichirou-kun.\Here.\Huh, where's your coffee?\I broke one of the cups.\It's fine... response:	Fine...? What do you mean?
context: Can you stop by my apartment after school?\Hey!\Shinichirou-kun.\Here.\Huh, where's your coffee?\I broke one of the cups.\It's fine...\Fine...? What do you mean? response:	What's going on with you...
context: Hey!\Shinichirou-kun.\Here.\Huh, where's your coffee?\I broke one of the cups.\It's fine...\Fine...? What do you mean?\What's going on with you... response:	You seems strange today.
context: Shinichirou-kun.\Here.\Huh, where's your coffee?\I broke one of the cups.\It's fine...\Fine...? What do you mean?\What's going on with you...\You seems strange today. response:	Don't hate me...
context: Here.\Huh, where's your coffee?\I broke one of the cups.\It's fine...\Fine...? What do you mean?\What's going on with you...\You seems strange today.\Don't hate me... response:	I'm not!
context: Huh, where's your coffee?\I broke one of the cups.\It's fine...\Fine...? What do you mean?\What's going on with you...\You seems strange today.\Don't hate me...\I'm not! response:	You liar...
context: I broke one of the cups.\It's fine...\Fine...? What do you mean?\What's going on with you...\You seems strange today.\Don't hate me...\I'm not!\You liar... response:	Hiromi...
context: It's fine...\Fine...? What do you mean?\What's going on with you...\You seems strange today.\Don't hate me...\I'm not!\You liar...\Hiromi... response:	I'm sorry...
context: Fine...? What do you mean?\What's going on with you...\You seems strange today.\Don't hate me...\I'm not!\You liar...\Hiromi...\I'm sorry... response:	I'm a bit off my mind...
context: What's going on with you...\You seems strange today.\Don't hate me...\I'm not!\You liar...\Hiromi...\I'm sorry...\I'm a bit off my mind... response:	Sorry, but please go home.
context: You seems strange today.\Don't hate me...\I'm not!\You liar...\Hiromi...\I'm sorry...\I'm a bit off my mind...\Sorry, but please go home. response:	It's a lie that my tears are beautiful.
context: Don't hate me...\I'm not!\You liar...\Hiromi...\I'm sorry...\I'm a bit off my mind...\Sorry, but please go home.\It's a lie that my tears are beautiful. response:	Slowly... slowly...
context: I'm not!\You liar...\Hiromi...\I'm sorry...\I'm a bit off my mind...\Sorry, but please go home.\It's a lie that my tears are beautiful.\Slowly... slowly... response:	Slowly... slowly...
context: You liar...\Hiromi...\I'm sorry...\I'm a bit off my mind...\Sorry, but please go home.\It's a lie that my tears are beautiful.\Slowly... slowly...\Slowly... slowly... response:	I became someone that's hated.
context: Hiromi...\I'm sorry...\I'm a bit off my mind...\Sorry, but please go home.\It's a lie that my tears are beautiful.\Slowly... slowly...\Slowly... slowly...\I became someone that's hated. response:	I can see everything, Hiromi-san.
context: I'm sorry...\I'm a bit off my mind...\Sorry, but please go home.\It's a lie that my tears are beautiful.\Slowly... slowly...\Slowly... slowly...\I became someone that's hated.\I can see everything, Hiromi-san. response:	Nice shoot!
context: I'm a bit off my mind...\Sorry, but please go home.\It's a lie that my tears are beautiful.\Slowly... slowly...\Slowly... slowly...\I became someone that's hated.\I can see everything, Hiromi-san.\Nice shoot! response:	I'm home.
context: Sorry, but please go home.\It's a lie that my tears are beautiful.\Slowly... slowly...\Slowly... slowly...\I became someone that's hated.\I can see everything, Hiromi-san.\Nice shoot!\I'm home. response:	There's a call for you.
context: It's a lie that my tears are beautiful.\Slowly... slowly...\Slowly... slowly...\I became someone that's hated.\I can see everything, Hiromi-san.\Nice shoot!\I'm home.\There's a call for you. response:	The phone.
context: Slowly... slowly...\Slowly... slowly...\I became someone that's hated.\I can see everything, Hiromi-san.\Nice shoot!\I'm home.\There's a call for you.\The phone. response:	Is it the publisher?
context: Slowly... slowly...\I became someone that's hated.\I can see everything, Hiromi-san.\Nice shoot!\I'm home.\There's a call for you.\The phone.\Is it the publisher? response:	Yeah...
context: I became someone that's hated.\I can see everything, Hiromi-san.\Nice shoot!\I'm home.\There's a call for you.\The phone.\Is it the publisher?\Yeah... response:	They want me to send in more.
context: I can see everything, Hiromi-san.\Nice shoot!\I'm home.\There's a call for you.\The phone.\Is it the publisher?\Yeah...\They want me to send in more. response:	Hey, dad...
context: Nice shoot!\I'm home.\There's a call for you.\The phone.\Is it the publisher?\Yeah...\They want me to send in more.\Hey, dad... response:	When do you usually cry?
context: I'm home.\There's a call for you.\The phone.\Is it the publisher?\Yeah...\They want me to send in more.\Hey, dad...\When do you usually cry? response:	When my heart's trembling... Perhaps...
context: There's a call for you.\The phone.\Is it the publisher?\Yeah...\They want me to send in more.\Hey, dad...\When do you usually cry?\When my heart's trembling... Perhaps... response:	Thanks.
context: The phone.\Is it the publisher?\Yeah...\They want me to send in more.\Hey, dad...\When do you usually cry?\When my heart's trembling... Perhaps...\Thanks. response:	When my heart trembles...
context: Is it the publisher?\Yeah...\They want me to send in more.\Hey, dad...\When do you usually cry?\When my heart's trembling... Perhaps...\Thanks.\When my heart trembles... response:	Hey, what's wrong?
context: Yeah...\They want me to send in more.\Hey, dad...\When do you usually cry?\When my heart's trembling... Perhaps...\Thanks.\When my heart trembles...\Hey, what's wrong? response:	Yeah, I want to talk to Shinichirou-kun.
context: They want me to send in more.\Hey, dad...\When do you usually cry?\When my heart's trembling... Perhaps...\Thanks.\When my heart trembles...\Hey, what's wrong?\Yeah, I want to talk to Shinichirou-kun. response:	Hiromi.
context: Hey, dad...\When do you usually cry?\When my heart's trembling... Perhaps...\Thanks.\When my heart trembles...\Hey, what's wrong?\Yeah, I want to talk to Shinichirou-kun.\Hiromi. response:	Shin-chan, there's some cheese cake in the fridge that someone brought over.
context: When do you usually cry?\When my heart's trembling... Perhaps...\Thanks.\When my heart trembles...\Hey, what's wrong?\Yeah, I want to talk to Shinichirou-kun.\Hiromi.\Shin-chan, there's some cheese cake in the fridge that someone brought over. response:	Err... The Che-
context: When my heart's trembling... Perhaps...\Thanks.\When my heart trembles...\Hey, what's wrong?\Yeah, I want to talk to Shinichirou-kun.\Hiromi.\Shin-chan, there's some cheese cake in the fridge that someone brought over.\Err... The Che- response:	Let's talk right here.
context: Thanks.\When my heart trembles...\Hey, what's wrong?\Yeah, I want to talk to Shinichirou-kun.\Hiromi.\Shin-chan, there's some cheese cake in the fridge that someone brought over.\Err... The Che-\Let's talk right here. response:	I think I am ashamed.
context: When my heart trembles...\Hey, what's wrong?\Yeah, I want to talk to Shinichirou-kun.\Hiromi.\Shin-chan, there's some cheese cake in the fridge that someone brought over.\Err... The Che-\Let's talk right here.\I think I am ashamed. response:	I hate how I am now.
context: Hey, what's wrong?\Yeah, I want to talk to Shinichirou-kun.\Hiromi.\Shin-chan, there's some cheese cake in the fridge that someone brought over.\Err... The Che-\Let's talk right here.\I think I am ashamed.\I hate how I am now. response:	So...
context: Yeah, I want to talk to Shinichirou-kun.\Hiromi.\Shin-chan, there's some cheese cake in the fridge that someone brought over.\Err... The Che-\Let's talk right here.\I think I am ashamed.\I hate how I am now.\So... response:	I never wanted to give up because I've always loved you.
context: Hiromi.\Shin-chan, there's some cheese cake in the fridge that someone brought over.\Err... The Che-\Let's talk right here.\I think I am ashamed.\I hate how I am now.\So...\I never wanted to give up because I've always loved you. response:	But in turn, I don't want to give you any trouble.
context: Shin-chan, there's some cheese cake in the fridge that someone brought over.\Err... The Che-\Let's talk right here.\I think I am ashamed.\I hate how I am now.\So...\I never wanted to give up because I've always loved you.\But in turn, I don't want to give you any trouble. response:	So, I hope you can face all this,
context: Err... The Che-\Let's talk right here.\I think I am ashamed.\I hate how I am now.\So...\I never wanted to give up because I've always loved you.\But in turn, I don't want to give you any trouble.\So, I hope you can face all this, response:	No matter if it's me, or Isurugi-san,
context: Let's talk right here.\I think I am ashamed.\I hate how I am now.\So...\I never wanted to give up because I've always loved you.\But in turn, I don't want to give you any trouble.\So, I hope you can face all this,\No matter if it's me, or Isurugi-san, response:	I want Shinichirou-kun to face it, and make a proper decision.
context: I think I am ashamed.\I hate how I am now.\So...\I never wanted to give up because I've always loved you.\But in turn, I don't want to give you any trouble.\So, I hope you can face all this,\No matter if it's me, or Isurugi-san,\I want Shinichirou-kun to face it, and make a proper decision. response:	I am going to accept it too.
context: I hate how I am now.\So...\I never wanted to give up because I've always loved you.\But in turn, I don't want to give you any trouble.\So, I hope you can face all this,\No matter if it's me, or Isurugi-san,\I want Shinichirou-kun to face it, and make a proper decision.\I am going to accept it too. response:	You know,
context: So...\I never wanted to give up because I've always loved you.\But in turn, I don't want to give you any trouble.\So, I hope you can face all this,\No matter if it's me, or Isurugi-san,\I want Shinichirou-kun to face it, and make a proper decision.\I am going to accept it too.\You know, response:	Hiromi, you aren't bad.
context: I never wanted to give up because I've always loved you.\But in turn, I don't want to give you any trouble.\So, I hope you can face all this,\No matter if it's me, or Isurugi-san,\I want Shinichirou-kun to face it, and make a proper decision.\I am going to accept it too.\You know,\Hiromi, you aren't bad. response:	You're pretty cool.
context: But in turn, I don't want to give you any trouble.\So, I hope you can face all this,\No matter if it's me, or Isurugi-san,\I want Shinichirou-kun to face it, and make a proper decision.\I am going to accept it too.\You know,\Hiromi, you aren't bad.\You're pretty cool. response:	I'm an athelete, after all.
context: So, I hope you can face all this,\No matter if it's me, or Isurugi-san,\I want Shinichirou-kun to face it, and make a proper decision.\I am going to accept it too.\You know,\Hiromi, you aren't bad.\You're pretty cool.\I'm an athelete, after all. response:	Shin-chan, you going out?
context: No matter if it's me, or Isurugi-san,\I want Shinichirou-kun to face it, and make a proper decision.\I am going to accept it too.\You know,\Hiromi, you aren't bad.\You're pretty cool.\I'm an athelete, after all.\Shin-chan, you going out? response:	Yeah, I'm heading out for a second.
context: I want Shinichirou-kun to face it, and make a proper decision.\I am going to accept it too.\You know,\Hiromi, you aren't bad.\You're pretty cool.\I'm an athelete, after all.\Shin-chan, you going out?\Yeah, I'm heading out for a second. response:	Hiromi-chan, too?
context: I am going to accept it too.\You know,\Hiromi, you aren't bad.\You're pretty cool.\I'm an athelete, after all.\Shin-chan, you going out?\Yeah, I'm heading out for a second.\Hiromi-chan, too? response:	If not, take a breather inside the living room.
context: You know,\Hiromi, you aren't bad.\You're pretty cool.\I'm an athelete, after all.\Shin-chan, you going out?\Yeah, I'm heading out for a second.\Hiromi-chan, too?\If not, take a breather inside the living room. response:	Sure.
context: Hiromi, you aren't bad.\You're pretty cool.\I'm an athelete, after all.\Shin-chan, you going out?\Yeah, I'm heading out for a second.\Hiromi-chan, too?\If not, take a breather inside the living room.\Sure. response:	Then...
context: You're pretty cool.\I'm an athelete, after all.\Shin-chan, you going out?\Yeah, I'm heading out for a second.\Hiromi-chan, too?\If not, take a breather inside the living room.\Sure.\Then... response:	Oh yeah, what are you having for dinner tonight?
context: I'm an athelete, after all.\Shin-chan, you going out?\Yeah, I'm heading out for a second.\Hiromi-chan, too?\If not, take a breather inside the living room.\Sure.\Then...\Oh yeah, what are you having for dinner tonight? response:	Ve- Veggie stew.
context: Shin-chan, you going out?\Yeah, I'm heading out for a second.\Hiromi-chan, too?\If not, take a breather inside the living room.\Sure.\Then...\Oh yeah, what are you having for dinner tonight?\Ve- Veggie stew. response:	That's great.
context: Yeah, I'm heading out for a second.\Hiromi-chan, too?\If not, take a breather inside the living room.\Sure.\Then...\Oh yeah, what are you having for dinner tonight?\Ve- Veggie stew.\That's great. response:	I will come over for dinner, wait for me.
context: Hiromi-chan, too?\If not, take a breather inside the living room.\Sure.\Then...\Oh yeah, what are you having for dinner tonight?\Ve- Veggie stew.\That's great.\I will come over for dinner, wait for me. response:	What's wrong?
context: If not, take a breather inside the living room.\Sure.\Then...\Oh yeah, what are you having for dinner tonight?\Ve- Veggie stew.\That's great.\I will come over for dinner, wait for me.\What's wrong? response:	Nothing.
context: Sure.\Then...\Oh yeah, what are you having for dinner tonight?\Ve- Veggie stew.\That's great.\I will come over for dinner, wait for me.\What's wrong?\Nothing. response:	Sure, I'll wait...
context: Then...\Oh yeah, what are you having for dinner tonight?\Ve- Veggie stew.\That's great.\I will come over for dinner, wait for me.\What's wrong?\Nothing.\Sure, I'll wait... response:	Take a look at it.
context: Oh yeah, what are you having for dinner tonight?\Ve- Veggie stew.\That's great.\I will come over for dinner, wait for me.\What's wrong?\Nothing.\Sure, I'll wait...\Take a look at it. response:	No.
context: Ve- Veggie stew.\That's great.\I will come over for dinner, wait for me.\What's wrong?\Nothing.\Sure, I'll wait...\Take a look at it.\No. response:	But I only drew it becaused Noe wanted it.
context: That's great.\I will come over for dinner, wait for me.\What's wrong?\Nothing.\Sure, I'll wait...\Take a look at it.\No.\But I only drew it becaused Noe wanted it. response:	You got it wrong.
context: I will come over for dinner, wait for me.\What's wrong?\Nothing.\Sure, I'll wait...\Take a look at it.\No.\But I only drew it becaused Noe wanted it.\You got it wrong. response:	Even without me, Shinichirou can do fine.
context: What's wrong?\Nothing.\Sure, I'll wait...\Take a look at it.\No.\But I only drew it becaused Noe wanted it.\You got it wrong.\Even without me, Shinichirou can do fine. response:	You can still draw it without me.
context: Nothing.\Sure, I'll wait...\Take a look at it.\No.\But I only drew it becaused Noe wanted it.\You got it wrong.\Even without me, Shinichirou can do fine.\You can still draw it without me. response:	Then, let's put it this way,
context: Sure, I'll wait...\Take a look at it.\No.\But I only drew it becaused Noe wanted it.\You got it wrong.\Even without me, Shinichirou can do fine.\You can still draw it without me.\Then, let's put it this way, response:	I only drew it because I want you to read it.
context: Take a look at it.\No.\But I only drew it becaused Noe wanted it.\You got it wrong.\Even without me, Shinichirou can do fine.\You can still draw it without me.\Then, let's put it this way,\I only drew it because I want you to read it. response:	No.
context: No.\But I only drew it becaused Noe wanted it.\You got it wrong.\Even without me, Shinichirou can do fine.\You can still draw it without me.\Then, let's put it this way,\I only drew it because I want you to read it.\No. response:	If you aren't gonna, I'm throwing it away.
context: But I only drew it becaused Noe wanted it.\You got it wrong.\Even without me, Shinichirou can do fine.\You can still draw it without me.\Then, let's put it this way,\I only drew it because I want you to read it.\No.\If you aren't gonna, I'm throwing it away. response:	If you want to, go ahead.
context: You got it wrong.\Even without me, Shinichirou can do fine.\You can still draw it without me.\Then, let's put it this way,\I only drew it because I want you to read it.\No.\If you aren't gonna, I'm throwing it away.\If you want to, go ahead. response:	I'm throwing it away.
context: Even without me, Shinichirou can do fine.\You can still draw it without me.\Then, let's put it this way,\I only drew it because I want you to read it.\No.\If you aren't gonna, I'm throwing it away.\If you want to, go ahead.\I'm throwing it away. response:	Just go ahead, why are you even telling me?
context: You can still draw it without me.\Then, let's put it this way,\I only drew it because I want you to read it.\No.\If you aren't gonna, I'm throwing it away.\If you want to, go ahead.\I'm throwing it away.\Just go ahead, why are you even telling me? response:	Where are you throwing it to?
context: Then, let's put it this way,\I only drew it because I want you to read it.\No.\If you aren't gonna, I'm throwing it away.\If you want to, go ahead.\I'm throwing it away.\Just go ahead, why are you even telling me?\Where are you throwing it to? response:	To the sea where Ground doesn't wish to fly to.
context: I only drew it because I want you to read it.\No.\If you aren't gonna, I'm throwing it away.\If you want to, go ahead.\I'm throwing it away.\Just go ahead, why are you even telling me?\Where are you throwing it to?\To the sea where Ground doesn't wish to fly to. response:	You saw it?
context: No.\If you aren't gonna, I'm throwing it away.\If you want to, go ahead.\I'm throwing it away.\Just go ahead, why are you even telling me?\Where are you throwing it to?\To the sea where Ground doesn't wish to fly to.\You saw it? response:	I did.
context: If you aren't gonna, I'm throwing it away.\If you want to, go ahead.\I'm throwing it away.\Just go ahead, why are you even telling me?\Where are you throwing it to?\To the sea where Ground doesn't wish to fly to.\You saw it?\I did. response:	Noe.
context: If you want to, go ahead.\I'm throwing it away.\Just go ahead, why are you even telling me?\Where are you throwing it to?\To the sea where Ground doesn't wish to fly to.\You saw it?\I did.\Noe. response:	Noe!
context: I'm throwing it away.\Just go ahead, why are you even telling me?\Where are you throwing it to?\To the sea where Ground doesn't wish to fly to.\You saw it?\I did.\Noe.\Noe! response:	What are you doing, you idiot?!
context: Just go ahead, why are you even telling me?\Where are you throwing it to?\To the sea where Ground doesn't wish to fly to.\You saw it?\I did.\Noe.\Noe!\What are you doing, you idiot?! response:	Coming.
context: Where are you throwing it to?\To the sea where Ground doesn't wish to fly to.\You saw it?\I did.\Noe.\Noe!\What are you doing, you idiot?!\Coming. response:	I've made a little bit too much fish, have some of it.
context: To the sea where Ground doesn't wish to fly to.\You saw it?\I did.\Noe.\Noe!\What are you doing, you idiot?!\Coming.\I've made a little bit too much fish, have some of it. response:	Err, thank you.
context: You saw it?\I did.\Noe.\Noe!\What are you doing, you idiot?!\Coming.\I've made a little bit too much fish, have some of it.\Err, thank you. response:	Please come in.
context: I did.\Noe.\Noe!\What are you doing, you idiot?!\Coming.\I've made a little bit too much fish, have some of it.\Err, thank you.\Please come in. response:	Don't worry about it.
context: Noe.\Noe!\What are you doing, you idiot?!\Coming.\I've made a little bit too much fish, have some of it.\Err, thank you.\Please come in.\Don't worry about it. response:	No, I'll go get some tea.
context: Noe!\What are you doing, you idiot?!\Coming.\I've made a little bit too much fish, have some of it.\Err, thank you.\Please come in.\Don't worry about it.\No, I'll go get some tea. response:	Err...
context: What are you doing, you idiot?!\Coming.\I've made a little bit too much fish, have some of it.\Err, thank you.\Please come in.\Don't worry about it.\No, I'll go get some tea.\Err... response:	Yeah.
context: Coming.\I've made a little bit too much fish, have some of it.\Err, thank you.\Please come in.\Don't worry about it.\No, I'll go get some tea.\Err...\Yeah. response:	Well, be sure to give me back my box.
context: I've made a little bit too much fish, have some of it.\Err, thank you.\Please come in.\Don't worry about it.\No, I'll go get some tea.\Err...\Yeah.\Well, be sure to give me back my box. response:	Looks like they are delicious, obaa-san.
context: Err, thank you.\Please come in.\Don't worry about it.\No, I'll go get some tea.\Err...\Yeah.\Well, be sure to give me back my box.\Looks like they are delicious, obaa-san. response:	Really?
context: Please come in.\Don't worry about it.\No, I'll go get some tea.\Err...\Yeah.\Well, be sure to give me back my box.\Looks like they are delicious, obaa-san.\Really? response:	Thanks.
context: Don't worry about it.\No, I'll go get some tea.\Err...\Yeah.\Well, be sure to give me back my box.\Looks like they are delicious, obaa-san.\Really?\Thanks. response:	Waiting takes a lot of patience, doesn't it?
context: No, I'll go get some tea.\Err...\Yeah.\Well, be sure to give me back my box.\Looks like they are delicious, obaa-san.\Really?\Thanks.\Waiting takes a lot of patience, doesn't it? response:	Thank you... Very much...
context: Err...\Yeah.\Well, be sure to give me back my box.\Looks like they are delicious, obaa-san.\Really?\Thanks.\Waiting takes a lot of patience, doesn't it?\Thank you... Very much... response:	And I thought it's still useable.
context: Yeah.\Well, be sure to give me back my box.\Looks like they are delicious, obaa-san.\Really?\Thanks.\Waiting takes a lot of patience, doesn't it?\Thank you... Very much...\And I thought it's still useable. response:	I made it.
context: Well, be sure to give me back my box.\Looks like they are delicious, obaa-san.\Really?\Thanks.\Waiting takes a lot of patience, doesn't it?\Thank you... Very much...\And I thought it's still useable.\I made it. response:	How is it?
context: Looks like they are delicious, obaa-san.\Really?\Thanks.\Waiting takes a lot of patience, doesn't it?\Thank you... Very much...\And I thought it's still useable.\I made it.\How is it? response:	The last page's gone.
context: Really?\Thanks.\Waiting takes a lot of patience, doesn't it?\Thank you... Very much...\And I thought it's still useable.\I made it.\How is it?\The last page's gone. response:	It's fine, I will take a guess about what happened after Raigoumaru flies.
context: Thanks.\Waiting takes a lot of patience, doesn't it?\Thank you... Very much...\And I thought it's still useable.\I made it.\How is it?\The last page's gone.\It's fine, I will take a guess about what happened after Raigoumaru flies. response:	I love Hiromi.
context: Waiting takes a lot of patience, doesn't it?\Thank you... Very much...\And I thought it's still useable.\I made it.\How is it?\The last page's gone.\It's fine, I will take a guess about what happened after Raigoumaru flies.\I love Hiromi. response:	I know.
context: Thank you... Very much...\And I thought it's still useable.\I made it.\How is it?\The last page's gone.\It's fine, I will take a guess about what happened after Raigoumaru flies.\I love Hiromi.\I know. response:	But, I drew the picture book for Noe...
context: And I thought it's still useable.\I made it.\How is it?\The last page's gone.\It's fine, I will take a guess about what happened after Raigoumaru flies.\I love Hiromi.\I know.\But, I drew the picture book for Noe... response:	And I only danced because of what Noe said...
context: I made it.\How is it?\The last page's gone.\It's fine, I will take a guess about what happened after Raigoumaru flies.\I love Hiromi.\I know.\But, I drew the picture book for Noe...\And I only danced because of what Noe said... response:	Shinichirou thinks I can fly.
context: How is it?\The last page's gone.\It's fine, I will take a guess about what happened after Raigoumaru flies.\I love Hiromi.\I know.\But, I drew the picture book for Noe...\And I only danced because of what Noe said...\Shinichirou thinks I can fly. response:	I do think that...
context: The last page's gone.\It's fine, I will take a guess about what happened after Raigoumaru flies.\I love Hiromi.\I know.\But, I drew the picture book for Noe...\And I only danced because of what Noe said...\Shinichirou thinks I can fly.\I do think that... response:	I love Hiromi...
context: It's fine, I will take a guess about what happened after Raigoumaru flies.\I love Hiromi.\I know.\But, I drew the picture book for Noe...\And I only danced because of what Noe said...\Shinichirou thinks I can fly.\I do think that...\I love Hiromi... response:	But...
context: I love Hiromi.\I know.\But, I drew the picture book for Noe...\And I only danced because of what Noe said...\Shinichirou thinks I can fly.\I do think that...\I love Hiromi...\But... response:	Whenever I see you...
context: I know.\But, I drew the picture book for Noe...\And I only danced because of what Noe said...\Shinichirou thinks I can fly.\I do think that...\I love Hiromi...\But...\Whenever I see you... response:	My heart trembles.
context: But, I drew the picture book for Noe...\And I only danced because of what Noe said...\Shinichirou thinks I can fly.\I do think that...\I love Hiromi...\But...\Whenever I see you...\My heart trembles. response:	Shinichirou thinks I can fly,
context: And I only danced because of what Noe said...\Shinichirou thinks I can fly.\I do think that...\I love Hiromi...\But...\Whenever I see you...\My heart trembles.\Shinichirou thinks I can fly, response:	That is what my wings are.
context: Shinichirou thinks I can fly.\I do think that...\I love Hiromi...\But...\Whenever I see you...\My heart trembles.\Shinichirou thinks I can fly,\That is what my wings are. response:	Let me carry you back to the hospital.
context: I do think that...\I love Hiromi...\But...\Whenever I see you...\My heart trembles.\Shinichirou thinks I can fly,\That is what my wings are.\Let me carry you back to the hospital. response:	No.
context: I love Hiromi...\But...\Whenever I see you...\My heart trembles.\Shinichirou thinks I can fly,\That is what my wings are.\Let me carry you back to the hospital.\No. response:	But... I am worried about your leg.
context: But...\Whenever I see you...\My heart trembles.\Shinichirou thinks I can fly,\That is what my wings are.\Let me carry you back to the hospital.\No.\But... I am worried about your leg. response:	So, please trust me.
context: Whenever I see you...\My heart trembles.\Shinichirou thinks I can fly,\That is what my wings are.\Let me carry you back to the hospital.\No.\But... I am worried about your leg.\So, please trust me. response:	It's tough...
context: My heart trembles.\Shinichirou thinks I can fly,\That is what my wings are.\Let me carry you back to the hospital.\No.\But... I am worried about your leg.\So, please trust me.\It's tough... response:	Inside the pot by the side, there's a cockroach.
context: Shinichirou thinks I can fly,\That is what my wings are.\Let me carry you back to the hospital.\No.\But... I am worried about your leg.\So, please trust me.\It's tough...\Inside the pot by the side, there's a cockroach. response:	And it's painful...
context: That is what my wings are.\Let me carry you back to the hospital.\No.\But... I am worried about your leg.\So, please trust me.\It's tough...\Inside the pot by the side, there's a cockroach.\And it's painful... response:	But because I can't fly yet...
context: Let me carry you back to the hospital.\No.\But... I am worried about your leg.\So, please trust me.\It's tough...\Inside the pot by the side, there's a cockroach.\And it's painful...\But because I can't fly yet... response:	Shinichirou's shoe has a cockroach.
context: No.\But... I am worried about your leg.\So, please trust me.\It's tough...\Inside the pot by the side, there's a cockroach.\And it's painful...\But because I can't fly yet...\Shinichirou's shoe has a cockroach. response:	I'm walking.
context: But... I am worried about your leg.\So, please trust me.\It's tough...\Inside the pot by the side, there's a cockroach.\And it's painful...\But because I can't fly yet...\Shinichirou's shoe has a cockroach.\I'm walking. response:	Inside the pot by the side, there's a cockroach.
context: So, please trust me.\It's tough...\Inside the pot by the side, there's a cockroach.\And it's painful...\But because I can't fly yet...\Shinichirou's shoe has a cockroach.\I'm walking.\Inside the pot by the side, there's a cockroach. response:	Shinichirou's shoe has a cockroach.
context: It's tough...\Inside the pot by the side, there's a cockroach.\And it's painful...\But because I can't fly yet...\Shinichirou's shoe has a cockroach.\I'm walking.\Inside the pot by the side, there's a cockroach.\Shinichirou's shoe has a cockroach. response:	Inside Shinichirou's heart there is...
context: Inside the pot by the side, there's a cockroach.\And it's painful...\But because I can't fly yet...\Shinichirou's shoe has a cockroach.\I'm walking.\Inside the pot by the side, there's a cockroach.\Shinichirou's shoe has a cockroach.\Inside Shinichirou's heart there is... response:	Yuasa Hiromi!
context: And it's painful...\But because I can't fly yet...\Shinichirou's shoe has a cockroach.\I'm walking.\Inside the pot by the side, there's a cockroach.\Shinichirou's shoe has a cockroach.\Inside Shinichirou's heart there is...\Yuasa Hiromi! response:	Inside the pot by the side, there's a cockroach...!
context: But because I can't fly yet...\Shinichirou's shoe has a cockroach.\I'm walking.\Inside the pot by the side, there's a cockroach.\Shinichirou's shoe has a cockroach.\Inside Shinichirou's heart there is...\Yuasa Hiromi!\Inside the pot by the side, there's a cockroach...! response:	Shinichirou's... shoe has... cockroach...
context: Shinichirou's shoe has a cockroach.\I'm walking.\Inside the pot by the side, there's a cockroach.\Shinichirou's shoe has a cockroach.\Inside Shinichirou's heart there is...\Yuasa Hiromi!\Inside the pot by the side, there's a cockroach...!\Shinichirou's... shoe has... cockroach... response:	Hiromi, are you there?
context: I'm walking.\Inside the pot by the side, there's a cockroach.\Shinichirou's shoe has a cockroach.\Inside Shinichirou's heart there is...\Yuasa Hiromi!\Inside the pot by the side, there's a cockroach...!\Shinichirou's... shoe has... cockroach...\Hiromi, are you there? response:	I'm coming in.
context: Inside the pot by the side, there's a cockroach.\Shinichirou's shoe has a cockroach.\Inside Shinichirou's heart there is...\Yuasa Hiromi!\Inside the pot by the side, there's a cockroach...!\Shinichirou's... shoe has... cockroach...\Hiromi, are you there?\I'm coming in. response:	Just now...
context: Shinichirou's shoe has a cockroach.\Inside Shinichirou's heart there is...\Yuasa Hiromi!\Inside the pot by the side, there's a cockroach...!\Shinichirou's... shoe has... cockroach...\Hiromi, are you there?\I'm coming in.\Just now... response:	I did a split.
context: Inside Shinichirou's heart there is...\Yuasa Hiromi!\Inside the pot by the side, there's a cockroach...!\Shinichirou's... shoe has... cockroach...\Hiromi, are you there?\I'm coming in.\Just now...\I did a split. response:	A 180 degrees one.
context: Yuasa Hiromi!\Inside the pot by the side, there's a cockroach...!\Shinichirou's... shoe has... cockroach...\Hiromi, are you there?\I'm coming in.\Just now...\I did a split.\A 180 degrees one. response:	It's the first time I've made it.
context: Inside the pot by the side, there's a cockroach...!\Shinichirou's... shoe has... cockroach...\Hiromi, are you there?\I'm coming in.\Just now...\I did a split.\A 180 degrees one.\It's the first time I've made it. response:	Did you let Isurugi-san see the picture book?
context: Shinichirou's... shoe has... cockroach...\Hiromi, are you there?\I'm coming in.\Just now...\I did a split.\A 180 degrees one.\It's the first time I've made it.\Did you let Isurugi-san see the picture book? response:	Yup.
context: Hiromi, are you there?\I'm coming in.\Just now...\I did a split.\A 180 degrees one.\It's the first time I've made it.\Did you let Isurugi-san see the picture book?\Yup. response:	I want to see it too.
context: I'm coming in.\Just now...\I did a split.\A 180 degrees one.\It's the first time I've made it.\Did you let Isurugi-san see the picture book?\Yup.\I want to see it too. response:	Let's go out together.
context: Just now...\I did a split.\A 180 degrees one.\It's the first time I've made it.\Did you let Isurugi-san see the picture book?\Yup.\I want to see it too.\Let's go out together. response:	No...
context: I did a split.\A 180 degrees one.\It's the first time I've made it.\Did you let Isurugi-san see the picture book?\Yup.\I want to see it too.\Let's go out together.\No... response:	Let's go out together!
context: A 180 degrees one.\It's the first time I've made it.\Did you let Isurugi-san see the picture book?\Yup.\I want to see it too.\Let's go out together.\No...\Let's go out together! response:	No!
context: It's the first time I've made it.\Did you let Isurugi-san see the picture book?\Yup.\I want to see it too.\Let's go out together.\No...\Let's go out together!\No! response:	You can see it whenever you want!
context: Did you let Isurugi-san see the picture book?\Yup.\I want to see it too.\Let's go out together.\No...\Let's go out together!\No!\You can see it whenever you want! response:	Since, from now on...
context: Yup.\I want to see it too.\Let's go out together.\No...\Let's go out together!\No!\You can see it whenever you want!\Since, from now on... response:	I'll be by your side forever...
context: I want to see it too.\Let's go out together.\No...\Let's go out together!\No!\You can see it whenever you want!\Since, from now on...\I'll be by your side forever... response:	By your side forever...?
context: Let's go out together.\No...\Let's go out together!\No!\You can see it whenever you want!\Since, from now on...\I'll be by your side forever...\By your side forever...? response:	What's that...
context: No...\Let's go out together!\No!\You can see it whenever you want!\Since, from now on...\I'll be by your side forever...\By your side forever...?\What's that... response:	It's just like an engagement...
context: Let's go out together!\No!\You can see it whenever you want!\Since, from now on...\I'll be by your side forever...\By your side forever...?\What's that...\It's just like an engagement... response:	I still haven't agreed to go out with you...
context: No!\You can see it whenever you want!\Since, from now on...\I'll be by your side forever...\By your side forever...?\What's that...\It's just like an engagement...\I still haven't agreed to go out with you... response:	I want to wipe your tears.
context: You can see it whenever you want!\Since, from now on...\I'll be by your side forever...\By your side forever...?\What's that...\It's just like an engagement...\I still haven't agreed to go out with you...\I want to wipe your tears. response:	As I am right now,
context: Since, from now on...\I'll be by your side forever...\By your side forever...?\What's that...\It's just like an engagement...\I still haven't agreed to go out with you...\I want to wipe your tears.\As I am right now, response:	I can do it.
context: I'll be by your side forever...\By your side forever...?\What's that...\It's just like an engagement...\I still haven't agreed to go out with you...\I want to wipe your tears.\As I am right now,\I can do it. response:	It's snowing...
context: By your side forever...?\What's that...\It's just like an engagement...\I still haven't agreed to go out with you...\I want to wipe your tears.\As I am right now,\I can do it.\It's snowing... response:	Nothing...
context: What's that...\It's just like an engagement...\I still haven't agreed to go out with you...\I want to wipe your tears.\As I am right now,\I can do it.\It's snowing...\Nothing... response:	Good Morning!
context: It's just like an engagement...\I still haven't agreed to go out with you...\I want to wipe your tears.\As I am right now,\I can do it.\It's snowing...\Nothing...\Good Morning! response:	Morning, Noe!
context: I still haven't agreed to go out with you...\I want to wipe your tears.\As I am right now,\I can do it.\It's snowing...\Nothing...\Good Morning!\Morning, Noe! response:	Good Morning!
context: I want to wipe your tears.\As I am right now,\I can do it.\It's snowing...\Nothing...\Good Morning!\Morning, Noe!\Good Morning! response:	People can really obtain tears from people most important to them.
context: As I am right now,\I can do it.\It's snowing...\Nothing...\Good Morning!\Morning, Noe!\Good Morning!\People can really obtain tears from people most important to them. response:	Noe, Granny probably is going to say that too.
context: I can do it.\It's snowing...\Nothing...\Good Morning!\Morning, Noe!\Good Morning!\People can really obtain tears from people most important to them.\Noe, Granny probably is going to say that too. response:	If you really think about the people important to you,
context: It's snowing...\Nothing...\Good Morning!\Morning, Noe!\Good Morning!\People can really obtain tears from people most important to them.\Noe, Granny probably is going to say that too.\If you really think about the people important to you, response:	Then the tears will flood out.
context: Nothing...\Good Morning!\Morning, Noe!\Good Morning!\People can really obtain tears from people most important to them.\Noe, Granny probably is going to say that too.\If you really think about the people important to you,\Then the tears will flood out. response:	Hiromi!
context: Good Morning!\Morning, Noe!\Good Morning!\People can really obtain tears from people most important to them.\Noe, Granny probably is going to say that too.\If you really think about the people important to you,\Then the tears will flood out.\Hiromi! response:	Watch your side!
context: Morning, Noe!\Good Morning!\People can really obtain tears from people most important to them.\Noe, Granny probably is going to say that too.\If you really think about the people important to you,\Then the tears will flood out.\Hiromi!\Watch your side! response:	If you can understand these true tears,
context: Good Morning!\People can really obtain tears from people most important to them.\Noe, Granny probably is going to say that too.\If you really think about the people important to you,\Then the tears will flood out.\Hiromi!\Watch your side!\If you can understand these true tears, response:	Listen,
context: People can really obtain tears from people most important to them.\Noe, Granny probably is going to say that too.\If you really think about the people important to you,\Then the tears will flood out.\Hiromi!\Watch your side!\If you can understand these true tears,\Listen, response:	Don't just use your eyes.
context: Noe, Granny probably is going to say that too.\If you really think about the people important to you,\Then the tears will flood out.\Hiromi!\Watch your side!\If you can understand these true tears,\Listen,\Don't just use your eyes. response:	Find the difference with your ears too.
context: If you really think about the people important to you,\Then the tears will flood out.\Hiromi!\Watch your side!\If you can understand these true tears,\Listen,\Don't just use your eyes.\Find the difference with your ears too. response:	Okay.
context: Then the tears will flood out.\Hiromi!\Watch your side!\If you can understand these true tears,\Listen,\Don't just use your eyes.\Find the difference with your ears too.\Okay. response:	Come take a break.
context: Hiromi!\Watch your side!\If you can understand these true tears,\Listen,\Don't just use your eyes.\Find the difference with your ears too.\Okay.\Come take a break. response:	Sure.
context: Watch your side!\If you can understand these true tears,\Listen,\Don't just use your eyes.\Find the difference with your ears too.\Okay.\Come take a break.\Sure. response:	It's already time to open up!
context: If you can understand these true tears,\Listen,\Don't just use your eyes.\Find the difference with your ears too.\Okay.\Come take a break.\Sure.\It's already time to open up! response:	Miyokichi,
context: Listen,\Don't just use your eyes.\Find the difference with your ears too.\Okay.\Come take a break.\Sure.\It's already time to open up!\Miyokichi, response:	Come on, you only came early by a tiny bit!
context: Don't just use your eyes.\Find the difference with your ears too.\Okay.\Come take a break.\Sure.\It's already time to open up!\Miyokichi,\Come on, you only came early by a tiny bit! response:	Let's go in.