context: I say yes response:	Stay with me
context: I say yes\Stay with me response:	I say yes
context: I say yes\Stay with me\I say yes response:	For e ver
context: I say yes\Stay with me\I say yes\For e ver response:	Ill be by your side forever
context: I say yes\Stay with me\I say yes\For e ver\Ill be by your side forever response:	No matter how the future tests us
context: I say yes\Stay with me\I say yes\For e ver\Ill be by your side forever\No matter how the future tests us response:	Im sure
context: I say yes\Stay with me\I say yes\For e ver\Ill be by your side forever\No matter how the future tests us\Im sure response:	Ah, its our destiny
context: I say yes\Stay with me\I say yes\For e ver\Ill be by your side forever\No matter how the future tests us\Im sure\Ah, its our destiny response:	I was able to meet you
context: Stay with me\I say yes\For e ver\Ill be by your side forever\No matter how the future tests us\Im sure\Ah, its our destiny\I was able to meet you response:	Because I heard your voice
context: I say yes\For e ver\Ill be by your side forever\No matter how the future tests us\Im sure\Ah, its our destiny\I was able to meet you\Because I heard your voice response:	Yeah, even if crisis events
context: For e ver\Ill be by your side forever\No matter how the future tests us\Im sure\Ah, its our destiny\I was able to meet you\Because I heard your voice\Yeah, even if crisis events response:	Press on at me
context: Ill be by your side forever\No matter how the future tests us\Im sure\Ah, its our destiny\I was able to meet you\Because I heard your voice\Yeah, even if crisis events\Press on at me response:	If I'm with you, then I can overcome them
context: No matter how the future tests us\Im sure\Ah, its our destiny\I was able to meet you\Because I heard your voice\Yeah, even if crisis events\Press on at me\If I'm with you, then I can overcome them response:	Palpitations and competitive spirit
context: Im sure\Ah, its our destiny\I was able to meet you\Because I heard your voice\Yeah, even if crisis events\Press on at me\If I'm with you, then I can overcome them\Palpitations and competitive spirit response:	Excite me on the contrary, but -
context: Ah, its our destiny\I was able to meet you\Because I heard your voice\Yeah, even if crisis events\Press on at me\If I'm with you, then I can overcome them\Palpitations and competitive spirit\Excite me on the contrary, but - response:	I only want to protect you
context: I was able to meet you\Because I heard your voice\Yeah, even if crisis events\Press on at me\If I'm with you, then I can overcome them\Palpitations and competitive spirit\Excite me on the contrary, but -\I only want to protect you response:	We were born in distant worlds
context: Because I heard your voice\Yeah, even if crisis events\Press on at me\If I'm with you, then I can overcome them\Palpitations and competitive spirit\Excite me on the contrary, but -\I only want to protect you\We were born in distant worlds response:	Ill be by your side forever
context: Yeah, even if crisis events\Press on at me\If I'm with you, then I can overcome them\Palpitations and competitive spirit\Excite me on the contrary, but -\I only want to protect you\We were born in distant worlds\Ill be by your side forever response:	Lets change any future into hope
context: Press on at me\If I'm with you, then I can overcome them\Palpitations and competitive spirit\Excite me on the contrary, but -\I only want to protect you\We were born in distant worlds\Ill be by your side forever\Lets change any future into hope response:	Don't touch! S
context: If I'm with you, then I can overcome them\Palpitations and competitive spirit\Excite me on the contrary, but -\I only want to protect you\We were born in distant worlds\Ill be by your side forever\Lets change any future into hope\Don't touch! S response:	Touch me S
context: Palpitations and competitive spirit\Excite me on the contrary, but -\I only want to protect you\We were born in distant worlds\Ill be by your side forever\Lets change any future into hope\Don't touch! S\Touch me S response:	Be right here! close to me
context: Excite me on the contrary, but -\I only want to protect you\We were born in distant worlds\Ill be by your side forever\Lets change any future into hope\Don't touch! S\Touch me S\Be right here! close to me response:	Always, always look at me at all times
context: I only want to protect you\We were born in distant worlds\Ill be by your side forever\Lets change any future into hope\Don't touch! S\Touch me S\Be right here! close to me\Always, always look at me at all times response:	You looked away, didnt you? At other girls
context: We were born in distant worlds\Ill be by your side forever\Lets change any future into hope\Don't touch! S\Touch me S\Be right here! close to me\Always, always look at me at all times\You looked away, didnt you? At other girls response:	Ill punish those who are wavering and insolent
context: Ill be by your side forever\Lets change any future into hope\Don't touch! S\Touch me S\Be right here! close to me\Always, always look at me at all times\You looked away, didnt you? At other girls\Ill punish those who are wavering and insolent response:	Dont touch! Because I wont listen to excuses
context: Lets change any future into hope\Don't touch! S\Touch me S\Be right here! close to me\Always, always look at me at all times\You looked away, didnt you? At other girls\Ill punish those who are wavering and insolent\Dont touch! Because I wont listen to excuses response:	Touch me because I'm tired Hey, lend me your shoulder
context: Don't touch! S\Touch me S\Be right here! close to me\Always, always look at me at all times\You looked away, didnt you? At other girls\Ill punish those who are wavering and insolent\Dont touch! Because I wont listen to excuses\Touch me because I'm tired Hey, lend me your shoulder response:	I love you, its a lie
context: Touch me S\Be right here! close to me\Always, always look at me at all times\You looked away, didnt you? At other girls\Ill punish those who are wavering and insolent\Dont touch! Because I wont listen to excuses\Touch me because I'm tired Hey, lend me your shoulder\I love you, its a lie response:	I hate you, thats a lie, too
context: Be right here! close to me\Always, always look at me at all times\You looked away, didnt you? At other girls\Ill punish those who are wavering and insolent\Dont touch! Because I wont listen to excuses\Touch me because I'm tired Hey, lend me your shoulder\I love you, its a lie\I hate you, thats a lie, too response:	Nay nay nay, its useless, its a misunderstanding
context: Always, always look at me at all times\You looked away, didnt you? At other girls\Ill punish those who are wavering and insolent\Dont touch! Because I wont listen to excuses\Touch me because I'm tired Hey, lend me your shoulder\I love you, its a lie\I hate you, thats a lie, too\Nay nay nay, its useless, its a misunderstanding response:	So I wont say, I love you”
context: You looked away, didnt you? At other girls\Ill punish those who are wavering and insolent\Dont touch! Because I wont listen to excuses\Touch me because I'm tired Hey, lend me your shoulder\I love you, its a lie\I hate you, thats a lie, too\Nay nay nay, its useless, its a misunderstanding\So I wont say, I love you” response:	Non non non, because I absolutely wont forgive you
context: Ill punish those who are wavering and insolent\Dont touch! Because I wont listen to excuses\Touch me because I'm tired Hey, lend me your shoulder\I love you, its a lie\I hate you, thats a lie, too\Nay nay nay, its useless, its a misunderstanding\So I wont say, I love you”\Non non non, because I absolutely wont forgive you response:	If you go to somewhere else
context: Dont touch! Because I wont listen to excuses\Touch me because I'm tired Hey, lend me your shoulder\I love you, its a lie\I hate you, thats a lie, too\Nay nay nay, its useless, its a misunderstanding\So I wont say, I love you”\Non non non, because I absolutely wont forgive you\If you go to somewhere else response:	But
context: Touch me because I'm tired Hey, lend me your shoulder\I love you, its a lie\I hate you, thats a lie, too\Nay nay nay, its useless, its a misunderstanding\So I wont say, I love you”\Non non non, because I absolutely wont forgive you\If you go to somewhere else\But response:	The truth is, I want to be by your side more than anyone else
context: I love you, its a lie\I hate you, thats a lie, too\Nay nay nay, its useless, its a misunderstanding\So I wont say, I love you”\Non non non, because I absolutely wont forgive you\If you go to somewhere else\But\The truth is, I want to be by your side more than anyone else response:	Lets go take a walk in chains of love!
context: I hate you, thats a lie, too\Nay nay nay, its useless, its a misunderstanding\So I wont say, I love you”\Non non non, because I absolutely wont forgive you\If you go to somewhere else\But\The truth is, I want to be by your side more than anyone else\Lets go take a walk in chains of love! response:	The Magic Academy's Crisis
context: Nay nay nay, its useless, its a misunderstanding\So I wont say, I love you”\Non non non, because I absolutely wont forgive you\If you go to somewhere else\But\The truth is, I want to be by your side more than anyone else\Lets go take a walk in chains of love!\The Magic Academy's Crisis response:	The Magic Academy's Crisis
context: So I wont say, I love you”\Non non non, because I absolutely wont forgive you\If you go to somewhere else\But\The truth is, I want to be by your side more than anyone else\Lets go take a walk in chains of love!\The Magic Academy's Crisis\The Magic Academy's Crisis response:	Next Time
context: Non non non, because I absolutely wont forgive you\If you go to somewhere else\But\The truth is, I want to be by your side more than anyone else\Lets go take a walk in chains of love!\The Magic Academy's Crisis\The Magic Academy's Crisis\Next Time response:	The Flame of Atonement
context: If you go to somewhere else\But\The truth is, I want to be by your side more than anyone else\Lets go take a walk in chains of love!\The Magic Academy's Crisis\The Magic Academy's Crisis\Next Time\The Flame of Atonement response:	The battlefield is great.
context: But\The truth is, I want to be by your side more than anyone else\Lets go take a walk in chains of love!\The Magic Academy's Crisis\The Magic Academy's Crisis\Next Time\The Flame of Atonement\The battlefield is great. response:	I love the smell of humans burning.
context: The truth is, I want to be by your side more than anyone else\Lets go take a walk in chains of love!\The Magic Academy's Crisis\The Magic Academy's Crisis\Next Time\The Flame of Atonement\The battlefield is great.\I love the smell of humans burning. response:	I can only enjoy this during war.
context: Lets go take a walk in chains of love!\The Magic Academy's Crisis\The Magic Academy's Crisis\Next Time\The Flame of Atonement\The battlefield is great.\I love the smell of humans burning.\I can only enjoy this during war. response:	Thank you for coming, Menville-dono.
context: The Magic Academy's Crisis\The Magic Academy's Crisis\Next Time\The Flame of Atonement\The battlefield is great.\I love the smell of humans burning.\I can only enjoy this during war.\Thank you for coming, Menville-dono. response:	I'd like to borrow your strength.
context: The Magic Academy's Crisis\Next Time\The Flame of Atonement\The battlefield is great.\I love the smell of humans burning.\I can only enjoy this during war.\Thank you for coming, Menville-dono.\I'd like to borrow your strength. response:	My unit is filled with wild ones.
context: Next Time\The Flame of Atonement\The battlefield is great.\I love the smell of humans burning.\I can only enjoy this during war.\Thank you for coming, Menville-dono.\I'd like to borrow your strength.\My unit is filled with wild ones. response:	What do you want us to do?
context: The Flame of Atonement\The battlefield is great.\I love the smell of humans burning.\I can only enjoy this during war.\Thank you for coming, Menville-dono.\I'd like to borrow your strength.\My unit is filled with wild ones.\What do you want us to do? response:	You heard how Tristain and Germania captured our port, right?
context: The battlefield is great.\I love the smell of humans burning.\I can only enjoy this during war.\Thank you for coming, Menville-dono.\I'd like to borrow your strength.\My unit is filled with wild ones.\What do you want us to do?\You heard how Tristain and Germania captured our port, right? response:	And you're telling me to repel them?
context: I love the smell of humans burning.\I can only enjoy this during war.\Thank you for coming, Menville-dono.\I'd like to borrow your strength.\My unit is filled with wild ones.\What do you want us to do?\You heard how Tristain and Germania captured our port, right?\And you're telling me to repel them? response:	No, I don't expect you to burn five hundred ships.
context: I can only enjoy this during war.\Thank you for coming, Menville-dono.\I'd like to borrow your strength.\My unit is filled with wild ones.\What do you want us to do?\You heard how Tristain and Germania captured our port, right?\And you're telling me to repel them?\No, I don't expect you to burn five hundred ships. response:	I don't like the roundabout conversations.
context: Thank you for coming, Menville-dono.\I'd like to borrow your strength.\My unit is filled with wild ones.\What do you want us to do?\You heard how Tristain and Germania captured our port, right?\And you're telling me to repel them?\No, I don't expect you to burn five hundred ships.\I don't like the roundabout conversations. response:	Tell me the place I get to burn.
context: I'd like to borrow your strength.\My unit is filled with wild ones.\What do you want us to do?\You heard how Tristain and Germania captured our port, right?\And you're telling me to repel them?\No, I don't expect you to burn five hundred ships.\I don't like the roundabout conversations.\Tell me the place I get to burn. response:	The Magic Academy.
context: My unit is filled with wild ones.\What do you want us to do?\You heard how Tristain and Germania captured our port, right?\And you're telling me to repel them?\No, I don't expect you to burn five hundred ships.\I don't like the roundabout conversations.\Tell me the place I get to burn.\The Magic Academy. response:	The Magic Academy?
context: What do you want us to do?\You heard how Tristain and Germania captured our port, right?\And you're telling me to repel them?\No, I don't expect you to burn five hundred ships.\I don't like the roundabout conversations.\Tell me the place I get to burn.\The Magic Academy.\The Magic Academy? response:	It's so huge...
context: You heard how Tristain and Germania captured our port, right?\And you're telling me to repel them?\No, I don't expect you to burn five hundred ships.\I don't like the roundabout conversations.\Tell me the place I get to burn.\The Magic Academy.\The Magic Academy?\It's so huge... response:	What's this?!
context: And you're telling me to repel them?\No, I don't expect you to burn five hundred ships.\I don't like the roundabout conversations.\Tell me the place I get to burn.\The Magic Academy.\The Magic Academy?\It's so huge...\What's this?! response:	Keep it down, will you?
context: No, I don't expect you to burn five hundred ships.\I don't like the roundabout conversations.\Tell me the place I get to burn.\The Magic Academy.\The Magic Academy?\It's so huge...\What's this?!\Keep it down, will you? response:	What? No!
context: I don't like the roundabout conversations.\Tell me the place I get to burn.\The Magic Academy.\The Magic Academy?\It's so huge...\What's this?!\Keep it down, will you?\What? No! response:	Saito!
context: Tell me the place I get to burn.\The Magic Academy.\The Magic Academy?\It's so huge...\What's this?!\Keep it down, will you?\What? No!\Saito! response:	Let me out, now!
context: The Magic Academy.\The Magic Academy?\It's so huge...\What's this?!\Keep it down, will you?\What? No!\Saito!\Let me out, now! response:	Who is this?!
context: The Magic Academy?\It's so huge...\What's this?!\Keep it down, will you?\What? No!\Saito!\Let me out, now!\Who is this?! response:	Who do you think I am?!
context: It's so huge...\What's this?!\Keep it down, will you?\What? No!\Saito!\Let me out, now!\Who is this?!\Who do you think I am?! response:	Eleonore-oneesama!
context: What's this?!\Keep it down, will you?\What? No!\Saito!\Let me out, now!\Who is this?!\Who do you think I am?!\Eleonore-oneesama! response:	And Saito?
context: Keep it down, will you?\What? No!\Saito!\Let me out, now!\Who is this?!\Who do you think I am?!\Eleonore-oneesama!\And Saito? response:	Louise. I'll have you stay in here for a while.
context: What? No!\Saito!\Let me out, now!\Who is this?!\Who do you think I am?!\Eleonore-oneesama!\And Saito?\Louise. I'll have you stay in here for a while. response:	Why, Onee-sama?
context: Saito!\Let me out, now!\Who is this?!\Who do you think I am?!\Eleonore-oneesama!\And Saito?\Louise. I'll have you stay in here for a while.\Why, Onee-sama? response:	Why?
context: Let me out, now!\Who is this?!\Who do you think I am?!\Eleonore-oneesama!\And Saito?\Louise. I'll have you stay in here for a while.\Why, Onee-sama?\Why? response:	Because of what you had said.
context: Who is this?!\Who do you think I am?!\Eleonore-oneesama!\And Saito?\Louise. I'll have you stay in here for a while.\Why, Onee-sama?\Why?\Because of what you had said. response:	Take aim!
context: Who do you think I am?!\Eleonore-oneesama!\And Saito?\Louise. I'll have you stay in here for a while.\Why, Onee-sama?\Why?\Because of what you had said.\Take aim! response:	Fire!
context: Eleonore-oneesama!\And Saito?\Louise. I'll have you stay in here for a while.\Why, Onee-sama?\Why?\Because of what you had said.\Take aim!\Fire! response:	Focus on the target!
context: And Saito?\Louise. I'll have you stay in here for a while.\Why, Onee-sama?\Why?\Because of what you had said.\Take aim!\Fire!\Focus on the target! response:	In a real battle, your target moves!
context: Louise. I'll have you stay in here for a while.\Why, Onee-sama?\Why?\Because of what you had said.\Take aim!\Fire!\Focus on the target!\In a real battle, your target moves! response:	Yes, Sir!
context: Why, Onee-sama?\Why?\Because of what you had said.\Take aim!\Fire!\Focus on the target!\In a real battle, your target moves!\Yes, Sir! response:	They're so into it.
context: Why?\Because of what you had said.\Take aim!\Fire!\Focus on the target!\In a real battle, your target moves!\Yes, Sir!\They're so into it. response:	I can't imagine this is only training.
context: Because of what you had said.\Take aim!\Fire!\Focus on the target!\In a real battle, your target moves!\Yes, Sir!\They're so into it.\I can't imagine this is only training. response:	Everyone, stop!
context: Take aim!\Fire!\Focus on the target!\In a real battle, your target moves!\Yes, Sir!\They're so into it.\I can't imagine this is only training.\Everyone, stop! response:	Five minute break.
context: Fire!\Focus on the target!\In a real battle, your target moves!\Yes, Sir!\They're so into it.\I can't imagine this is only training.\Everyone, stop!\Five minute break. response:	Agnes, did something happen?
context: Focus on the target!\In a real battle, your target moves!\Yes, Sir!\They're so into it.\I can't imagine this is only training.\Everyone, stop!\Five minute break.\Agnes, did something happen? response:	You're quick to notice.
context: In a real battle, your target moves!\Yes, Sir!\They're so into it.\I can't imagine this is only training.\Everyone, stop!\Five minute break.\Agnes, did something happen?\You're quick to notice. response:	I'll soon be gone from here.
context: Yes, Sir!\They're so into it.\I can't imagine this is only training.\Everyone, stop!\Five minute break.\Agnes, did something happen?\You're quick to notice.\I'll soon be gone from here. response:	Our Queen will be heading to the front line.
context: They're so into it.\I can't imagine this is only training.\Everyone, stop!\Five minute break.\Agnes, did something happen?\You're quick to notice.\I'll soon be gone from here.\Our Queen will be heading to the front line. response:	She will leave in seven days.
context: I can't imagine this is only training.\Everyone, stop!\Five minute break.\Agnes, did something happen?\You're quick to notice.\I'll soon be gone from here.\Our Queen will be heading to the front line.\She will leave in seven days. response:	We, the Musketeer Force, will be going to Albion to protect Her Highness.
context: Everyone, stop!\Five minute break.\Agnes, did something happen?\You're quick to notice.\I'll soon be gone from here.\Our Queen will be heading to the front line.\She will leave in seven days.\We, the Musketeer Force, will be going to Albion to protect Her Highness. response:	We'll say farewell to this academy, too.
context: Five minute break.\Agnes, did something happen?\You're quick to notice.\I'll soon be gone from here.\Our Queen will be heading to the front line.\She will leave in seven days.\We, the Musketeer Force, will be going to Albion to protect Her Highness.\We'll say farewell to this academy, too. response:	It's a shame I couldn't uncover the name of the person who razed Dungletale...
context: Agnes, did something happen?\You're quick to notice.\I'll soon be gone from here.\Our Queen will be heading to the front line.\She will leave in seven days.\We, the Musketeer Force, will be going to Albion to protect Her Highness.\We'll say farewell to this academy, too.\It's a shame I couldn't uncover the name of the person who razed Dungletale... response:	I'll go to the front line, too.
context: You're quick to notice.\I'll soon be gone from here.\Our Queen will be heading to the front line.\She will leave in seven days.\We, the Musketeer Force, will be going to Albion to protect Her Highness.\We'll say farewell to this academy, too.\It's a shame I couldn't uncover the name of the person who razed Dungletale...\I'll go to the front line, too. response:	Front line?! What are you...?
context: I'll soon be gone from here.\Our Queen will be heading to the front line.\She will leave in seven days.\We, the Musketeer Force, will be going to Albion to protect Her Highness.\We'll say farewell to this academy, too.\It's a shame I couldn't uncover the name of the person who razed Dungletale...\I'll go to the front line, too.\Front line?! What are you...? response:	I have to help the Princess.
context: Our Queen will be heading to the front line.\She will leave in seven days.\We, the Musketeer Force, will be going to Albion to protect Her Highness.\We'll say farewell to this academy, too.\It's a shame I couldn't uncover the name of the person who razed Dungletale...\I'll go to the front line, too.\Front line?! What are you...?\I have to help the Princess. response:	I heard everything from this plebeian.
context: She will leave in seven days.\We, the Musketeer Force, will be going to Albion to protect Her Highness.\We'll say farewell to this academy, too.\It's a shame I couldn't uncover the name of the person who razed Dungletale...\I'll go to the front line, too.\Front line?! What are you...?\I have to help the Princess.\I heard everything from this plebeian. response:	Saito!
context: We, the Musketeer Force, will be going to Albion to protect Her Highness.\We'll say farewell to this academy, too.\It's a shame I couldn't uncover the name of the person who razed Dungletale...\I'll go to the front line, too.\Front line?! What are you...?\I have to help the Princess.\I heard everything from this plebeian.\Saito! response:	Louise!
context: We'll say farewell to this academy, too.\It's a shame I couldn't uncover the name of the person who razed Dungletale...\I'll go to the front line, too.\Front line?! What are you...?\I have to help the Princess.\I heard everything from this plebeian.\Saito!\Louise! response:	I cannot allow a daughter of the La Valliere family to go to war.
context: It's a shame I couldn't uncover the name of the person who razed Dungletale...\I'll go to the front line, too.\Front line?! What are you...?\I have to help the Princess.\I heard everything from this plebeian.\Saito!\Louise!\I cannot allow a daughter of the La Valliere family to go to war. response:	Besides, what good would come out of your going when you can't use any magic?
context: I'll go to the front line, too.\Front line?! What are you...?\I have to help the Princess.\I heard everything from this plebeian.\Saito!\Louise!\I cannot allow a daughter of the La Valliere family to go to war.\Besides, what good would come out of your going when you can't use any magic? response:	It's okay! I'd definitely be of help!
context: Front line?! What are you...?\I have to help the Princess.\I heard everything from this plebeian.\Saito!\Louise!\I cannot allow a daughter of the La Valliere family to go to war.\Besides, what good would come out of your going when you can't use any magic?\It's okay! I'd definitely be of help! response:	Listen, Louise.
context: I have to help the Princess.\I heard everything from this plebeian.\Saito!\Louise!\I cannot allow a daughter of the La Valliere family to go to war.\Besides, what good would come out of your going when you can't use any magic?\It's okay! I'd definitely be of help!\Listen, Louise. response:	War isn't as simple as you think.
context: I heard everything from this plebeian.\Saito!\Louise!\I cannot allow a daughter of the La Valliere family to go to war.\Besides, what good would come out of your going when you can't use any magic?\It's okay! I'd definitely be of help!\Listen, Louise.\War isn't as simple as you think. response:	That's why I'm going.
context: Saito!\Louise!\I cannot allow a daughter of the La Valliere family to go to war.\Besides, what good would come out of your going when you can't use any magic?\It's okay! I'd definitely be of help!\Listen, Louise.\War isn't as simple as you think.\That's why I'm going. response:	I'm the only one who can protect the Princess.
context: Louise!\I cannot allow a daughter of the La Valliere family to go to war.\Besides, what good would come out of your going when you can't use any magic?\It's okay! I'd definitely be of help!\Listen, Louise.\War isn't as simple as you think.\That's why I'm going.\I'm the only one who can protect the Princess. response:	Silence!
context: I cannot allow a daughter of the La Valliere family to go to war.\Besides, what good would come out of your going when you can't use any magic?\It's okay! I'd definitely be of help!\Listen, Louise.\War isn't as simple as you think.\That's why I'm going.\I'm the only one who can protect the Princess.\Silence! response:	Until you change your mind, I will not let you out of here.
context: Besides, what good would come out of your going when you can't use any magic?\It's okay! I'd definitely be of help!\Listen, Louise.\War isn't as simple as you think.\That's why I'm going.\I'm the only one who can protect the Princess.\Silence!\Until you change your mind, I will not let you out of here. response:	You can't do that!
context: It's okay! I'd definitely be of help!\Listen, Louise.\War isn't as simple as you think.\That's why I'm going.\I'm the only one who can protect the Princess.\Silence!\Until you change your mind, I will not let you out of here.\You can't do that! response:	I'll hold onto this.
context: Listen, Louise.\War isn't as simple as you think.\That's why I'm going.\I'm the only one who can protect the Princess.\Silence!\Until you change your mind, I will not let you out of here.\You can't do that!\I'll hold onto this. response:	You're being tyrannical, Onee-sama!
context: War isn't as simple as you think.\That's why I'm going.\I'm the only one who can protect the Princess.\Silence!\Until you change your mind, I will not let you out of here.\You can't do that!\I'll hold onto this.\You're being tyrannical, Onee-sama! response:	W-What?
context: That's why I'm going.\I'm the only one who can protect the Princess.\Silence!\Until you change your mind, I will not let you out of here.\You can't do that!\I'll hold onto this.\You're being tyrannical, Onee-sama!\W-What? response:	L-Let me down!
context: I'm the only one who can protect the Princess.\Silence!\Until you change your mind, I will not let you out of here.\You can't do that!\I'll hold onto this.\You're being tyrannical, Onee-sama!\W-What?\L-Let me down! response:	Louise!
context: Silence!\Until you change your mind, I will not let you out of here.\You can't do that!\I'll hold onto this.\You're being tyrannical, Onee-sama!\W-What?\L-Let me down!\Louise! response:	Saito!
context: Until you change your mind, I will not let you out of here.\You can't do that!\I'll hold onto this.\You're being tyrannical, Onee-sama!\W-What?\L-Let me down!\Louise!\Saito! response:	Onee-sama!
context: You can't do that!\I'll hold onto this.\You're being tyrannical, Onee-sama!\W-What?\L-Let me down!\Louise!\Saito!\Onee-sama! response:	Ow, ow, ow, ow!
context: I'll hold onto this.\You're being tyrannical, Onee-sama!\W-What?\L-Let me down!\Louise!\Saito!\Onee-sama!\Ow, ow, ow, ow! response:	Cool your head in here for a while.
context: You're being tyrannical, Onee-sama!\W-What?\L-Let me down!\Louise!\Saito!\Onee-sama!\Ow, ow, ow, ow!\Cool your head in here for a while. response:	Keep your eyes on Louise here.
context: W-What?\L-Let me down!\Louise!\Saito!\Onee-sama!\Ow, ow, ow, ow!\Cool your head in here for a while.\Keep your eyes on Louise here. response:	Okay...
context: L-Let me down!\Louise!\Saito!\Onee-sama!\Ow, ow, ow, ow!\Cool your head in here for a while.\Keep your eyes on Louise here.\Okay... response:	Saito, you're going to take Eleonore-oneesama's side?
context: Louise!\Saito!\Onee-sama!\Ow, ow, ow, ow!\Cool your head in here for a while.\Keep your eyes on Louise here.\Okay...\Saito, you're going to take Eleonore-oneesama's side? response:	I'm sorry, but I agree with your sister this time.
context: Saito!\Onee-sama!\Ow, ow, ow, ow!\Cool your head in here for a while.\Keep your eyes on Louise here.\Okay...\Saito, you're going to take Eleonore-oneesama's side?\I'm sorry, but I agree with your sister this time. response:	It's ridiculous for you to go to war.
context: Onee-sama!\Ow, ow, ow, ow!\Cool your head in here for a while.\Keep your eyes on Louise here.\Okay...\Saito, you're going to take Eleonore-oneesama's side?\I'm sorry, but I agree with your sister this time.\It's ridiculous for you to go to war. response:	Saito!
context: Ow, ow, ow, ow!\Cool your head in here for a while.\Keep your eyes on Louise here.\Okay...\Saito, you're going to take Eleonore-oneesama's side?\I'm sorry, but I agree with your sister this time.\It's ridiculous for you to go to war.\Saito! response:	Miss Valliere.
context: Cool your head in here for a while.\Keep your eyes on Louise here.\Okay...\Saito, you're going to take Eleonore-oneesama's side?\I'm sorry, but I agree with your sister this time.\It's ridiculous for you to go to war.\Saito!\Miss Valliere. response:	Saito-kun's right.
context: Keep your eyes on Louise here.\Okay...\Saito, you're going to take Eleonore-oneesama's side?\I'm sorry, but I agree with your sister this time.\It's ridiculous for you to go to war.\Saito!\Miss Valliere.\Saito-kun's right. response:	Sensei...
context: Okay...\Saito, you're going to take Eleonore-oneesama's side?\I'm sorry, but I agree with your sister this time.\It's ridiculous for you to go to war.\Saito!\Miss Valliere.\Saito-kun's right.\Sensei... response:	Colbert-sensei. Please provide this impudent girl with guidance.
context: Saito, you're going to take Eleonore-oneesama's side?\I'm sorry, but I agree with your sister this time.\It's ridiculous for you to go to war.\Saito!\Miss Valliere.\Saito-kun's right.\Sensei...\Colbert-sensei. Please provide this impudent girl with guidance. response:	Excuse me.
context: I'm sorry, but I agree with your sister this time.\It's ridiculous for you to go to war.\Saito!\Miss Valliere.\Saito-kun's right.\Sensei...\Colbert-sensei. Please provide this impudent girl with guidance.\Excuse me. response:	You blockhead!
context: It's ridiculous for you to go to war.\Saito!\Miss Valliere.\Saito-kun's right.\Sensei...\Colbert-sensei. Please provide this impudent girl with guidance.\Excuse me.\You blockhead! response:	Your sister is worried about you.
context: Saito!\Miss Valliere.\Saito-kun's right.\Sensei...\Colbert-sensei. Please provide this impudent girl with guidance.\Excuse me.\You blockhead!\Your sister is worried about you. response:	Though I'm not good with magic, if it's for Her Highness, I could do anything.
context: Miss Valliere.\Saito-kun's right.\Sensei...\Colbert-sensei. Please provide this impudent girl with guidance.\Excuse me.\You blockhead!\Your sister is worried about you.\Though I'm not good with magic, if it's for Her Highness, I could do anything. response:	I'll defeat the enemy forces, too!
context: Saito-kun's right.\Sensei...\Colbert-sensei. Please provide this impudent girl with guidance.\Excuse me.\You blockhead!\Your sister is worried about you.\Though I'm not good with magic, if it's for Her Highness, I could do anything.\I'll defeat the enemy forces, too! response:	Defeat the enemy?
context: Sensei...\Colbert-sensei. Please provide this impudent girl with guidance.\Excuse me.\You blockhead!\Your sister is worried about you.\Though I'm not good with magic, if it's for Her Highness, I could do anything.\I'll defeat the enemy forces, too!\Defeat the enemy? response:	In other words, you'll go and kill the enemy?
context: Colbert-sensei. Please provide this impudent girl with guidance.\Excuse me.\You blockhead!\Your sister is worried about you.\Though I'm not good with magic, if it's for Her Highness, I could do anything.\I'll defeat the enemy forces, too!\Defeat the enemy?\In other words, you'll go and kill the enemy? response:	I didn't mean that...
context: Excuse me.\You blockhead!\Your sister is worried about you.\Though I'm not good with magic, if it's for Her Highness, I could do anything.\I'll defeat the enemy forces, too!\Defeat the enemy?\In other words, you'll go and kill the enemy?\I didn't mean that... response:	To fight for her Highness' sake.
context: You blockhead!\Your sister is worried about you.\Though I'm not good with magic, if it's for Her Highness, I could do anything.\I'll defeat the enemy forces, too!\Defeat the enemy?\In other words, you'll go and kill the enemy?\I didn't mean that...\To fight for her Highness' sake. response:	To defeat the enemy for the country's sake.
context: Your sister is worried about you.\Though I'm not good with magic, if it's for Her Highness, I could do anything.\I'll defeat the enemy forces, too!\Defeat the enemy?\In other words, you'll go and kill the enemy?\I didn't mean that...\To fight for her Highness' sake.\To defeat the enemy for the country's sake. response:	No matter how you phrase it, it's still murder!
context: Though I'm not good with magic, if it's for Her Highness, I could do anything.\I'll defeat the enemy forces, too!\Defeat the enemy?\In other words, you'll go and kill the enemy?\I didn't mean that...\To fight for her Highness' sake.\To defeat the enemy for the country's sake.\No matter how you phrase it, it's still murder! response:	Colbert-sensei...
context: I'll defeat the enemy forces, too!\Defeat the enemy?\In other words, you'll go and kill the enemy?\I didn't mean that...\To fight for her Highness' sake.\To defeat the enemy for the country's sake.\No matter how you phrase it, it's still murder!\Colbert-sensei... response:	I don't want my students to go through that experience.
context: Defeat the enemy?\In other words, you'll go and kill the enemy?\I didn't mean that...\To fight for her Highness' sake.\To defeat the enemy for the country's sake.\No matter how you phrase it, it's still murder!\Colbert-sensei...\I don't want my students to go through that experience. response:	Please don't say you'll go to war.
context: In other words, you'll go and kill the enemy?\I didn't mean that...\To fight for her Highness' sake.\To defeat the enemy for the country's sake.\No matter how you phrase it, it's still murder!\Colbert-sensei...\I don't want my students to go through that experience.\Please don't say you'll go to war. response:	Sensei...
context: I didn't mean that...\To fight for her Highness' sake.\To defeat the enemy for the country's sake.\No matter how you phrase it, it's still murder!\Colbert-sensei...\I don't want my students to go through that experience.\Please don't say you'll go to war.\Sensei... response:	It isn't fun to assault a school if there are only kids there.
context: To fight for her Highness' sake.\To defeat the enemy for the country's sake.\No matter how you phrase it, it's still murder!\Colbert-sensei...\I don't want my students to go through that experience.\Please don't say you'll go to war.\Sensei...\It isn't fun to assault a school if there are only kids there. response:	No, I heard there are only girls at the school right now.
context: To defeat the enemy for the country's sake.\No matter how you phrase it, it's still murder!\Colbert-sensei...\I don't want my students to go through that experience.\Please don't say you'll go to war.\Sensei...\It isn't fun to assault a school if there are only kids there.\No, I heard there are only girls at the school right now. response:	Girls? That's great!
context: No matter how you phrase it, it's still murder!\Colbert-sensei...\I don't want my students to go through that experience.\Please don't say you'll go to war.\Sensei...\It isn't fun to assault a school if there are only kids there.\No, I heard there are only girls at the school right now.\Girls? That's great! response:	Let's capture them alive.
context: Colbert-sensei...\I don't want my students to go through that experience.\Please don't say you'll go to war.\Sensei...\It isn't fun to assault a school if there are only kids there.\No, I heard there are only girls at the school right now.\Girls? That's great!\Let's capture them alive. response:	You're all so filthy.
context: I don't want my students to go through that experience.\Please don't say you'll go to war.\Sensei...\It isn't fun to assault a school if there are only kids there.\No, I heard there are only girls at the school right now.\Girls? That's great!\Let's capture them alive.\You're all so filthy. response:	It doesn't matter if they're women.
context: Please don't say you'll go to war.\Sensei...\It isn't fun to assault a school if there are only kids there.\No, I heard there are only girls at the school right now.\Girls? That's great!\Let's capture them alive.\You're all so filthy.\It doesn't matter if they're women. response:	We'll bring death to them all.
context: Sensei...\It isn't fun to assault a school if there are only kids there.\No, I heard there are only girls at the school right now.\Girls? That's great!\Let's capture them alive.\You're all so filthy.\It doesn't matter if they're women.\We'll bring death to them all. response:	What's wrong?
context: It isn't fun to assault a school if there are only kids there.\No, I heard there are only girls at the school right now.\Girls? That's great!\Let's capture them alive.\You're all so filthy.\It doesn't matter if they're women.\We'll bring death to them all.\What's wrong? response:	Nothing, I just thought I saw something move.
context: No, I heard there are only girls at the school right now.\Girls? That's great!\Let's capture them alive.\You're all so filthy.\It doesn't matter if they're women.\We'll bring death to them all.\What's wrong?\Nothing, I just thought I saw something move. response:	That was easy.
context: Girls? That's great!\Let's capture them alive.\You're all so filthy.\It doesn't matter if they're women.\We'll bring death to them all.\What's wrong?\Nothing, I just thought I saw something move.\That was easy. response:	No way...
context: Let's capture them alive.\You're all so filthy.\It doesn't matter if they're women.\We'll bring death to them all.\What's wrong?\Nothing, I just thought I saw something move.\That was easy.\No way... response:	All right. Get moving as we planned.
context: You're all so filthy.\It doesn't matter if they're women.\We'll bring death to them all.\What's wrong?\Nothing, I just thought I saw something move.\That was easy.\No way...\All right. Get moving as we planned. response:	Sir!
context: It doesn't matter if they're women.\We'll bring death to them all.\What's wrong?\Nothing, I just thought I saw something move.\That was easy.\No way...\All right. Get moving as we planned.\Sir! response:	What do you want, Tabitha?
context: We'll bring death to them all.\What's wrong?\Nothing, I just thought I saw something move.\That was easy.\No way...\All right. Get moving as we planned.\Sir!\What do you want, Tabitha? response:	Outside...
context: What's wrong?\Nothing, I just thought I saw something move.\That was easy.\No way...\All right. Get moving as we planned.\Sir!\What do you want, Tabitha?\Outside... response:	It's not even light out yet...
context: Nothing, I just thought I saw something move.\That was easy.\No way...\All right. Get moving as we planned.\Sir!\What do you want, Tabitha?\Outside...\It's not even light out yet... response:	Sounds like it...
context: That was easy.\No way...\All right. Get moving as we planned.\Sir!\What do you want, Tabitha?\Outside...\It's not even light out yet...\Sounds like it... response:	Captain!
context: No way...\All right. Get moving as we planned.\Sir!\What do you want, Tabitha?\Outside...\It's not even light out yet...\Sounds like it...\Captain! response:	Are you safe?
context: All right. Get moving as we planned.\Sir!\What do you want, Tabitha?\Outside...\It's not even light out yet...\Sounds like it...\Captain!\Are you safe? response:	I'm fine.
context: Sir!\What do you want, Tabitha?\Outside...\It's not even light out yet...\Sounds like it...\Captain!\Are you safe?\I'm fine. response:	Two came to our rooms, too.
context: What do you want, Tabitha?\Outside...\It's not even light out yet...\Sounds like it...\Captain!\Are you safe?\I'm fine.\Two came to our rooms, too. response:	We took care of them.
context: Outside...\It's not even light out yet...\Sounds like it...\Captain!\Are you safe?\I'm fine.\Two came to our rooms, too.\We took care of them. response:	Looks like they're dogs from Albion.
context: It's not even light out yet...\Sounds like it...\Captain!\Are you safe?\I'm fine.\Two came to our rooms, too.\We took care of them.\Looks like they're dogs from Albion. response:	Most likely.
context: Sounds like it...\Captain!\Are you safe?\I'm fine.\Two came to our rooms, too.\We took care of them.\Looks like they're dogs from Albion.\Most likely. response:	Okay, armour up and follow me!
context: Captain!\Are you safe?\I'm fine.\Two came to our rooms, too.\We took care of them.\Looks like they're dogs from Albion.\Most likely.\Okay, armour up and follow me! response:	Sensei!
context: Are you safe?\I'm fine.\Two came to our rooms, too.\We took care of them.\Looks like they're dogs from Albion.\Most likely.\Okay, armour up and follow me!\Sensei! response:	What's this?
context: I'm fine.\Two came to our rooms, too.\We took care of them.\Looks like they're dogs from Albion.\Most likely.\Okay, armour up and follow me!\Sensei!\What's this? response:	I'll go check.
context: Two came to our rooms, too.\We took care of them.\Looks like they're dogs from Albion.\Most likely.\Okay, armour up and follow me!\Sensei!\What's this?\I'll go check. response:	Saito-kun, you stay here and protect Miss Valliere.
context: We took care of them.\Looks like they're dogs from Albion.\Most likely.\Okay, armour up and follow me!\Sensei!\What's this?\I'll go check.\Saito-kun, you stay here and protect Miss Valliere. response:	Okay.
context: Looks like they're dogs from Albion.\Most likely.\Okay, armour up and follow me!\Sensei!\What's this?\I'll go check.\Saito-kun, you stay here and protect Miss Valliere.\Okay. response:	What... happened?
context: Most likely.\Okay, armour up and follow me!\Sensei!\What's this?\I'll go check.\Saito-kun, you stay here and protect Miss Valliere.\Okay.\What... happened? response:	Captain! They have occupied the dormitory wing!
context: Okay, armour up and follow me!\Sensei!\What's this?\I'll go check.\Saito-kun, you stay here and protect Miss Valliere.\Okay.\What... happened?\Captain! They have occupied the dormitory wing! response:	And the students?
context: Sensei!\What's this?\I'll go check.\Saito-kun, you stay here and protect Miss Valliere.\Okay.\What... happened?\Captain! They have occupied the dormitory wing!\And the students? response:	They're assembling in the cafeteria...
context: What's this?\I'll go check.\Saito-kun, you stay here and protect Miss Valliere.\Okay.\What... happened?\Captain! They have occupied the dormitory wing!\And the students?\They're assembling in the cafeteria... response:	Damn it, they have hostages in their hands...
context: I'll go check.\Saito-kun, you stay here and protect Miss Valliere.\Okay.\What... happened?\Captain! They have occupied the dormitory wing!\And the students?\They're assembling in the cafeteria...\Damn it, they have hostages in their hands... response:	Something isn't right.
context: Saito-kun, you stay here and protect Miss Valliere.\Okay.\What... happened?\Captain! They have occupied the dormitory wing!\And the students?\They're assembling in the cafeteria...\Damn it, they have hostages in their hands...\Something isn't right. response:	What's going on outside?
context: Okay.\What... happened?\Captain! They have occupied the dormitory wing!\And the students?\They're assembling in the cafeteria...\Damn it, they have hostages in their hands...\Something isn't right.\What's going on outside? response:	Don't worry about it, go to bed.
context: What... happened?\Captain! They have occupied the dormitory wing!\And the students?\They're assembling in the cafeteria...\Damn it, they have hostages in their hands...\Something isn't right.\What's going on outside?\Don't worry about it, go to bed. response:	I'll wake you up if something happens.
context: Captain! They have occupied the dormitory wing!\And the students?\They're assembling in the cafeteria...\Damn it, they have hostages in their hands...\Something isn't right.\What's going on outside?\Don't worry about it, go to bed.\I'll wake you up if something happens. response:	To come to the academy instead of the front line...
context: And the students?\They're assembling in the cafeteria...\Damn it, they have hostages in their hands...\Something isn't right.\What's going on outside?\Don't worry about it, go to bed.\I'll wake you up if something happens.\To come to the academy instead of the front line... response:	It looks like Albion's cornered.
context: They're assembling in the cafeteria...\Damn it, they have hostages in their hands...\Something isn't right.\What's going on outside?\Don't worry about it, go to bed.\I'll wake you up if something happens.\To come to the academy instead of the front line...\It looks like Albion's cornered. response:	Trying to be cynical, brat?
context: Damn it, they have hostages in their hands...\Something isn't right.\What's going on outside?\Don't worry about it, go to bed.\I'll wake you up if something happens.\To come to the academy instead of the front line...\It looks like Albion's cornered.\Trying to be cynical, brat? response:	It all means nothing to me.
context: Something isn't right.\What's going on outside?\Don't worry about it, go to bed.\I'll wake you up if something happens.\To come to the academy instead of the front line...\It looks like Albion's cornered.\Trying to be cynical, brat?\It all means nothing to me. response:	It's what my employer wants.
context: What's going on outside?\Don't worry about it, go to bed.\I'll wake you up if something happens.\To come to the academy instead of the front line...\It looks like Albion's cornered.\Trying to be cynical, brat?\It all means nothing to me.\It's what my employer wants. response:	I see, you're only a mercenary who's moved by money.
context: Don't worry about it, go to bed.\I'll wake you up if something happens.\To come to the academy instead of the front line...\It looks like Albion's cornered.\Trying to be cynical, brat?\It all means nothing to me.\It's what my employer wants.\I see, you're only a mercenary who's moved by money. response:	Julio-kun, it's dangerous. Stop provoking him.
context: I'll wake you up if something happens.\To come to the academy instead of the front line...\It looks like Albion's cornered.\Trying to be cynical, brat?\It all means nothing to me.\It's what my employer wants.\I see, you're only a mercenary who's moved by money.\Julio-kun, it's dangerous. Stop provoking him. response:	Let me say this.
context: To come to the academy instead of the front line...\It looks like Albion's cornered.\Trying to be cynical, brat?\It all means nothing to me.\It's what my employer wants.\I see, you're only a mercenary who's moved by money.\Julio-kun, it's dangerous. Stop provoking him.\Let me say this. response:	As long as you don't do anything to hinder us,
context: It looks like Albion's cornered.\Trying to be cynical, brat?\It all means nothing to me.\It's what my employer wants.\I see, you're only a mercenary who's moved by money.\Julio-kun, it's dangerous. Stop provoking him.\Let me say this.\As long as you don't do anything to hinder us, response:	we will not take your lives.
context: Trying to be cynical, brat?\It all means nothing to me.\It's what my employer wants.\I see, you're only a mercenary who's moved by money.\Julio-kun, it's dangerous. Stop provoking him.\Let me say this.\As long as you don't do anything to hinder us,\we will not take your lives. response:	Rest assured.
context: It all means nothing to me.\It's what my employer wants.\I see, you're only a mercenary who's moved by money.\Julio-kun, it's dangerous. Stop provoking him.\Let me say this.\As long as you don't do anything to hinder us,\we will not take your lives.\Rest assured. response:	Shut up!
context: It's what my employer wants.\I see, you're only a mercenary who's moved by money.\Julio-kun, it's dangerous. Stop provoking him.\Let me say this.\As long as you don't do anything to hinder us,\we will not take your lives.\Rest assured.\Shut up! response:	Do you want to turn into ashes?
context: I see, you're only a mercenary who's moved by money.\Julio-kun, it's dangerous. Stop provoking him.\Let me say this.\As long as you don't do anything to hinder us,\we will not take your lives.\Rest assured.\Shut up!\Do you want to turn into ashes? response:	Then, shut it.
context: Julio-kun, it's dangerous. Stop provoking him.\Let me say this.\As long as you don't do anything to hinder us,\we will not take your lives.\Rest assured.\Shut up!\Do you want to turn into ashes?\Then, shut it. response:	Hey, you guys.
context: Let me say this.\As long as you don't do anything to hinder us,\we will not take your lives.\Rest assured.\Shut up!\Do you want to turn into ashes?\Then, shut it.\Hey, you guys. response:	What?
context: As long as you don't do anything to hinder us,\we will not take your lives.\Rest assured.\Shut up!\Do you want to turn into ashes?\Then, shut it.\Hey, you guys.\What? response:	You want a hostage, right?
context: we will not take your lives.\Rest assured.\Shut up!\Do you want to turn into ashes?\Then, shut it.\Hey, you guys.\What?\You want a hostage, right? response:	Can you make due with only myself?
context: Rest assured.\Shut up!\Do you want to turn into ashes?\Then, shut it.\Hey, you guys.\What?\You want a hostage, right?\Can you make due with only myself? response:	I want you to release the students.
context: Shut up!\Do you want to turn into ashes?\Then, shut it.\Hey, you guys.\What?\You want a hostage, right?\Can you make due with only myself?\I want you to release the students. response:	I'm sorry, but you won't do.
context: Do you want to turn into ashes?\Then, shut it.\Hey, you guys.\What?\You want a hostage, right?\Can you make due with only myself?\I want you to release the students.\I'm sorry, but you won't do. response:	The country won't move for you.
context: Then, shut it.\Hey, you guys.\What?\You want a hostage, right?\Can you make due with only myself?\I want you to release the students.\I'm sorry, but you won't do.\The country won't move for you. response:	How about me, then?
context: Hey, you guys.\What?\You want a hostage, right?\Can you make due with only myself?\I want you to release the students.\I'm sorry, but you won't do.\The country won't move for you.\How about me, then? response:	I'm the first-born daughter of the La Valliere family.
context: What?\You want a hostage, right?\Can you make due with only myself?\I want you to release the students.\I'm sorry, but you won't do.\The country won't move for you.\How about me, then?\I'm the first-born daughter of the La Valliere family. response:	My father is an aristocrat with influence in this country.
context: You want a hostage, right?\Can you make due with only myself?\I want you to release the students.\I'm sorry, but you won't do.\The country won't move for you.\How about me, then?\I'm the first-born daughter of the La Valliere family.\My father is an aristocrat with influence in this country. response:	There shouldn't be any problems.
context: Can you make due with only myself?\I want you to release the students.\I'm sorry, but you won't do.\The country won't move for you.\How about me, then?\I'm the first-born daughter of the La Valliere family.\My father is an aristocrat with influence in this country.\There shouldn't be any problems. response:	I shall become a hostage as well,
context: I want you to release the students.\I'm sorry, but you won't do.\The country won't move for you.\How about me, then?\I'm the first-born daughter of the La Valliere family.\My father is an aristocrat with influence in this country.\There shouldn't be any problems.\I shall become a hostage as well, response:	so please release the students.
context: I'm sorry, but you won't do.\The country won't move for you.\How about me, then?\I'm the first-born daughter of the La Valliere family.\My father is an aristocrat with influence in this country.\There shouldn't be any problems.\I shall become a hostage as well,\so please release the students. response:	I like your spirit, but two isn't enough.
context: The country won't move for you.\How about me, then?\I'm the first-born daughter of the La Valliere family.\My father is an aristocrat with influence in this country.\There shouldn't be any problems.\I shall become a hostage as well,\so please release the students.\I like your spirit, but two isn't enough. response:	I need all of the students.
context: How about me, then?\I'm the first-born daughter of the La Valliere family.\My father is an aristocrat with influence in this country.\There shouldn't be any problems.\I shall become a hostage as well,\so please release the students.\I like your spirit, but two isn't enough.\I need all of the students. response:	With the lives of all the aristocrats' daughters in danger,
context: I'm the first-born daughter of the La Valliere family.\My father is an aristocrat with influence in this country.\There shouldn't be any problems.\I shall become a hostage as well,\so please release the students.\I like your spirit, but two isn't enough.\I need all of the students.\With the lives of all the aristocrats' daughters in danger, response:	Queen Henrietta will have to give us a thought.
context: My father is an aristocrat with influence in this country.\There shouldn't be any problems.\I shall become a hostage as well,\so please release the students.\I like your spirit, but two isn't enough.\I need all of the students.\With the lives of all the aristocrats' daughters in danger,\Queen Henrietta will have to give us a thought. response:	Those inside the cafeteria, listen!
context: There shouldn't be any problems.\I shall become a hostage as well,\so please release the students.\I like your spirit, but two isn't enough.\I need all of the students.\With the lives of all the aristocrats' daughters in danger,\Queen Henrietta will have to give us a thought.\Those inside the cafeteria, listen! response:	We are Her Highness' Musketeer Force!
context: I shall become a hostage as well,\so please release the students.\I like your spirit, but two isn't enough.\I need all of the students.\With the lives of all the aristocrats' daughters in danger,\Queen Henrietta will have to give us a thought.\Those inside the cafeteria, listen!\We are Her Highness' Musketeer Force! response:	We have you surrounded with my unit!
context: so please release the students.\I like your spirit, but two isn't enough.\I need all of the students.\With the lives of all the aristocrats' daughters in danger,\Queen Henrietta will have to give us a thought.\Those inside the cafeteria, listen!\We are Her Highness' Musketeer Force!\We have you surrounded with my unit! response:	Release the hostages!
context: I like your spirit, but two isn't enough.\I need all of the students.\With the lives of all the aristocrats' daughters in danger,\Queen Henrietta will have to give us a thought.\Those inside the cafeteria, listen!\We are Her Highness' Musketeer Force!\We have you surrounded with my unit!\Release the hostages! response:	If you surrender, we won't kill you!
context: I need all of the students.\With the lives of all the aristocrats' daughters in danger,\Queen Henrietta will have to give us a thought.\Those inside the cafeteria, listen!\We are Her Highness' Musketeer Force!\We have you surrounded with my unit!\Release the hostages!\If you surrender, we won't kill you! response:	Musketeer Force, eh?
context: With the lives of all the aristocrats' daughters in danger,\Queen Henrietta will have to give us a thought.\Those inside the cafeteria, listen!\We are Her Highness' Musketeer Force!\We have you surrounded with my unit!\Release the hostages!\If you surrender, we won't kill you!\Musketeer Force, eh? response:	We have hostages in hand, though.
context: Queen Henrietta will have to give us a thought.\Those inside the cafeteria, listen!\We are Her Highness' Musketeer Force!\We have you surrounded with my unit!\Release the hostages!\If you surrender, we won't kill you!\Musketeer Force, eh?\We have hostages in hand, though. response:	Those in the cafeteria!
context: Those inside the cafeteria, listen!\We are Her Highness' Musketeer Force!\We have you surrounded with my unit!\Release the hostages!\If you surrender, we won't kill you!\Musketeer Force, eh?\We have hostages in hand, though.\Those in the cafeteria! response:	No... Albionians!
context: We are Her Highness' Musketeer Force!\We have you surrounded with my unit!\Release the hostages!\If you surrender, we won't kill you!\Musketeer Force, eh?\We have hostages in hand, though.\Those in the cafeteria!\No... Albionians! response:	What is it that you want?!
context: We have you surrounded with my unit!\Release the hostages!\If you surrender, we won't kill you!\Musketeer Force, eh?\We have hostages in hand, though.\Those in the cafeteria!\No... Albionians!\What is it that you want?! response:	This isn't a political target, nor are there any weapons stored here.
context: Release the hostages!\If you surrender, we won't kill you!\Musketeer Force, eh?\We have hostages in hand, though.\Those in the cafeteria!\No... Albionians!\What is it that you want?!\This isn't a political target, nor are there any weapons stored here. response:	This is only an academy of magic.
context: If you surrender, we won't kill you!\Musketeer Force, eh?\We have hostages in hand, though.\Those in the cafeteria!\No... Albionians!\What is it that you want?!\This isn't a political target, nor are there any weapons stored here.\This is only an academy of magic. response:	It exploded before the signal?
context: Musketeer Force, eh?\We have hostages in hand, though.\Those in the cafeteria!\No... Albionians!\What is it that you want?!\This isn't a political target, nor are there any weapons stored here.\This is only an academy of magic.\It exploded before the signal? response:	You guys stay on watch here!
context: We have hostages in hand, though.\Those in the cafeteria!\No... Albionians!\What is it that you want?!\This isn't a political target, nor are there any weapons stored here.\This is only an academy of magic.\It exploded before the signal?\You guys stay on watch here! response:	Sir!
context: Those in the cafeteria!\No... Albionians!\What is it that you want?!\This isn't a political target, nor are there any weapons stored here.\This is only an academy of magic.\It exploded before the signal?\You guys stay on watch here!\Sir! response:	What was that?
context: No... Albionians!\What is it that you want?!\This isn't a political target, nor are there any weapons stored here.\This is only an academy of magic.\It exploded before the signal?\You guys stay on watch here!\Sir!\What was that? response:	An explosion?
context: What is it that you want?!\This isn't a political target, nor are there any weapons stored here.\This is only an academy of magic.\It exploded before the signal?\You guys stay on watch here!\Sir!\What was that?\An explosion? response:	Let's go, Saito!
context: This isn't a political target, nor are there any weapons stored here.\This is only an academy of magic.\It exploded before the signal?\You guys stay on watch here!\Sir!\What was that?\An explosion?\Let's go, Saito! response:	No, Colbert-sensei told us to stay here.
context: This is only an academy of magic.\It exploded before the signal?\You guys stay on watch here!\Sir!\What was that?\An explosion?\Let's go, Saito!\No, Colbert-sensei told us to stay here. response:	I'm worried because he isn't coming back!
context: It exploded before the signal?\You guys stay on watch here!\Sir!\What was that?\An explosion?\Let's go, Saito!\No, Colbert-sensei told us to stay here.\I'm worried because he isn't coming back! response:	Give me back my wand.
context: You guys stay on watch here!\Sir!\What was that?\An explosion?\Let's go, Saito!\No, Colbert-sensei told us to stay here.\I'm worried because he isn't coming back!\Give me back my wand. response:	Fine.
context: Sir!\What was that?\An explosion?\Let's go, Saito!\No, Colbert-sensei told us to stay here.\I'm worried because he isn't coming back!\Give me back my wand.\Fine. response:	Here.
context: What was that?\An explosion?\Let's go, Saito!\No, Colbert-sensei told us to stay here.\I'm worried because he isn't coming back!\Give me back my wand.\Fine.\Here. response:	Let's see, Unlock was...
context: An explosion?\Let's go, Saito!\No, Colbert-sensei told us to stay here.\I'm worried because he isn't coming back!\Give me back my wand.\Fine.\Here.\Let's see, Unlock was... response:	Whatever.
context: Let's go, Saito!\No, Colbert-sensei told us to stay here.\I'm worried because he isn't coming back!\Give me back my wand.\Fine.\Here.\Let's see, Unlock was...\Whatever. response:	Blowing up the door, eh?
context: No, Colbert-sensei told us to stay here.\I'm worried because he isn't coming back!\Give me back my wand.\Fine.\Here.\Let's see, Unlock was...\Whatever.\Blowing up the door, eh? response:	It opened, so what's the big deal?
context: I'm worried because he isn't coming back!\Give me back my wand.\Fine.\Here.\Let's see, Unlock was...\Whatever.\Blowing up the door, eh?\It opened, so what's the big deal? response:	Let's go.
context: Give me back my wand.\Fine.\Here.\Let's see, Unlock was...\Whatever.\Blowing up the door, eh?\It opened, so what's the big deal?\Let's go. response:	Okay, okay, Master.
context: Fine.\Here.\Let's see, Unlock was...\Whatever.\Blowing up the door, eh?\It opened, so what's the big deal?\Let's go.\Okay, okay, Master. response:	What a cheap tactic.
context: Here.\Let's see, Unlock was...\Whatever.\Blowing up the door, eh?\It opened, so what's the big deal?\Let's go.\Okay, okay, Master.\What a cheap tactic. response:	Henrietta's Musketeer Force!
context: Let's see, Unlock was...\Whatever.\Blowing up the door, eh?\It opened, so what's the big deal?\Let's go.\Okay, okay, Master.\What a cheap tactic.\Henrietta's Musketeer Force! response:	Stop this futile resistance!
context: Whatever.\Blowing up the door, eh?\It opened, so what's the big deal?\Let's go.\Okay, okay, Master.\What a cheap tactic.\Henrietta's Musketeer Force!\Stop this futile resistance! response:	Only an academy of magic?!
context: Blowing up the door, eh?\It opened, so what's the big deal?\Let's go.\Okay, okay, Master.\What a cheap tactic.\Henrietta's Musketeer Force!\Stop this futile resistance!\Only an academy of magic?! response:	Then why is your Musketeer Force stationed here?
context: It opened, so what's the big deal?\Let's go.\Okay, okay, Master.\What a cheap tactic.\Henrietta's Musketeer Force!\Stop this futile resistance!\Only an academy of magic?!\Then why is your Musketeer Force stationed here? response:	To Tristain, this is a treasure chest filled with people of Tristain's future.
context: Let's go.\Okay, okay, Master.\What a cheap tactic.\Henrietta's Musketeer Force!\Stop this futile resistance!\Only an academy of magic?!\Then why is your Musketeer Force stationed here?\To Tristain, this is a treasure chest filled with people of Tristain's future. response:	Right?
context: Okay, okay, Master.\What a cheap tactic.\Henrietta's Musketeer Force!\Stop this futile resistance!\Only an academy of magic?!\Then why is your Musketeer Force stationed here?\To Tristain, this is a treasure chest filled with people of Tristain's future.\Right? response:	Maybe I'll kill one person to test that.
context: What a cheap tactic.\Henrietta's Musketeer Force!\Stop this futile resistance!\Only an academy of magic?!\Then why is your Musketeer Force stationed here?\To Tristain, this is a treasure chest filled with people of Tristain's future.\Right?\Maybe I'll kill one person to test that. response:	Who should it be?
context: Henrietta's Musketeer Force!\Stop this futile resistance!\Only an academy of magic?!\Then why is your Musketeer Force stationed here?\To Tristain, this is a treasure chest filled with people of Tristain's future.\Right?\Maybe I'll kill one person to test that.\Who should it be? response:	You first.
context: Stop this futile resistance!\Only an academy of magic?!\Then why is your Musketeer Force stationed here?\To Tristain, this is a treasure chest filled with people of Tristain's future.\Right?\Maybe I'll kill one person to test that.\Who should it be?\You first. response:	I'll show them that we're serious.
context: Only an academy of magic?!\Then why is your Musketeer Force stationed here?\To Tristain, this is a treasure chest filled with people of Tristain's future.\Right?\Maybe I'll kill one person to test that.\Who should it be?\You first.\I'll show them that we're serious. response:	Stop it!
context: Then why is your Musketeer Force stationed here?\To Tristain, this is a treasure chest filled with people of Tristain's future.\Right?\Maybe I'll kill one person to test that.\Who should it be?\You first.\I'll show them that we're serious.\Stop it! response:	Agnes!
context: To Tristain, this is a treasure chest filled with people of Tristain's future.\Right?\Maybe I'll kill one person to test that.\Who should it be?\You first.\I'll show them that we're serious.\Stop it!\Agnes! response:	So she's the captain?
context: Right?\Maybe I'll kill one person to test that.\Who should it be?\You first.\I'll show them that we're serious.\Stop it!\Agnes!\So she's the captain? response:	How foolish.
context: Maybe I'll kill one person to test that.\Who should it be?\You first.\I'll show them that we're serious.\Stop it!\Agnes!\So she's the captain?\How foolish. response:	You think you can beat me?
context: Who should it be?\You first.\I'll show them that we're serious.\Stop it!\Agnes!\So she's the captain?\How foolish.\You think you can beat me? response:	I will not lose to a coward who takes hostages!
context: You first.\I'll show them that we're serious.\Stop it!\Agnes!\So she's the captain?\How foolish.\You think you can beat me?\I will not lose to a coward who takes hostages! response:	Personally, I don't like taking hostages.
context: I'll show them that we're serious.\Stop it!\Agnes!\So she's the captain?\How foolish.\You think you can beat me?\I will not lose to a coward who takes hostages!\Personally, I don't like taking hostages. response:	Rather than going through the trouble, I'd burn everything.
context: Stop it!\Agnes!\So she's the captain?\How foolish.\You think you can beat me?\I will not lose to a coward who takes hostages!\Personally, I don't like taking hostages.\Rather than going through the trouble, I'd burn everything. response:	What?
context: Agnes!\So she's the captain?\How foolish.\You think you can beat me?\I will not lose to a coward who takes hostages!\Personally, I don't like taking hostages.\Rather than going through the trouble, I'd burn everything.\What? response:	I burned an entire village once before.
context: So she's the captain?\How foolish.\You think you can beat me?\I will not lose to a coward who takes hostages!\Personally, I don't like taking hostages.\Rather than going through the trouble, I'd burn everything.\What?\I burned an entire village once before. response:	The sight of the fire engulfing everything was breathtaking!
context: How foolish.\You think you can beat me?\I will not lose to a coward who takes hostages!\Personally, I don't like taking hostages.\Rather than going through the trouble, I'd burn everything.\What?\I burned an entire village once before.\The sight of the fire engulfing everything was breathtaking! response:	That's what's great about war.
context: You think you can beat me?\I will not lose to a coward who takes hostages!\Personally, I don't like taking hostages.\Rather than going through the trouble, I'd burn everything.\What?\I burned an entire village once before.\The sight of the fire engulfing everything was breathtaking!\That's what's great about war. response:	You're...
context: I will not lose to a coward who takes hostages!\Personally, I don't like taking hostages.\Rather than going through the trouble, I'd burn everything.\What?\I burned an entire village once before.\The sight of the fire engulfing everything was breathtaking!\That's what's great about war.\You're... response:	You're the...
context: Personally, I don't like taking hostages.\Rather than going through the trouble, I'd burn everything.\What?\I burned an entire village once before.\The sight of the fire engulfing everything was breathtaking!\That's what's great about war.\You're...\You're the... response:	You're the one who...
context: Rather than going through the trouble, I'd burn everything.\What?\I burned an entire village once before.\The sight of the fire engulfing everything was breathtaking!\That's what's great about war.\You're...\You're the...\You're the one who... response:	It was you!
context: What?\I burned an entire village once before.\The sight of the fire engulfing everything was breathtaking!\That's what's great about war.\You're...\You're the...\You're the one who...\It was you! response:	They must be from Albion.
context: I burned an entire village once before.\The sight of the fire engulfing everything was breathtaking!\That's what's great about war.\You're...\You're the...\You're the one who...\It was you!\They must be from Albion. response:	Damn it, they took hostages.
context: The sight of the fire engulfing everything was breathtaking!\That's what's great about war.\You're...\You're the...\You're the one who...\It was you!\They must be from Albion.\Damn it, they took hostages. response:	Those cowards!
context: That's what's great about war.\You're...\You're the...\You're the one who...\It was you!\They must be from Albion.\Damn it, they took hostages.\Those cowards! response:	Yup, cowardly and unmerciful guys.
context: You're...\You're the...\You're the one who...\It was you!\They must be from Albion.\Damn it, they took hostages.\Those cowards!\Yup, cowardly and unmerciful guys. response:	You guys sure took your time to show up, Valliere and Saito.
context: You're the...\You're the one who...\It was you!\They must be from Albion.\Damn it, they took hostages.\Those cowards!\Yup, cowardly and unmerciful guys.\You guys sure took your time to show up, Valliere and Saito. response:	Kirche, Tabitha...
context: You're the one who...\It was you!\They must be from Albion.\Damn it, they took hostages.\Those cowards!\Yup, cowardly and unmerciful guys.\You guys sure took your time to show up, Valliere and Saito.\Kirche, Tabitha... response:	Oh, you're a survivor of that village?
context: It was you!\They must be from Albion.\Damn it, they took hostages.\Those cowards!\Yup, cowardly and unmerciful guys.\You guys sure took your time to show up, Valliere and Saito.\Kirche, Tabitha...\Oh, you're a survivor of that village? response:	You're one person I'll never forgive!
context: They must be from Albion.\Damn it, they took hostages.\Those cowards!\Yup, cowardly and unmerciful guys.\You guys sure took your time to show up, Valliere and Saito.\Kirche, Tabitha...\Oh, you're a survivor of that village?\You're one person I'll never forgive! response:	Die!
context: Damn it, they took hostages.\Those cowards!\Yup, cowardly and unmerciful guys.\You guys sure took your time to show up, Valliere and Saito.\Kirche, Tabitha...\Oh, you're a survivor of that village?\You're one person I'll never forgive!\Die! response:	Looks like you're more skilled with swords than myself.
context: Those cowards!\Yup, cowardly and unmerciful guys.\You guys sure took your time to show up, Valliere and Saito.\Kirche, Tabitha...\Oh, you're a survivor of that village?\You're one person I'll never forgive!\Die!\Looks like you're more skilled with swords than myself. response:	However...
context: Yup, cowardly and unmerciful guys.\You guys sure took your time to show up, Valliere and Saito.\Kirche, Tabitha...\Oh, you're a survivor of that village?\You're one person I'll never forgive!\Die!\Looks like you're more skilled with swords than myself.\However... response:	You're only a plebeian in the end!
context: You guys sure took your time to show up, Valliere and Saito.\Kirche, Tabitha...\Oh, you're a survivor of that village?\You're one person I'll never forgive!\Die!\Looks like you're more skilled with swords than myself.\However...\You're only a plebeian in the end! response:	Now you're unarmed!
context: Kirche, Tabitha...\Oh, you're a survivor of that village?\You're one person I'll never forgive!\Die!\Looks like you're more skilled with swords than myself.\However...\You're only a plebeian in the end!\Now you're unarmed! response:	Take this!
context: Oh, you're a survivor of that village?\You're one person I'll never forgive!\Die!\Looks like you're more skilled with swords than myself.\However...\You're only a plebeian in the end!\Now you're unarmed!\Take this! response:	Kirche, do you know how many of them there are?
context: You're one person I'll never forgive!\Die!\Looks like you're more skilled with swords than myself.\However...\You're only a plebeian in the end!\Now you're unarmed!\Take this!\Kirche, do you know how many of them there are? response:	I don't think there are too many of them.
context: Die!\Looks like you're more skilled with swords than myself.\However...\You're only a plebeian in the end!\Now you're unarmed!\Take this!\Kirche, do you know how many of them there are?\I don't think there are too many of them. response:	However...
context: Looks like you're more skilled with swords than myself.\However...\You're only a plebeian in the end!\Now you're unarmed!\Take this!\Kirche, do you know how many of them there are?\I don't think there are too many of them.\However... response:	They're skilled.
context: However...\You're only a plebeian in the end!\Now you're unarmed!\Take this!\Kirche, do you know how many of them there are?\I don't think there are too many of them.\However...\They're skilled. response:	Doesn't look too good...
context: You're only a plebeian in the end!\Now you're unarmed!\Take this!\Kirche, do you know how many of them there are?\I don't think there are too many of them.\However...\They're skilled.\Doesn't look too good... response:	We need to hurry and save them.
context: Now you're unarmed!\Take this!\Kirche, do you know how many of them there are?\I don't think there are too many of them.\However...\They're skilled.\Doesn't look too good...\We need to hurry and save them. response:	Shh... someone's here.
context: Take this!\Kirche, do you know how many of them there are?\I don't think there are too many of them.\However...\They're skilled.\Doesn't look too good...\We need to hurry and save them.\Shh... someone's here. response:	Everyone.
context: Kirche, do you know how many of them there are?\I don't think there are too many of them.\However...\They're skilled.\Doesn't look too good...\We need to hurry and save them.\Shh... someone's here.\Everyone. response:	Colbert-sensei.
context: I don't think there are too many of them.\However...\They're skilled.\Doesn't look too good...\We need to hurry and save them.\Shh... someone's here.\Everyone.\Colbert-sensei. response:	So you came here...
context: However...\They're skilled.\Doesn't look too good...\We need to hurry and save them.\Shh... someone's here.\Everyone.\Colbert-sensei.\So you came here... response:	I looked all over for you.
context: They're skilled.\Doesn't look too good...\We need to hurry and save them.\Shh... someone's here.\Everyone.\Colbert-sensei.\So you came here...\I looked all over for you. response:	Sensei, everyone's been taken hostage.
context: Doesn't look too good...\We need to hurry and save them.\Shh... someone's here.\Everyone.\Colbert-sensei.\So you came here...\I looked all over for you.\Sensei, everyone's been taken hostage. response:	I know.
context: We need to hurry and save them.\Shh... someone's here.\Everyone.\Colbert-sensei.\So you came here...\I looked all over for you.\Sensei, everyone's been taken hostage.\I know. response:	I just sent for reinforcements.
context: Shh... someone's here.\Everyone.\Colbert-sensei.\So you came here...\I looked all over for you.\Sensei, everyone's been taken hostage.\I know.\I just sent for reinforcements. response:	You guys get out of here now.
context: Everyone.\Colbert-sensei.\So you came here...\I looked all over for you.\Sensei, everyone's been taken hostage.\I know.\I just sent for reinforcements.\You guys get out of here now. response:	Reinforcements? They have to come all the way from the palace, don't they?
context: Colbert-sensei.\So you came here...\I looked all over for you.\Sensei, everyone's been taken hostage.\I know.\I just sent for reinforcements.\You guys get out of here now.\Reinforcements? They have to come all the way from the palace, don't they? response:	We've got to handle this.
context: So you came here...\I looked all over for you.\Sensei, everyone's been taken hostage.\I know.\I just sent for reinforcements.\You guys get out of here now.\Reinforcements? They have to come all the way from the palace, don't they?\We've got to handle this. response:	We're up against professionals.
context: I looked all over for you.\Sensei, everyone's been taken hostage.\I know.\I just sent for reinforcements.\You guys get out of here now.\Reinforcements? They have to come all the way from the palace, don't they?\We've got to handle this.\We're up against professionals. response:	You won't be a match for them!
context: Sensei, everyone's been taken hostage.\I know.\I just sent for reinforcements.\You guys get out of here now.\Reinforcements? They have to come all the way from the palace, don't they?\We've got to handle this.\We're up against professionals.\You won't be a match for them! response:	But what about everyone else?
context: I know.\I just sent for reinforcements.\You guys get out of here now.\Reinforcements? They have to come all the way from the palace, don't they?\We've got to handle this.\We're up against professionals.\You won't be a match for them!\But what about everyone else? response:	We need to wait until the reinforcements arrive.
context: I just sent for reinforcements.\You guys get out of here now.\Reinforcements? They have to come all the way from the palace, don't they?\We've got to handle this.\We're up against professionals.\You won't be a match for them!\But what about everyone else?\We need to wait until the reinforcements arrive. response:	You all get out of here.
context: You guys get out of here now.\Reinforcements? They have to come all the way from the palace, don't they?\We've got to handle this.\We're up against professionals.\You won't be a match for them!\But what about everyone else?\We need to wait until the reinforcements arrive.\You all get out of here. response:	I don't need a coward.
context: Reinforcements? They have to come all the way from the palace, don't they?\We've got to handle this.\We're up against professionals.\You won't be a match for them!\But what about everyone else?\We need to wait until the reinforcements arrive.\You all get out of here.\I don't need a coward. response:	If you want to run, then please do.
context: We've got to handle this.\We're up against professionals.\You won't be a match for them!\But what about everyone else?\We need to wait until the reinforcements arrive.\You all get out of here.\I don't need a coward.\If you want to run, then please do. response:	You can go.
context: We're up against professionals.\You won't be a match for them!\But what about everyone else?\We need to wait until the reinforcements arrive.\You all get out of here.\I don't need a coward.\If you want to run, then please do.\You can go. response:	So you're...
context: You won't be a match for them!\But what about everyone else?\We need to wait until the reinforcements arrive.\You all get out of here.\I don't need a coward.\If you want to run, then please do.\You can go.\So you're... response:	You were the captain!
context: But what about everyone else?\We need to wait until the reinforcements arrive.\You all get out of here.\I don't need a coward.\If you want to run, then please do.\You can go.\So you're...\You were the captain! response:	Unfortunately, no.
context: We need to wait until the reinforcements arrive.\You all get out of here.\I don't need a coward.\If you want to run, then please do.\You can go.\So you're...\You were the captain!\Unfortunately, no. response:	What?
context: You all get out of here.\I don't need a coward.\If you want to run, then please do.\You can go.\So you're...\You were the captain!\Unfortunately, no.\What? response:	Unfortunately, I was not.
context: I don't need a coward.\If you want to run, then please do.\You can go.\So you're...\You were the captain!\Unfortunately, no.\What?\Unfortunately, I was not. response:	I was only the vice-captain at the time.
context: If you want to run, then please do.\You can go.\So you're...\You were the captain!\Unfortunately, no.\What?\Unfortunately, I was not.\I was only the vice-captain at the time. response:	Flame Snake was the captain.
context: You can go.\So you're...\You were the captain!\Unfortunately, no.\What?\Unfortunately, I was not.\I was only the vice-captain at the time.\Flame Snake was the captain. response:	He was referred to as Enjya.
context: So you're...\You were the captain!\Unfortunately, no.\What?\Unfortunately, I was not.\I was only the vice-captain at the time.\Flame Snake was the captain.\He was referred to as Enjya. response:	He's more cruel than myself,
context: You were the captain!\Unfortunately, no.\What?\Unfortunately, I was not.\I was only the vice-captain at the time.\Flame Snake was the captain.\He was referred to as Enjya.\He's more cruel than myself, response:	and possessed a flame that burned everything.
context: Unfortunately, no.\What?\Unfortunately, I was not.\I was only the vice-captain at the time.\Flame Snake was the captain.\He was referred to as Enjya.\He's more cruel than myself,\and possessed a flame that burned everything. response:	What?
context: What?\Unfortunately, I was not.\I was only the vice-captain at the time.\Flame Snake was the captain.\He was referred to as Enjya.\He's more cruel than myself,\and possessed a flame that burned everything.\What? response:	I'm in search of that man myself!
context: Unfortunately, I was not.\I was only the vice-captain at the time.\Flame Snake was the captain.\He was referred to as Enjya.\He's more cruel than myself,\and possessed a flame that burned everything.\What?\I'm in search of that man myself! response:	That man who inflicted a wound upon me...
context: I was only the vice-captain at the time.\Flame Snake was the captain.\He was referred to as Enjya.\He's more cruel than myself,\and possessed a flame that burned everything.\What?\I'm in search of that man myself!\That man who inflicted a wound upon me... response:	I want to burn that man...!
context: Flame Snake was the captain.\He was referred to as Enjya.\He's more cruel than myself,\and possessed a flame that burned everything.\What?\I'm in search of that man myself!\That man who inflicted a wound upon me...\I want to burn that man...! response:	That's all I wish for!
context: He was referred to as Enjya.\He's more cruel than myself,\and possessed a flame that burned everything.\What?\I'm in search of that man myself!\That man who inflicted a wound upon me...\I want to burn that man...!\That's all I wish for! response:	You dog!
context: He's more cruel than myself,\and possessed a flame that burned everything.\What?\I'm in search of that man myself!\That man who inflicted a wound upon me...\I want to burn that man...!\That's all I wish for!\You dog! response:	We need to save everyone, fast!
context: and possessed a flame that burned everything.\What?\I'm in search of that man myself!\That man who inflicted a wound upon me...\I want to burn that man...!\That's all I wish for!\You dog!\We need to save everyone, fast! response:	What? Colbert-sensei is...?
context: What?\I'm in search of that man myself!\That man who inflicted a wound upon me...\I want to burn that man...!\That's all I wish for!\You dog!\We need to save everyone, fast!\What? Colbert-sensei is...? response:	He can't be!
context: I'm in search of that man myself!\That man who inflicted a wound upon me...\I want to burn that man...!\That's all I wish for!\You dog!\We need to save everyone, fast!\What? Colbert-sensei is...?\He can't be! response:	Zero no Tsukaima. Futatsuki no Kishi.
context: That man who inflicted a wound upon me...\I want to burn that man...!\That's all I wish for!\You dog!\We need to save everyone, fast!\What? Colbert-sensei is...?\He can't be!\Zero no Tsukaima. Futatsuki no Kishi. response:	The Flame of Atonement.
context: I want to burn that man...!\That's all I wish for!\You dog!\We need to save everyone, fast!\What? Colbert-sensei is...?\He can't be!\Zero no Tsukaima. Futatsuki no Kishi.\The Flame of Atonement. response:	If you want to meet me again next week, then sit tightly and wait!