context: The reality of the destruction around us fills our mind response:	The raging rain sounds like a storm of tears
context: The reality of the destruction around us fills our mind\The raging rain sounds like a storm of tears response:	that your eyes were given to you to acknowledge others,
context: The reality of the destruction around us fills our mind\The raging rain sounds like a storm of tears\that your eyes were given to you to acknowledge others, response:	that your eyes were given to you to acknowledge others,
context: The reality of the destruction around us fills our mind\The raging rain sounds like a storm of tears\that your eyes were given to you to acknowledge others,\that your eyes were given to you to acknowledge others, response:	that your eyes were given to you to acknowledge others,
context: The reality of the destruction around us fills our mind\The raging rain sounds like a storm of tears\that your eyes were given to you to acknowledge others,\that your eyes were given to you to acknowledge others,\that your eyes were given to you to acknowledge others, response:	that your eyes were given to you to acknowledge others,
context: The reality of the destruction around us fills our mind\The raging rain sounds like a storm of tears\that your eyes were given to you to acknowledge others,\that your eyes were given to you to acknowledge others,\that your eyes were given to you to acknowledge others,\that your eyes were given to you to acknowledge others, response:	that your eyes were given to you to acknowledge others,
context: The reality of the destruction around us fills our mind\The raging rain sounds like a storm of tears\that your eyes were given to you to acknowledge others,\that your eyes were given to you to acknowledge others,\that your eyes were given to you to acknowledge others,\that your eyes were given to you to acknowledge others,\that your eyes were given to you to acknowledge others, response:	that your voice was given to you to tell others how you feel
context: The reality of the destruction around us fills our mind\The raging rain sounds like a storm of tears\that your eyes were given to you to acknowledge others,\that your eyes were given to you to acknowledge others,\that your eyes were given to you to acknowledge others,\that your eyes were given to you to acknowledge others,\that your eyes were given to you to acknowledge others,\that your voice was given to you to tell others how you feel response:	All living things
context: The raging rain sounds like a storm of tears\that your eyes were given to you to acknowledge others,\that your eyes were given to you to acknowledge others,\that your eyes were given to you to acknowledge others,\that your eyes were given to you to acknowledge others,\that your eyes were given to you to acknowledge others,\that your voice was given to you to tell others how you feel\All living things response:	bear witness to my song
context: that your eyes were given to you to acknowledge others,\that your eyes were given to you to acknowledge others,\that your eyes were given to you to acknowledge others,\that your eyes were given to you to acknowledge others,\that your eyes were given to you to acknowledge others,\that your voice was given to you to tell others how you feel\All living things\bear witness to my song response:	Your heart contains all its truth
context: that your eyes were given to you to acknowledge others,\that your eyes were given to you to acknowledge others,\that your eyes were given to you to acknowledge others,\that your eyes were given to you to acknowledge others,\that your voice was given to you to tell others how you feel\All living things\bear witness to my song\Your heart contains all its truth response:	Even when all you see in your path are storms
context: that your eyes were given to you to acknowledge others,\that your eyes were given to you to acknowledge others,\that your eyes were given to you to acknowledge others,\that your voice was given to you to tell others how you feel\All living things\bear witness to my song\Your heart contains all its truth\Even when all you see in your path are storms response:	remember that your strength is no coincidence
context: that your eyes were given to you to acknowledge others,\that your eyes were given to you to acknowledge others,\that your voice was given to you to tell others how you feel\All living things\bear witness to my song\Your heart contains all its truth\Even when all you see in your path are storms\remember that your strength is no coincidence response:	Mana will be reborn by consuming Inori.
context: that your eyes were given to you to acknowledge others,\that your voice was given to you to tell others how you feel\All living things\bear witness to my song\Your heart contains all its truth\Even when all you see in your path are storms\remember that your strength is no coincidence\Mana will be reborn by consuming Inori. response:	Our lost Eve...
context: that your voice was given to you to tell others how you feel\All living things\bear witness to my song\Your heart contains all its truth\Even when all you see in your path are storms\remember that your strength is no coincidence\Mana will be reborn by consuming Inori.\Our lost Eve... response:	You're too late,
context: All living things\bear witness to my song\Your heart contains all its truth\Even when all you see in your path are storms\remember that your strength is no coincidence\Mana will be reborn by consuming Inori.\Our lost Eve...\You're too late, response:	Shu.
context: bear witness to my song\Your heart contains all its truth\Even when all you see in your path are storms\remember that your strength is no coincidence\Mana will be reborn by consuming Inori.\Our lost Eve...\You're too late,\Shu. response:	That can't be!
context: Your heart contains all its truth\Even when all you see in your path are storms\remember that your strength is no coincidence\Mana will be reborn by consuming Inori.\Our lost Eve...\You're too late,\Shu.\That can't be! response:	What's going on?
context: Even when all you see in your path are storms\remember that your strength is no coincidence\Mana will be reborn by consuming Inori.\Our lost Eve...\You're too late,\Shu.\That can't be!\What's going on? response:	What's this light?!
context: remember that your strength is no coincidence\Mana will be reborn by consuming Inori.\Our lost Eve...\You're too late,\Shu.\That can't be!\What's going on?\What's this light?! response:	Something's starting to happen!
context: Mana will be reborn by consuming Inori.\Our lost Eve...\You're too late,\Shu.\That can't be!\What's going on?\What's this light?!\Something's starting to happen! response:	There's no doubt about it.
context: Our lost Eve...\You're too late,\Shu.\That can't be!\What's going on?\What's this light?!\Something's starting to happen!\There's no doubt about it. response:	Okay. We'll hold them off here.
context: You're too late,\Shu.\That can't be!\What's going on?\What's this light?!\Something's starting to happen!\There's no doubt about it.\Okay. We'll hold them off here. response:	You go up as quickly as possible.
context: Shu.\That can't be!\What's going on?\What's this light?!\Something's starting to happen!\There's no doubt about it.\Okay. We'll hold them off here.\You go up as quickly as possible. response:	Ayase! Cover them!
context: That can't be!\What's going on?\What's this light?!\Something's starting to happen!\There's no doubt about it.\Okay. We'll hold them off here.\You go up as quickly as possible.\Ayase! Cover them! response:	Roger! But...
context: What's going on?\What's this light?!\Something's starting to happen!\There's no doubt about it.\Okay. We'll hold them off here.\You go up as quickly as possible.\Ayase! Cover them!\Roger! But... response:	You really got me last time.
context: What's this light?!\Something's starting to happen!\There's no doubt about it.\Okay. We'll hold them off here.\You go up as quickly as possible.\Ayase! Cover them!\Roger! But...\You really got me last time. response:	But this time will be different!
context: Something's starting to happen!\There's no doubt about it.\Okay. We'll hold them off here.\You go up as quickly as possible.\Ayase! Cover them!\Roger! But...\You really got me last time.\But this time will be different! response:	Now, I have the Gespenst!
context: There's no doubt about it.\Okay. We'll hold them off here.\You go up as quickly as possible.\Ayase! Cover them!\Roger! But...\You really got me last time.\But this time will be different!\Now, I have the Gespenst! response:	Tsugumi, you still can't take back control?
context: Okay. We'll hold them off here.\You go up as quickly as possible.\Ayase! Cover them!\Roger! But...\You really got me last time.\But this time will be different!\Now, I have the Gespenst!\Tsugumi, you still can't take back control? response:	The defenses suddenly got stronger!
context: You go up as quickly as possible.\Ayase! Cover them!\Roger! But...\You really got me last time.\But this time will be different!\Now, I have the Gespenst!\Tsugumi, you still can't take back control?\The defenses suddenly got stronger! response:	I keep trying to erase it, but it keeps coming back like a zombie!
context: Ayase! Cover them!\Roger! But...\You really got me last time.\But this time will be different!\Now, I have the Gespenst!\Tsugumi, you still can't take back control?\The defenses suddenly got stronger!\I keep trying to erase it, but it keeps coming back like a zombie! response:	Someone on par with Tsugumi...
context: Roger! But...\You really got me last time.\But this time will be different!\Now, I have the Gespenst!\Tsugumi, you still can't take back control?\The defenses suddenly got stronger!\I keep trying to erase it, but it keeps coming back like a zombie!\Someone on par with Tsugumi... response:	Kenji...
context: You really got me last time.\But this time will be different!\Now, I have the Gespenst!\Tsugumi, you still can't take back control?\The defenses suddenly got stronger!\I keep trying to erase it, but it keeps coming back like a zombie!\Someone on par with Tsugumi...\Kenji... response:	Is that you?
context: But this time will be different!\Now, I have the Gespenst!\Tsugumi, you still can't take back control?\The defenses suddenly got stronger!\I keep trying to erase it, but it keeps coming back like a zombie!\Someone on par with Tsugumi...\Kenji...\Is that you? response:	Good morning, Triton.
context: Now, I have the Gespenst!\Tsugumi, you still can't take back control?\The defenses suddenly got stronger!\I keep trying to erase it, but it keeps coming back like a zombie!\Someone on par with Tsugumi...\Kenji...\Is that you?\Good morning, Triton. response:	I see you're awake, Mana.
context: Tsugumi, you still can't take back control?\The defenses suddenly got stronger!\I keep trying to erase it, but it keeps coming back like a zombie!\Someone on par with Tsugumi...\Kenji...\Is that you?\Good morning, Triton.\I see you're awake, Mana. response:	Shu!
context: The defenses suddenly got stronger!\I keep trying to erase it, but it keeps coming back like a zombie!\Someone on par with Tsugumi...\Kenji...\Is that you?\Good morning, Triton.\I see you're awake, Mana.\Shu! response:	I'm so happy!
context: I keep trying to erase it, but it keeps coming back like a zombie!\Someone on par with Tsugumi...\Kenji...\Is that you?\Good morning, Triton.\I see you're awake, Mana.\Shu!\I'm so happy! response:	You came for me!
context: Someone on par with Tsugumi...\Kenji...\Is that you?\Good morning, Triton.\I see you're awake, Mana.\Shu!\I'm so happy!\You came for me! response:	It was terrible!
context: Kenji...\Is that you?\Good morning, Triton.\I see you're awake, Mana.\Shu!\I'm so happy!\You came for me!\It was terrible! response:	There was this annoying woman who kept getting in my way!
context: Is that you?\Good morning, Triton.\I see you're awake, Mana.\Shu!\I'm so happy!\You came for me!\It was terrible!\There was this annoying woman who kept getting in my way! response:	But it's all right now.
context: Good morning, Triton.\I see you're awake, Mana.\Shu!\I'm so happy!\You came for me!\It was terrible!\There was this annoying woman who kept getting in my way!\But it's all right now. response:	I crushed her and took this body for my own!
context: I see you're awake, Mana.\Shu!\I'm so happy!\You came for me!\It was terrible!\There was this annoying woman who kept getting in my way!\But it's all right now.\I crushed her and took this body for my own! response:	What was she thinking?!
context: Shu!\I'm so happy!\You came for me!\It was terrible!\There was this annoying woman who kept getting in my way!\But it's all right now.\I crushed her and took this body for my own!\What was she thinking?! response:	That manmade monster.
context: I'm so happy!\You came for me!\It was terrible!\There was this annoying woman who kept getting in my way!\But it's all right now.\I crushed her and took this body for my own!\What was she thinking?!\That manmade monster. response:	Stop!
context: You came for me!\It was terrible!\There was this annoying woman who kept getting in my way!\But it's all right now.\I crushed her and took this body for my own!\What was she thinking?!\That manmade monster.\Stop! response:	Shu!
context: It was terrible!\There was this annoying woman who kept getting in my way!\But it's all right now.\I crushed her and took this body for my own!\What was she thinking?!\That manmade monster.\Stop!\Shu! response:	Inori's no monster!
context: There was this annoying woman who kept getting in my way!\But it's all right now.\I crushed her and took this body for my own!\What was she thinking?!\That manmade monster.\Stop!\Shu!\Inori's no monster! response:	She cried for me!
context: But it's all right now.\I crushed her and took this body for my own!\What was she thinking?!\That manmade monster.\Stop!\Shu!\Inori's no monster!\She cried for me! response:	You look and sound the same, but she's not like you!
context: I crushed her and took this body for my own!\What was she thinking?!\That manmade monster.\Stop!\Shu!\Inori's no monster!\She cried for me!\You look and sound the same, but she's not like you! response:	She's human!
context: What was she thinking?!\That manmade monster.\Stop!\Shu!\Inori's no monster!\She cried for me!\You look and sound the same, but she's not like you!\She's human! response:	You're mean, Shu.
context: That manmade monster.\Stop!\Shu!\Inori's no monster!\She cried for me!\You look and sound the same, but she's not like you!\She's human!\You're mean, Shu. response:	Your big sister loves you so much.
context: Stop!\Shu!\Inori's no monster!\She cried for me!\You look and sound the same, but she's not like you!\She's human!\You're mean, Shu.\Your big sister loves you so much. response:	I loved you even when my body was blown to shreds.
context: Shu!\Inori's no monster!\She cried for me!\You look and sound the same, but she's not like you!\She's human!\You're mean, Shu.\Your big sister loves you so much.\I loved you even when my body was blown to shreds. response:	And yet,
context: Inori's no monster!\She cried for me!\You look and sound the same, but she's not like you!\She's human!\You're mean, Shu.\Your big sister loves you so much.\I loved you even when my body was blown to shreds.\And yet, response:	you reject me again, Shu!
context: She cried for me!\You look and sound the same, but she's not like you!\She's human!\You're mean, Shu.\Your big sister loves you so much.\I loved you even when my body was blown to shreds.\And yet,\you reject me again, Shu! response:	Stop right there.
context: You look and sound the same, but she's not like you!\She's human!\You're mean, Shu.\Your big sister loves you so much.\I loved you even when my body was blown to shreds.\And yet,\you reject me again, Shu!\Stop right there. response:	Gai?
context: She's human!\You're mean, Shu.\Your big sister loves you so much.\I loved you even when my body was blown to shreds.\And yet,\you reject me again, Shu!\Stop right there.\Gai? response:	Leave the rest to me.
context: You're mean, Shu.\Your big sister loves you so much.\I loved you even when my body was blown to shreds.\And yet,\you reject me again, Shu!\Stop right there.\Gai?\Leave the rest to me. response:	You hurt me, Shu.
context: Your big sister loves you so much.\I loved you even when my body was blown to shreds.\And yet,\you reject me again, Shu!\Stop right there.\Gai?\Leave the rest to me.\You hurt me, Shu. response:	If you hurt someone, you must be prepared to receive the same amount in return.
context: I loved you even when my body was blown to shreds.\And yet,\you reject me again, Shu!\Stop right there.\Gai?\Leave the rest to me.\You hurt me, Shu.\If you hurt someone, you must be prepared to receive the same amount in return. response:	I won't forgive you
context: And yet,\you reject me again, Shu!\Stop right there.\Gai?\Leave the rest to me.\You hurt me, Shu.\If you hurt someone, you must be prepared to receive the same amount in return.\I won't forgive you response:	even if you apologize.
context: you reject me again, Shu!\Stop right there.\Gai?\Leave the rest to me.\You hurt me, Shu.\If you hurt someone, you must be prepared to receive the same amount in return.\I won't forgive you\even if you apologize. response:	This is...!
context: Stop right there.\Gai?\Leave the rest to me.\You hurt me, Shu.\If you hurt someone, you must be prepared to receive the same amount in return.\I won't forgive you\even if you apologize.\This is...! response:	It's started, Gai.
context: Gai?\Leave the rest to me.\You hurt me, Shu.\If you hurt someone, you must be prepared to receive the same amount in return.\I won't forgive you\even if you apologize.\This is...!\It's started, Gai. response:	What's going on?!
context: Leave the rest to me.\You hurt me, Shu.\If you hurt someone, you must be prepared to receive the same amount in return.\I won't forgive you\even if you apologize.\This is...!\It's started, Gai.\What's going on?! response:	There's genomic resonance values higher than Lost Christmas coming from Tokyo!
context: You hurt me, Shu.\If you hurt someone, you must be prepared to receive the same amount in return.\I won't forgive you\even if you apologize.\This is...!\It's started, Gai.\What's going on?!\There's genomic resonance values higher than Lost Christmas coming from Tokyo! response:	It's even affecting the Endlave remote control system!
context: If you hurt someone, you must be prepared to receive the same amount in return.\I won't forgive you\even if you apologize.\This is...!\It's started, Gai.\What's going on?!\There's genomic resonance values higher than Lost Christmas coming from Tokyo!\It's even affecting the Endlave remote control system! response:	This is...
context: I won't forgive you\even if you apologize.\This is...!\It's started, Gai.\What's going on?!\There's genomic resonance values higher than Lost Christmas coming from Tokyo!\It's even affecting the Endlave remote control system!\This is... response:	The Fourth Apocalypse has started.
context: even if you apologize.\This is...!\It's started, Gai.\What's going on?!\There's genomic resonance values higher than Lost Christmas coming from Tokyo!\It's even affecting the Endlave remote control system!\This is...\The Fourth Apocalypse has started. response:	The evolution and selection of life on this planet.
context: This is...!\It's started, Gai.\What's going on?!\There's genomic resonance values higher than Lost Christmas coming from Tokyo!\It's even affecting the Endlave remote control system!\This is...\The Fourth Apocalypse has started.\The evolution and selection of life on this planet. response:	Yahiro!
context: It's started, Gai.\What's going on?!\There's genomic resonance values higher than Lost Christmas coming from Tokyo!\It's even affecting the Endlave remote control system!\This is...\The Fourth Apocalypse has started.\The evolution and selection of life on this planet.\Yahiro! response:	Discard our weak bodies and achieve an eternal consciousness within the crystals.
context: What's going on?!\There's genomic resonance values higher than Lost Christmas coming from Tokyo!\It's even affecting the Endlave remote control system!\This is...\The Fourth Apocalypse has started.\The evolution and selection of life on this planet.\Yahiro!\Discard our weak bodies and achieve an eternal consciousness within the crystals. response:	That's the next stage.
context: There's genomic resonance values higher than Lost Christmas coming from Tokyo!\It's even affecting the Endlave remote control system!\This is...\The Fourth Apocalypse has started.\The evolution and selection of life on this planet.\Yahiro!\Discard our weak bodies and achieve an eternal consciousness within the crystals.\That's the next stage. response:	The Voids were just a sign of a new world,
context: It's even affecting the Endlave remote control system!\This is...\The Fourth Apocalypse has started.\The evolution and selection of life on this planet.\Yahiro!\Discard our weak bodies and achieve an eternal consciousness within the crystals.\That's the next stage.\The Voids were just a sign of a new world, response:	where hearts are material!
context: This is...\The Fourth Apocalypse has started.\The evolution and selection of life on this planet.\Yahiro!\Discard our weak bodies and achieve an eternal consciousness within the crystals.\That's the next stage.\The Voids were just a sign of a new world,\where hearts are material! response:	It's because you're using normal weaponry!
context: The Fourth Apocalypse has started.\The evolution and selection of life on this planet.\Yahiro!\Discard our weak bodies and achieve an eternal consciousness within the crystals.\That's the next stage.\The Voids were just a sign of a new world,\where hearts are material!\It's because you're using normal weaponry! response:	We'll crush you!
context: The evolution and selection of life on this planet.\Yahiro!\Discard our weak bodies and achieve an eternal consciousness within the crystals.\That's the next stage.\The Voids were just a sign of a new world,\where hearts are material!\It's because you're using normal weaponry!\We'll crush you! response:	We won't let you!
context: Yahiro!\Discard our weak bodies and achieve an eternal consciousness within the crystals.\That's the next stage.\The Voids were just a sign of a new world,\where hearts are material!\It's because you're using normal weaponry!\We'll crush you!\We won't let you! response:	Don't underestimate us, you son of a bitch!
context: Discard our weak bodies and achieve an eternal consciousness within the crystals.\That's the next stage.\The Voids were just a sign of a new world,\where hearts are material!\It's because you're using normal weaponry!\We'll crush you!\We won't let you!\Don't underestimate us, you son of a bitch! response:	Ayase! Connect with a cable!
context: That's the next stage.\The Voids were just a sign of a new world,\where hearts are material!\It's because you're using normal weaponry!\We'll crush you!\We won't let you!\Don't underestimate us, you son of a bitch!\Ayase! Connect with a cable! response:	Tsugumi! An evasion program!
context: The Voids were just a sign of a new world,\where hearts are material!\It's because you're using normal weaponry!\We'll crush you!\We won't let you!\Don't underestimate us, you son of a bitch!\Ayase! Connect with a cable!\Tsugumi! An evasion program! response:	Tsugumi?!
context: where hearts are material!\It's because you're using normal weaponry!\We'll crush you!\We won't let you!\Don't underestimate us, you son of a bitch!\Ayase! Connect with a cable!\Tsugumi! An evasion program!\Tsugumi?! response:	You bitch!
context: It's because you're using normal weaponry!\We'll crush you!\We won't let you!\Don't underestimate us, you son of a bitch!\Ayase! Connect with a cable!\Tsugumi! An evasion program!\Tsugumi?!\You bitch! response:	Damn!
context: We'll crush you!\We won't let you!\Don't underestimate us, you son of a bitch!\Ayase! Connect with a cable!\Tsugumi! An evasion program!\Tsugumi?!\You bitch!\Damn! response:	What?!
context: We won't let you!\Don't underestimate us, you son of a bitch!\Ayase! Connect with a cable!\Tsugumi! An evasion program!\Tsugumi?!\You bitch!\Damn!\What?! response:	Lieutenant Daryl!
context: Don't underestimate us, you son of a bitch!\Ayase! Connect with a cable!\Tsugumi! An evasion program!\Tsugumi?!\You bitch!\Damn!\What?!\Lieutenant Daryl! response:	The Void Genome Emulator is still being tested!
context: Ayase! Connect with a cable!\Tsugumi! An evasion program!\Tsugumi?!\You bitch!\Damn!\What?!\Lieutenant Daryl!\The Void Genome Emulator is still being tested! response:	Don't overuse it!
context: Tsugumi! An evasion program!\Tsugumi?!\You bitch!\Damn!\What?!\Lieutenant Daryl!\The Void Genome Emulator is still being tested!\Don't overuse it! response:	What are you talking about?
context: Tsugumi?!\You bitch!\Damn!\What?!\Lieutenant Daryl!\The Void Genome Emulator is still being tested!\Don't overuse it!\What are you talking about? response:	I won't stop until I've butchered them all!
context: You bitch!\Damn!\What?!\Lieutenant Daryl!\The Void Genome Emulator is still being tested!\Don't overuse it!\What are you talking about?\I won't stop until I've butchered them all! response:	Souta!
context: Damn!\What?!\Lieutenant Daryl!\The Void Genome Emulator is still being tested!\Don't overuse it!\What are you talking about?\I won't stop until I've butchered them all!\Souta! response:	Gai!
context: What?!\Lieutenant Daryl!\The Void Genome Emulator is still being tested!\Don't overuse it!\What are you talking about?\I won't stop until I've butchered them all!\Souta!\Gai! response:	Back in Roppongi, you said you'd save Mana!
context: Lieutenant Daryl!\The Void Genome Emulator is still being tested!\Don't overuse it!\What are you talking about?\I won't stop until I've butchered them all!\Souta!\Gai!\Back in Roppongi, you said you'd save Mana! response:	You told me to stab you to save her!
context: The Void Genome Emulator is still being tested!\Don't overuse it!\What are you talking about?\I won't stop until I've butchered them all!\Souta!\Gai!\Back in Roppongi, you said you'd save Mana!\You told me to stab you to save her! response:	How did it come to this?!
context: Don't overuse it!\What are you talking about?\I won't stop until I've butchered them all!\Souta!\Gai!\Back in Roppongi, you said you'd save Mana!\You told me to stab you to save her!\How did it come to this?! response:	You can't understand, Shu.
context: What are you talking about?\I won't stop until I've butchered them all!\Souta!\Gai!\Back in Roppongi, you said you'd save Mana!\You told me to stab you to save her!\How did it come to this?!\You can't understand, Shu. response:	You were chosen, yet you chose to let go!
context: I won't stop until I've butchered them all!\Souta!\Gai!\Back in Roppongi, you said you'd save Mana!\You told me to stab you to save her!\How did it come to this?!\You can't understand, Shu.\You were chosen, yet you chose to let go! response:	You could never understand!
context: Souta!\Gai!\Back in Roppongi, you said you'd save Mana!\You told me to stab you to save her!\How did it come to this?!\You can't understand, Shu.\You were chosen, yet you chose to let go!\You could never understand! response:	How is it, Kurosu?
context: Gai!\Back in Roppongi, you said you'd save Mana!\You told me to stab you to save her!\How did it come to this?!\You can't understand, Shu.\You were chosen, yet you chose to let go!\You could never understand!\How is it, Kurosu? response:	The girl you tried to save is ending the world.
context: Back in Roppongi, you said you'd save Mana!\You told me to stab you to save her!\How did it come to this?!\You can't understand, Shu.\You were chosen, yet you chose to let go!\You could never understand!\How is it, Kurosu?\The girl you tried to save is ending the world. response:	I win.
context: You told me to stab you to save her!\How did it come to this?!\You can't understand, Shu.\You were chosen, yet you chose to let go!\You could never understand!\How is it, Kurosu?\The girl you tried to save is ending the world.\I win. response:	You did this to the world...
context: How did it come to this?!\You can't understand, Shu.\You were chosen, yet you chose to let go!\You could never understand!\How is it, Kurosu?\The girl you tried to save is ending the world.\I win.\You did this to the world... response:	To Shu... just for that?
context: You can't understand, Shu.\You were chosen, yet you chose to let go!\You could never understand!\How is it, Kurosu?\The girl you tried to save is ending the world.\I win.\You did this to the world...\To Shu... just for that? response:	I will not deny it.
context: You were chosen, yet you chose to let go!\You could never understand!\How is it, Kurosu?\The girl you tried to save is ending the world.\I win.\You did this to the world...\To Shu... just for that?\I will not deny it. response:	Are you going to shoot me,
context: You could never understand!\How is it, Kurosu?\The girl you tried to save is ending the world.\I win.\You did this to the world...\To Shu... just for that?\I will not deny it.\Are you going to shoot me, response:	Haruka?
context: How is it, Kurosu?\The girl you tried to save is ending the world.\I win.\You did this to the world...\To Shu... just for that?\I will not deny it.\Are you going to shoot me,\Haruka? response:	I can't let them through.
context: The girl you tried to save is ending the world.\I win.\You did this to the world...\To Shu... just for that?\I will not deny it.\Are you going to shoot me,\Haruka?\I can't let them through. response:	I will hold them off.
context: I win.\You did this to the world...\To Shu... just for that?\I will not deny it.\Are you going to shoot me,\Haruka?\I can't let them through.\I will hold them off. response:	For him...
context: You did this to the world...\To Shu... just for that?\I will not deny it.\Are you going to shoot me,\Haruka?\I can't let them through.\I will hold them off.\For him... response:	How persistent!
context: To Shu... just for that?\I will not deny it.\Are you going to shoot me,\Haruka?\I can't let them through.\I will hold them off.\For him...\How persistent! response:	Damn, I can't keep up!
context: I will not deny it.\Are you going to shoot me,\Haruka?\I can't let them through.\I will hold them off.\For him...\How persistent!\Damn, I can't keep up! response:	Tsugumi.
context: Are you going to shoot me,\Haruka?\I can't let them through.\I will hold them off.\For him...\How persistent!\Damn, I can't keep up!\Tsugumi. response:	Hold out until my signal.
context: Haruka?\I can't let them through.\I will hold them off.\For him...\How persistent!\Damn, I can't keep up!\Tsugumi.\Hold out until my signal. response:	Can you do that?
context: I can't let them through.\I will hold them off.\For him...\How persistent!\Damn, I can't keep up!\Tsugumi.\Hold out until my signal.\Can you do that? response:	Who do you think you're talking to?
context: I will hold them off.\For him...\How persistent!\Damn, I can't keep up!\Tsugumi.\Hold out until my signal.\Can you do that?\Who do you think you're talking to? response:	Back then, I would've let you
context: For him...\How persistent!\Damn, I can't keep up!\Tsugumi.\Hold out until my signal.\Can you do that?\Who do you think you're talking to?\Back then, I would've let you response:	have Mana and the place of Adam.
context: How persistent!\Damn, I can't keep up!\Tsugumi.\Hold out until my signal.\Can you do that?\Who do you think you're talking to?\Back then, I would've let you\have Mana and the place of Adam. response:	But now, you're unworthy.
context: Damn, I can't keep up!\Tsugumi.\Hold out until my signal.\Can you do that?\Who do you think you're talking to?\Back then, I would've let you\have Mana and the place of Adam.\But now, you're unworthy. response:	Die, Shu.
context: Tsugumi.\Hold out until my signal.\Can you do that?\Who do you think you're talking to?\Back then, I would've let you\have Mana and the place of Adam.\But now, you're unworthy.\Die, Shu. response:	My body's numb.
context: Hold out until my signal.\Can you do that?\Who do you think you're talking to?\Back then, I would've let you\have Mana and the place of Adam.\But now, you're unworthy.\Die, Shu.\My body's numb. response:	Am I going to die here?
context: Can you do that?\Who do you think you're talking to?\Back then, I would've let you\have Mana and the place of Adam.\But now, you're unworthy.\Die, Shu.\My body's numb.\Am I going to die here? response:	With everyone's Void's in me?
context: Who do you think you're talking to?\Back then, I would've let you\have Mana and the place of Adam.\But now, you're unworthy.\Die, Shu.\My body's numb.\Am I going to die here?\With everyone's Void's in me? response:	Don't give up, Shu.
context: Back then, I would've let you\have Mana and the place of Adam.\But now, you're unworthy.\Die, Shu.\My body's numb.\Am I going to die here?\With everyone's Void's in me?\Don't give up, Shu. response:	You can still move.
context: have Mana and the place of Adam.\But now, you're unworthy.\Die, Shu.\My body's numb.\Am I going to die here?\With everyone's Void's in me?\Don't give up, Shu.\You can still move. response:	Everyone's waiting for you.
context: But now, you're unworthy.\Die, Shu.\My body's numb.\Am I going to die here?\With everyone's Void's in me?\Don't give up, Shu.\You can still move.\Everyone's waiting for you. response:	Please, everyone...
context: Die, Shu.\My body's numb.\Am I going to die here?\With everyone's Void's in me?\Don't give up, Shu.\You can still move.\Everyone's waiting for you.\Please, everyone... response:	use me!
context: My body's numb.\Am I going to die here?\With everyone's Void's in me?\Don't give up, Shu.\You can still move.\Everyone's waiting for you.\Please, everyone...\use me! response:	What?
context: Am I going to die here?\With everyone's Void's in me?\Don't give up, Shu.\You can still move.\Everyone's waiting for you.\Please, everyone...\use me!\What? response:	What's going on?
context: With everyone's Void's in me?\Don't give up, Shu.\You can still move.\Everyone's waiting for you.\Please, everyone...\use me!\What?\What's going on? response:	Kenji,
context: Don't give up, Shu.\You can still move.\Everyone's waiting for you.\Please, everyone...\use me!\What?\What's going on?\Kenji, response:	it's checkmate.
context: You can still move.\Everyone's waiting for you.\Please, everyone...\use me!\What?\What's going on?\Kenji,\it's checkmate. response:	There are people
context: Everyone's waiting for you.\Please, everyone...\use me!\What?\What's going on?\Kenji,\it's checkmate.\There are people response:	who trusted me with their lives.
context: Please, everyone...\use me!\What?\What's going on?\Kenji,\it's checkmate.\There are people\who trusted me with their lives. response:	I can't die here.
context: use me!\What?\What's going on?\Kenji,\it's checkmate.\There are people\who trusted me with their lives.\I can't die here. response:	I will get Inori back for sure.
context: What?\What's going on?\Kenji,\it's checkmate.\There are people\who trusted me with their lives.\I can't die here.\I will get Inori back for sure. response:	Now!
context: What's going on?\Kenji,\it's checkmate.\There are people\who trusted me with their lives.\I can't die here.\I will get Inori back for sure.\Now! response:	Ayase, sorry for the wait!
context: Kenji,\it's checkmate.\There are people\who trusted me with their lives.\I can't die here.\I will get Inori back for sure.\Now!\Ayase, sorry for the wait! response:	Let's go!
context: it's checkmate.\There are people\who trusted me with their lives.\I can't die here.\I will get Inori back for sure.\Now!\Ayase, sorry for the wait!\Let's go! response:	Leave remote control to me!
context: There are people\who trusted me with their lives.\I can't die here.\I will get Inori back for sure.\Now!\Ayase, sorry for the wait!\Let's go!\Leave remote control to me! response:	Gai...
context: who trusted me with their lives.\I can't die here.\I will get Inori back for sure.\Now!\Ayase, sorry for the wait!\Let's go!\Leave remote control to me!\Gai... response:	Don't get in my way.
context: I can't die here.\I will get Inori back for sure.\Now!\Ayase, sorry for the wait!\Let's go!\Leave remote control to me!\Gai...\Don't get in my way. response:	I'll defeat you with all I have!
context: I will get Inori back for sure.\Now!\Ayase, sorry for the wait!\Let's go!\Leave remote control to me!\Gai...\Don't get in my way.\I'll defeat you with all I have! response:	That voice...
context: Now!\Ayase, sorry for the wait!\Let's go!\Leave remote control to me!\Gai...\Don't get in my way.\I'll defeat you with all I have!\That voice... response:	I knew it. You're there, aren't you?!
context: Ayase, sorry for the wait!\Let's go!\Leave remote control to me!\Gai...\Don't get in my way.\I'll defeat you with all I have!\That voice...\I knew it. You're there, aren't you?! response:	Tsugumi!
context: Let's go!\Leave remote control to me!\Gai...\Don't get in my way.\I'll defeat you with all I have!\That voice...\I knew it. You're there, aren't you?!\Tsugumi! response:	Aye!
context: Leave remote control to me!\Gai...\Don't get in my way.\I'll defeat you with all I have!\That voice...\I knew it. You're there, aren't you?!\Tsugumi!\Aye! response:	What?!
context: Gai...\Don't get in my way.\I'll defeat you with all I have!\That voice...\I knew it. You're there, aren't you?!\Tsugumi!\Aye!\What?! response:	If I take you out, I can be myself!
context: Don't get in my way.\I'll defeat you with all I have!\That voice...\I knew it. You're there, aren't you?!\Tsugumi!\Aye!\What?!\If I take you out, I can be myself! response:	I can be Daryl the butcher!
context: I'll defeat you with all I have!\That voice...\I knew it. You're there, aren't you?!\Tsugumi!\Aye!\What?!\If I take you out, I can be myself!\I can be Daryl the butcher! response:	Shut up! We'll fry you first!
context: That voice...\I knew it. You're there, aren't you?!\Tsugumi!\Aye!\What?!\If I take you out, I can be myself!\I can be Daryl the butcher!\Shut up! We'll fry you first! response:	Inori?
context: I knew it. You're there, aren't you?!\Tsugumi!\Aye!\What?!\If I take you out, I can be myself!\I can be Daryl the butcher!\Shut up! We'll fry you first!\Inori? response:	No!
context: Tsugumi!\Aye!\What?!\If I take you out, I can be myself!\I can be Daryl the butcher!\Shut up! We'll fry you first!\Inori?\No! response:	We did it?
context: Aye!\What?!\If I take you out, I can be myself!\I can be Daryl the butcher!\Shut up! We'll fry you first!\Inori?\No!\We did it? response:	Brother!
context: What?!\If I take you out, I can be myself!\I can be Daryl the butcher!\Shut up! We'll fry you first!\Inori?\No!\We did it?\Brother! response:	In the end, the winner was neither Kurosu nor I.
context: If I take you out, I can be myself!\I can be Daryl the butcher!\Shut up! We'll fry you first!\Inori?\No!\We did it?\Brother!\In the end, the winner was neither Kurosu nor I. response:	Go, Haruka.
context: I can be Daryl the butcher!\Shut up! We'll fry you first!\Inori?\No!\We did it?\Brother!\In the end, the winner was neither Kurosu nor I.\Go, Haruka. response:	Gai!
context: Shut up! We'll fry you first!\Inori?\No!\We did it?\Brother!\In the end, the winner was neither Kurosu nor I.\Go, Haruka.\Gai! response:	It's okay, Shu.
context: Inori?\No!\We did it?\Brother!\In the end, the winner was neither Kurosu nor I.\Go, Haruka.\Gai!\It's okay, Shu. response:	Just stay yourself.
context: No!\We did it?\Brother!\In the end, the winner was neither Kurosu nor I.\Go, Haruka.\Gai!\It's okay, Shu.\Just stay yourself. response:	Where am I?
context: We did it?\Brother!\In the end, the winner was neither Kurosu nor I.\Go, Haruka.\Gai!\It's okay, Shu.\Just stay yourself.\Where am I? response:	The place where selection converges.
context: Brother!\In the end, the winner was neither Kurosu nor I.\Go, Haruka.\Gai!\It's okay, Shu.\Just stay yourself.\Where am I?\The place where selection converges. response:	The world beyond the Apocalypse.
context: In the end, the winner was neither Kurosu nor I.\Go, Haruka.\Gai!\It's okay, Shu.\Just stay yourself.\Where am I?\The place where selection converges.\The world beyond the Apocalypse. response:	Gai...
context: Go, Haruka.\Gai!\It's okay, Shu.\Just stay yourself.\Where am I?\The place where selection converges.\The world beyond the Apocalypse.\Gai... response:	This is
context: Gai!\It's okay, Shu.\Just stay yourself.\Where am I?\The place where selection converges.\The world beyond the Apocalypse.\Gai...\This is response:	the utopia of the Da'at.
context: It's okay, Shu.\Just stay yourself.\Where am I?\The place where selection converges.\The world beyond the Apocalypse.\Gai...\This is\the utopia of the Da'at. response:	This whole planet will turn into
context: Just stay yourself.\Where am I?\The place where selection converges.\The world beyond the Apocalypse.\Gai...\This is\the utopia of the Da'at.\This whole planet will turn into response:	memories inside the crystals.
context: Where am I?\The place where selection converges.\The world beyond the Apocalypse.\Gai...\This is\the utopia of the Da'at.\This whole planet will turn into\memories inside the crystals. response:	I have been celebrated as a king,
context: The place where selection converges.\The world beyond the Apocalypse.\Gai...\This is\the utopia of the Da'at.\This whole planet will turn into\memories inside the crystals.\I have been celebrated as a king, response:	but in the end...
context: The world beyond the Apocalypse.\Gai...\This is\the utopia of the Da'at.\This whole planet will turn into\memories inside the crystals.\I have been celebrated as a king,\but in the end... response:	I have always been afraid of being selected out.
context: Gai...\This is\the utopia of the Da'at.\This whole planet will turn into\memories inside the crystals.\I have been celebrated as a king,\but in the end...\I have always been afraid of being selected out. response:	That's the reason why
context: This is\the utopia of the Da'at.\This whole planet will turn into\memories inside the crystals.\I have been celebrated as a king,\but in the end...\I have always been afraid of being selected out.\That's the reason why response:	I wanted Eve...
context: the utopia of the Da'at.\This whole planet will turn into\memories inside the crystals.\I have been celebrated as a king,\but in the end...\I have always been afraid of being selected out.\That's the reason why\I wanted Eve... response:	Mana.
context: This whole planet will turn into\memories inside the crystals.\I have been celebrated as a king,\but in the end...\I have always been afraid of being selected out.\That's the reason why\I wanted Eve...\Mana. response:	Back there,
context: memories inside the crystals.\I have been celebrated as a king,\but in the end...\I have always been afraid of being selected out.\That's the reason why\I wanted Eve...\Mana.\Back there, response:	when you stabbed us in Roppongi,
context: I have been celebrated as a king,\but in the end...\I have always been afraid of being selected out.\That's the reason why\I wanted Eve...\Mana.\Back there,\when you stabbed us in Roppongi, response:	I believed that Mana would be freed that way.
context: but in the end...\I have always been afraid of being selected out.\That's the reason why\I wanted Eve...\Mana.\Back there,\when you stabbed us in Roppongi,\I believed that Mana would be freed that way. response:	But Da'at,
context: I have always been afraid of being selected out.\That's the reason why\I wanted Eve...\Mana.\Back there,\when you stabbed us in Roppongi,\I believed that Mana would be freed that way.\But Da'at, response:	the will of the natural selection
context: That's the reason why\I wanted Eve...\Mana.\Back there,\when you stabbed us in Roppongi,\I believed that Mana would be freed that way.\But Da'at,\the will of the natural selection response:	will not allow Mana to die.
context: I wanted Eve...\Mana.\Back there,\when you stabbed us in Roppongi,\I believed that Mana would be freed that way.\But Da'at,\the will of the natural selection\will not allow Mana to die. response:	Even if she died, she'd just be reanimated again.
context: Mana.\Back there,\when you stabbed us in Roppongi,\I believed that Mana would be freed that way.\But Da'at,\the will of the natural selection\will not allow Mana to die.\Even if she died, she'd just be reanimated again. response:	There is just one way to save her.
context: Back there,\when you stabbed us in Roppongi,\I believed that Mana would be freed that way.\But Da'at,\the will of the natural selection\will not allow Mana to die.\Even if she died, she'd just be reanimated again.\There is just one way to save her. response:	That is to let her finish her role.
context: when you stabbed us in Roppongi,\I believed that Mana would be freed that way.\But Da'at,\the will of the natural selection\will not allow Mana to die.\Even if she died, she'd just be reanimated again.\There is just one way to save her.\That is to let her finish her role. response:	That's why I risked it.
context: I believed that Mana would be freed that way.\But Da'at,\the will of the natural selection\will not allow Mana to die.\Even if she died, she'd just be reanimated again.\There is just one way to save her.\That is to let her finish her role.\That's why I risked it. response:	I would become the devil myself and bring about the Apocalypse.
context: But Da'at,\the will of the natural selection\will not allow Mana to die.\Even if she died, she'd just be reanimated again.\There is just one way to save her.\That is to let her finish her role.\That's why I risked it.\I would become the devil myself and bring about the Apocalypse. response:	Then you would come to stop us.
context: the will of the natural selection\will not allow Mana to die.\Even if she died, she'd just be reanimated again.\There is just one way to save her.\That is to let her finish her role.\That's why I risked it.\I would become the devil myself and bring about the Apocalypse.\Then you would come to stop us. response:	My role ends here.
context: will not allow Mana to die.\Even if she died, she'd just be reanimated again.\There is just one way to save her.\That is to let her finish her role.\That's why I risked it.\I would become the devil myself and bring about the Apocalypse.\Then you would come to stop us.\My role ends here. response:	Gai!
context: Even if she died, she'd just be reanimated again.\There is just one way to save her.\That is to let her finish her role.\That's why I risked it.\I would become the devil myself and bring about the Apocalypse.\Then you would come to stop us.\My role ends here.\Gai! response:	Now go
context: There is just one way to save her.\That is to let her finish her role.\That's why I risked it.\I would become the devil myself and bring about the Apocalypse.\Then you would come to stop us.\My role ends here.\Gai!\Now go response:	and save Inori.
context: That is to let her finish her role.\That's why I risked it.\I would become the devil myself and bring about the Apocalypse.\Then you would come to stop us.\My role ends here.\Gai!\Now go\and save Inori. response:	Shu...
context: That's why I risked it.\I would become the devil myself and bring about the Apocalypse.\Then you would come to stop us.\My role ends here.\Gai!\Now go\and save Inori.\Shu... response:	Shu...
context: I would become the devil myself and bring about the Apocalypse.\Then you would come to stop us.\My role ends here.\Gai!\Now go\and save Inori.\Shu...\Shu... response:	Don't blame yourself...
context: Then you would come to stop us.\My role ends here.\Gai!\Now go\and save Inori.\Shu...\Shu...\Don't blame yourself... response:	got a lot of feelings from you.
context: My role ends here.\Gai!\Now go\and save Inori.\Shu...\Shu...\Don't blame yourself...\got a lot of feelings from you. response:	It's all
context: Gai!\Now go\and save Inori.\Shu...\Shu...\Don't blame yourself...\got a lot of feelings from you.\It's all response:	thanks to you.
context: Now go\and save Inori.\Shu...\Shu...\Don't blame yourself...\got a lot of feelings from you.\It's all\thanks to you. response:	Hey, Shu...
context: and save Inori.\Shu...\Shu...\Don't blame yourself...\got a lot of feelings from you.\It's all\thanks to you.\Hey, Shu... response:	Where are you?
context: Shu...\Shu...\Don't blame yourself...\got a lot of feelings from you.\It's all\thanks to you.\Hey, Shu...\Where are you? response:	Shu?
context: Shu...\Don't blame yourself...\got a lot of feelings from you.\It's all\thanks to you.\Hey, Shu...\Where are you?\Shu? response:	Shu...
context: Don't blame yourself...\got a lot of feelings from you.\It's all\thanks to you.\Hey, Shu...\Where are you?\Shu?\Shu... response:	Please stay with me.
context: got a lot of feelings from you.\It's all\thanks to you.\Hey, Shu...\Where are you?\Shu?\Shu...\Please stay with me. response:	I'm on your side.
context: It's all\thanks to you.\Hey, Shu...\Where are you?\Shu?\Shu...\Please stay with me.\I'm on your side. response:	Okay?
context: thanks to you.\Hey, Shu...\Where are you?\Shu?\Shu...\Please stay with me.\I'm on your side.\Okay? response:	Inori...
context: Hey, Shu...\Where are you?\Shu?\Shu...\Please stay with me.\I'm on your side.\Okay?\Inori... response:	Let's go together.
context: Where are you?\Shu?\Shu...\Please stay with me.\I'm on your side.\Okay?\Inori...\Let's go together. response:	This feeling!
context: Shu?\Shu...\Please stay with me.\I'm on your side.\Okay?\Inori...\Let's go together.\This feeling! response:	I felt it too!
context: Shu...\Please stay with me.\I'm on your side.\Okay?\Inori...\Let's go together.\This feeling!\I felt it too! response:	It's Ouma!
context: Please stay with me.\I'm on your side.\Okay?\Inori...\Let's go together.\This feeling!\I felt it too!\It's Ouma! response:	Shu! Are you going to become the new Savior!?
context: I'm on your side.\Okay?\Inori...\Let's go together.\This feeling!\I felt it too!\It's Ouma!\Shu! Are you going to become the new Savior!? response:	The entire framework is in havoc because of the Genome Crystal!
context: Okay?\Inori...\Let's go together.\This feeling!\I felt it too!\It's Ouma!\Shu! Are you going to become the new Savior!?\The entire framework is in havoc because of the Genome Crystal! response:	The whole building will collapse soon!
context: Inori...\Let's go together.\This feeling!\I felt it too!\It's Ouma!\Shu! Are you going to become the new Savior!?\The entire framework is in havoc because of the Genome Crystal!\The whole building will collapse soon! response:	Guys...
context: Let's go together.\This feeling!\I felt it too!\It's Ouma!\Shu! Are you going to become the new Savior!?\The entire framework is in havoc because of the Genome Crystal!\The whole building will collapse soon!\Guys... response:	Dr. Ouma! Are you unhurt?
context: This feeling!\I felt it too!\It's Ouma!\Shu! Are you going to become the new Savior!?\The entire framework is in havoc because of the Genome Crystal!\The whole building will collapse soon!\Guys...\Dr. Ouma! Are you unhurt? response:	You?
context: I felt it too!\It's Ouma!\Shu! Are you going to become the new Savior!?\The entire framework is in havoc because of the Genome Crystal!\The whole building will collapse soon!\Guys...\Dr. Ouma! Are you unhurt?\You? response:	If you get another chance,
context: It's Ouma!\Shu! Are you going to become the new Savior!?\The entire framework is in havoc because of the Genome Crystal!\The whole building will collapse soon!\Guys...\Dr. Ouma! Are you unhurt?\You?\If you get another chance, response:	be more kind to people!
context: Shu! Are you going to become the new Savior!?\The entire framework is in havoc because of the Genome Crystal!\The whole building will collapse soon!\Guys...\Dr. Ouma! Are you unhurt?\You?\If you get another chance,\be more kind to people! response:	Deep down, you were a nice guy, Daryl!
context: The entire framework is in havoc because of the Genome Crystal!\The whole building will collapse soon!\Guys...\Dr. Ouma! Are you unhurt?\You?\If you get another chance,\be more kind to people!\Deep down, you were a nice guy, Daryl! response:	I can feel the hearts of everyone flowing towards me.
context: The whole building will collapse soon!\Guys...\Dr. Ouma! Are you unhurt?\You?\If you get another chance,\be more kind to people!\Deep down, you were a nice guy, Daryl!\I can feel the hearts of everyone flowing towards me. response:	Their memories...
context: Guys...\Dr. Ouma! Are you unhurt?\You?\If you get another chance,\be more kind to people!\Deep down, you were a nice guy, Daryl!\I can feel the hearts of everyone flowing towards me.\Their memories... response:	Even the people who hated me were born
context: Dr. Ouma! Are you unhurt?\You?\If you get another chance,\be more kind to people!\Deep down, you were a nice guy, Daryl!\I can feel the hearts of everyone flowing towards me.\Their memories...\Even the people who hated me were born response:	and loved by someone.
context: You?\If you get another chance,\be more kind to people!\Deep down, you were a nice guy, Daryl!\I can feel the hearts of everyone flowing towards me.\Their memories...\Even the people who hated me were born\and loved by someone. response:	Inori...
context: If you get another chance,\be more kind to people!\Deep down, you were a nice guy, Daryl!\I can feel the hearts of everyone flowing towards me.\Their memories...\Even the people who hated me were born\and loved by someone.\Inori... response:	Take it.
context: be more kind to people!\Deep down, you were a nice guy, Daryl!\I can feel the hearts of everyone flowing towards me.\Their memories...\Even the people who hated me were born\and loved by someone.\Inori...\Take it. response:	Inori!
context: Deep down, you were a nice guy, Daryl!\I can feel the hearts of everyone flowing towards me.\Their memories...\Even the people who hated me were born\and loved by someone.\Inori...\Take it.\Inori! response:	Wait! Shu's still in there!
context: I can feel the hearts of everyone flowing towards me.\Their memories...\Even the people who hated me were born\and loved by someone.\Inori...\Take it.\Inori!\Wait! Shu's still in there! response:	I know!
context: Their memories...\Even the people who hated me were born\and loved by someone.\Inori...\Take it.\Inori!\Wait! Shu's still in there!\I know! response:	But, I can't let you die here either!
context: Even the people who hated me were born\and loved by someone.\Inori...\Take it.\Inori!\Wait! Shu's still in there!\I know!\But, I can't let you die here either! response:	Shu!
context: and loved by someone.\Inori...\Take it.\Inori!\Wait! Shu's still in there!\I know!\But, I can't let you die here either!\Shu! response:	Hey, Yahiro!
context: Inori...\Take it.\Inori!\Wait! Shu's still in there!\I know!\But, I can't let you die here either!\Shu!\Hey, Yahiro! response:	You're early.
context: Take it.\Inori!\Wait! Shu's still in there!\I know!\But, I can't let you die here either!\Shu!\Hey, Yahiro!\You're early. response:	You're busy with work?
context: Inori!\Wait! Shu's still in there!\I know!\But, I can't let you die here either!\Shu!\Hey, Yahiro!\You're early.\You're busy with work? response:	Kinda.
context: Wait! Shu's still in there!\I know!\But, I can't let you die here either!\Shu!\Hey, Yahiro!\You're early.\You're busy with work?\Kinda. response:	But I left early today.
context: I know!\But, I can't let you die here either!\Shu!\Hey, Yahiro!\You're early.\You're busy with work?\Kinda.\But I left early today. response:	Can I sit here?
context: But, I can't let you die here either!\Shu!\Hey, Yahiro!\You're early.\You're busy with work?\Kinda.\But I left early today.\Can I sit here? response:	Sure.
context: Shu!\Hey, Yahiro!\You're early.\You're busy with work?\Kinda.\But I left early today.\Can I sit here?\Sure. response:	Ayase, you're okay with an Earl Gray?
context: Hey, Yahiro!\You're early.\You're busy with work?\Kinda.\But I left early today.\Can I sit here?\Sure.\Ayase, you're okay with an Earl Gray? response:	These days you love me no more
context: You're early.\You're busy with work?\Kinda.\But I left early today.\Can I sit here?\Sure.\Ayase, you're okay with an Earl Gray?\These days you love me no more response:	That's so nice of you, Tsugumi.
context: You're busy with work?\Kinda.\But I left early today.\Can I sit here?\Sure.\Ayase, you're okay with an Earl Gray?\These days you love me no more\That's so nice of you, Tsugumi. response:	Just for today.
context: Kinda.\But I left early today.\Can I sit here?\Sure.\Ayase, you're okay with an Earl Gray?\These days you love me no more\That's so nice of you, Tsugumi.\Just for today. response:	Teacher exams are coming up, so I'll turn into a demon again at home.
context: But I left early today.\Can I sit here?\Sure.\Ayase, you're okay with an Earl Gray?\These days you love me no more\That's so nice of you, Tsugumi.\Just for today.\Teacher exams are coming up, so I'll turn into a demon again at home. response:	nor am I still treasured by you
context: Can I sit here?\Sure.\Ayase, you're okay with an Earl Gray?\These days you love me no more\That's so nice of you, Tsugumi.\Just for today.\Teacher exams are coming up, so I'll turn into a demon again at home.\nor am I still treasured by you response:	He's not here yet?
context: Sure.\Ayase, you're okay with an Earl Gray?\These days you love me no more\That's so nice of you, Tsugumi.\Just for today.\Teacher exams are coming up, so I'll turn into a demon again at home.\nor am I still treasured by you\He's not here yet? response:	He'll be here.
context: Ayase, you're okay with an Earl Gray?\These days you love me no more\That's so nice of you, Tsugumi.\Just for today.\Teacher exams are coming up, so I'll turn into a demon again at home.\nor am I still treasured by you\He's not here yet?\He'll be here. response:	Now I am all alone
context: These days you love me no more\That's so nice of you, Tsugumi.\Just for today.\Teacher exams are coming up, so I'll turn into a demon again at home.\nor am I still treasured by you\He's not here yet?\He'll be here.\Now I am all alone response:	He was looking forward to it.
context: That's so nice of you, Tsugumi.\Just for today.\Teacher exams are coming up, so I'll turn into a demon again at home.\nor am I still treasured by you\He's not here yet?\He'll be here.\Now I am all alone\He was looking forward to it. response:	Ah, there he is!
context: Just for today.\Teacher exams are coming up, so I'll turn into a demon again at home.\nor am I still treasured by you\He's not here yet?\He'll be here.\Now I am all alone\He was looking forward to it.\Ah, there he is! response:	It's been a while, hasn't it?
context: Teacher exams are coming up, so I'll turn into a demon again at home.\nor am I still treasured by you\He's not here yet?\He'll be here.\Now I am all alone\He was looking forward to it.\Ah, there he is!\It's been a while, hasn't it? response:	What did you tell me when we parted?
context: nor am I still treasured by you\He's not here yet?\He'll be here.\Now I am all alone\He was looking forward to it.\Ah, there he is!\It's been a while, hasn't it?\What did you tell me when we parted? response:	Sorry for the wait.
context: He's not here yet?\He'll be here.\Now I am all alone\He was looking forward to it.\Ah, there he is!\It's been a while, hasn't it?\What did you tell me when we parted?\Sorry for the wait. response:	The words hung in midair and never reached me
context: He'll be here.\Now I am all alone\He was looking forward to it.\Ah, there he is!\It's been a while, hasn't it?\What did you tell me when we parted?\Sorry for the wait.\The words hung in midair and never reached me response:	Then, to this year!
context: Now I am all alone\He was looking forward to it.\Ah, there he is!\It's been a while, hasn't it?\What did you tell me when we parted?\Sorry for the wait.\The words hung in midair and never reached me\Then, to this year! response:	Cheers!
context: He was looking forward to it.\Ah, there he is!\It's been a while, hasn't it?\What did you tell me when we parted?\Sorry for the wait.\The words hung in midair and never reached me\Then, to this year!\Cheers! response:	I know my dreams and wishes are illusory
context: Ah, there he is!\It's been a while, hasn't it?\What did you tell me when we parted?\Sorry for the wait.\The words hung in midair and never reached me\Then, to this year!\Cheers!\I know my dreams and wishes are illusory response:	and yet I cannot give up on them
context: It's been a while, hasn't it?\What did you tell me when we parted?\Sorry for the wait.\The words hung in midair and never reached me\Then, to this year!\Cheers!\I know my dreams and wishes are illusory\and yet I cannot give up on them response:	You said, Don't let go, hold onto my hand
context: What did you tell me when we parted?\Sorry for the wait.\The words hung in midair and never reached me\Then, to this year!\Cheers!\I know my dreams and wishes are illusory\and yet I cannot give up on them\You said, Don't let go, hold onto my hand response:	and, We will always be together
context: Sorry for the wait.\The words hung in midair and never reached me\Then, to this year!\Cheers!\I know my dreams and wishes are illusory\and yet I cannot give up on them\You said, Don't let go, hold onto my hand\and, We will always be together response:	Your hands as I held them were warm
context: The words hung in midair and never reached me\Then, to this year!\Cheers!\I know my dreams and wishes are illusory\and yet I cannot give up on them\You said, Don't let go, hold onto my hand\and, We will always be together\Your hands as I held them were warm response:	and tender
context: Then, to this year!\Cheers!\I know my dreams and wishes are illusory\and yet I cannot give up on them\You said, Don't let go, hold onto my hand\and, We will always be together\Your hands as I held them were warm\and tender response:	Thank you very much for watching until now!
context: Cheers!\I know my dreams and wishes are illusory\and yet I cannot give up on them\You said, Don't let go, hold onto my hand\and, We will always be together\Your hands as I held them were warm\and tender\Thank you very much for watching until now! response:	Production I.G., Team 6