context: This is your last chance. response:	He's gone.
context: This is your last chance.\He's gone. response:	Uesugi-kun! Did you see all that?
context: This is your last chance.\He's gone.\Uesugi-kun! Did you see all that? response:	He's as scary a dad as I imagined.
context: This is your last chance.\He's gone.\Uesugi-kun! Did you see all that?\He's as scary a dad as I imagined. response:	Yeah.
context: This is your last chance.\He's gone.\Uesugi-kun! Did you see all that?\He's as scary a dad as I imagined.\Yeah. response:	He's absolutely in the right.
context: This is your last chance.\He's gone.\Uesugi-kun! Did you see all that?\He's as scary a dad as I imagined.\Yeah.\He's absolutely in the right. response:	But some things matter more than being right.
context: This is your last chance.\He's gone.\Uesugi-kun! Did you see all that?\He's as scary a dad as I imagined.\Yeah.\He's absolutely in the right.\But some things matter more than being right. response:	I never thought he'd bring up transferring.
context: This is your last chance.\He's gone.\Uesugi-kun! Did you see all that?\He's as scary a dad as I imagined.\Yeah.\He's absolutely in the right.\But some things matter more than being right.\I never thought he'd bring up transferring. response:	Now I really can't afford to fail.
context: He's gone.\Uesugi-kun! Did you see all that?\He's as scary a dad as I imagined.\Yeah.\He's absolutely in the right.\But some things matter more than being right.\I never thought he'd bring up transferring.\Now I really can't afford to fail. response:	I'm sorry for getting you caught up in our family matters.
context: Uesugi-kun! Did you see all that?\He's as scary a dad as I imagined.\Yeah.\He's absolutely in the right.\But some things matter more than being right.\I never thought he'd bring up transferring.\Now I really can't afford to fail.\I'm sorry for getting you caught up in our family matters. response:	I don't want to transfer.
context: He's as scary a dad as I imagined.\Yeah.\He's absolutely in the right.\But some things matter more than being right.\I never thought he'd bring up transferring.\Now I really can't afford to fail.\I'm sorry for getting you caught up in our family matters.\I don't want to transfer. response:	But that's not my concern.
context: Yeah.\He's absolutely in the right.\But some things matter more than being right.\I never thought he'd bring up transferring.\Now I really can't afford to fail.\I'm sorry for getting you caught up in our family matters.\I don't want to transfer.\But that's not my concern. response:	Whether it's your circumstances, or your family's circumstances,
context: He's absolutely in the right.\But some things matter more than being right.\I never thought he'd bring up transferring.\Now I really can't afford to fail.\I'm sorry for getting you caught up in our family matters.\I don't want to transfer.\But that's not my concern.\Whether it's your circumstances, or your family's circumstances, response:	or your previous school, or this transfer ultimatum...
context: But some things matter more than being right.\I never thought he'd bring up transferring.\Now I really can't afford to fail.\I'm sorry for getting you caught up in our family matters.\I don't want to transfer.\But that's not my concern.\Whether it's your circumstances, or your family's circumstances,\or your previous school, or this transfer ultimatum... response:	None of it matters.
context: I never thought he'd bring up transferring.\Now I really can't afford to fail.\I'm sorry for getting you caught up in our family matters.\I don't want to transfer.\But that's not my concern.\Whether it's your circumstances, or your family's circumstances,\or your previous school, or this transfer ultimatum...\None of it matters. response:	I'm going to do as I please.
context: Now I really can't afford to fail.\I'm sorry for getting you caught up in our family matters.\I don't want to transfer.\But that's not my concern.\Whether it's your circumstances, or your family's circumstances,\or your previous school, or this transfer ultimatum...\None of it matters.\I'm going to do as I please. response:	And I'm going to make you all pass!
context: I'm sorry for getting you caught up in our family matters.\I don't want to transfer.\But that's not my concern.\Whether it's your circumstances, or your family's circumstances,\or your previous school, or this transfer ultimatum...\None of it matters.\I'm going to do as I please.\And I'm going to make you all pass! response:	I'm going to make you all graduate with your heads held high.
context: I don't want to transfer.\But that's not my concern.\Whether it's your circumstances, or your family's circumstances,\or your previous school, or this transfer ultimatum...\None of it matters.\I'm going to do as I please.\And I'm going to make you all pass!\I'm going to make you all graduate with your heads held high. response:	That's all I'm thinking about!
context: But that's not my concern.\Whether it's your circumstances, or your family's circumstances,\or your previous school, or this transfer ultimatum...\None of it matters.\I'm going to do as I please.\And I'm going to make you all pass!\I'm going to make you all graduate with your heads held high.\That's all I'm thinking about! response:	That's encouraging.
context: Whether it's your circumstances, or your family's circumstances,\or your previous school, or this transfer ultimatum...\None of it matters.\I'm going to do as I please.\And I'm going to make you all pass!\I'm going to make you all graduate with your heads held high.\That's all I'm thinking about!\That's encouraging. response:	The Last Exam
context: or your previous school, or this transfer ultimatum...\None of it matters.\I'm going to do as I please.\And I'm going to make you all pass!\I'm going to make you all graduate with your heads held high.\That's all I'm thinking about!\That's encouraging.\The Last Exam response:	Final Exams
context: None of it matters.\I'm going to do as I please.\And I'm going to make you all pass!\I'm going to make you all graduate with your heads held high.\That's all I'm thinking about!\That's encouraging.\The Last Exam\Final Exams response:	I have my promise with Father,
context: I'm going to do as I please.\And I'm going to make you all pass!\I'm going to make you all graduate with your heads held high.\That's all I'm thinking about!\That's encouraging.\The Last Exam\Final Exams\I have my promise with Father, response:	but unless I can pass this exam and move on to the next grade,
context: And I'm going to make you all pass!\I'm going to make you all graduate with your heads held high.\That's all I'm thinking about!\That's encouraging.\The Last Exam\Final Exams\I have my promise with Father,\but unless I can pass this exam and move on to the next grade, response:	my dreams won't matter.
context: I'm going to make you all graduate with your heads held high.\That's all I'm thinking about!\That's encouraging.\The Last Exam\Final Exams\I have my promise with Father,\but unless I can pass this exam and move on to the next grade,\my dreams won't matter. response:	Passing isn't my only goal on this exam.
context: That's all I'm thinking about!\That's encouraging.\The Last Exam\Final Exams\I have my promise with Father,\but unless I can pass this exam and move on to the next grade,\my dreams won't matter.\Passing isn't my only goal on this exam. response:	I decided back on that day that I would beat my sisters.
context: That's encouraging.\The Last Exam\Final Exams\I have my promise with Father,\but unless I can pass this exam and move on to the next grade,\my dreams won't matter.\Passing isn't my only goal on this exam.\I decided back on that day that I would beat my sisters. response:	Don't think about anything else.
context: The Last Exam\Final Exams\I have my promise with Father,\but unless I can pass this exam and move on to the next grade,\my dreams won't matter.\Passing isn't my only goal on this exam.\I decided back on that day that I would beat my sisters.\Don't think about anything else. response:	I need to focus on passing.
context: Final Exams\I have my promise with Father,\but unless I can pass this exam and move on to the next grade,\my dreams won't matter.\Passing isn't my only goal on this exam.\I decided back on that day that I would beat my sisters.\Don't think about anything else.\I need to focus on passing. response:	This can't be...
context: I have my promise with Father,\but unless I can pass this exam and move on to the next grade,\my dreams won't matter.\Passing isn't my only goal on this exam.\I decided back on that day that I would beat my sisters.\Don't think about anything else.\I need to focus on passing.\This can't be... response:	This can't be happening.
context: but unless I can pass this exam and move on to the next grade,\my dreams won't matter.\Passing isn't my only goal on this exam.\I decided back on that day that I would beat my sisters.\Don't think about anything else.\I need to focus on passing.\This can't be...\This can't be happening. response:	Me? With him, of all people?
context: my dreams won't matter.\Passing isn't my only goal on this exam.\I decided back on that day that I would beat my sisters.\Don't think about anything else.\I need to focus on passing.\This can't be...\This can't be happening.\Me? With him, of all people? response:	I've kept messing up until now.
context: Passing isn't my only goal on this exam.\I decided back on that day that I would beat my sisters.\Don't think about anything else.\I need to focus on passing.\This can't be...\This can't be happening.\Me? With him, of all people?\I've kept messing up until now. response:	But please, gods of studying, give me your strength this time.
context: I decided back on that day that I would beat my sisters.\Don't think about anything else.\I need to focus on passing.\This can't be...\This can't be happening.\Me? With him, of all people?\I've kept messing up until now.\But please, gods of studying, give me your strength this time. response:	We all worked so hard together!
context: Don't think about anything else.\I need to focus on passing.\This can't be...\This can't be happening.\Me? With him, of all people?\I've kept messing up until now.\But please, gods of studying, give me your strength this time.\We all worked so hard together! response:	We have two months until final exams.
context: I need to focus on passing.\This can't be...\This can't be happening.\Me? With him, of all people?\I've kept messing up until now.\But please, gods of studying, give me your strength this time.\We all worked so hard together!\We have two months until final exams. response:	Let's get started with our lessons, everyone!
context: This can't be...\This can't be happening.\Me? With him, of all people?\I've kept messing up until now.\But please, gods of studying, give me your strength this time.\We all worked so hard together!\We have two months until final exams.\Let's get started with our lessons, everyone! response:	Please do begin!
context: This can't be happening.\Me? With him, of all people?\I've kept messing up until now.\But please, gods of studying, give me your strength this time.\We all worked so hard together!\We have two months until final exams.\Let's get started with our lessons, everyone!\Please do begin! response:	And find out for us what we need to do to pass the exams!
context: Me? With him, of all people?\I've kept messing up until now.\But please, gods of studying, give me your strength this time.\We all worked so hard together!\We have two months until final exams.\Let's get started with our lessons, everyone!\Please do begin!\And find out for us what we need to do to pass the exams! response:	Y-Yeah.
context: I've kept messing up until now.\But please, gods of studying, give me your strength this time.\We all worked so hard together!\We have two months until final exams.\Let's get started with our lessons, everyone!\Please do begin!\And find out for us what we need to do to pass the exams!\Y-Yeah. response:	I'm glad you're enthusiastic.
context: But please, gods of studying, give me your strength this time.\We all worked so hard together!\We have two months until final exams.\Let's get started with our lessons, everyone!\Please do begin!\And find out for us what we need to do to pass the exams!\Y-Yeah.\I'm glad you're enthusiastic. response:	Anyway, let's start.
context: We all worked so hard together!\We have two months until final exams.\Let's get started with our lessons, everyone!\Please do begin!\And find out for us what we need to do to pass the exams!\Y-Yeah.\I'm glad you're enthusiastic.\Anyway, let's start. response:	Our goal is to get over 30 percent!
context: We have two months until final exams.\Let's get started with our lessons, everyone!\Please do begin!\And find out for us what we need to do to pass the exams!\Y-Yeah.\I'm glad you're enthusiastic.\Anyway, let's start.\Our goal is to get over 30 percent! response:	What's the matter?
context: Let's get started with our lessons, everyone!\Please do begin!\And find out for us what we need to do to pass the exams!\Y-Yeah.\I'm glad you're enthusiastic.\Anyway, let's start.\Our goal is to get over 30 percent!\What's the matter? response:	Maybe he's been reading something dirty.
context: Please do begin!\And find out for us what we need to do to pass the exams!\Y-Yeah.\I'm glad you're enthusiastic.\Anyway, let's start.\Our goal is to get over 30 percent!\What's the matter?\Maybe he's been reading something dirty. response:	It's her fault.
context: And find out for us what we need to do to pass the exams!\Y-Yeah.\I'm glad you're enthusiastic.\Anyway, let's start.\Our goal is to get over 30 percent!\What's the matter?\Maybe he's been reading something dirty.\It's her fault. response:	She's been force feeding me chocolates lately for some reason.
context: Y-Yeah.\I'm glad you're enthusiastic.\Anyway, let's start.\Our goal is to get over 30 percent!\What's the matter?\Maybe he's been reading something dirty.\It's her fault.\She's been force feeding me chocolates lately for some reason. response:	I brought some again.
context: I'm glad you're enthusiastic.\Anyway, let's start.\Our goal is to get over 30 percent!\What's the matter?\Maybe he's been reading something dirty.\It's her fault.\She's been force feeding me chocolates lately for some reason.\I brought some again. response:	Hey, I've been craving something sweet.
context: Anyway, let's start.\Our goal is to get over 30 percent!\What's the matter?\Maybe he's been reading something dirty.\It's her fault.\She's been force feeding me chocolates lately for some reason.\I brought some again.\Hey, I've been craving something sweet. response:	I'm not giving you any.
context: Our goal is to get over 30 percent!\What's the matter?\Maybe he's been reading something dirty.\It's her fault.\She's been force feeding me chocolates lately for some reason.\I brought some again.\Hey, I've been craving something sweet.\I'm not giving you any. response:	What? Quit being so greedy.
context: What's the matter?\Maybe he's been reading something dirty.\It's her fault.\She's been force feeding me chocolates lately for some reason.\I brought some again.\Hey, I've been craving something sweet.\I'm not giving you any.\What? Quit being so greedy. response:	I'm not.
context: Maybe he's been reading something dirty.\It's her fault.\She's been force feeding me chocolates lately for some reason.\I brought some again.\Hey, I've been craving something sweet.\I'm not giving you any.\What? Quit being so greedy.\I'm not. response:	Not yet.
context: It's her fault.\She's been force feeding me chocolates lately for some reason.\I brought some again.\Hey, I've been craving something sweet.\I'm not giving you any.\What? Quit being so greedy.\I'm not.\Not yet. response:	Have all of these and tell me what you think.
context: She's been force feeding me chocolates lately for some reason.\I brought some again.\Hey, I've been craving something sweet.\I'm not giving you any.\What? Quit being so greedy.\I'm not.\Not yet.\Have all of these and tell me what you think. response:	What kind of punishment is this?
context: I brought some again.\Hey, I've been craving something sweet.\I'm not giving you any.\What? Quit being so greedy.\I'm not.\Not yet.\Have all of these and tell me what you think.\What kind of punishment is this? response:	You're still up?
context: Hey, I've been craving something sweet.\I'm not giving you any.\What? Quit being so greedy.\I'm not.\Not yet.\Have all of these and tell me what you think.\What kind of punishment is this?\You're still up? response:	Ichika.
context: I'm not giving you any.\What? Quit being so greedy.\I'm not.\Not yet.\Have all of these and tell me what you think.\What kind of punishment is this?\You're still up?\Ichika. response:	Did I wake you? Sorry.
context: What? Quit being so greedy.\I'm not.\Not yet.\Have all of these and tell me what you think.\What kind of punishment is this?\You're still up?\Ichika.\Did I wake you? Sorry. response:	You must have a good idea of Futaro-kun's tastes by now.
context: I'm not.\Not yet.\Have all of these and tell me what you think.\What kind of punishment is this?\You're still up?\Ichika.\Did I wake you? Sorry.\You must have a good idea of Futaro-kun's tastes by now. response:	So you realized.
context: Not yet.\Have all of these and tell me what you think.\What kind of punishment is this?\You're still up?\Ichika.\Did I wake you? Sorry.\You must have a good idea of Futaro-kun's tastes by now.\So you realized. response:	I don't like sweet stuff, so I don't know what to do.
context: Have all of these and tell me what you think.\What kind of punishment is this?\You're still up?\Ichika.\Did I wake you? Sorry.\You must have a good idea of Futaro-kun's tastes by now.\So you realized.\I don't like sweet stuff, so I don't know what to do. response:	I'm making test batches.
context: What kind of punishment is this?\You're still up?\Ichika.\Did I wake you? Sorry.\You must have a good idea of Futaro-kun's tastes by now.\So you realized.\I don't like sweet stuff, so I don't know what to do.\I'm making test batches. response:	Uh...
context: You're still up?\Ichika.\Did I wake you? Sorry.\You must have a good idea of Futaro-kun's tastes by now.\So you realized.\I don't like sweet stuff, so I don't know what to do.\I'm making test batches.\Uh... response:	I see a skull icon.
context: Ichika.\Did I wake you? Sorry.\You must have a good idea of Futaro-kun's tastes by now.\So you realized.\I don't like sweet stuff, so I don't know what to do.\I'm making test batches.\Uh...\I see a skull icon. response:	This is the safe kind of skull icon.
context: Did I wake you? Sorry.\You must have a good idea of Futaro-kun's tastes by now.\So you realized.\I don't like sweet stuff, so I don't know what to do.\I'm making test batches.\Uh...\I see a skull icon.\This is the safe kind of skull icon. response:	What's a safe kind of skull icon?
context: You must have a good idea of Futaro-kun's tastes by now.\So you realized.\I don't like sweet stuff, so I don't know what to do.\I'm making test batches.\Uh...\I see a skull icon.\This is the safe kind of skull icon.\What's a safe kind of skull icon? response:	Why don't you try a simpler recipe?
context: So you realized.\I don't like sweet stuff, so I don't know what to do.\I'm making test batches.\Uh...\I see a skull icon.\This is the safe kind of skull icon.\What's a safe kind of skull icon?\Why don't you try a simpler recipe? response:	Just melt and mold it.
context: I don't like sweet stuff, so I don't know what to do.\I'm making test batches.\Uh...\I see a skull icon.\This is the safe kind of skull icon.\What's a safe kind of skull icon?\Why don't you try a simpler recipe?\Just melt and mold it. response:	I'm not particularly good at cooking, either.
context: I'm making test batches.\Uh...\I see a skull icon.\This is the safe kind of skull icon.\What's a safe kind of skull icon?\Why don't you try a simpler recipe?\Just melt and mold it.\I'm not particularly good at cooking, either. response:	Oh, right.
context: Uh...\I see a skull icon.\This is the safe kind of skull icon.\What's a safe kind of skull icon?\Why don't you try a simpler recipe?\Just melt and mold it.\I'm not particularly good at cooking, either.\Oh, right. response:	I know someone who's a great cook.
context: I see a skull icon.\This is the safe kind of skull icon.\What's a safe kind of skull icon?\Why don't you try a simpler recipe?\Just melt and mold it.\I'm not particularly good at cooking, either.\Oh, right.\I know someone who's a great cook. response:	Why don't you have them teach you?
context: This is the safe kind of skull icon.\What's a safe kind of skull icon?\Why don't you try a simpler recipe?\Just melt and mold it.\I'm not particularly good at cooking, either.\Oh, right.\I know someone who's a great cook.\Why don't you have them teach you? response:	We're a week into the third term.
context: What's a safe kind of skull icon?\Why don't you try a simpler recipe?\Just melt and mold it.\I'm not particularly good at cooking, either.\Oh, right.\I know someone who's a great cook.\Why don't you have them teach you?\We're a week into the third term. response:	We have a Sunday to work with.
context: Why don't you try a simpler recipe?\Just melt and mold it.\I'm not particularly good at cooking, either.\Oh, right.\I know someone who's a great cook.\Why don't you have them teach you?\We're a week into the third term.\We have a Sunday to work with. response:	Now's the time to buckle down.
context: Just melt and mold it.\I'm not particularly good at cooking, either.\Oh, right.\I know someone who's a great cook.\Why don't you have them teach you?\We're a week into the third term.\We have a Sunday to work with.\Now's the time to buckle down. response:	So why isn't Itsuki here?!
context: I'm not particularly good at cooking, either.\Oh, right.\I know someone who's a great cook.\Why don't you have them teach you?\We're a week into the third term.\We have a Sunday to work with.\Now's the time to buckle down.\So why isn't Itsuki here?! response:	Please do begin!
context: Oh, right.\I know someone who's a great cook.\Why don't you have them teach you?\We're a week into the third term.\We have a Sunday to work with.\Now's the time to buckle down.\So why isn't Itsuki here?!\Please do begin! response:	And find out for us...
context: I know someone who's a great cook.\Why don't you have them teach you?\We're a week into the third term.\We have a Sunday to work with.\Now's the time to buckle down.\So why isn't Itsuki here?!\Please do begin!\And find out for us... response:	What ever happened to that?!
context: Why don't you have them teach you?\We're a week into the third term.\We have a Sunday to work with.\Now's the time to buckle down.\So why isn't Itsuki here?!\Please do begin!\And find out for us...\What ever happened to that?! response:	There, there.
context: We're a week into the third term.\We have a Sunday to work with.\Now's the time to buckle down.\So why isn't Itsuki here?!\Please do begin!\And find out for us...\What ever happened to that?!\There, there. response:	Calm down.
context: We have a Sunday to work with.\Now's the time to buckle down.\So why isn't Itsuki here?!\Please do begin!\And find out for us...\What ever happened to that?!\There, there.\Calm down. response:	Where did she go, though?
context: Now's the time to buckle down.\So why isn't Itsuki here?!\Please do begin!\And find out for us...\What ever happened to that?!\There, there.\Calm down.\Where did she go, though? response:	Itsuki has that thing, remember?
context: So why isn't Itsuki here?!\Please do begin!\And find out for us...\What ever happened to that?!\There, there.\Calm down.\Where did she go, though?\Itsuki has that thing, remember? response:	It's that day for her.
context: Please do begin!\And find out for us...\What ever happened to that?!\There, there.\Calm down.\Where did she go, though?\Itsuki has that thing, remember?\It's that day for her. response:	Huh? What are you talking about?
context: And find out for us...\What ever happened to that?!\There, there.\Calm down.\Where did she go, though?\Itsuki has that thing, remember?\It's that day for her.\Huh? What are you talking about? response:	Just say it!
context: What ever happened to that?!\There, there.\Calm down.\Where did she go, though?\Itsuki has that thing, remember?\It's that day for her.\Huh? What are you talking about?\Just say it! response:	He's asking straight-up.
context: There, there.\Calm down.\Where did she go, though?\Itsuki has that thing, remember?\It's that day for her.\Huh? What are you talking about?\Just say it!\He's asking straight-up. response:	You sure are insensitive, aren't you?
context: Calm down.\Where did she go, though?\Itsuki has that thing, remember?\It's that day for her.\Huh? What are you talking about?\Just say it!\He's asking straight-up.\You sure are insensitive, aren't you? response:	Well, it's hard to talk about, but...
context: Where did she go, though?\Itsuki has that thing, remember?\It's that day for her.\Huh? What are you talking about?\Just say it!\He's asking straight-up.\You sure are insensitive, aren't you?\Well, it's hard to talk about, but... response:	What is it?
context: Itsuki has that thing, remember?\It's that day for her.\Huh? What are you talking about?\Just say it!\He's asking straight-up.\You sure are insensitive, aren't you?\Well, it's hard to talk about, but...\What is it? response:	Is it more important than exams?
context: It's that day for her.\Huh? What are you talking about?\Just say it!\He's asking straight-up.\You sure are insensitive, aren't you?\Well, it's hard to talk about, but...\What is it?\Is it more important than exams? response:	If it isn't, I'll kill her.
context: Huh? What are you talking about?\Just say it!\He's asking straight-up.\You sure are insensitive, aren't you?\Well, it's hard to talk about, but...\What is it?\Is it more important than exams?\If it isn't, I'll kill her. response:	Well...
context: Just say it!\He's asking straight-up.\You sure are insensitive, aren't you?\Well, it's hard to talk about, but...\What is it?\Is it more important than exams?\If it isn't, I'll kill her.\Well... response:	A girl has...
context: He's asking straight-up.\You sure are insensitive, aren't you?\Well, it's hard to talk about, but...\What is it?\Is it more important than exams?\If it isn't, I'll kill her.\Well...\A girl has... response:	No, it's the day Mother died.
context: You sure are insensitive, aren't you?\Well, it's hard to talk about, but...\What is it?\Is it more important than exams?\If it isn't, I'll kill her.\Well...\A girl has...\No, it's the day Mother died. response:	But wait, she was your mother, too.
context: Well, it's hard to talk about, but...\What is it?\Is it more important than exams?\If it isn't, I'll kill her.\Well...\A girl has...\No, it's the day Mother died.\But wait, she was your mother, too. response:	To be accurate, it isn't today.
context: What is it?\Is it more important than exams?\If it isn't, I'll kill her.\Well...\A girl has...\No, it's the day Mother died.\But wait, she was your mother, too.\To be accurate, it isn't today. response:	Mother passed away on August 14th.
context: Is it more important than exams?\If it isn't, I'll kill her.\Well...\A girl has...\No, it's the day Mother died.\But wait, she was your mother, too.\To be accurate, it isn't today.\Mother passed away on August 14th. response:	So, like, the monthiversary?
context: If it isn't, I'll kill her.\Well...\A girl has...\No, it's the day Mother died.\But wait, she was your mother, too.\To be accurate, it isn't today.\Mother passed away on August 14th.\So, like, the monthiversary? response:	Yeah.
context: Well...\A girl has...\No, it's the day Mother died.\But wait, she was your mother, too.\To be accurate, it isn't today.\Mother passed away on August 14th.\So, like, the monthiversary?\Yeah. response:	She's devoted to visiting her grave every month on the fourteenth.
context: A girl has...\No, it's the day Mother died.\But wait, she was your mother, too.\To be accurate, it isn't today.\Mother passed away on August 14th.\So, like, the monthiversary?\Yeah.\She's devoted to visiting her grave every month on the fourteenth. response:	Devoted, huh?
context: No, it's the day Mother died.\But wait, she was your mother, too.\To be accurate, it isn't today.\Mother passed away on August 14th.\So, like, the monthiversary?\Yeah.\She's devoted to visiting her grave every month on the fourteenth.\Devoted, huh? response:	Itsuki, is that really the only reason?
context: But wait, she was your mother, too.\To be accurate, it isn't today.\Mother passed away on August 14th.\So, like, the monthiversary?\Yeah.\She's devoted to visiting her grave every month on the fourteenth.\Devoted, huh?\Itsuki, is that really the only reason? response:	Am I ever going to be like you, Mother?
context: To be accurate, it isn't today.\Mother passed away on August 14th.\So, like, the monthiversary?\Yeah.\She's devoted to visiting her grave every month on the fourteenth.\Devoted, huh?\Itsuki, is that really the only reason?\Am I ever going to be like you, Mother? response:	Hey, I don't see other people here often.
context: Mother passed away on August 14th.\So, like, the monthiversary?\Yeah.\She's devoted to visiting her grave every month on the fourteenth.\Devoted, huh?\Itsuki, is that really the only reason?\Am I ever going to be like you, Mother?\Hey, I don't see other people here often. response:	Um...
context: So, like, the monthiversary?\Yeah.\She's devoted to visiting her grave every month on the fourteenth.\Devoted, huh?\Itsuki, is that really the only reason?\Am I ever going to be like you, Mother?\Hey, I don't see other people here often.\Um... response:	Nice to meet you.
context: Yeah.\She's devoted to visiting her grave every month on the fourteenth.\Devoted, huh?\Itsuki, is that really the only reason?\Am I ever going to be like you, Mother?\Hey, I don't see other people here often.\Um...\Nice to meet you. response:	Sensei?
context: She's devoted to visiting her grave every month on the fourteenth.\Devoted, huh?\Itsuki, is that really the only reason?\Am I ever going to be like you, Mother?\Hey, I don't see other people here often.\Um...\Nice to meet you.\Sensei? response:	Sorry, you look so much like Sensei, I thought you were her.
context: Devoted, huh?\Itsuki, is that really the only reason?\Am I ever going to be like you, Mother?\Hey, I don't see other people here often.\Um...\Nice to meet you.\Sensei?\Sorry, you look so much like Sensei, I thought you were her. response:	But thinking about it, she's been dead for a long time.
context: Itsuki, is that really the only reason?\Am I ever going to be like you, Mother?\Hey, I don't see other people here often.\Um...\Nice to meet you.\Sensei?\Sorry, you look so much like Sensei, I thought you were her.\But thinking about it, she's been dead for a long time. response:	That's not a nice thing to say in front of her daughter, huh?
context: Am I ever going to be like you, Mother?\Hey, I don't see other people here often.\Um...\Nice to meet you.\Sensei?\Sorry, you look so much like Sensei, I thought you were her.\But thinking about it, she's been dead for a long time.\That's not a nice thing to say in front of her daughter, huh? response:	Forgive me.
context: Hey, I don't see other people here often.\Um...\Nice to meet you.\Sensei?\Sorry, you look so much like Sensei, I thought you were her.\But thinking about it, she's been dead for a long time.\That's not a nice thing to say in front of her daughter, huh?\Forgive me. response:	There must be a reason we bumped into each other here.
context: Um...\Nice to meet you.\Sensei?\Sorry, you look so much like Sensei, I thought you were her.\But thinking about it, she's been dead for a long time.\That's not a nice thing to say in front of her daughter, huh?\Forgive me.\There must be a reason we bumped into each other here. response:	I'll buy you as much as you like, to show my appreciation for your mother.
context: Nice to meet you.\Sensei?\Sorry, you look so much like Sensei, I thought you were her.\But thinking about it, she's been dead for a long time.\That's not a nice thing to say in front of her daughter, huh?\Forgive me.\There must be a reason we bumped into each other here.\I'll buy you as much as you like, to show my appreciation for your mother. response:	A-As much as I like?!
context: Sensei?\Sorry, you look so much like Sensei, I thought you were her.\But thinking about it, she's been dead for a long time.\That's not a nice thing to say in front of her daughter, huh?\Forgive me.\There must be a reason we bumped into each other here.\I'll buy you as much as you like, to show my appreciation for your mother.\A-As much as I like?! response:	U-Um...
context: Sorry, you look so much like Sensei, I thought you were her.\But thinking about it, she's been dead for a long time.\That's not a nice thing to say in front of her daughter, huh?\Forgive me.\There must be a reason we bumped into each other here.\I'll buy you as much as you like, to show my appreciation for your mother.\A-As much as I like?!\U-Um... response:	Shimoda-san, are you my mother's...
context: But thinking about it, she's been dead for a long time.\That's not a nice thing to say in front of her daughter, huh?\Forgive me.\There must be a reason we bumped into each other here.\I'll buy you as much as you like, to show my appreciation for your mother.\A-As much as I like?!\U-Um...\Shimoda-san, are you my mother's... response:	I was her student.
context: That's not a nice thing to say in front of her daughter, huh?\Forgive me.\There must be a reason we bumped into each other here.\I'll buy you as much as you like, to show my appreciation for your mother.\A-As much as I like?!\U-Um...\Shimoda-san, are you my mother's...\I was her student. response:	I've lost count of how many times she smacked me.
context: Forgive me.\There must be a reason we bumped into each other here.\I'll buy you as much as you like, to show my appreciation for your mother.\A-As much as I like?!\U-Um...\Shimoda-san, are you my mother's...\I was her student.\I've lost count of how many times she smacked me. response:	That's the thing.
context: There must be a reason we bumped into each other here.\I'll buy you as much as you like, to show my appreciation for your mother.\A-As much as I like?!\U-Um...\Shimoda-san, are you my mother's...\I was her student.\I've lost count of how many times she smacked me.\That's the thing. response:	Could you please tell me what kind of person my mother was?
context: I'll buy you as much as you like, to show my appreciation for your mother.\A-As much as I like?!\U-Um...\Shimoda-san, are you my mother's...\I was her student.\I've lost count of how many times she smacked me.\That's the thing.\Could you please tell me what kind of person my mother was? response:	You don't remember?
context: A-As much as I like?!\U-Um...\Shimoda-san, are you my mother's...\I was her student.\I've lost count of how many times she smacked me.\That's the thing.\Could you please tell me what kind of person my mother was?\You don't remember? response:	It was only five years ago. Surely you were old enough.
context: U-Um...\Shimoda-san, are you my mother's...\I was her student.\I've lost count of how many times she smacked me.\That's the thing.\Could you please tell me what kind of person my mother was?\You don't remember?\It was only five years ago. Surely you were old enough. response:	Yes, but...
context: Shimoda-san, are you my mother's...\I was her student.\I've lost count of how many times she smacked me.\That's the thing.\Could you please tell me what kind of person my mother was?\You don't remember?\It was only five years ago. Surely you were old enough.\Yes, but... response:	I only know how my mother was at home.
context: I was her student.\I've lost count of how many times she smacked me.\That's the thing.\Could you please tell me what kind of person my mother was?\You don't remember?\It was only five years ago. Surely you were old enough.\Yes, but...\I only know how my mother was at home. response:	I want to know what kind of person she was as a teacher.
context: I've lost count of how many times she smacked me.\That's the thing.\Could you please tell me what kind of person my mother was?\You don't remember?\It was only five years ago. Surely you were old enough.\Yes, but...\I only know how my mother was at home.\I want to know what kind of person she was as a teacher. response:	She was unfriendly. She never tried to be nice to students.
context: That's the thing.\Could you please tell me what kind of person my mother was?\You don't remember?\It was only five years ago. Surely you were old enough.\Yes, but...\I only know how my mother was at home.\I want to know what kind of person she was as a teacher.\She was unfriendly. She never tried to be nice to students. response:	I never saw her smile at school.
context: Could you please tell me what kind of person my mother was?\You don't remember?\It was only five years ago. Surely you were old enough.\Yes, but...\I only know how my mother was at home.\I want to know what kind of person she was as a teacher.\She was unfriendly. She never tried to be nice to students.\I never saw her smile at school. response:	The students must have been terrified of her, then.
context: You don't remember?\It was only five years ago. Surely you were old enough.\Yes, but...\I only know how my mother was at home.\I want to know what kind of person she was as a teacher.\She was unfriendly. She never tried to be nice to students.\I never saw her smile at school.\The students must have been terrified of her, then. response:	Nope. Believe it or not, we weren't.
context: It was only five years ago. Surely you were old enough.\Yes, but...\I only know how my mother was at home.\I want to know what kind of person she was as a teacher.\She was unfriendly. She never tried to be nice to students.\I never saw her smile at school.\The students must have been terrified of her, then.\Nope. Believe it or not, we weren't. response:	She could be as fierce and expressionless as she pleased.
context: Yes, but...\I only know how my mother was at home.\I want to know what kind of person she was as a teacher.\She was unfriendly. She never tried to be nice to students.\I never saw her smile at school.\The students must have been terrified of her, then.\Nope. Believe it or not, we weren't.\She could be as fierce and expressionless as she pleased. response:	Hell, we loved her for it.
context: I only know how my mother was at home.\I want to know what kind of person she was as a teacher.\She was unfriendly. She never tried to be nice to students.\I never saw her smile at school.\The students must have been terrified of her, then.\Nope. Believe it or not, we weren't.\She could be as fierce and expressionless as she pleased.\Hell, we loved her for it. response:	Sensei was just that damn super beautiful.
context: I want to know what kind of person she was as a teacher.\She was unfriendly. She never tried to be nice to students.\I never saw her smile at school.\The students must have been terrified of her, then.\Nope. Believe it or not, we weren't.\She could be as fierce and expressionless as she pleased.\Hell, we loved her for it.\Sensei was just that damn super beautiful. response:	Super beautiful?
context: She was unfriendly. She never tried to be nice to students.\I never saw her smile at school.\The students must have been terrified of her, then.\Nope. Believe it or not, we weren't.\She could be as fierce and expressionless as she pleased.\Hell, we loved her for it.\Sensei was just that damn super beautiful.\Super beautiful? response:	She even had a fan club.
context: I never saw her smile at school.\The students must have been terrified of her, then.\Nope. Believe it or not, we weren't.\She could be as fierce and expressionless as she pleased.\Hell, we loved her for it.\Sensei was just that damn super beautiful.\Super beautiful?\She even had a fan club. response:	The boys at school were utterly smitten.
context: The students must have been terrified of her, then.\Nope. Believe it or not, we weren't.\She could be as fierce and expressionless as she pleased.\Hell, we loved her for it.\Sensei was just that damn super beautiful.\Super beautiful?\She even had a fan club.\The boys at school were utterly smitten. response:	Utterly smitten? Really?
context: Nope. Believe it or not, we weren't.\She could be as fierce and expressionless as she pleased.\Hell, we loved her for it.\Sensei was just that damn super beautiful.\Super beautiful?\She even had a fan club.\The boys at school were utterly smitten.\Utterly smitten? Really? response:	Given how much you resemble her, you're probably popular, too.
context: She could be as fierce and expressionless as she pleased.\Hell, we loved her for it.\Sensei was just that damn super beautiful.\Super beautiful?\She even had a fan club.\The boys at school were utterly smitten.\Utterly smitten? Really?\Given how much you resemble her, you're probably popular, too. response:	M-Me? Absolutely not!
context: Hell, we loved her for it.\Sensei was just that damn super beautiful.\Super beautiful?\She even had a fan club.\The boys at school were utterly smitten.\Utterly smitten? Really?\Given how much you resemble her, you're probably popular, too.\M-Me? Absolutely not! response:	Anyway, she was so pretty that even I fell for her.
context: Sensei was just that damn super beautiful.\Super beautiful?\She even had a fan club.\The boys at school were utterly smitten.\Utterly smitten? Really?\Given how much you resemble her, you're probably popular, too.\M-Me? Absolutely not!\Anyway, she was so pretty that even I fell for her. response:	We delinquents revered her for her expressionless wallops.
context: Super beautiful?\She even had a fan club.\The boys at school were utterly smitten.\Utterly smitten? Really?\Given how much you resemble her, you're probably popular, too.\M-Me? Absolutely not!\Anyway, she was so pretty that even I fell for her.\We delinquents revered her for her expressionless wallops. response:	But there was always a certain righteousness to it.
context: She even had a fan club.\The boys at school were utterly smitten.\Utterly smitten? Really?\Given how much you resemble her, you're probably popular, too.\M-Me? Absolutely not!\Anyway, she was so pretty that even I fell for her.\We delinquents revered her for her expressionless wallops.\But there was always a certain righteousness to it. response:	We'd eventually fall in love with more than just her appearance.
context: The boys at school were utterly smitten.\Utterly smitten? Really?\Given how much you resemble her, you're probably popular, too.\M-Me? Absolutely not!\Anyway, she was so pretty that even I fell for her.\We delinquents revered her for her expressionless wallops.\But there was always a certain righteousness to it.\We'd eventually fall in love with more than just her appearance. response:	All I remember of her for the entire year was how she scolded us.
context: Utterly smitten? Really?\Given how much you resemble her, you're probably popular, too.\M-Me? Absolutely not!\Anyway, she was so pretty that even I fell for her.\We delinquents revered her for her expressionless wallops.\But there was always a certain righteousness to it.\We'd eventually fall in love with more than just her appearance.\All I remember of her for the entire year was how she scolded us. response:	But without that year,
context: Given how much you resemble her, you're probably popular, too.\M-Me? Absolutely not!\Anyway, she was so pretty that even I fell for her.\We delinquents revered her for her expressionless wallops.\But there was always a certain righteousness to it.\We'd eventually fall in love with more than just her appearance.\All I remember of her for the entire year was how she scolded us.\But without that year, response:	I wouldn't have wanted to be a teacher or become a cram school instructor.
context: M-Me? Absolutely not!\Anyway, she was so pretty that even I fell for her.\We delinquents revered her for her expressionless wallops.\But there was always a certain righteousness to it.\We'd eventually fall in love with more than just her appearance.\All I remember of her for the entire year was how she scolded us.\But without that year,\I wouldn't have wanted to be a teacher or become a cram school instructor. response:	You've helped me come to a decision, Shimoda-san.
context: Anyway, she was so pretty that even I fell for her.\We delinquents revered her for her expressionless wallops.\But there was always a certain righteousness to it.\We'd eventually fall in love with more than just her appearance.\All I remember of her for the entire year was how she scolded us.\But without that year,\I wouldn't have wanted to be a teacher or become a cram school instructor.\You've helped me come to a decision, Shimoda-san. response:	Second-Year Post-Secondary Career Path Survey
context: We delinquents revered her for her expressionless wallops.\But there was always a certain righteousness to it.\We'd eventually fall in love with more than just her appearance.\All I remember of her for the entire year was how she scolded us.\But without that year,\I wouldn't have wanted to be a teacher or become a cram school instructor.\You've helped me come to a decision, Shimoda-san.\Second-Year Post-Secondary Career Path Survey response:	First choice
context: But there was always a certain righteousness to it.\We'd eventually fall in love with more than just her appearance.\All I remember of her for the entire year was how she scolded us.\But without that year,\I wouldn't have wanted to be a teacher or become a cram school instructor.\You've helped me come to a decision, Shimoda-san.\Second-Year Post-Secondary Career Path Survey\First choice response:	Second choice
context: We'd eventually fall in love with more than just her appearance.\All I remember of her for the entire year was how she scolded us.\But without that year,\I wouldn't have wanted to be a teacher or become a cram school instructor.\You've helped me come to a decision, Shimoda-san.\Second-Year Post-Secondary Career Path Survey\First choice\Second choice response:	Third choice
context: All I remember of her for the entire year was how she scolded us.\But without that year,\I wouldn't have wanted to be a teacher or become a cram school instructor.\You've helped me come to a decision, Shimoda-san.\Second-Year Post-Secondary Career Path Survey\First choice\Second choice\Third choice response:	If I can follow in my mother's footsteps, just like you did,
context: But without that year,\I wouldn't have wanted to be a teacher or become a cram school instructor.\You've helped me come to a decision, Shimoda-san.\Second-Year Post-Secondary Career Path Survey\First choice\Second choice\Third choice\If I can follow in my mother's footsteps, just like you did, response:	then my answer is obvious.
context: I wouldn't have wanted to be a teacher or become a cram school instructor.\You've helped me come to a decision, Shimoda-san.\Second-Year Post-Secondary Career Path Survey\First choice\Second choice\Third choice\If I can follow in my mother's footsteps, just like you did,\then my answer is obvious. response:	Just a second.
context: You've helped me come to a decision, Shimoda-san.\Second-Year Post-Secondary Career Path Survey\First choice\Second choice\Third choice\If I can follow in my mother's footsteps, just like you did,\then my answer is obvious.\Just a second. response:	It's great that you admire your mother.
context: Second-Year Post-Secondary Career Path Survey\First choice\Second choice\Third choice\If I can follow in my mother's footsteps, just like you did,\then my answer is obvious.\Just a second.\It's great that you admire your mother. response:	And there's nothing wrong with trying to become like someone you admire.
context: First choice\Second choice\Third choice\If I can follow in my mother's footsteps, just like you did,\then my answer is obvious.\Just a second.\It's great that you admire your mother.\And there's nothing wrong with trying to become like someone you admire. response:	That's what I did, too.
context: Second choice\Third choice\If I can follow in my mother's footsteps, just like you did,\then my answer is obvious.\Just a second.\It's great that you admire your mother.\And there's nothing wrong with trying to become like someone you admire.\That's what I did, too. response:	But you aren't just trying to become your mother, are you?
context: Third choice\If I can follow in my mother's footsteps, just like you did,\then my answer is obvious.\Just a second.\It's great that you admire your mother.\And there's nothing wrong with trying to become like someone you admire.\That's what I did, too.\But you aren't just trying to become your mother, are you? response:	There are plenty of other ways to do that.
context: If I can follow in my mother's footsteps, just like you did,\then my answer is obvious.\Just a second.\It's great that you admire your mother.\And there's nothing wrong with trying to become like someone you admire.\That's what I did, too.\But you aren't just trying to become your mother, are you?\There are plenty of other ways to do that. response:	That said, no one has the right to tell you what what your dreams should be.
context: then my answer is obvious.\Just a second.\It's great that you admire your mother.\And there's nothing wrong with trying to become like someone you admire.\That's what I did, too.\But you aren't just trying to become your mother, are you?\There are plenty of other ways to do that.\That said, no one has the right to tell you what what your dreams should be. response:	Go for it, if there's a reason you want to become a teacher.
context: Just a second.\It's great that you admire your mother.\And there's nothing wrong with trying to become like someone you admire.\That's what I did, too.\But you aren't just trying to become your mother, are you?\There are plenty of other ways to do that.\That said, no one has the right to tell you what what your dreams should be.\Go for it, if there's a reason you want to become a teacher. response:	Huh?
context: It's great that you admire your mother.\And there's nothing wrong with trying to become like someone you admire.\That's what I did, too.\But you aren't just trying to become your mother, are you?\There are plenty of other ways to do that.\That said, no one has the right to tell you what what your dreams should be.\Go for it, if there's a reason you want to become a teacher.\Huh? response:	What are you doing all by yourself?
context: And there's nothing wrong with trying to become like someone you admire.\That's what I did, too.\But you aren't just trying to become your mother, are you?\There are plenty of other ways to do that.\That said, no one has the right to tell you what what your dreams should be.\Go for it, if there's a reason you want to become a teacher.\Huh?\What are you doing all by yourself? response:	Nino.
context: That's what I did, too.\But you aren't just trying to become your mother, are you?\There are plenty of other ways to do that.\That said, no one has the right to tell you what what your dreams should be.\Go for it, if there's a reason you want to become a teacher.\Huh?\What are you doing all by yourself?\Nino. response:	I thought you had a study group at school today.
context: But you aren't just trying to become your mother, are you?\There are plenty of other ways to do that.\That said, no one has the right to tell you what what your dreams should be.\Go for it, if there's a reason you want to become a teacher.\Huh?\What are you doing all by yourself?\Nino.\I thought you had a study group at school today. response:	Ichika made me come back.
context: There are plenty of other ways to do that.\That said, no one has the right to tell you what what your dreams should be.\Go for it, if there's a reason you want to become a teacher.\Huh?\What are you doing all by yourself?\Nino.\I thought you had a study group at school today.\Ichika made me come back. response:	Wait, are you the person she was talking about?
context: That said, no one has the right to tell you what what your dreams should be.\Go for it, if there's a reason you want to become a teacher.\Huh?\What are you doing all by yourself?\Nino.\I thought you had a study group at school today.\Ichika made me come back.\Wait, are you the person she was talking about? response:	Go get'em, Miku.
context: Go for it, if there's a reason you want to become a teacher.\Huh?\What are you doing all by yourself?\Nino.\I thought you had a study group at school today.\Ichika made me come back.\Wait, are you the person she was talking about?\Go get'em, Miku. response:	Now she'll have no trouble giving him V-Day chocolates.
context: Huh?\What are you doing all by yourself?\Nino.\I thought you had a study group at school today.\Ichika made me come back.\Wait, are you the person she was talking about?\Go get'em, Miku.\Now she'll have no trouble giving him V-Day chocolates. response:	As dense as he is, even Futaro-kun's sure to be surprised.
context: What are you doing all by yourself?\Nino.\I thought you had a study group at school today.\Ichika made me come back.\Wait, are you the person she was talking about?\Go get'em, Miku.\Now she'll have no trouble giving him V-Day chocolates.\As dense as he is, even Futaro-kun's sure to be surprised. response:	Why did I end up liking him?
context: Nino.\I thought you had a study group at school today.\Ichika made me come back.\Wait, are you the person she was talking about?\Go get'em, Miku.\Now she'll have no trouble giving him V-Day chocolates.\As dense as he is, even Futaro-kun's sure to be surprised.\Why did I end up liking him? response:	What are you doing?
context: I thought you had a study group at school today.\Ichika made me come back.\Wait, are you the person she was talking about?\Go get'em, Miku.\Now she'll have no trouble giving him V-Day chocolates.\As dense as he is, even Futaro-kun's sure to be surprised.\Why did I end up liking him?\What are you doing? response:	Are you all right?
context: Ichika made me come back.\Wait, are you the person she was talking about?\Go get'em, Miku.\Now she'll have no trouble giving him V-Day chocolates.\As dense as he is, even Futaro-kun's sure to be surprised.\Why did I end up liking him?\What are you doing?\Are you all right? response:	Futaro?!
context: Wait, are you the person she was talking about?\Go get'em, Miku.\Now she'll have no trouble giving him V-Day chocolates.\As dense as he is, even Futaro-kun's sure to be surprised.\Why did I end up liking him?\What are you doing?\Are you all right?\Futaro?! response:	What was that?
context: Go get'em, Miku.\Now she'll have no trouble giving him V-Day chocolates.\As dense as he is, even Futaro-kun's sure to be surprised.\Why did I end up liking him?\What are you doing?\Are you all right?\Futaro?!\What was that? response:	What the heck are you doing?
context: Now she'll have no trouble giving him V-Day chocolates.\As dense as he is, even Futaro-kun's sure to be surprised.\Why did I end up liking him?\What are you doing?\Are you all right?\Futaro?!\What was that?\What the heck are you doing? response:	Shoot.
context: As dense as he is, even Futaro-kun's sure to be surprised.\Why did I end up liking him?\What are you doing?\Are you all right?\Futaro?!\What was that?\What the heck are you doing?\Shoot. response:	Wh-Wh-Why...
context: Why did I end up liking him?\What are you doing?\Are you all right?\Futaro?!\What was that?\What the heck are you doing?\Shoot.\Wh-Wh-Why... response:	Yotsuba said she forgot her reference book at home, so I'm here to get it.
context: What are you doing?\Are you all right?\Futaro?!\What was that?\What the heck are you doing?\Shoot.\Wh-Wh-Why...\Yotsuba said she forgot her reference book at home, so I'm here to get it. response:	O-Oh, I think I threw that away the other day.
context: Are you all right?\Futaro?!\What was that?\What the heck are you doing?\Shoot.\Wh-Wh-Why...\Yotsuba said she forgot her reference book at home, so I'm here to get it.\O-Oh, I think I threw that away the other day. response:	What?!
context: Futaro?!\What was that?\What the heck are you doing?\Shoot.\Wh-Wh-Why...\Yotsuba said she forgot her reference book at home, so I'm here to get it.\O-Oh, I think I threw that away the other day.\What?! response:	I'll go buy another one.
context: What was that?\What the heck are you doing?\Shoot.\Wh-Wh-Why...\Yotsuba said she forgot her reference book at home, so I'm here to get it.\O-Oh, I think I threw that away the other day.\What?!\I'll go buy another one. response:	Hey!
context: What the heck are you doing?\Shoot.\Wh-Wh-Why...\Yotsuba said she forgot her reference book at home, so I'm here to get it.\O-Oh, I think I threw that away the other day.\What?!\I'll go buy another one.\Hey! response:	Come with me.
context: Shoot.\Wh-Wh-Why...\Yotsuba said she forgot her reference book at home, so I'm here to get it.\O-Oh, I think I threw that away the other day.\What?!\I'll go buy another one.\Hey!\Come with me. response:	What is this?!
context: Wh-Wh-Why...\Yotsuba said she forgot her reference book at home, so I'm here to get it.\O-Oh, I think I threw that away the other day.\What?!\I'll go buy another one.\Hey!\Come with me.\What is this?! response:	It looks disgusting.
context: Yotsuba said she forgot her reference book at home, so I'm here to get it.\O-Oh, I think I threw that away the other day.\What?!\I'll go buy another one.\Hey!\Come with me.\What is this?!\It looks disgusting. response:	This is horrible.
context: O-Oh, I think I threw that away the other day.\What?!\I'll go buy another one.\Hey!\Come with me.\What is this?!\It looks disgusting.\This is horrible. response:	Who's going to enjoy anything like this?
context: What?!\I'll go buy another one.\Hey!\Come with me.\What is this?!\It looks disgusting.\This is horrible.\Who's going to enjoy anything like this? response:	You're a double whammy of bad taste buds and bad with your hands.
context: I'll go buy another one.\Hey!\Come with me.\What is this?!\It looks disgusting.\This is horrible.\Who's going to enjoy anything like this?\You're a double whammy of bad taste buds and bad with your hands. response:	Just give up and buy some chocolates from the store.
context: Hey!\Come with me.\What is this?!\It looks disgusting.\This is horrible.\Who's going to enjoy anything like this?\You're a double whammy of bad taste buds and bad with your hands.\Just give up and buy some chocolates from the store. response:	Shut up!
context: Come with me.\What is this?!\It looks disgusting.\This is horrible.\Who's going to enjoy anything like this?\You're a double whammy of bad taste buds and bad with your hands.\Just give up and buy some chocolates from the store.\Shut up! response:	Shut up.
context: What is this?!\It looks disgusting.\This is horrible.\Who's going to enjoy anything like this?\You're a double whammy of bad taste buds and bad with your hands.\Just give up and buy some chocolates from the store.\Shut up!\Shut up. response:	They say love is the best ingredient, though.
context: It looks disgusting.\This is horrible.\Who's going to enjoy anything like this?\You're a double whammy of bad taste buds and bad with your hands.\Just give up and buy some chocolates from the store.\Shut up!\Shut up.\They say love is the best ingredient, though. response:	All that matters is that you made it.
context: This is horrible.\Who's going to enjoy anything like this?\You're a double whammy of bad taste buds and bad with your hands.\Just give up and buy some chocolates from the store.\Shut up!\Shut up.\They say love is the best ingredient, though.\All that matters is that you made it. response:	Besides, it's a bit endearing if it's not perfect.
context: Who's going to enjoy anything like this?\You're a double whammy of bad taste buds and bad with your hands.\Just give up and buy some chocolates from the store.\Shut up!\Shut up.\They say love is the best ingredient, though.\All that matters is that you made it.\Besides, it's a bit endearing if it's not perfect. response:	This one's cute, like a bug!
context: You're a double whammy of bad taste buds and bad with your hands.\Just give up and buy some chocolates from the store.\Shut up!\Shut up.\They say love is the best ingredient, though.\All that matters is that you made it.\Besides, it's a bit endearing if it's not perfect.\This one's cute, like a bug! response:	Futaro won't eat my food lately.
context: Just give up and buy some chocolates from the store.\Shut up!\Shut up.\They say love is the best ingredient, though.\All that matters is that you made it.\Besides, it's a bit endearing if it's not perfect.\This one's cute, like a bug!\Futaro won't eat my food lately. response:	I think I know why.
context: Shut up!\Shut up.\They say love is the best ingredient, though.\All that matters is that you made it.\Besides, it's a bit endearing if it's not perfect.\This one's cute, like a bug!\Futaro won't eat my food lately.\I think I know why. response:	And I know I'm not good at it.
context: Shut up.\They say love is the best ingredient, though.\All that matters is that you made it.\Besides, it's a bit endearing if it's not perfect.\This one's cute, like a bug!\Futaro won't eat my food lately.\I think I know why.\And I know I'm not good at it. response:	But I want to.
context: They say love is the best ingredient, though.\All that matters is that you made it.\Besides, it's a bit endearing if it's not perfect.\This one's cute, like a bug!\Futaro won't eat my food lately.\I think I know why.\And I know I'm not good at it.\But I want to. response:	I want to make chocolates that he can't resist.
context: All that matters is that you made it.\Besides, it's a bit endearing if it's not perfect.\This one's cute, like a bug!\Futaro won't eat my food lately.\I think I know why.\And I know I'm not good at it.\But I want to.\I want to make chocolates that he can't resist. response:	I'd like you to teach me.
context: Besides, it's a bit endearing if it's not perfect.\This one's cute, like a bug!\Futaro won't eat my food lately.\I think I know why.\And I know I'm not good at it.\But I want to.\I want to make chocolates that he can't resist.\I'd like you to teach me. response:	Please.
context: This one's cute, like a bug!\Futaro won't eat my food lately.\I think I know why.\And I know I'm not good at it.\But I want to.\I want to make chocolates that he can't resist.\I'd like you to teach me.\Please. response:	All the moisture's gone.
context: Futaro won't eat my food lately.\I think I know why.\And I know I'm not good at it.\But I want to.\I want to make chocolates that he can't resist.\I'd like you to teach me.\Please.\All the moisture's gone. response:	You're turning up the heat too much.
context: I think I know why.\And I know I'm not good at it.\But I want to.\I want to make chocolates that he can't resist.\I'd like you to teach me.\Please.\All the moisture's gone.\You're turning up the heat too much. response:	And you used dairy cream without heating it up first, didn't you?
context: And I know I'm not good at it.\But I want to.\I want to make chocolates that he can't resist.\I'd like you to teach me.\Please.\All the moisture's gone.\You're turning up the heat too much.\And you used dairy cream without heating it up first, didn't you? response:	The texture's awful.
context: But I want to.\I want to make chocolates that he can't resist.\I'd like you to teach me.\Please.\All the moisture's gone.\You're turning up the heat too much.\And you used dairy cream without heating it up first, didn't you?\The texture's awful. response:	Jeez.
context: I want to make chocolates that he can't resist.\I'd like you to teach me.\Please.\All the moisture's gone.\You're turning up the heat too much.\And you used dairy cream without heating it up first, didn't you?\The texture's awful.\Jeez. response:	What a pain.
context: I'd like you to teach me.\Please.\All the moisture's gone.\You're turning up the heat too much.\And you used dairy cream without heating it up first, didn't you?\The texture's awful.\Jeez.\What a pain. response:	Get set up.
context: Please.\All the moisture's gone.\You're turning up the heat too much.\And you used dairy cream without heating it up first, didn't you?\The texture's awful.\Jeez.\What a pain.\Get set up. response:	You're such a pain, you know that?
context: All the moisture's gone.\You're turning up the heat too much.\And you used dairy cream without heating it up first, didn't you?\The texture's awful.\Jeez.\What a pain.\Get set up.\You're such a pain, you know that? response:	Mathematics
context: You're turning up the heat too much.\And you used dairy cream without heating it up first, didn't you?\The texture's awful.\Jeez.\What a pain.\Get set up.\You're such a pain, you know that?\Mathematics response:	Found it. It's this one.
context: And you used dairy cream without heating it up first, didn't you?\The texture's awful.\Jeez.\What a pain.\Get set up.\You're such a pain, you know that?\Mathematics\Found it. It's this one. response:	Boohoo...
context: The texture's awful.\Jeez.\What a pain.\Get set up.\You're such a pain, you know that?\Mathematics\Found it. It's this one.\Boohoo... response:	Why is this happening?
context: Jeez.\What a pain.\Get set up.\You're such a pain, you know that?\Mathematics\Found it. It's this one.\Boohoo...\Why is this happening? response:	It's pretty expensive.
context: What a pain.\Get set up.\You're such a pain, you know that?\Mathematics\Found it. It's this one.\Boohoo...\Why is this happening?\It's pretty expensive. response:	Can you afford it?
context: Get set up.\You're such a pain, you know that?\Mathematics\Found it. It's this one.\Boohoo...\Why is this happening?\It's pretty expensive.\Can you afford it? response:	U-Um...
context: You're such a pain, you know that?\Mathematics\Found it. It's this one.\Boohoo...\Why is this happening?\It's pretty expensive.\Can you afford it?\U-Um... response:	Don't worry about it.
context: Mathematics\Found it. It's this one.\Boohoo...\Why is this happening?\It's pretty expensive.\Can you afford it?\U-Um...\Don't worry about it. response:	I'll go buy it.
context: Found it. It's this one.\Boohoo...\Why is this happening?\It's pretty expensive.\Can you afford it?\U-Um...\Don't worry about it.\I'll go buy it. response:	Huh?
context: Boohoo...\Why is this happening?\It's pretty expensive.\Can you afford it?\U-Um...\Don't worry about it.\I'll go buy it.\Huh? response:	What about that book?
context: Why is this happening?\It's pretty expensive.\Can you afford it?\U-Um...\Don't worry about it.\I'll go buy it.\Huh?\What about that book? response:	Oh, this is...
context: It's pretty expensive.\Can you afford it?\U-Um...\Don't worry about it.\I'll go buy it.\Huh?\What about that book?\Oh, this is... response:	Is it actually something dirty?!
context: Can you afford it?\U-Um...\Don't worry about it.\I'll go buy it.\Huh?\What about that book?\Oh, this is...\Is it actually something dirty?! response:	Hey!
context: U-Um...\Don't worry about it.\I'll go buy it.\Huh?\What about that book?\Oh, this is...\Is it actually something dirty?!\Hey! response:	How to Become A Good Teacher
context: Don't worry about it.\I'll go buy it.\Huh?\What about that book?\Oh, this is...\Is it actually something dirty?!\Hey!\How to Become A Good Teacher response:	I haven't decided to buy it yet.
context: I'll go buy it.\Huh?\What about that book?\Oh, this is...\Is it actually something dirty?!\Hey!\How to Become A Good Teacher\I haven't decided to buy it yet. response:	Wow.
context: Huh?\What about that book?\Oh, this is...\Is it actually something dirty?!\Hey!\How to Become A Good Teacher\I haven't decided to buy it yet.\Wow. response:	You want to become a good teacher, huh?
context: What about that book?\Oh, this is...\Is it actually something dirty?!\Hey!\How to Become A Good Teacher\I haven't decided to buy it yet.\Wow.\You want to become a good teacher, huh? response:	Sh-Shut up!
context: Oh, this is...\Is it actually something dirty?!\Hey!\How to Become A Good Teacher\I haven't decided to buy it yet.\Wow.\You want to become a good teacher, huh?\Sh-Shut up! response:	Don't be shy about it.
context: Is it actually something dirty?!\Hey!\How to Become A Good Teacher\I haven't decided to buy it yet.\Wow.\You want to become a good teacher, huh?\Sh-Shut up!\Don't be shy about it. response:	I'll buy it for you along with the reference book.
context: Hey!\How to Become A Good Teacher\I haven't decided to buy it yet.\Wow.\You want to become a good teacher, huh?\Sh-Shut up!\Don't be shy about it.\I'll buy it for you along with the reference book. response:	I can buy it myself.
context: How to Become A Good Teacher\I haven't decided to buy it yet.\Wow.\You want to become a good teacher, huh?\Sh-Shut up!\Don't be shy about it.\I'll buy it for you along with the reference book.\I can buy it myself. response:	Don't worry about it.
context: I haven't decided to buy it yet.\Wow.\You want to become a good teacher, huh?\Sh-Shut up!\Don't be shy about it.\I'll buy it for you along with the reference book.\I can buy it myself.\Don't worry about it. response:	We might really end up failing this time.
context: Wow.\You want to become a good teacher, huh?\Sh-Shut up!\Don't be shy about it.\I'll buy it for you along with the reference book.\I can buy it myself.\Don't worry about it.\We might really end up failing this time. response:	This time?
context: You want to become a good teacher, huh?\Sh-Shut up!\Don't be shy about it.\I'll buy it for you along with the reference book.\I can buy it myself.\Don't worry about it.\We might really end up failing this time.\This time? response:	Huh? Don't you know?
context: Sh-Shut up!\Don't be shy about it.\I'll buy it for you along with the reference book.\I can buy it myself.\Don't worry about it.\We might really end up failing this time.\This time?\Huh? Don't you know? response:	It really was expensive.
context: Don't be shy about it.\I'll buy it for you along with the reference book.\I can buy it myself.\Don't worry about it.\We might really end up failing this time.\This time?\Huh? Don't you know?\It really was expensive. response:	I don't have much left in savings, too.
context: I'll buy it for you along with the reference book.\I can buy it myself.\Don't worry about it.\We might really end up failing this time.\This time?\Huh? Don't you know?\It really was expensive.\I don't have much left in savings, too. response:	But if it'll make Futaro-kun happy...
context: I can buy it myself.\Don't worry about it.\We might really end up failing this time.\This time?\Huh? Don't you know?\It really was expensive.\I don't have much left in savings, too.\But if it'll make Futaro-kun happy... response:	No, no!
context: Don't worry about it.\We might really end up failing this time.\This time?\Huh? Don't you know?\It really was expensive.\I don't have much left in savings, too.\But if it'll make Futaro-kun happy...\No, no! response:	This isn't a healthy relationship.
context: We might really end up failing this time.\This time?\Huh? Don't you know?\It really was expensive.\I don't have much left in savings, too.\But if it'll make Futaro-kun happy...\No, no!\This isn't a healthy relationship. response:	If we were to start going out,
context: This time?\Huh? Don't you know?\It really was expensive.\I don't have much left in savings, too.\But if it'll make Futaro-kun happy...\No, no!\This isn't a healthy relationship.\If we were to start going out, response:	I could totally see myself spoiling him by spending on him all the time.
context: Huh? Don't you know?\It really was expensive.\I don't have much left in savings, too.\But if it'll make Futaro-kun happy...\No, no!\This isn't a healthy relationship.\If we were to start going out,\I could totally see myself spoiling him by spending on him all the time. response:	So I have to give up on him.
context: It really was expensive.\I don't have much left in savings, too.\But if it'll make Futaro-kun happy...\No, no!\This isn't a healthy relationship.\If we were to start going out,\I could totally see myself spoiling him by spending on him all the time.\So I have to give up on him. response:	Yeah, that's the right call.
context: I don't have much left in savings, too.\But if it'll make Futaro-kun happy...\No, no!\This isn't a healthy relationship.\If we were to start going out,\I could totally see myself spoiling him by spending on him all the time.\So I have to give up on him.\Yeah, that's the right call. response:	You bought it?
context: But if it'll make Futaro-kun happy...\No, no!\This isn't a healthy relationship.\If we were to start going out,\I could totally see myself spoiling him by spending on him all the time.\So I have to give up on him.\Yeah, that's the right call.\You bought it? response:	Yeah.
context: No, no!\This isn't a healthy relationship.\If we were to start going out,\I could totally see myself spoiling him by spending on him all the time.\So I have to give up on him.\Yeah, that's the right call.\You bought it?\Yeah. response:	We're done shopping.
context: This isn't a healthy relationship.\If we were to start going out,\I could totally see myself spoiling him by spending on him all the time.\So I have to give up on him.\Yeah, that's the right call.\You bought it?\Yeah.\We're done shopping. response:	Let's go.
context: If we were to start going out,\I could totally see myself spoiling him by spending on him all the time.\So I have to give up on him.\Yeah, that's the right call.\You bought it?\Yeah.\We're done shopping.\Let's go. response:	What happened to your hand?
context: I could totally see myself spoiling him by spending on him all the time.\So I have to give up on him.\Yeah, that's the right call.\You bought it?\Yeah.\We're done shopping.\Let's go.\What happened to your hand? response:	I hit it back at the apartment.
context: So I have to give up on him.\Yeah, that's the right call.\You bought it?\Yeah.\We're done shopping.\Let's go.\What happened to your hand?\I hit it back at the apartment. response:	It doesn't hurt that much, so don't worry.
context: Yeah, that's the right call.\You bought it?\Yeah.\We're done shopping.\Let's go.\What happened to your hand?\I hit it back at the apartment.\It doesn't hurt that much, so don't worry. response:	You're so clumsy.
context: You bought it?\Yeah.\We're done shopping.\Let's go.\What happened to your hand?\I hit it back at the apartment.\It doesn't hurt that much, so don't worry.\You're so clumsy. response:	Be careful.
context: Yeah.\We're done shopping.\Let's go.\What happened to your hand?\I hit it back at the apartment.\It doesn't hurt that much, so don't worry.\You're so clumsy.\Be careful. response:	Okay.
context: We're done shopping.\Let's go.\What happened to your hand?\I hit it back at the apartment.\It doesn't hurt that much, so don't worry.\You're so clumsy.\Be careful.\Okay. response:	I guess this side of him is exactly why.
context: Let's go.\What happened to your hand?\I hit it back at the apartment.\It doesn't hurt that much, so don't worry.\You're so clumsy.\Be careful.\Okay.\I guess this side of him is exactly why. response:	And he keeps doing this when I know I shouldn't fall any harder for him!
context: What happened to your hand?\I hit it back at the apartment.\It doesn't hurt that much, so don't worry.\You're so clumsy.\Be careful.\Okay.\I guess this side of him is exactly why.\And he keeps doing this when I know I shouldn't fall any harder for him! response:	Listen carefully, everyone.
context: I hit it back at the apartment.\It doesn't hurt that much, so don't worry.\You're so clumsy.\Be careful.\Okay.\I guess this side of him is exactly why.\And he keeps doing this when I know I shouldn't fall any harder for him!\Listen carefully, everyone. response:	The point here isn't to answer with what the author is thinking.
context: It doesn't hurt that much, so don't worry.\You're so clumsy.\Be careful.\Okay.\I guess this side of him is exactly why.\And he keeps doing this when I know I shouldn't fall any harder for him!\Listen carefully, everyone.\The point here isn't to answer with what the author is thinking. response:	It's to write what you, as the readers, feel.
context: You're so clumsy.\Be careful.\Okay.\I guess this side of him is exactly why.\And he keeps doing this when I know I shouldn't fall any harder for him!\Listen carefully, everyone.\The point here isn't to answer with what the author is thinking.\It's to write what you, as the readers, feel. response:	Damn it, we've hit a wall.
context: Be careful.\Okay.\I guess this side of him is exactly why.\And he keeps doing this when I know I shouldn't fall any harder for him!\Listen carefully, everyone.\The point here isn't to answer with what the author is thinking.\It's to write what you, as the readers, feel.\Damn it, we've hit a wall. response:	Um...
context: Okay.\I guess this side of him is exactly why.\And he keeps doing this when I know I shouldn't fall any harder for him!\Listen carefully, everyone.\The point here isn't to answer with what the author is thinking.\It's to write what you, as the readers, feel.\Damn it, we've hit a wall.\Um... response:	What is it that I felt?
context: I guess this side of him is exactly why.\And he keeps doing this when I know I shouldn't fall any harder for him!\Listen carefully, everyone.\The point here isn't to answer with what the author is thinking.\It's to write what you, as the readers, feel.\Damn it, we've hit a wall.\Um...\What is it that I felt? response:	I did think we'd come to this point eventually.
context: And he keeps doing this when I know I shouldn't fall any harder for him!\Listen carefully, everyone.\The point here isn't to answer with what the author is thinking.\It's to write what you, as the readers, feel.\Damn it, we've hit a wall.\Um...\What is it that I felt?\I did think we'd come to this point eventually. response:	This is my limit as someone who doesn't have the nous of a teacher.
context: Listen carefully, everyone.\The point here isn't to answer with what the author is thinking.\It's to write what you, as the readers, feel.\Damn it, we've hit a wall.\Um...\What is it that I felt?\I did think we'd come to this point eventually.\This is my limit as someone who doesn't have the nous of a teacher. response:	I don't know what it is that they don't know!
context: The point here isn't to answer with what the author is thinking.\It's to write what you, as the readers, feel.\Damn it, we've hit a wall.\Um...\What is it that I felt?\I did think we'd come to this point eventually.\This is my limit as someone who doesn't have the nous of a teacher.\I don't know what it is that they don't know! response:	I don't know how to teach them!
context: It's to write what you, as the readers, feel.\Damn it, we've hit a wall.\Um...\What is it that I felt?\I did think we'd come to this point eventually.\This is my limit as someone who doesn't have the nous of a teacher.\I don't know what it is that they don't know!\I don't know how to teach them! response:	How cruel it is that our IQs must differ so!
context: Damn it, we've hit a wall.\Um...\What is it that I felt?\I did think we'd come to this point eventually.\This is my limit as someone who doesn't have the nous of a teacher.\I don't know what it is that they don't know!\I don't know how to teach them!\How cruel it is that our IQs must differ so! response:	I'm just guessing, but I have a feeling he's thinking something rude.
context: Um...\What is it that I felt?\I did think we'd come to this point eventually.\This is my limit as someone who doesn't have the nous of a teacher.\I don't know what it is that they don't know!\I don't know how to teach them!\How cruel it is that our IQs must differ so!\I'm just guessing, but I have a feeling he's thinking something rude. response:	I don't think we can focus anymore, let alone answer these questions.
context: What is it that I felt?\I did think we'd come to this point eventually.\This is my limit as someone who doesn't have the nous of a teacher.\I don't know what it is that they don't know!\I don't know how to teach them!\How cruel it is that our IQs must differ so!\I'm just guessing, but I have a feeling he's thinking something rude.\I don't think we can focus anymore, let alone answer these questions. response:	We've been studying nonstop for days.
context: I did think we'd come to this point eventually.\This is my limit as someone who doesn't have the nous of a teacher.\I don't know what it is that they don't know!\I don't know how to teach them!\How cruel it is that our IQs must differ so!\I'm just guessing, but I have a feeling he's thinking something rude.\I don't think we can focus anymore, let alone answer these questions.\We've been studying nonstop for days. response:	I-I can still keep going!
context: This is my limit as someone who doesn't have the nous of a teacher.\I don't know what it is that they don't know!\I don't know how to teach them!\How cruel it is that our IQs must differ so!\I'm just guessing, but I have a feeling he's thinking something rude.\I don't think we can focus anymore, let alone answer these questions.\We've been studying nonstop for days.\I-I can still keep going! response:	Cramming too much is counterproductive.
context: I don't know what it is that they don't know!\I don't know how to teach them!\How cruel it is that our IQs must differ so!\I'm just guessing, but I have a feeling he's thinking something rude.\I don't think we can focus anymore, let alone answer these questions.\We've been studying nonstop for days.\I-I can still keep going!\Cramming too much is counterproductive. response:	Cramming too much is counterproductive.
context: I don't know how to teach them!\How cruel it is that our IQs must differ so!\I'm just guessing, but I have a feeling he's thinking something rude.\I don't think we can focus anymore, let alone answer these questions.\We've been studying nonstop for days.\I-I can still keep going!\Cramming too much is counterproductive.\Cramming too much is counterproductive. response:	I see. They need an occasional reward.
context: How cruel it is that our IQs must differ so!\I'm just guessing, but I have a feeling he's thinking something rude.\I don't think we can focus anymore, let alone answer these questions.\We've been studying nonstop for days.\I-I can still keep going!\Cramming too much is counterproductive.\Cramming too much is counterproductive.\I see. They need an occasional reward. response:	Let's take the afternoon off.
context: I'm just guessing, but I have a feeling he's thinking something rude.\I don't think we can focus anymore, let alone answer these questions.\We've been studying nonstop for days.\I-I can still keep going!\Cramming too much is counterproductive.\Cramming too much is counterproductive.\I see. They need an occasional reward.\Let's take the afternoon off. response:	Terrors of the Netherworld
context: I don't think we can focus anymore, let alone answer these questions.\We've been studying nonstop for days.\I-I can still keep going!\Cramming too much is counterproductive.\Cramming too much is counterproductive.\I see. They need an occasional reward.\Let's take the afternoon off.\Terrors of the Netherworld response:	Entrance
context: We've been studying nonstop for days.\I-I can still keep going!\Cramming too much is counterproductive.\Cramming too much is counterproductive.\I see. They need an occasional reward.\Let's take the afternoon off.\Terrors of the Netherworld\Entrance response:	Exit
context: I-I can still keep going!\Cramming too much is counterproductive.\Cramming too much is counterproductive.\I see. They need an occasional reward.\Let's take the afternoon off.\Terrors of the Netherworld\Entrance\Exit response:	Let's ride that one next!
context: Cramming too much is counterproductive.\Cramming too much is counterproductive.\I see. They need an occasional reward.\Let's take the afternoon off.\Terrors of the Netherworld\Entrance\Exit\Let's ride that one next! response:	Give me a second, Itsuki-chan.
context: Cramming too much is counterproductive.\I see. They need an occasional reward.\Let's take the afternoon off.\Terrors of the Netherworld\Entrance\Exit\Let's ride that one next!\Give me a second, Itsuki-chan. response:	Huh? Where did Yotsuba go?
context: I see. They need an occasional reward.\Let's take the afternoon off.\Terrors of the Netherworld\Entrance\Exit\Let's ride that one next!\Give me a second, Itsuki-chan.\Huh? Where did Yotsuba go? response:	She says she's in the washroom with a stomach ache.
context: Let's take the afternoon off.\Terrors of the Netherworld\Entrance\Exit\Let's ride that one next!\Give me a second, Itsuki-chan.\Huh? Where did Yotsuba go?\She says she's in the washroom with a stomach ache. response:	Why doesn't she just say so?
context: Terrors of the Netherworld\Entrance\Exit\Let's ride that one next!\Give me a second, Itsuki-chan.\Huh? Where did Yotsuba go?\She says she's in the washroom with a stomach ache.\Why doesn't she just say so? response:	Bathroom break for me, too.
context: Entrance\Exit\Let's ride that one next!\Give me a second, Itsuki-chan.\Huh? Where did Yotsuba go?\She says she's in the washroom with a stomach ache.\Why doesn't she just say so?\Bathroom break for me, too. response:	Sure.
context: Exit\Let's ride that one next!\Give me a second, Itsuki-chan.\Huh? Where did Yotsuba go?\She says she's in the washroom with a stomach ache.\Why doesn't she just say so?\Bathroom break for me, too.\Sure. response:	Catch up with us later.
context: Let's ride that one next!\Give me a second, Itsuki-chan.\Huh? Where did Yotsuba go?\She says she's in the washroom with a stomach ache.\Why doesn't she just say so?\Bathroom break for me, too.\Sure.\Catch up with us later. response:	Okay.
context: Give me a second, Itsuki-chan.\Huh? Where did Yotsuba go?\She says she's in the washroom with a stomach ache.\Why doesn't she just say so?\Bathroom break for me, too.\Sure.\Catch up with us later.\Okay. response:	What?
context: Huh? Where did Yotsuba go?\She says she's in the washroom with a stomach ache.\Why doesn't she just say so?\Bathroom break for me, too.\Sure.\Catch up with us later.\Okay.\What? response:	Nothing.
context: She says she's in the washroom with a stomach ache.\Why doesn't she just say so?\Bathroom break for me, too.\Sure.\Catch up with us later.\Okay.\What?\Nothing. response:	Just how many laps are you doing?
context: Why doesn't she just say so?\Bathroom break for me, too.\Sure.\Catch up with us later.\Okay.\What?\Nothing.\Just how many laps are you doing? response:	I'm getting on.
context: Bathroom break for me, too.\Sure.\Catch up with us later.\Okay.\What?\Nothing.\Just how many laps are you doing?\I'm getting on. response:	Huh? That one's occupied.
context: Sure.\Catch up with us later.\Okay.\What?\Nothing.\Just how many laps are you doing?\I'm getting on.\Huh? That one's occupied. response:	Mind if I join you?
context: Catch up with us later.\Okay.\What?\Nothing.\Just how many laps are you doing?\I'm getting on.\Huh? That one's occupied.\Mind if I join you? response:	F-Feel free.
context: Okay.\What?\Nothing.\Just how many laps are you doing?\I'm getting on.\Huh? That one's occupied.\Mind if I join you?\F-Feel free. response:	I thought I was doing a good job hiding.
context: What?\Nothing.\Just how many laps are you doing?\I'm getting on.\Huh? That one's occupied.\Mind if I join you?\F-Feel free.\I thought I was doing a good job hiding. response:	How did I get found?
context: Nothing.\Just how many laps are you doing?\I'm getting on.\Huh? That one's occupied.\Mind if I join you?\F-Feel free.\I thought I was doing a good job hiding.\How did I get found? response:	Because I saw that.
context: Just how many laps are you doing?\I'm getting on.\Huh? That one's occupied.\Mind if I join you?\F-Feel free.\I thought I was doing a good job hiding.\How did I get found?\Because I saw that. response:	Dead giveaway
context: I'm getting on.\Huh? That one's occupied.\Mind if I join you?\F-Feel free.\I thought I was doing a good job hiding.\How did I get found?\Because I saw that.\Dead giveaway response:	The ribbon was out of the bag!
context: Huh? That one's occupied.\Mind if I join you?\F-Feel free.\I thought I was doing a good job hiding.\How did I get found?\Because I saw that.\Dead giveaway\The ribbon was out of the bag! response:	Japanese
context: Mind if I join you?\F-Feel free.\I thought I was doing a good job hiding.\How did I get found?\Because I saw that.\Dead giveaway\The ribbon was out of the bag!\Japanese response:	You were studying here?
context: F-Feel free.\I thought I was doing a good job hiding.\How did I get found?\Because I saw that.\Dead giveaway\The ribbon was out of the bag!\Japanese\You were studying here? response:	Yes.
context: I thought I was doing a good job hiding.\How did I get found?\Because I saw that.\Dead giveaway\The ribbon was out of the bag!\Japanese\You were studying here?\Yes. response:	I thought I could keep going, since I have more stamina than the others.
context: How did I get found?\Because I saw that.\Dead giveaway\The ribbon was out of the bag!\Japanese\You were studying here?\Yes.\I thought I could keep going, since I have more stamina than the others. response:	Also, the secret is that I'm the biggest dummy of the five of us.
context: Because I saw that.\Dead giveaway\The ribbon was out of the bag!\Japanese\You were studying here?\Yes.\I thought I could keep going, since I have more stamina than the others.\Also, the secret is that I'm the biggest dummy of the five of us. response:	We all know.
context: Dead giveaway\The ribbon was out of the bag!\Japanese\You were studying here?\Yes.\I thought I could keep going, since I have more stamina than the others.\Also, the secret is that I'm the biggest dummy of the five of us.\We all know. response:	You should take a break.
context: The ribbon was out of the bag!\Japanese\You were studying here?\Yes.\I thought I could keep going, since I have more stamina than the others.\Also, the secret is that I'm the biggest dummy of the five of us.\We all know.\You should take a break. response:	We spent money to come to the amusement park.
context: Japanese\You were studying here?\Yes.\I thought I could keep going, since I have more stamina than the others.\Also, the secret is that I'm the biggest dummy of the five of us.\We all know.\You should take a break.\We spent money to come to the amusement park. response:	No.
context: You were studying here?\Yes.\I thought I could keep going, since I have more stamina than the others.\Also, the secret is that I'm the biggest dummy of the five of us.\We all know.\You should take a break.\We spent money to come to the amusement park.\No. response:	You don't have any idea how dumb I am.
context: Yes.\I thought I could keep going, since I have more stamina than the others.\Also, the secret is that I'm the biggest dummy of the five of us.\We all know.\You should take a break.\We spent money to come to the amusement park.\No.\You don't have any idea how dumb I am. response:	Do you know why we transferred to this school?
context: I thought I could keep going, since I have more stamina than the others.\Also, the secret is that I'm the biggest dummy of the five of us.\We all know.\You should take a break.\We spent money to come to the amusement park.\No.\You don't have any idea how dumb I am.\Do you know why we transferred to this school? response:	Ichika told me.
context: Also, the secret is that I'm the biggest dummy of the five of us.\We all know.\You should take a break.\We spent money to come to the amusement park.\No.\You don't have any idea how dumb I am.\Do you know why we transferred to this school?\Ichika told me. response:	You were about to flunk.
context: We all know.\You should take a break.\We spent money to come to the amusement park.\No.\You don't have any idea how dumb I am.\Do you know why we transferred to this school?\Ichika told me.\You were about to flunk. response:	Our high school was what you would call a prestigious one.
context: You should take a break.\We spent money to come to the amusement park.\No.\You don't have any idea how dumb I am.\Do you know why we transferred to this school?\Ichika told me.\You were about to flunk.\Our high school was what you would call a prestigious one. response:	It wasn't unusual for people to be held back a year if they failed an exam.
context: We spent money to come to the amusement park.\No.\You don't have any idea how dumb I am.\Do you know why we transferred to this school?\Ichika told me.\You were about to flunk.\Our high school was what you would call a prestigious one.\It wasn't unusual for people to be held back a year if they failed an exam. response:	Naturally, we failed.
context: No.\You don't have any idea how dumb I am.\Do you know why we transferred to this school?\Ichika told me.\You were about to flunk.\Our high school was what you would call a prestigious one.\It wasn't unusual for people to be held back a year if they failed an exam.\Naturally, we failed. response:	Don't make it sound natural!
context: You don't have any idea how dumb I am.\Do you know why we transferred to this school?\Ichika told me.\You were about to flunk.\Our high school was what you would call a prestigious one.\It wasn't unusual for people to be held back a year if they failed an exam.\Naturally, we failed.\Don't make it sound natural! response:	We were given a chance to retake the exams, so we all tried our best.
context: Do you know why we transferred to this school?\Ichika told me.\You were about to flunk.\Our high school was what you would call a prestigious one.\It wasn't unusual for people to be held back a year if they failed an exam.\Naturally, we failed.\Don't make it sound natural!\We were given a chance to retake the exams, so we all tried our best. response:	Don't tell me...
context: Ichika told me.\You were about to flunk.\Our high school was what you would call a prestigious one.\It wasn't unusual for people to be held back a year if they failed an exam.\Naturally, we failed.\Don't make it sound natural!\We were given a chance to retake the exams, so we all tried our best.\Don't tell me... response:	You were the only one who failed?
context: You were about to flunk.\Our high school was what you would call a prestigious one.\It wasn't unusual for people to be held back a year if they failed an exam.\Naturally, we failed.\Don't make it sound natural!\We were given a chance to retake the exams, so we all tried our best.\Don't tell me...\You were the only one who failed? response:	That's our Uesugi-san.
context: Our high school was what you would call a prestigious one.\It wasn't unusual for people to be held back a year if they failed an exam.\Naturally, we failed.\Don't make it sound natural!\We were given a chance to retake the exams, so we all tried our best.\Don't tell me...\You were the only one who failed?\That's our Uesugi-san. response:	You get everything right.
context: It wasn't unusual for people to be held back a year if they failed an exam.\Naturally, we failed.\Don't make it sound natural!\We were given a chance to retake the exams, so we all tried our best.\Don't tell me...\You were the only one who failed?\That's our Uesugi-san.\You get everything right. response:	Yotsuba was the only one who failed.
context: Naturally, we failed.\Don't make it sound natural!\We were given a chance to retake the exams, so we all tried our best.\Don't tell me...\You were the only one who failed?\That's our Uesugi-san.\You get everything right.\Yotsuba was the only one who failed. response:	And yet they all transferred.
context: Don't make it sound natural!\We were given a chance to retake the exams, so we all tried our best.\Don't tell me...\You were the only one who failed?\That's our Uesugi-san.\You get everything right.\Yotsuba was the only one who failed.\And yet they all transferred. response:	They all came along with me.
context: We were given a chance to retake the exams, so we all tried our best.\Don't tell me...\You were the only one who failed?\That's our Uesugi-san.\You get everything right.\Yotsuba was the only one who failed.\And yet they all transferred.\They all came along with me. response:	They never so much as frowned.
context: Don't tell me...\You were the only one who failed?\That's our Uesugi-san.\You get everything right.\Yotsuba was the only one who failed.\And yet they all transferred.\They all came along with me.\They never so much as frowned. response:	Is that from what you were taught about staying together?
context: You were the only one who failed?\That's our Uesugi-san.\You get everything right.\Yotsuba was the only one who failed.\And yet they all transferred.\They all came along with me.\They never so much as frowned.\Is that from what you were taught about staying together? response:	That's helped them through tough times,
context: That's our Uesugi-san.\You get everything right.\Yotsuba was the only one who failed.\And yet they all transferred.\They all came along with me.\They never so much as frowned.\Is that from what you were taught about staying together?\That's helped them through tough times, response:	but it's certainly shackling them as well.
context: You get everything right.\Yotsuba was the only one who failed.\And yet they all transferred.\They all came along with me.\They never so much as frowned.\Is that from what you were taught about staying together?\That's helped them through tough times,\but it's certainly shackling them as well. response:	So, please...
context: Yotsuba was the only one who failed.\And yet they all transferred.\They all came along with me.\They never so much as frowned.\Is that from what you were taught about staying together?\That's helped them through tough times,\but it's certainly shackling them as well.\So, please... response:	Let me study as much as I can.
context: And yet they all transferred.\They all came along with me.\They never so much as frowned.\Is that from what you were taught about staying together?\That's helped them through tough times,\but it's certainly shackling them as well.\So, please...\Let me study as much as I can. response:	I don't want to drag the others down anymore.
context: They all came along with me.\They never so much as frowned.\Is that from what you were taught about staying together?\That's helped them through tough times,\but it's certainly shackling them as well.\So, please...\Let me study as much as I can.\I don't want to drag the others down anymore. response:	I told you, we're taking the day off.
context: They never so much as frowned.\Is that from what you were taught about staying together?\That's helped them through tough times,\but it's certainly shackling them as well.\So, please...\Let me study as much as I can.\I don't want to drag the others down anymore.\I told you, we're taking the day off. response:	That said, we have nothing to do for the remaining half of the lap.
context: Is that from what you were taught about staying together?\That's helped them through tough times,\but it's certainly shackling them as well.\So, please...\Let me study as much as I can.\I don't want to drag the others down anymore.\I told you, we're taking the day off.\That said, we have nothing to do for the remaining half of the lap. response:	I'm bored. Let's study. Man-to-man.
context: That's helped them through tough times,\but it's certainly shackling them as well.\So, please...\Let me study as much as I can.\I don't want to drag the others down anymore.\I told you, we're taking the day off.\That said, we have nothing to do for the remaining half of the lap.\I'm bored. Let's study. Man-to-man. response:	Okay!
context: but it's certainly shackling them as well.\So, please...\Let me study as much as I can.\I don't want to drag the others down anymore.\I told you, we're taking the day off.\That said, we have nothing to do for the remaining half of the lap.\I'm bored. Let's study. Man-to-man.\Okay! response:	This is a good opportunity.
context: So, please...\Let me study as much as I can.\I don't want to drag the others down anymore.\I told you, we're taking the day off.\That said, we have nothing to do for the remaining half of the lap.\I'm bored. Let's study. Man-to-man.\Okay!\This is a good opportunity. response:	I'm going to make sure you understand that Japanese passage from earlier.
context: Let me study as much as I can.\I don't want to drag the others down anymore.\I told you, we're taking the day off.\That said, we have nothing to do for the remaining half of the lap.\I'm bored. Let's study. Man-to-man.\Okay!\This is a good opportunity.\I'm going to make sure you understand that Japanese passage from earlier. response:	Oh, that's okay.
context: I don't want to drag the others down anymore.\I told you, we're taking the day off.\That said, we have nothing to do for the remaining half of the lap.\I'm bored. Let's study. Man-to-man.\Okay!\This is a good opportunity.\I'm going to make sure you understand that Japanese passage from earlier.\Oh, that's okay. response:	I figured it out.
context: I told you, we're taking the day off.\That said, we have nothing to do for the remaining half of the lap.\I'm bored. Let's study. Man-to-man.\Okay!\This is a good opportunity.\I'm going to make sure you understand that Japanese passage from earlier.\Oh, that's okay.\I figured it out. response:	Let's see.
context: That said, we have nothing to do for the remaining half of the lap.\I'm bored. Let's study. Man-to-man.\Okay!\This is a good opportunity.\I'm going to make sure you understand that Japanese passage from earlier.\Oh, that's okay.\I figured it out.\Let's see. response:	You did.
context: I'm bored. Let's study. Man-to-man.\Okay!\This is a good opportunity.\I'm going to make sure you understand that Japanese passage from earlier.\Oh, that's okay.\I figured it out.\Let's see.\You did. response:	The other girls had so much trouble here.
context: Okay!\This is a good opportunity.\I'm going to make sure you understand that Japanese passage from earlier.\Oh, that's okay.\I figured it out.\Let's see.\You did.\The other girls had so much trouble here. response:	Yotsuba!
context: This is a good opportunity.\I'm going to make sure you understand that Japanese passage from earlier.\Oh, that's okay.\I figured it out.\Let's see.\You did.\The other girls had so much trouble here.\Yotsuba! response:	Ack!
context: I'm going to make sure you understand that Japanese passage from earlier.\Oh, that's okay.\I figured it out.\Let's see.\You did.\The other girls had so much trouble here.\Yotsuba!\Ack! response:	When you said man-to-man, you didn't mean mouth-to-mouth, did you?
context: Oh, that's okay.\I figured it out.\Let's see.\You did.\The other girls had so much trouble here.\Yotsuba!\Ack!\When you said man-to-man, you didn't mean mouth-to-mouth, did you? response:	What happened on New Year's was an accident!
context: I figured it out.\Let's see.\You did.\The other girls had so much trouble here.\Yotsuba!\Ack!\When you said man-to-man, you didn't mean mouth-to-mouth, did you?\What happened on New Year's was an accident! response:	I'm beginning to see the light.
context: Let's see.\You did.\The other girls had so much trouble here.\Yotsuba!\Ack!\When you said man-to-man, you didn't mean mouth-to-mouth, did you?\What happened on New Year's was an accident!\I'm beginning to see the light. response:	Your father's right.
context: You did.\The other girls had so much trouble here.\Yotsuba!\Ack!\When you said man-to-man, you didn't mean mouth-to-mouth, did you?\What happened on New Year's was an accident!\I'm beginning to see the light.\Your father's right. response:	If someone can help me, I think we can make it work.
context: The other girls had so much trouble here.\Yotsuba!\Ack!\When you said man-to-man, you didn't mean mouth-to-mouth, did you?\What happened on New Year's was an accident!\I'm beginning to see the light.\Your father's right.\If someone can help me, I think we can make it work. response:	Could you, uh, dumb that down for me?
context: Yotsuba!\Ack!\When you said man-to-man, you didn't mean mouth-to-mouth, did you?\What happened on New Year's was an accident!\I'm beginning to see the light.\Your father's right.\If someone can help me, I think we can make it work.\Could you, uh, dumb that down for me? response:	You'll teach Japanese with me.
context: Ack!\When you said man-to-man, you didn't mean mouth-to-mouth, did you?\What happened on New Year's was an accident!\I'm beginning to see the light.\Your father's right.\If someone can help me, I think we can make it work.\Could you, uh, dumb that down for me?\You'll teach Japanese with me. response:	Me?
context: When you said man-to-man, you didn't mean mouth-to-mouth, did you?\What happened on New Year's was an accident!\I'm beginning to see the light.\Your father's right.\If someone can help me, I think we can make it work.\Could you, uh, dumb that down for me?\You'll teach Japanese with me.\Me? response:	I can't! I can't!
context: What happened on New Year's was an accident!\I'm beginning to see the light.\Your father's right.\If someone can help me, I think we can make it work.\Could you, uh, dumb that down for me?\You'll teach Japanese with me.\Me?\I can't! I can't! response:	You can!
context: I'm beginning to see the light.\Your father's right.\If someone can help me, I think we can make it work.\Could you, uh, dumb that down for me?\You'll teach Japanese with me.\Me?\I can't! I can't!\You can! response:	I've always known from your exam results that you each have different areas of expertise.
context: Your father's right.\If someone can help me, I think we can make it work.\Could you, uh, dumb that down for me?\You'll teach Japanese with me.\Me?\I can't! I can't!\You can!\I've always known from your exam results that you each have different areas of expertise. response:	Miku is good at Socials Studies.
context: If someone can help me, I think we can make it work.\Could you, uh, dumb that down for me?\You'll teach Japanese with me.\Me?\I can't! I can't!\You can!\I've always known from your exam results that you each have different areas of expertise.\Miku is good at Socials Studies. response:	Itsuki is good at Science.
context: Could you, uh, dumb that down for me?\You'll teach Japanese with me.\Me?\I can't! I can't!\You can!\I've always known from your exam results that you each have different areas of expertise.\Miku is good at Socials Studies.\Itsuki is good at Science. response:	And you, Yotsuba, are good at Japanese.
context: You'll teach Japanese with me.\Me?\I can't! I can't!\You can!\I've always known from your exam results that you each have different areas of expertise.\Miku is good at Socials Studies.\Itsuki is good at Science.\And you, Yotsuba, are good at Japanese. response:	I am?
context: Me?\I can't! I can't!\You can!\I've always known from your exam results that you each have different areas of expertise.\Miku is good at Socials Studies.\Itsuki is good at Science.\And you, Yotsuba, are good at Japanese.\I am? response:	You don't have to do anything special.
context: I can't! I can't!\You can!\I've always known from your exam results that you each have different areas of expertise.\Miku is good at Socials Studies.\Itsuki is good at Science.\And you, Yotsuba, are good at Japanese.\I am?\You don't have to do anything special. response:	Just say what's on your mind.
context: You can!\I've always known from your exam results that you each have different areas of expertise.\Miku is good at Socials Studies.\Itsuki is good at Science.\And you, Yotsuba, are good at Japanese.\I am?\You don't have to do anything special.\Just say what's on your mind. response:	If you can do it, the other four can, too.
context: I've always known from your exam results that you each have different areas of expertise.\Miku is good at Socials Studies.\Itsuki is good at Science.\And you, Yotsuba, are good at Japanese.\I am?\You don't have to do anything special.\Just say what's on your mind.\If you can do it, the other four can, too. response:	You're quintuplets.
context: Miku is good at Socials Studies.\Itsuki is good at Science.\And you, Yotsuba, are good at Japanese.\I am?\You don't have to do anything special.\Just say what's on your mind.\If you can do it, the other four can, too.\You're quintuplets. response:	I can be useful to everyone, even if I'm stupid?
context: Itsuki is good at Science.\And you, Yotsuba, are good at Japanese.\I am?\You don't have to do anything special.\Just say what's on your mind.\If you can do it, the other four can, too.\You're quintuplets.\I can be useful to everyone, even if I'm stupid? response:	Sorry you're having to make up for my failings as a teacher.
context: And you, Yotsuba, are good at Japanese.\I am?\You don't have to do anything special.\Just say what's on your mind.\If you can do it, the other four can, too.\You're quintuplets.\I can be useful to everyone, even if I'm stupid?\Sorry you're having to make up for my failings as a teacher. response:	From now on, we'll all be teachers and students together.
context: I am?\You don't have to do anything special.\Just say what's on your mind.\If you can do it, the other four can, too.\You're quintuplets.\I can be useful to everyone, even if I'm stupid?\Sorry you're having to make up for my failings as a teacher.\From now on, we'll all be teachers and students together. response:	There's something an idiot like me can do?
context: You don't have to do anything special.\Just say what's on your mind.\If you can do it, the other four can, too.\You're quintuplets.\I can be useful to everyone, even if I'm stupid?\Sorry you're having to make up for my failings as a teacher.\From now on, we'll all be teachers and students together.\There's something an idiot like me can do? response:	Yeah, there's a job only you can do.
context: Just say what's on your mind.\If you can do it, the other four can, too.\You're quintuplets.\I can be useful to everyone, even if I'm stupid?\Sorry you're having to make up for my failings as a teacher.\From now on, we'll all be teachers and students together.\There's something an idiot like me can do?\Yeah, there's a job only you can do. response:	I'm not just going to drag everyone down?
context: If you can do it, the other four can, too.\You're quintuplets.\I can be useful to everyone, even if I'm stupid?\Sorry you're having to make up for my failings as a teacher.\From now on, we'll all be teachers and students together.\There's something an idiot like me can do?\Yeah, there's a job only you can do.\I'm not just going to drag everyone down? response:	That's right.
context: You're quintuplets.\I can be useful to everyone, even if I'm stupid?\Sorry you're having to make up for my failings as a teacher.\From now on, we'll all be teachers and students together.\There's something an idiot like me can do?\Yeah, there's a job only you can do.\I'm not just going to drag everyone down?\That's right. response:	This time,
context: I can be useful to everyone, even if I'm stupid?\Sorry you're having to make up for my failings as a teacher.\From now on, we'll all be teachers and students together.\There's something an idiot like me can do?\Yeah, there's a job only you can do.\I'm not just going to drag everyone down?\That's right.\This time, response:	you'll be pulling everyone forward.
context: Sorry you're having to make up for my failings as a teacher.\From now on, we'll all be teachers and students together.\There's something an idiot like me can do?\Yeah, there's a job only you can do.\I'm not just going to drag everyone down?\That's right.\This time,\you'll be pulling everyone forward. response:	Okay.
context: From now on, we'll all be teachers and students together.\There's something an idiot like me can do?\Yeah, there's a job only you can do.\I'm not just going to drag everyone down?\That's right.\This time,\you'll be pulling everyone forward.\Okay. response:	I can handle this!
context: There's something an idiot like me can do?\Yeah, there's a job only you can do.\I'm not just going to drag everyone down?\That's right.\This time,\you'll be pulling everyone forward.\Okay.\I can handle this! response:	I'll make sure the others pass!
context: Yeah, there's a job only you can do.\I'm not just going to drag everyone down?\That's right.\This time,\you'll be pulling everyone forward.\Okay.\I can handle this!\I'll make sure the others pass! response:	Hold it.
context: I'm not just going to drag everyone down?\That's right.\This time,\you'll be pulling everyone forward.\Okay.\I can handle this!\I'll make sure the others pass!\Hold it. response:	Don't forget that you're the biggest danger.
context: That's right.\This time,\you'll be pulling everyone forward.\Okay.\I can handle this!\I'll make sure the others pass!\Hold it.\Don't forget that you're the biggest danger. response:	You really do come here every month.
context: This time,\you'll be pulling everyone forward.\Okay.\I can handle this!\I'll make sure the others pass!\Hold it.\Don't forget that you're the biggest danger.\You really do come here every month. response:	Why are you here?
context: you'll be pulling everyone forward.\Okay.\I can handle this!\I'll make sure the others pass!\Hold it.\Don't forget that you're the biggest danger.\You really do come here every month.\Why are you here? response:	Your plan to have everyone be a tutor is showing positive signs.
context: Okay.\I can handle this!\I'll make sure the others pass!\Hold it.\Don't forget that you're the biggest danger.\You really do come here every month.\Why are you here?\Your plan to have everyone be a tutor is showing positive signs. response:	I realized you can learn some things better by teaching than by being taught.
context: I can handle this!\I'll make sure the others pass!\Hold it.\Don't forget that you're the biggest danger.\You really do come here every month.\Why are you here?\Your plan to have everyone be a tutor is showing positive signs.\I realized you can learn some things better by teaching than by being taught. response:	Are you telling me you don't need me anymore?
context: I'll make sure the others pass!\Hold it.\Don't forget that you're the biggest danger.\You really do come here every month.\Why are you here?\Your plan to have everyone be a tutor is showing positive signs.\I realized you can learn some things better by teaching than by being taught.\Are you telling me you don't need me anymore? response:	I'm appreciating what you taught us.
context: Hold it.\Don't forget that you're the biggest danger.\You really do come here every month.\Why are you here?\Your plan to have everyone be a tutor is showing positive signs.\I realized you can learn some things better by teaching than by being taught.\Are you telling me you don't need me anymore?\I'm appreciating what you taught us. response:	Thank you.
context: Don't forget that you're the biggest danger.\You really do come here every month.\Why are you here?\Your plan to have everyone be a tutor is showing positive signs.\I realized you can learn some things better by teaching than by being taught.\Are you telling me you don't need me anymore?\I'm appreciating what you taught us.\Thank you. response:	How does it feel to be thanked by someone you taught?
context: You really do come here every month.\Why are you here?\Your plan to have everyone be a tutor is showing positive signs.\I realized you can learn some things better by teaching than by being taught.\Are you telling me you don't need me anymore?\I'm appreciating what you taught us.\Thank you.\How does it feel to be thanked by someone you taught? response:	Jeez, that's so patronizing.
context: Why are you here?\Your plan to have everyone be a tutor is showing positive signs.\I realized you can learn some things better by teaching than by being taught.\Are you telling me you don't need me anymore?\I'm appreciating what you taught us.\Thank you.\How does it feel to be thanked by someone you taught?\Jeez, that's so patronizing. response:	Wow, that makes so much sense.
context: Your plan to have everyone be a tutor is showing positive signs.\I realized you can learn some things better by teaching than by being taught.\Are you telling me you don't need me anymore?\I'm appreciating what you taught us.\Thank you.\How does it feel to be thanked by someone you taught?\Jeez, that's so patronizing.\Wow, that makes so much sense. response:	Thanks, Itsuki!
context: I realized you can learn some things better by teaching than by being taught.\Are you telling me you don't need me anymore?\I'm appreciating what you taught us.\Thank you.\How does it feel to be thanked by someone you taught?\Jeez, that's so patronizing.\Wow, that makes so much sense.\Thanks, Itsuki! response:	I want to cherish that feeling.
context: Are you telling me you don't need me anymore?\I'm appreciating what you taught us.\Thank you.\How does it feel to be thanked by someone you taught?\Jeez, that's so patronizing.\Wow, that makes so much sense.\Thanks, Itsuki!\I want to cherish that feeling. response:	Mother, I'm going to work toward becoming a teacher.
context: I'm appreciating what you taught us.\Thank you.\How does it feel to be thanked by someone you taught?\Jeez, that's so patronizing.\Wow, that makes so much sense.\Thanks, Itsuki!\I want to cherish that feeling.\Mother, I'm going to work toward becoming a teacher. response:	It took me all night to make chocolates.
context: Thank you.\How does it feel to be thanked by someone you taught?\Jeez, that's so patronizing.\Wow, that makes so much sense.\Thanks, Itsuki!\I want to cherish that feeling.\Mother, I'm going to work toward becoming a teacher.\It took me all night to make chocolates. response:	Miku.
context: How does it feel to be thanked by someone you taught?\Jeez, that's so patronizing.\Wow, that makes so much sense.\Thanks, Itsuki!\I want to cherish that feeling.\Mother, I'm going to work toward becoming a teacher.\It took me all night to make chocolates.\Miku. response:	Good morning.
context: Jeez, that's so patronizing.\Wow, that makes so much sense.\Thanks, Itsuki!\I want to cherish that feeling.\Mother, I'm going to work toward becoming a teacher.\It took me all night to make chocolates.\Miku.\Good morning. response:	You and Nino both stay in bed way too late.
context: Wow, that makes so much sense.\Thanks, Itsuki!\I want to cherish that feeling.\Mother, I'm going to work toward becoming a teacher.\It took me all night to make chocolates.\Miku.\Good morning.\You and Nino both stay in bed way too late. response:	Futaro.
context: Thanks, Itsuki!\I want to cherish that feeling.\Mother, I'm going to work toward becoming a teacher.\It took me all night to make chocolates.\Miku.\Good morning.\You and Nino both stay in bed way too late.\Futaro. response:	You're here.
context: I want to cherish that feeling.\Mother, I'm going to work toward becoming a teacher.\It took me all night to make chocolates.\Miku.\Good morning.\You and Nino both stay in bed way too late.\Futaro.\You're here. response:	I wish you'd told me you were coming over.
context: Mother, I'm going to work toward becoming a teacher.\It took me all night to make chocolates.\Miku.\Good morning.\You and Nino both stay in bed way too late.\Futaro.\You're here.\I wish you'd told me you were coming over. response:	I'm glad you're here, though.
context: It took me all night to make chocolates.\Miku.\Good morning.\You and Nino both stay in bed way too late.\Futaro.\You're here.\I wish you'd told me you were coming over.\I'm glad you're here, though. response:	Huh?
context: Miku.\Good morning.\You and Nino both stay in bed way too late.\Futaro.\You're here.\I wish you'd told me you were coming over.\I'm glad you're here, though.\Huh? response:	Where'd the chocolates go?
context: Good morning.\You and Nino both stay in bed way too late.\Futaro.\You're here.\I wish you'd told me you were coming over.\I'm glad you're here, though.\Huh?\Where'd the chocolates go? response:	Oh, those?
context: You and Nino both stay in bed way too late.\Futaro.\You're here.\I wish you'd told me you were coming over.\I'm glad you're here, though.\Huh?\Where'd the chocolates go?\Oh, those? response:	I ate them, as always.
context: Futaro.\You're here.\I wish you'd told me you were coming over.\I'm glad you're here, though.\Huh?\Where'd the chocolates go?\Oh, those?\I ate them, as always. response:	They were good.
context: You're here.\I wish you'd told me you were coming over.\I'm glad you're here, though.\Huh?\Where'd the chocolates go?\Oh, those?\I ate them, as always.\They were good. response:	Th-Thanks.
context: I wish you'd told me you were coming over.\I'm glad you're here, though.\Huh?\Where'd the chocolates go?\Oh, those?\I ate them, as always.\They were good.\Th-Thanks. response:	About those chocolates...
context: I'm glad you're here, though.\Huh?\Where'd the chocolates go?\Oh, those?\I ate them, as always.\They were good.\Th-Thanks.\About those chocolates... response:	Miku, there's something I should let you know.
context: Huh?\Where'd the chocolates go?\Oh, those?\I ate them, as always.\They were good.\Th-Thanks.\About those chocolates...\Miku, there's something I should let you know. response:	You're number one.
context: Where'd the chocolates go?\Oh, those?\I ate them, as always.\They were good.\Th-Thanks.\About those chocolates...\Miku, there's something I should let you know.\You're number one. response:	Number one?
context: Oh, those?\I ate them, as always.\They were good.\Th-Thanks.\About those chocolates...\Miku, there's something I should let you know.\You're number one.\Number one? response:	What do you mean by that?
context: I ate them, as always.\They were good.\Th-Thanks.\About those chocolates...\Miku, there's something I should let you know.\You're number one.\Number one?\What do you mean by that? response:	The mock exam we did the other day, of course!
context: They were good.\Th-Thanks.\About those chocolates...\Miku, there's something I should let you know.\You're number one.\Number one?\What do you mean by that?\The mock exam we did the other day, of course! response:	You got the highest score!
context: Th-Thanks.\About those chocolates...\Miku, there's something I should let you know.\You're number one.\Number one?\What do you mean by that?\The mock exam we did the other day, of course!\You got the highest score! response:	Oh.
context: About those chocolates...\Miku, there's something I should let you know.\You're number one.\Number one?\What do you mean by that?\The mock exam we did the other day, of course!\You got the highest score!\Oh. response:	Cool.
context: Miku, there's something I should let you know.\You're number one.\Number one?\What do you mean by that?\The mock exam we did the other day, of course!\You got the highest score!\Oh.\Cool. response:	I'm beginning to see some hope!
context: You're number one.\Number one?\What do you mean by that?\The mock exam we did the other day, of course!\You got the highest score!\Oh.\Cool.\I'm beginning to see some hope! response:	I'm going to keep trying.
context: Number one?\What do you mean by that?\The mock exam we did the other day, of course!\You got the highest score!\Oh.\Cool.\I'm beginning to see some hope!\I'm going to keep trying. response:	Just watch me, Futaro.
context: What do you mean by that?\The mock exam we did the other day, of course!\You got the highest score!\Oh.\Cool.\I'm beginning to see some hope!\I'm going to keep trying.\Just watch me, Futaro. response:	So cold.
context: The mock exam we did the other day, of course!\You got the highest score!\Oh.\Cool.\I'm beginning to see some hope!\I'm going to keep trying.\Just watch me, Futaro.\So cold. response:	Ichika.
context: You got the highest score!\Oh.\Cool.\I'm beginning to see some hope!\I'm going to keep trying.\Just watch me, Futaro.\So cold.\Ichika. response:	Long day at work, huh?
context: Oh.\Cool.\I'm beginning to see some hope!\I'm going to keep trying.\Just watch me, Futaro.\So cold.\Ichika.\Long day at work, huh? response:	What are you doing?
context: Cool.\I'm beginning to see some hope!\I'm going to keep trying.\Just watch me, Futaro.\So cold.\Ichika.\Long day at work, huh?\What are you doing? response:	How'd it go today?
context: I'm beginning to see some hope!\I'm going to keep trying.\Just watch me, Futaro.\So cold.\Ichika.\Long day at work, huh?\What are you doing?\How'd it go today? response:	Aren't you giving Futaro any chocolates?
context: I'm going to keep trying.\Just watch me, Futaro.\So cold.\Ichika.\Long day at work, huh?\What are you doing?\How'd it go today?\Aren't you giving Futaro any chocolates? response:	Wh-What brings that up?
context: Just watch me, Futaro.\So cold.\Ichika.\Long day at work, huh?\What are you doing?\How'd it go today?\Aren't you giving Futaro any chocolates?\Wh-What brings that up? response:	I mean, I'd feel bad for him if no one did.
context: So cold.\Ichika.\Long day at work, huh?\What are you doing?\How'd it go today?\Aren't you giving Futaro any chocolates?\Wh-What brings that up?\I mean, I'd feel bad for him if no one did. response:	I thought about buying him some.
context: Ichika.\Long day at work, huh?\What are you doing?\How'd it go today?\Aren't you giving Futaro any chocolates?\Wh-What brings that up?\I mean, I'd feel bad for him if no one did.\I thought about buying him some. response:	But I figured it's all good if you're going to.
context: Long day at work, huh?\What are you doing?\How'd it go today?\Aren't you giving Futaro any chocolates?\Wh-What brings that up?\I mean, I'd feel bad for him if no one did.\I thought about buying him some.\But I figured it's all good if you're going to. response:	What do you mean, all good?
context: What are you doing?\How'd it go today?\Aren't you giving Futaro any chocolates?\Wh-What brings that up?\I mean, I'd feel bad for him if no one did.\I thought about buying him some.\But I figured it's all good if you're going to.\What do you mean, all good? response:	Futaro doesn't see us as girls at all.
context: How'd it go today?\Aren't you giving Futaro any chocolates?\Wh-What brings that up?\I mean, I'd feel bad for him if no one did.\I thought about buying him some.\But I figured it's all good if you're going to.\What do you mean, all good?\Futaro doesn't see us as girls at all. response:	I've always known it, but to him,
context: Aren't you giving Futaro any chocolates?\Wh-What brings that up?\I mean, I'd feel bad for him if no one did.\I thought about buying him some.\But I figured it's all good if you're going to.\What do you mean, all good?\Futaro doesn't see us as girls at all.\I've always known it, but to him, response:	we're all just students.
context: Wh-What brings that up?\I mean, I'd feel bad for him if no one did.\I thought about buying him some.\But I figured it's all good if you're going to.\What do you mean, all good?\Futaro doesn't see us as girls at all.\I've always known it, but to him,\we're all just students. response:	Miku...
context: I mean, I'd feel bad for him if no one did.\I thought about buying him some.\But I figured it's all good if you're going to.\What do you mean, all good?\Futaro doesn't see us as girls at all.\I've always known it, but to him,\we're all just students.\Miku... response:	That's why I made up my mind.
context: I thought about buying him some.\But I figured it's all good if you're going to.\What do you mean, all good?\Futaro doesn't see us as girls at all.\I've always known it, but to him,\we're all just students.\Miku...\That's why I made up my mind. response:	I'm going to pass this final exam.
context: But I figured it's all good if you're going to.\What do you mean, all good?\Futaro doesn't see us as girls at all.\I've always known it, but to him,\we're all just students.\Miku...\That's why I made up my mind.\I'm going to pass this final exam. response:	And I'm going to get the highest scores of all of us.
context: What do you mean, all good?\Futaro doesn't see us as girls at all.\I've always known it, but to him,\we're all just students.\Miku...\That's why I made up my mind.\I'm going to pass this final exam.\And I'm going to get the highest scores of all of us. response:	And if I can gain confidence and graduate from being his student,
context: Futaro doesn't see us as girls at all.\I've always known it, but to him,\we're all just students.\Miku...\That's why I made up my mind.\I'm going to pass this final exam.\And I'm going to get the highest scores of all of us.\And if I can gain confidence and graduate from being his student, response:	I'm going to really tell him that I have feelings for him.
context: I've always known it, but to him,\we're all just students.\Miku...\That's why I made up my mind.\I'm going to pass this final exam.\And I'm going to get the highest scores of all of us.\And if I can gain confidence and graduate from being his student,\I'm going to really tell him that I have feelings for him. response:	Th-That sounds good.
context: we're all just students.\Miku...\That's why I made up my mind.\I'm going to pass this final exam.\And I'm going to get the highest scores of all of us.\And if I can gain confidence and graduate from being his student,\I'm going to really tell him that I have feelings for him.\Th-That sounds good. response:	If that's your way of keeping yourself disciplined...
context: Miku...\That's why I made up my mind.\I'm going to pass this final exam.\And I'm going to get the highest scores of all of us.\And if I can gain confidence and graduate from being his student,\I'm going to really tell him that I have feelings for him.\Th-That sounds good.\If that's your way of keeping yourself disciplined... response:	I'm sure you can do it.
context: That's why I made up my mind.\I'm going to pass this final exam.\And I'm going to get the highest scores of all of us.\And if I can gain confidence and graduate from being his student,\I'm going to really tell him that I have feelings for him.\Th-That sounds good.\If that's your way of keeping yourself disciplined...\I'm sure you can do it. response:	I'm not going to wait for you.
context: I'm going to pass this final exam.\And I'm going to get the highest scores of all of us.\And if I can gain confidence and graduate from being his student,\I'm going to really tell him that I have feelings for him.\Th-That sounds good.\If that's your way of keeping yourself disciplined...\I'm sure you can do it.\I'm not going to wait for you. response:	This is a race.
context: And I'm going to get the highest scores of all of us.\And if I can gain confidence and graduate from being his student,\I'm going to really tell him that I have feelings for him.\Th-That sounds good.\If that's your way of keeping yourself disciplined...\I'm sure you can do it.\I'm not going to wait for you.\This is a race. response:	Yeah.
context: And if I can gain confidence and graduate from being his student,\I'm going to really tell him that I have feelings for him.\Th-That sounds good.\If that's your way of keeping yourself disciplined...\I'm sure you can do it.\I'm not going to wait for you.\This is a race.\Yeah. response:	I can't be slacking off either, though.
context: I'm going to really tell him that I have feelings for him.\Th-That sounds good.\If that's your way of keeping yourself disciplined...\I'm sure you can do it.\I'm not going to wait for you.\This is a race.\Yeah.\I can't be slacking off either, though. response:	So work hard.
context: Th-That sounds good.\If that's your way of keeping yourself disciplined...\I'm sure you can do it.\I'm not going to wait for you.\This is a race.\Yeah.\I can't be slacking off either, though.\So work hard. response:	Miku keeps changing.
context: If that's your way of keeping yourself disciplined...\I'm sure you can do it.\I'm not going to wait for you.\This is a race.\Yeah.\I can't be slacking off either, though.\So work hard.\Miku keeps changing. response:	I'm beat...
context: I'm sure you can do it.\I'm not going to wait for you.\This is a race.\Yeah.\I can't be slacking off either, though.\So work hard.\Miku keeps changing.\I'm beat... response:	I should sleep and continue tomorrow.
context: I'm not going to wait for you.\This is a race.\Yeah.\I can't be slacking off either, though.\So work hard.\Miku keeps changing.\I'm beat...\I should sleep and continue tomorrow. response:	These times aren't going to last forever.
context: This is a race.\Yeah.\I can't be slacking off either, though.\So work hard.\Miku keeps changing.\I'm beat...\I should sleep and continue tomorrow.\These times aren't going to last forever. response:	A little more!
context: Yeah.\I can't be slacking off either, though.\So work hard.\Miku keeps changing.\I'm beat...\I should sleep and continue tomorrow.\These times aren't going to last forever.\A little more! response:	Just a little more.
context: I can't be slacking off either, though.\So work hard.\Miku keeps changing.\I'm beat...\I should sleep and continue tomorrow.\These times aren't going to last forever.\A little more!\Just a little more. response:	Final Exams
context: So work hard.\Miku keeps changing.\I'm beat...\I should sleep and continue tomorrow.\These times aren't going to last forever.\A little more!\Just a little more.\Final Exams response:	Yotsuba!
context: Miku keeps changing.\I'm beat...\I should sleep and continue tomorrow.\These times aren't going to last forever.\A little more!\Just a little more.\Final Exams\Yotsuba! response:	How did the exams go?
context: I'm beat...\I should sleep and continue tomorrow.\These times aren't going to last forever.\A little more!\Just a little more.\Final Exams\Yotsuba!\How did the exams go? response:	Uesugi-san.
context: I should sleep and continue tomorrow.\These times aren't going to last forever.\A little more!\Just a little more.\Final Exams\Yotsuba!\How did the exams go?\Uesugi-san. response:	Thank you.
context: These times aren't going to last forever.\A little more!\Just a little more.\Final Exams\Yotsuba!\How did the exams go?\Uesugi-san.\Thank you. response:	I feel vindicated for the first time.
context: A little more!\Just a little more.\Final Exams\Yotsuba!\How did the exams go?\Uesugi-san.\Thank you.\I feel vindicated for the first time. response:	Pass
context: Just a little more.\Final Exams\Yotsuba!\How did the exams go?\Uesugi-san.\Thank you.\I feel vindicated for the first time.\Pass response:	Well Done
context: Final Exams\Yotsuba!\How did the exams go?\Uesugi-san.\Thank you.\I feel vindicated for the first time.\Pass\Well Done response:	Yotsuba!
context: Yotsuba!\How did the exams go?\Uesugi-san.\Thank you.\I feel vindicated for the first time.\Pass\Well Done\Yotsuba! response:	You did it!
context: How did the exams go?\Uesugi-san.\Thank you.\I feel vindicated for the first time.\Pass\Well Done\Yotsuba!\You did it! response:	Congrats.
context: Uesugi-san.\Thank you.\I feel vindicated for the first time.\Pass\Well Done\Yotsuba!\You did it!\Congrats. response:	These are the highest scores I've ever gotten.
context: Thank you.\I feel vindicated for the first time.\Pass\Well Done\Yotsuba!\You did it!\Congrats.\These are the highest scores I've ever gotten. response:	I just barely passed with a total score of 184, though.
context: I feel vindicated for the first time.\Pass\Well Done\Yotsuba!\You did it!\Congrats.\These are the highest scores I've ever gotten.\I just barely passed with a total score of 184, though. response:	I scored 224 total.
context: Pass\Well Done\Yotsuba!\You did it!\Congrats.\These are the highest scores I've ever gotten.\I just barely passed with a total score of 184, though.\I scored 224 total. response:	I'm going to have to work on the subjects that I nearly failed.
context: Well Done\Yotsuba!\You did it!\Congrats.\These are the highest scores I've ever gotten.\I just barely passed with a total score of 184, though.\I scored 224 total.\I'm going to have to work on the subjects that I nearly failed. response:	Pass
context: Yotsuba!\You did it!\Congrats.\These are the highest scores I've ever gotten.\I just barely passed with a total score of 184, though.\I scored 224 total.\I'm going to have to work on the subjects that I nearly failed.\Pass response:	Well Done
context: You did it!\Congrats.\These are the highest scores I've ever gotten.\I just barely passed with a total score of 184, though.\I scored 224 total.\I'm going to have to work on the subjects that I nearly failed.\Pass\Well Done response:	I got 238.
context: Congrats.\These are the highest scores I've ever gotten.\I just barely passed with a total score of 184, though.\I scored 224 total.\I'm going to have to work on the subjects that I nearly failed.\Pass\Well Done\I got 238. response:	Wow!
context: These are the highest scores I've ever gotten.\I just barely passed with a total score of 184, though.\I scored 224 total.\I'm going to have to work on the subjects that I nearly failed.\Pass\Well Done\I got 238.\Wow! response:	Pass
context: I just barely passed with a total score of 184, though.\I scored 224 total.\I'm going to have to work on the subjects that I nearly failed.\Pass\Well Done\I got 238.\Wow!\Pass response:	Well Done
context: I scored 224 total.\I'm going to have to work on the subjects that I nearly failed.\Pass\Well Done\I got 238.\Wow!\Pass\Well Done response:	I knew you could do it, Miku.
context: I'm going to have to work on the subjects that I nearly failed.\Pass\Well Done\I got 238.\Wow!\Pass\Well Done\I knew you could do it, Miku. response:	Ichika's here, too.
context: Pass\Well Done\I got 238.\Wow!\Pass\Well Done\I knew you could do it, Miku.\Ichika's here, too. response:	I'm here.
context: Well Done\I got 238.\Wow!\Pass\Well Done\I knew you could do it, Miku.\Ichika's here, too.\I'm here. response:	Miku.
context: I got 238.\Wow!\Pass\Well Done\I knew you could do it, Miku.\Ichika's here, too.\I'm here.\Miku. response:	I'm impressed.
context: Wow!\Pass\Well Done\I knew you could do it, Miku.\Ichika's here, too.\I'm here.\Miku.\I'm impressed. response:	I knew you had the most potential.
context: Pass\Well Done\I knew you could do it, Miku.\Ichika's here, too.\I'm here.\Miku.\I'm impressed.\I knew you had the most potential. response:	Futaro...
context: Well Done\I knew you could do it, Miku.\Ichika's here, too.\I'm here.\Miku.\I'm impressed.\I knew you had the most potential.\Futaro... response:	What was your total score, Ichika?
context: I knew you could do it, Miku.\Ichika's here, too.\I'm here.\Miku.\I'm impressed.\I knew you had the most potential.\Futaro...\What was your total score, Ichika? response:	Um...
context: Ichika's here, too.\I'm here.\Miku.\I'm impressed.\I knew you had the most potential.\Futaro...\What was your total score, Ichika?\Um... response:	240.
context: I'm here.\Miku.\I'm impressed.\I knew you had the most potential.\Futaro...\What was your total score, Ichika?\Um...\240. response:	Which means...
context: Miku.\I'm impressed.\I knew you had the most potential.\Futaro...\What was your total score, Ichika?\Um...\240.\Which means... response:	You scored the highest, Ichika!
context: I'm impressed.\I knew you had the most potential.\Futaro...\What was your total score, Ichika?\Um...\240.\Which means...\You scored the highest, Ichika! response:	Oh, did I?
context: I knew you had the most potential.\Futaro...\What was your total score, Ichika?\Um...\240.\Which means...\You scored the highest, Ichika!\Oh, did I? response:	Yay.
context: Futaro...\What was your total score, Ichika?\Um...\240.\Which means...\You scored the highest, Ichika!\Oh, did I?\Yay. response:	Pass
context: What was your total score, Ichika?\Um...\240.\Which means...\You scored the highest, Ichika!\Oh, did I?\Yay.\Pass response:	Well Done
context: Um...\240.\Which means...\You scored the highest, Ichika!\Oh, did I?\Yay.\Pass\Well Done response:	Congratulations on passing your exams.
context: 240.\Which means...\You scored the highest, Ichika!\Oh, did I?\Yay.\Pass\Well Done\Congratulations on passing your exams. response:	Let's celebrate.
context: Which means...\You scored the highest, Ichika!\Oh, did I?\Yay.\Pass\Well Done\Congratulations on passing your exams.\Let's celebrate. response:	Have as much as you like. I'll deduct the bill from Uesugi-kun's pay.
context: You scored the highest, Ichika!\Oh, did I?\Yay.\Pass\Well Done\Congratulations on passing your exams.\Let's celebrate.\Have as much as you like. I'll deduct the bill from Uesugi-kun's pay. response:	Oh, boss, you're so funny.
context: Oh, did I?\Yay.\Pass\Well Done\Congratulations on passing your exams.\Let's celebrate.\Have as much as you like. I'll deduct the bill from Uesugi-kun's pay.\Oh, boss, you're so funny. response:	Thank you.
context: Yay.\Pass\Well Done\Congratulations on passing your exams.\Let's celebrate.\Have as much as you like. I'll deduct the bill from Uesugi-kun's pay.\Oh, boss, you're so funny.\Thank you. response:	We're still missing one person, though.
context: Pass\Well Done\Congratulations on passing your exams.\Let's celebrate.\Have as much as you like. I'll deduct the bill from Uesugi-kun's pay.\Oh, boss, you're so funny.\Thank you.\We're still missing one person, though. response:	The girl with the pigtails came earlier and left this with me.
context: Well Done\Congratulations on passing your exams.\Let's celebrate.\Have as much as you like. I'll deduct the bill from Uesugi-kun's pay.\Oh, boss, you're so funny.\Thank you.\We're still missing one person, though.\The girl with the pigtails came earlier and left this with me. response:	Also, she had a message for you.
context: Congratulations on passing your exams.\Let's celebrate.\Have as much as you like. I'll deduct the bill from Uesugi-kun's pay.\Oh, boss, you're so funny.\Thank you.\We're still missing one person, though.\The girl with the pigtails came earlier and left this with me.\Also, she had a message for you. response:	Congratulations.
context: Let's celebrate.\Have as much as you like. I'll deduct the bill from Uesugi-kun's pay.\Oh, boss, you're so funny.\Thank you.\We're still missing one person, though.\The girl with the pigtails came earlier and left this with me.\Also, she had a message for you.\Congratulations. response:	I have no more use for you now.
context: Have as much as you like. I'll deduct the bill from Uesugi-kun's pay.\Oh, boss, you're so funny.\Thank you.\We're still missing one person, though.\The girl with the pigtails came earlier and left this with me.\Also, she had a message for you.\Congratulations.\I have no more use for you now. response:	Pass
context: Oh, boss, you're so funny.\Thank you.\We're still missing one person, though.\The girl with the pigtails came earlier and left this with me.\Also, she had a message for you.\Congratulations.\I have no more use for you now.\Pass response:	Well Done
context: Thank you.\We're still missing one person, though.\The girl with the pigtails came earlier and left this with me.\Also, she had a message for you.\Congratulations.\I have no more use for you now.\Pass\Well Done response:	Yay!
context: We're still missing one person, though.\The girl with the pigtails came earlier and left this with me.\Also, she had a message for you.\Congratulations.\I have no more use for you now.\Pass\Well Done\Yay! response:	We all made it through!
context: The girl with the pigtails came earlier and left this with me.\Also, she had a message for you.\Congratulations.\I have no more use for you now.\Pass\Well Done\Yay!\We all made it through! response:	Hey, where are you going?
context: Also, she had a message for you.\Congratulations.\I have no more use for you now.\Pass\Well Done\Yay!\We all made it through!\Hey, where are you going? response:	This is a celebration for everyone.
context: Congratulations.\I have no more use for you now.\Pass\Well Done\Yay!\We all made it through!\Hey, where are you going?\This is a celebration for everyone. response:	I'm going to go get Nino.
context: I have no more use for you now.\Pass\Well Done\Yay!\We all made it through!\Hey, where are you going?\This is a celebration for everyone.\I'm going to go get Nino. response:	Begin the Offensive
context: Pass\Well Done\Yay!\We all made it through!\Hey, where are you going?\This is a celebration for everyone.\I'm going to go get Nino.\Begin the Offensive response:	Begin the Offensive.