context: My name is Gouda Takeo. response:	I may not look like it, but I'm a first-year in high school.
context: My name is Gouda Takeo.\I may not look like it, but I'm a first-year in high school. response:	Soon after I entered high school,
context: My name is Gouda Takeo.\I may not look like it, but I'm a first-year in high school.\Soon after I entered high school, response:	I fell in love with Yamato after saving her from a groper.
context: My name is Gouda Takeo.\I may not look like it, but I'm a first-year in high school.\Soon after I entered high school,\I fell in love with Yamato after saving her from a groper. response:	Get off this train at the next station!
context: My name is Gouda Takeo.\I may not look like it, but I'm a first-year in high school.\Soon after I entered high school,\I fell in love with Yamato after saving her from a groper.\Get off this train at the next station! response:	Thank you.
context: My name is Gouda Takeo.\I may not look like it, but I'm a first-year in high school.\Soon after I entered high school,\I fell in love with Yamato after saving her from a groper.\Get off this train at the next station!\Thank you. response:	I'll get going.
context: My name is Gouda Takeo.\I may not look like it, but I'm a first-year in high school.\Soon after I entered high school,\I fell in love with Yamato after saving her from a groper.\Get off this train at the next station!\Thank you.\I'll get going. response:	Huh?
context: My name is Gouda Takeo.\I may not look like it, but I'm a first-year in high school.\Soon after I entered high school,\I fell in love with Yamato after saving her from a groper.\Get off this train at the next station!\Thank you.\I'll get going.\Huh? response:	You're leaving?!
context: I may not look like it, but I'm a first-year in high school.\Soon after I entered high school,\I fell in love with Yamato after saving her from a groper.\Get off this train at the next station!\Thank you.\I'll get going.\Huh?\You're leaving?! response:	But Yamato had fallen for Suna.
context: Soon after I entered high school,\I fell in love with Yamato after saving her from a groper.\Get off this train at the next station!\Thank you.\I'll get going.\Huh?\You're leaving?!\But Yamato had fallen for Suna. response:	She's...
context: I fell in love with Yamato after saving her from a groper.\Get off this train at the next station!\Thank you.\I'll get going.\Huh?\You're leaving?!\But Yamato had fallen for Suna.\She's... response:	kind of nice.
context: Get off this train at the next station!\Thank you.\I'll get going.\Huh?\You're leaving?!\But Yamato had fallen for Suna.\She's...\kind of nice. response:	Suna seems to have a thing for her, too.
context: Thank you.\I'll get going.\Huh?\You're leaving?!\But Yamato had fallen for Suna.\She's...\kind of nice.\Suna seems to have a thing for her, too. response:	Now that I think about it, you're always helping me...
context: I'll get going.\Huh?\You're leaving?!\But Yamato had fallen for Suna.\She's...\kind of nice.\Suna seems to have a thing for her, too.\Now that I think about it, you're always helping me... response:	Thank you.
context: Huh?\You're leaving?!\But Yamato had fallen for Suna.\She's...\kind of nice.\Suna seems to have a thing for her, too.\Now that I think about it, you're always helping me...\Thank you. response:	Next time, could it be without Sunakawa-kun?
context: You're leaving?!\But Yamato had fallen for Suna.\She's...\kind of nice.\Suna seems to have a thing for her, too.\Now that I think about it, you're always helping me...\Thank you.\Next time, could it be without Sunakawa-kun? response:	She's finally ready to ask for advice with her relationship.
context: But Yamato had fallen for Suna.\She's...\kind of nice.\Suna seems to have a thing for her, too.\Now that I think about it, you're always helping me...\Thank you.\Next time, could it be without Sunakawa-kun?\She's finally ready to ask for advice with her relationship. response:	You can count on me!
context: She's...\kind of nice.\Suna seems to have a thing for her, too.\Now that I think about it, you're always helping me...\Thank you.\Next time, could it be without Sunakawa-kun?\She's finally ready to ask for advice with her relationship.\You can count on me! response:	My Blue Ogre
context: kind of nice.\Suna seems to have a thing for her, too.\Now that I think about it, you're always helping me...\Thank you.\Next time, could it be without Sunakawa-kun?\She's finally ready to ask for advice with her relationship.\You can count on me!\My Blue Ogre response:	Here I am...
context: Suna seems to have a thing for her, too.\Now that I think about it, you're always helping me...\Thank you.\Next time, could it be without Sunakawa-kun?\She's finally ready to ask for advice with her relationship.\You can count on me!\My Blue Ogre\Here I am... response:	Sorry, was I late?
context: Now that I think about it, you're always helping me...\Thank you.\Next time, could it be without Sunakawa-kun?\She's finally ready to ask for advice with her relationship.\You can count on me!\My Blue Ogre\Here I am...\Sorry, was I late? response:	No, you're still five minutes early.
context: Thank you.\Next time, could it be without Sunakawa-kun?\She's finally ready to ask for advice with her relationship.\You can count on me!\My Blue Ogre\Here I am...\Sorry, was I late?\No, you're still five minutes early. response:	Thank goodness.
context: Next time, could it be without Sunakawa-kun?\She's finally ready to ask for advice with her relationship.\You can count on me!\My Blue Ogre\Here I am...\Sorry, was I late?\No, you're still five minutes early.\Thank goodness. response:	I thought I'd kept you waiting.
context: She's finally ready to ask for advice with her relationship.\You can count on me!\My Blue Ogre\Here I am...\Sorry, was I late?\No, you're still five minutes early.\Thank goodness.\I thought I'd kept you waiting. response:	No...
context: You can count on me!\My Blue Ogre\Here I am...\Sorry, was I late?\No, you're still five minutes early.\Thank goodness.\I thought I'd kept you waiting.\No... response:	Huh, is it just my imagination,
context: My Blue Ogre\Here I am...\Sorry, was I late?\No, you're still five minutes early.\Thank goodness.\I thought I'd kept you waiting.\No...\Huh, is it just my imagination, response:	or does she look extra-ridiculously cute today?
context: Here I am...\Sorry, was I late?\No, you're still five minutes early.\Thank goodness.\I thought I'd kept you waiting.\No...\Huh, is it just my imagination,\or does she look extra-ridiculously cute today? response:	O-Oh...
context: Sorry, was I late?\No, you're still five minutes early.\Thank goodness.\I thought I'd kept you waiting.\No...\Huh, is it just my imagination,\or does she look extra-ridiculously cute today?\O-Oh... response:	Yeah?
context: No, you're still five minutes early.\Thank goodness.\I thought I'd kept you waiting.\No...\Huh, is it just my imagination,\or does she look extra-ridiculously cute today?\O-Oh...\Yeah? response:	Um, I thought it shouldn't always be cake,
context: Thank goodness.\I thought I'd kept you waiting.\No...\Huh, is it just my imagination,\or does she look extra-ridiculously cute today?\O-Oh...\Yeah?\Um, I thought it shouldn't always be cake, response:	so I made cake sale today.
context: I thought I'd kept you waiting.\No...\Huh, is it just my imagination,\or does she look extra-ridiculously cute today?\O-Oh...\Yeah?\Um, I thought it shouldn't always be cake,\so I made cake sale today. response:	Cake?
context: No...\Huh, is it just my imagination,\or does she look extra-ridiculously cute today?\O-Oh...\Yeah?\Um, I thought it shouldn't always be cake,\so I made cake sale today.\Cake? response:	What's this?
context: Huh, is it just my imagination,\or does she look extra-ridiculously cute today?\O-Oh...\Yeah?\Um, I thought it shouldn't always be cake,\so I made cake sale today.\Cake?\What's this? response:	You might take a bite, thinking it's sweet, but it's actually salty.
context: or does she look extra-ridiculously cute today?\O-Oh...\Yeah?\Um, I thought it shouldn't always be cake,\so I made cake sale today.\Cake?\What's this?\You might take a bite, thinking it's sweet, but it's actually salty. response:	So don't take a bite, thinking it's sweet, because it's actually salty!
context: O-Oh...\Yeah?\Um, I thought it shouldn't always be cake,\so I made cake sale today.\Cake?\What's this?\You might take a bite, thinking it's sweet, but it's actually salty.\So don't take a bite, thinking it's sweet, because it's actually salty! response:	She said it twice.
context: Yeah?\Um, I thought it shouldn't always be cake,\so I made cake sale today.\Cake?\What's this?\You might take a bite, thinking it's sweet, but it's actually salty.\So don't take a bite, thinking it's sweet, because it's actually salty!\She said it twice. response:	Thanks.
context: Um, I thought it shouldn't always be cake,\so I made cake sale today.\Cake?\What's this?\You might take a bite, thinking it's sweet, but it's actually salty.\So don't take a bite, thinking it's sweet, because it's actually salty!\She said it twice.\Thanks. response:	It's great!
context: so I made cake sale today.\Cake?\What's this?\You might take a bite, thinking it's sweet, but it's actually salty.\So don't take a bite, thinking it's sweet, because it's actually salty!\She said it twice.\Thanks.\It's great! response:	It's awesome.
context: Cake?\What's this?\You might take a bite, thinking it's sweet, but it's actually salty.\So don't take a bite, thinking it's sweet, because it's actually salty!\She said it twice.\Thanks.\It's great!\It's awesome. response:	I've never tasted anything like it before!
context: What's this?\You might take a bite, thinking it's sweet, but it's actually salty.\So don't take a bite, thinking it's sweet, because it's actually salty!\She said it twice.\Thanks.\It's great!\It's awesome.\I've never tasted anything like it before! response:	You always eat a lot of my baking. That makes me happy.
context: You might take a bite, thinking it's sweet, but it's actually salty.\So don't take a bite, thinking it's sweet, because it's actually salty!\She said it twice.\Thanks.\It's great!\It's awesome.\I've never tasted anything like it before!\You always eat a lot of my baking. That makes me happy. response:	T-Takeo-kun...
context: So don't take a bite, thinking it's sweet, because it's actually salty!\She said it twice.\Thanks.\It's great!\It's awesome.\I've never tasted anything like it before!\You always eat a lot of my baking. That makes me happy.\T-Takeo-kun... response:	U-Um...
context: She said it twice.\Thanks.\It's great!\It's awesome.\I've never tasted anything like it before!\You always eat a lot of my baking. That makes me happy.\T-Takeo-kun...\U-Um... response:	Oh!
context: Thanks.\It's great!\It's awesome.\I've never tasted anything like it before!\You always eat a lot of my baking. That makes me happy.\T-Takeo-kun...\U-Um...\Oh! response:	I brought tea today, too.
context: It's great!\It's awesome.\I've never tasted anything like it before!\You always eat a lot of my baking. That makes me happy.\T-Takeo-kun...\U-Um...\Oh!\I brought tea today, too. response:	Last time, Sunakawa-kun bought drinks,
context: It's awesome.\I've never tasted anything like it before!\You always eat a lot of my baking. That makes me happy.\T-Takeo-kun...\U-Um...\Oh!\I brought tea today, too.\Last time, Sunakawa-kun bought drinks, response:	and that was really considerate of him.
context: I've never tasted anything like it before!\You always eat a lot of my baking. That makes me happy.\T-Takeo-kun...\U-Um...\Oh!\I brought tea today, too.\Last time, Sunakawa-kun bought drinks,\and that was really considerate of him. response:	Yeah! Suna is really considerate!
context: You always eat a lot of my baking. That makes me happy.\T-Takeo-kun...\U-Um...\Oh!\I brought tea today, too.\Last time, Sunakawa-kun bought drinks,\and that was really considerate of him.\Yeah! Suna is really considerate! response:	He doesn't have a girlfriend, either.
context: T-Takeo-kun...\U-Um...\Oh!\I brought tea today, too.\Last time, Sunakawa-kun bought drinks,\and that was really considerate of him.\Yeah! Suna is really considerate!\He doesn't have a girlfriend, either. response:	And he spoke highly of you.
context: U-Um...\Oh!\I brought tea today, too.\Last time, Sunakawa-kun bought drinks,\and that was really considerate of him.\Yeah! Suna is really considerate!\He doesn't have a girlfriend, either.\And he spoke highly of you. response:	He wouldn't cheat on a girl, either.
context: Oh!\I brought tea today, too.\Last time, Sunakawa-kun bought drinks,\and that was really considerate of him.\Yeah! Suna is really considerate!\He doesn't have a girlfriend, either.\And he spoke highly of you.\He wouldn't cheat on a girl, either. response:	He's smart and good-looking.
context: I brought tea today, too.\Last time, Sunakawa-kun bought drinks,\and that was really considerate of him.\Yeah! Suna is really considerate!\He doesn't have a girlfriend, either.\And he spoke highly of you.\He wouldn't cheat on a girl, either.\He's smart and good-looking. response:	He's a good guy.
context: Last time, Sunakawa-kun bought drinks,\and that was really considerate of him.\Yeah! Suna is really considerate!\He doesn't have a girlfriend, either.\And he spoke highly of you.\He wouldn't cheat on a girl, either.\He's smart and good-looking.\He's a good guy. response:	Yamato...
context: and that was really considerate of him.\Yeah! Suna is really considerate!\He doesn't have a girlfriend, either.\And he spoke highly of you.\He wouldn't cheat on a girl, either.\He's smart and good-looking.\He's a good guy.\Yamato... response:	You can't do much about how people feel, but...
context: Yeah! Suna is really considerate!\He doesn't have a girlfriend, either.\And he spoke highly of you.\He wouldn't cheat on a girl, either.\He's smart and good-looking.\He's a good guy.\Yamato...\You can't do much about how people feel, but... response:	Take it from someone who's known him since we were three years old.
context: He doesn't have a girlfriend, either.\And he spoke highly of you.\He wouldn't cheat on a girl, either.\He's smart and good-looking.\He's a good guy.\Yamato...\You can't do much about how people feel, but...\Take it from someone who's known him since we were three years old. response:	You have my guarantee!
context: And he spoke highly of you.\He wouldn't cheat on a girl, either.\He's smart and good-looking.\He's a good guy.\Yamato...\You can't do much about how people feel, but...\Take it from someone who's known him since we were three years old.\You have my guarantee! response:	Suna's a good guy!
context: He wouldn't cheat on a girl, either.\He's smart and good-looking.\He's a good guy.\Yamato...\You can't do much about how people feel, but...\Take it from someone who's known him since we were three years old.\You have my guarantee!\Suna's a good guy! response:	Don't worry... I'm a man.
context: He's smart and good-looking.\He's a good guy.\Yamato...\You can't do much about how people feel, but...\Take it from someone who's known him since we were three years old.\You have my guarantee!\Suna's a good guy!\Don't worry... I'm a man. response:	I won't make you uncomfortable by confessing my feelings to you!
context: He's a good guy.\Yamato...\You can't do much about how people feel, but...\Take it from someone who's known him since we were three years old.\You have my guarantee!\Suna's a good guy!\Don't worry... I'm a man.\I won't make you uncomfortable by confessing my feelings to you! response:	This is how it should be.
context: Yamato...\You can't do much about how people feel, but...\Take it from someone who's known him since we were three years old.\You have my guarantee!\Suna's a good guy!\Don't worry... I'm a man.\I won't make you uncomfortable by confessing my feelings to you!\This is how it should be. response:	They'd make a great couple.
context: You can't do much about how people feel, but...\Take it from someone who's known him since we were three years old.\You have my guarantee!\Suna's a good guy!\Don't worry... I'm a man.\I won't make you uncomfortable by confessing my feelings to you!\This is how it should be.\They'd make a great couple. response:	She thanked me.
context: Take it from someone who's known him since we were three years old.\You have my guarantee!\Suna's a good guy!\Don't worry... I'm a man.\I won't make you uncomfortable by confessing my feelings to you!\This is how it should be.\They'd make a great couple.\She thanked me. response:	She lifted the beam with me.
context: You have my guarantee!\Suna's a good guy!\Don't worry... I'm a man.\I won't make you uncomfortable by confessing my feelings to you!\This is how it should be.\They'd make a great couple.\She thanked me.\She lifted the beam with me. response:	And sometimes, I get to eat tasty cake like this.
context: Suna's a good guy!\Don't worry... I'm a man.\I won't make you uncomfortable by confessing my feelings to you!\This is how it should be.\They'd make a great couple.\She thanked me.\She lifted the beam with me.\And sometimes, I get to eat tasty cake like this. response:	That's enough for me.
context: Don't worry... I'm a man.\I won't make you uncomfortable by confessing my feelings to you!\This is how it should be.\They'd make a great couple.\She thanked me.\She lifted the beam with me.\And sometimes, I get to eat tasty cake like this.\That's enough for me. response:	In the end, I'm the Red Ogre.
context: I won't make you uncomfortable by confessing my feelings to you!\This is how it should be.\They'd make a great couple.\She thanked me.\She lifted the beam with me.\And sometimes, I get to eat tasty cake like this.\That's enough for me.\In the end, I'm the Red Ogre. response:	So I can't be like the Blue Ogre, but...
context: This is how it should be.\They'd make a great couple.\She thanked me.\She lifted the beam with me.\And sometimes, I get to eat tasty cake like this.\That's enough for me.\In the end, I'm the Red Ogre.\So I can't be like the Blue Ogre, but... response:	I do want the people I care for to smile.
context: They'd make a great couple.\She thanked me.\She lifted the beam with me.\And sometimes, I get to eat tasty cake like this.\That's enough for me.\In the end, I'm the Red Ogre.\So I can't be like the Blue Ogre, but...\I do want the people I care for to smile. response:	I want them to be happy.
context: She thanked me.\She lifted the beam with me.\And sometimes, I get to eat tasty cake like this.\That's enough for me.\In the end, I'm the Red Ogre.\So I can't be like the Blue Ogre, but...\I do want the people I care for to smile.\I want them to be happy. response:	Yamato, Suna's...
context: She lifted the beam with me.\And sometimes, I get to eat tasty cake like this.\That's enough for me.\In the end, I'm the Red Ogre.\So I can't be like the Blue Ogre, but...\I do want the people I care for to smile.\I want them to be happy.\Yamato, Suna's... response:	Yamato?
context: And sometimes, I get to eat tasty cake like this.\That's enough for me.\In the end, I'm the Red Ogre.\So I can't be like the Blue Ogre, but...\I do want the people I care for to smile.\I want them to be happy.\Yamato, Suna's...\Yamato? response:	Sorry...
context: That's enough for me.\In the end, I'm the Red Ogre.\So I can't be like the Blue Ogre, but...\I do want the people I care for to smile.\I want them to be happy.\Yamato, Suna's...\Yamato?\Sorry... response:	Something got into my eye...
context: In the end, I'm the Red Ogre.\So I can't be like the Blue Ogre, but...\I do want the people I care for to smile.\I want them to be happy.\Yamato, Suna's...\Yamato?\Sorry...\Something got into my eye... response:	Uh-oh, I guess my contacts shifted...
context: So I can't be like the Blue Ogre, but...\I do want the people I care for to smile.\I want them to be happy.\Yamato, Suna's...\Yamato?\Sorry...\Something got into my eye...\Uh-oh, I guess my contacts shifted... response:	Sorry, I have to go!
context: I do want the people I care for to smile.\I want them to be happy.\Yamato, Suna's...\Yamato?\Sorry...\Something got into my eye...\Uh-oh, I guess my contacts shifted...\Sorry, I have to go! response:	Sorry!
context: I want them to be happy.\Yamato, Suna's...\Yamato?\Sorry...\Something got into my eye...\Uh-oh, I guess my contacts shifted...\Sorry, I have to go!\Sorry! response:	What was that?
context: Yamato, Suna's...\Yamato?\Sorry...\Something got into my eye...\Uh-oh, I guess my contacts shifted...\Sorry, I have to go!\Sorry!\What was that? response:	Why was she crying?!
context: Yamato?\Sorry...\Something got into my eye...\Uh-oh, I guess my contacts shifted...\Sorry, I have to go!\Sorry!\What was that?\Why was she crying?! response:	Did you do something to Yamato?
context: Sorry...\Something got into my eye...\Uh-oh, I guess my contacts shifted...\Sorry, I have to go!\Sorry!\What was that?\Why was she crying?!\Did you do something to Yamato? response:	Nothing.
context: Something got into my eye...\Uh-oh, I guess my contacts shifted...\Sorry, I have to go!\Sorry!\What was that?\Why was she crying?!\Did you do something to Yamato?\Nothing. response:	Nothing?!
context: Uh-oh, I guess my contacts shifted...\Sorry, I have to go!\Sorry!\What was that?\Why was she crying?!\Did you do something to Yamato?\Nothing.\Nothing?! response:	Today, you aren't even going to say, I'm coming in?
context: Sorry, I have to go!\Sorry!\What was that?\Why was she crying?!\Did you do something to Yamato?\Nothing.\Nothing?!\Today, you aren't even going to say, I'm coming in? response:	Then why did Yamato cry when I told her about you?!
context: Sorry!\What was that?\Why was she crying?!\Did you do something to Yamato?\Nothing.\Nothing?!\Today, you aren't even going to say, I'm coming in?\Then why did Yamato cry when I told her about you?! response:	She cried?
context: What was that?\Why was she crying?!\Did you do something to Yamato?\Nothing.\Nothing?!\Today, you aren't even going to say, I'm coming in?\Then why did Yamato cry when I told her about you?!\She cried? response:	It's because she likes you,
context: Why was she crying?!\Did you do something to Yamato?\Nothing.\Nothing?!\Today, you aren't even going to say, I'm coming in?\Then why did Yamato cry when I told her about you?!\She cried?\It's because she likes you, response:	you idiot!
context: Did you do something to Yamato?\Nothing.\Nothing?!\Today, you aren't even going to say, I'm coming in?\Then why did Yamato cry when I told her about you?!\She cried?\It's because she likes you,\you idiot! response:	Dude, way too close.
context: Nothing.\Nothing?!\Today, you aren't even going to say, I'm coming in?\Then why did Yamato cry when I told her about you?!\She cried?\It's because she likes you,\you idiot!\Dude, way too close. response:	Actually, you're the idiot.
context: Nothing?!\Today, you aren't even going to say, I'm coming in?\Then why did Yamato cry when I told her about you?!\She cried?\It's because she likes you,\you idiot!\Dude, way too close.\Actually, you're the idiot. response:	What?
context: Today, you aren't even going to say, I'm coming in?\Then why did Yamato cry when I told her about you?!\She cried?\It's because she likes you,\you idiot!\Dude, way too close.\Actually, you're the idiot.\What? response:	It's because Yamato-san likes you.
context: Then why did Yamato cry when I told her about you?!\She cried?\It's because she likes you,\you idiot!\Dude, way too close.\Actually, you're the idiot.\What?\It's because Yamato-san likes you. response:	Don't mess with me! She likes you!
context: She cried?\It's because she likes you,\you idiot!\Dude, way too close.\Actually, you're the idiot.\What?\It's because Yamato-san likes you.\Don't mess with me! She likes you! response:	No, it's you.
context: It's because she likes you,\you idiot!\Dude, way too close.\Actually, you're the idiot.\What?\It's because Yamato-san likes you.\Don't mess with me! She likes you!\No, it's you. response:	No, you!
context: you idiot!\Dude, way too close.\Actually, you're the idiot.\What?\It's because Yamato-san likes you.\Don't mess with me! She likes you!\No, it's you.\No, you! response:	Why?
context: Dude, way too close.\Actually, you're the idiot.\What?\It's because Yamato-san likes you.\Don't mess with me! She likes you!\No, it's you.\No, you!\Why? response:	Because you're cool!
context: Actually, you're the idiot.\What?\It's because Yamato-san likes you.\Don't mess with me! She likes you!\No, it's you.\No, you!\Why?\Because you're cool! response:	Suna, you're cool!
context: What?\It's because Yamato-san likes you.\Don't mess with me! She likes you!\No, it's you.\No, you!\Why?\Because you're cool!\Suna, you're cool! response:	Thanks, I guess.
context: It's because Yamato-san likes you.\Don't mess with me! She likes you!\No, it's you.\No, you!\Why?\Because you're cool!\Suna, you're cool!\Thanks, I guess. response:	Don't worry. You're cool, too.
context: Don't mess with me! She likes you!\No, it's you.\No, you!\Why?\Because you're cool!\Suna, you're cool!\Thanks, I guess.\Don't worry. You're cool, too. response:	Yamato-san said you were cool, also.
context: No, it's you.\No, you!\Why?\Because you're cool!\Suna, you're cool!\Thanks, I guess.\Don't worry. You're cool, too.\Yamato-san said you were cool, also. response:	What?
context: No, you!\Why?\Because you're cool!\Suna, you're cool!\Thanks, I guess.\Don't worry. You're cool, too.\Yamato-san said you were cool, also.\What? response:	This is getting really tiresome. Can I just tell you everything?
context: Why?\Because you're cool!\Suna, you're cool!\Thanks, I guess.\Don't worry. You're cool, too.\Yamato-san said you were cool, also.\What?\This is getting really tiresome. Can I just tell you everything? response:	When we met Yamato-san in the park to return her phone,
context: Because you're cool!\Suna, you're cool!\Thanks, I guess.\Don't worry. You're cool, too.\Yamato-san said you were cool, also.\What?\This is getting really tiresome. Can I just tell you everything?\When we met Yamato-san in the park to return her phone, response:	you vanished into the restroom at some point, remember?
context: Suna, you're cool!\Thanks, I guess.\Don't worry. You're cool, too.\Yamato-san said you were cool, also.\What?\This is getting really tiresome. Can I just tell you everything?\When we met Yamato-san in the park to return her phone,\you vanished into the restroom at some point, remember? response:	At that point, she'd told me a lot of things.
context: Thanks, I guess.\Don't worry. You're cool, too.\Yamato-san said you were cool, also.\What?\This is getting really tiresome. Can I just tell you everything?\When we met Yamato-san in the park to return her phone,\you vanished into the restroom at some point, remember?\At that point, she'd told me a lot of things. response:	Um...
context: Don't worry. You're cool, too.\Yamato-san said you were cool, also.\What?\This is getting really tiresome. Can I just tell you everything?\When we met Yamato-san in the park to return her phone,\you vanished into the restroom at some point, remember?\At that point, she'd told me a lot of things.\Um... response:	Does he have friends?
context: Yamato-san said you were cool, also.\What?\This is getting really tiresome. Can I just tell you everything?\When we met Yamato-san in the park to return her phone,\you vanished into the restroom at some point, remember?\At that point, she'd told me a lot of things.\Um...\Does he have friends? response:	A girlfriend, maybe?
context: What?\This is getting really tiresome. Can I just tell you everything?\When we met Yamato-san in the park to return her phone,\you vanished into the restroom at some point, remember?\At that point, she'd told me a lot of things.\Um...\Does he have friends?\A girlfriend, maybe? response:	Of course he does.
context: This is getting really tiresome. Can I just tell you everything?\When we met Yamato-san in the park to return her phone,\you vanished into the restroom at some point, remember?\At that point, she'd told me a lot of things.\Um...\Does he have friends?\A girlfriend, maybe?\Of course he does. response:	He's so cool!
context: When we met Yamato-san in the park to return her phone,\you vanished into the restroom at some point, remember?\At that point, she'd told me a lot of things.\Um...\Does he have friends?\A girlfriend, maybe?\Of course he does.\He's so cool! response:	Nope.
context: you vanished into the restroom at some point, remember?\At that point, she'd told me a lot of things.\Um...\Does he have friends?\A girlfriend, maybe?\Of course he does.\He's so cool!\Nope. response:	Really?
context: At that point, she'd told me a lot of things.\Um...\Does he have friends?\A girlfriend, maybe?\Of course he does.\He's so cool!\Nope.\Really? response:	Really.
context: Um...\Does he have friends?\A girlfriend, maybe?\Of course he does.\He's so cool!\Nope.\Really?\Really. response:	No way! Really?
context: Does he have friends?\A girlfriend, maybe?\Of course he does.\He's so cool!\Nope.\Really?\Really.\No way! Really? response:	He isn't the type who could hide that sort of thing.
context: A girlfriend, maybe?\Of course he does.\He's so cool!\Nope.\Really?\Really.\No way! Really?\He isn't the type who could hide that sort of thing. response:	Then I can like him?
context: Of course he does.\He's so cool!\Nope.\Really?\Really.\No way! Really?\He isn't the type who could hide that sort of thing.\Then I can like him? response:	I can't help myself, you know?
context: He's so cool!\Nope.\Really?\Really.\No way! Really?\He isn't the type who could hide that sort of thing.\Then I can like him?\I can't help myself, you know? response:	He was so cool yesterday!
context: Nope.\Really?\Really.\No way! Really?\He isn't the type who could hide that sort of thing.\Then I can like him?\I can't help myself, you know?\He was so cool yesterday! response:	You can't help but fall for that.
context: Really?\Really.\No way! Really?\He isn't the type who could hide that sort of thing.\Then I can like him?\I can't help myself, you know?\He was so cool yesterday!\You can't help but fall for that. response:	Fall for you?
context: Really.\No way! Really?\He isn't the type who could hide that sort of thing.\Then I can like him?\I can't help myself, you know?\He was so cool yesterday!\You can't help but fall for that.\Fall for you? response:	Dude, are you even listening?
context: No way! Really?\He isn't the type who could hide that sort of thing.\Then I can like him?\I can't help myself, you know?\He was so cool yesterday!\You can't help but fall for that.\Fall for you?\Dude, are you even listening? response:	But that time in my room, she didn't want you to leave!
context: He isn't the type who could hide that sort of thing.\Then I can like him?\I can't help myself, you know?\He was so cool yesterday!\You can't help but fall for that.\Fall for you?\Dude, are you even listening?\But that time in my room, she didn't want you to leave! response:	Really?
context: Then I can like him?\I can't help myself, you know?\He was so cool yesterday!\You can't help but fall for that.\Fall for you?\Dude, are you even listening?\But that time in my room, she didn't want you to leave!\Really? response:	Really.
context: I can't help myself, you know?\He was so cool yesterday!\You can't help but fall for that.\Fall for you?\Dude, are you even listening?\But that time in my room, she didn't want you to leave!\Really?\Really. response:	I'll get going.
context: He was so cool yesterday!\You can't help but fall for that.\Fall for you?\Dude, are you even listening?\But that time in my room, she didn't want you to leave!\Really?\Really.\I'll get going. response:	Huh?
context: You can't help but fall for that.\Fall for you?\Dude, are you even listening?\But that time in my room, she didn't want you to leave!\Really?\Really.\I'll get going.\Huh? response:	You're leaving?!
context: Fall for you?\Dude, are you even listening?\But that time in my room, she didn't want you to leave!\Really?\Really.\I'll get going.\Huh?\You're leaving?! response:	Her face totally said she wanted to spend more time with you!
context: Dude, are you even listening?\But that time in my room, she didn't want you to leave!\Really?\Really.\I'll get going.\Huh?\You're leaving?!\Her face totally said she wanted to spend more time with you! response:	She probably didn't want me to go
context: But that time in my room, she didn't want you to leave!\Really?\Really.\I'll get going.\Huh?\You're leaving?!\Her face totally said she wanted to spend more time with you!\She probably didn't want me to go response:	because she'd be too nervous if she were alone with you.
context: Really?\Really.\I'll get going.\Huh?\You're leaving?!\Her face totally said she wanted to spend more time with you!\She probably didn't want me to go\because she'd be too nervous if she were alone with you. response:	She's always looking at you!
context: Really.\I'll get going.\Huh?\You're leaving?!\Her face totally said she wanted to spend more time with you!\She probably didn't want me to go\because she'd be too nervous if she were alone with you.\She's always looking at you! response:	You're always staring at her. Of course she can't look you in the eye.
context: I'll get going.\Huh?\You're leaving?!\Her face totally said she wanted to spend more time with you!\She probably didn't want me to go\because she'd be too nervous if she were alone with you.\She's always looking at you!\You're always staring at her. Of course she can't look you in the eye. response:	Think back harder...
context: Huh?\You're leaving?!\Her face totally said she wanted to spend more time with you!\She probably didn't want me to go\because she'd be too nervous if she were alone with you.\She's always looking at you!\You're always staring at her. Of course she can't look you in the eye.\Think back harder... response:	I'd like for you to develop a better eye for people.
context: You're leaving?!\Her face totally said she wanted to spend more time with you!\She probably didn't want me to go\because she'd be too nervous if she were alone with you.\She's always looking at you!\You're always staring at her. Of course she can't look you in the eye.\Think back harder...\I'd like for you to develop a better eye for people. response:	She likes me?
context: Her face totally said she wanted to spend more time with you!\She probably didn't want me to go\because she'd be too nervous if she were alone with you.\She's always looking at you!\You're always staring at her. Of course she can't look you in the eye.\Think back harder...\I'd like for you to develop a better eye for people.\She likes me? response:	Yamato likes me?
context: She probably didn't want me to go\because she'd be too nervous if she were alone with you.\She's always looking at you!\You're always staring at her. Of course she can't look you in the eye.\Think back harder...\I'd like for you to develop a better eye for people.\She likes me?\Yamato likes me? response:	No way. It can't be true.
context: because she'd be too nervous if she were alone with you.\She's always looking at you!\You're always staring at her. Of course she can't look you in the eye.\Think back harder...\I'd like for you to develop a better eye for people.\She likes me?\Yamato likes me?\No way. It can't be true. response:	You said Yamato's a nice girl, right?
context: She's always looking at you!\You're always staring at her. Of course she can't look you in the eye.\Think back harder...\I'd like for you to develop a better eye for people.\She likes me?\Yamato likes me?\No way. It can't be true.\You said Yamato's a nice girl, right? response:	You don't like her?
context: You're always staring at her. Of course she can't look you in the eye.\Think back harder...\I'd like for you to develop a better eye for people.\She likes me?\Yamato likes me?\No way. It can't be true.\You said Yamato's a nice girl, right?\You don't like her? response:	She is a nice girl.
context: Think back harder...\I'd like for you to develop a better eye for people.\She likes me?\Yamato likes me?\No way. It can't be true.\You said Yamato's a nice girl, right?\You don't like her?\She is a nice girl. response:	When I'm with her, she only talks about how she likes you.
context: I'd like for you to develop a better eye for people.\She likes me?\Yamato likes me?\No way. It can't be true.\You said Yamato's a nice girl, right?\You don't like her?\She is a nice girl.\When I'm with her, she only talks about how she likes you. response:	Till now, you've had poor taste in girls.
context: She likes me?\Yamato likes me?\No way. It can't be true.\You said Yamato's a nice girl, right?\You don't like her?\She is a nice girl.\When I'm with her, she only talks about how she likes you.\Till now, you've had poor taste in girls. response:	All the girls you liked talked smack about you behind your back.
context: Yamato likes me?\No way. It can't be true.\You said Yamato's a nice girl, right?\You don't like her?\She is a nice girl.\When I'm with her, she only talks about how she likes you.\Till now, you've had poor taste in girls.\All the girls you liked talked smack about you behind your back. response:	I think Gouda likes you!
context: No way. It can't be true.\You said Yamato's a nice girl, right?\You don't like her?\She is a nice girl.\When I'm with her, she only talks about how she likes you.\Till now, you've had poor taste in girls.\All the girls you liked talked smack about you behind your back.\I think Gouda likes you! response:	Ew, creepy...
context: You said Yamato's a nice girl, right?\You don't like her?\She is a nice girl.\When I'm with her, she only talks about how she likes you.\Till now, you've had poor taste in girls.\All the girls you liked talked smack about you behind your back.\I think Gouda likes you!\Ew, creepy... response:	His face is huge.
context: You don't like her?\She is a nice girl.\When I'm with her, she only talks about how she likes you.\Till now, you've had poor taste in girls.\All the girls you liked talked smack about you behind your back.\I think Gouda likes you!\Ew, creepy...\His face is huge. response:	Way too huge.
context: She is a nice girl.\When I'm with her, she only talks about how she likes you.\Till now, you've had poor taste in girls.\All the girls you liked talked smack about you behind your back.\I think Gouda likes you!\Ew, creepy...\His face is huge.\Way too huge. response:	He's loud and annoying.
context: When I'm with her, she only talks about how she likes you.\Till now, you've had poor taste in girls.\All the girls you liked talked smack about you behind your back.\I think Gouda likes you!\Ew, creepy...\His face is huge.\Way too huge.\He's loud and annoying. response:	But he's always looking at you, Satou.
context: Till now, you've had poor taste in girls.\All the girls you liked talked smack about you behind your back.\I think Gouda likes you!\Ew, creepy...\His face is huge.\Way too huge.\He's loud and annoying.\But he's always looking at you, Satou. response:	That's seriously creepy!
context: All the girls you liked talked smack about you behind your back.\I think Gouda likes you!\Ew, creepy...\His face is huge.\Way too huge.\He's loud and annoying.\But he's always looking at you, Satou.\That's seriously creepy! response:	You should seriously have better taste in girls.
context: I think Gouda likes you!\Ew, creepy...\His face is huge.\Way too huge.\He's loud and annoying.\But he's always looking at you, Satou.\That's seriously creepy!\You should seriously have better taste in girls. response:	Really?
context: Ew, creepy...\His face is huge.\Way too huge.\He's loud and annoying.\But he's always looking at you, Satou.\That's seriously creepy!\You should seriously have better taste in girls.\Really? response:	Who'd want to date girls that talk smack about your friends?
context: His face is huge.\Way too huge.\He's loud and annoying.\But he's always looking at you, Satou.\That's seriously creepy!\You should seriously have better taste in girls.\Really?\Who'd want to date girls that talk smack about your friends? response:	So that's why you...
context: Way too huge.\He's loud and annoying.\But he's always looking at you, Satou.\That's seriously creepy!\You should seriously have better taste in girls.\Really?\Who'd want to date girls that talk smack about your friends?\So that's why you... response:	You always turned them down when they told you how they felt about you.
context: He's loud and annoying.\But he's always looking at you, Satou.\That's seriously creepy!\You should seriously have better taste in girls.\Really?\Who'd want to date girls that talk smack about your friends?\So that's why you...\You always turned them down when they told you how they felt about you. response:	Suna, you're the manliest of men!
context: But he's always looking at you, Satou.\That's seriously creepy!\You should seriously have better taste in girls.\Really?\Who'd want to date girls that talk smack about your friends?\So that's why you...\You always turned them down when they told you how they felt about you.\Suna, you're the manliest of men! response:	I'm sorry I said you didn't have a pair!
context: That's seriously creepy!\You should seriously have better taste in girls.\Really?\Who'd want to date girls that talk smack about your friends?\So that's why you...\You always turned them down when they told you how they felt about you.\Suna, you're the manliest of men!\I'm sorry I said you didn't have a pair! response:	You definitely have a pair!
context: You should seriously have better taste in girls.\Really?\Who'd want to date girls that talk smack about your friends?\So that's why you...\You always turned them down when they told you how they felt about you.\Suna, you're the manliest of men!\I'm sorry I said you didn't have a pair!\You definitely have a pair! response:	Yeah, yeah. I do.
context: Really?\Who'd want to date girls that talk smack about your friends?\So that's why you...\You always turned them down when they told you how they felt about you.\Suna, you're the manliest of men!\I'm sorry I said you didn't have a pair!\You definitely have a pair!\Yeah, yeah. I do. response:	But I still can't believe that Yamato likes me.
context: Who'd want to date girls that talk smack about your friends?\So that's why you...\You always turned them down when they told you how they felt about you.\Suna, you're the manliest of men!\I'm sorry I said you didn't have a pair!\You definitely have a pair!\Yeah, yeah. I do.\But I still can't believe that Yamato likes me. response:	Well, I guess you might find it hard unless you hear her say it for yourself.
context: So that's why you...\You always turned them down when they told you how they felt about you.\Suna, you're the manliest of men!\I'm sorry I said you didn't have a pair!\You definitely have a pair!\Yeah, yeah. I do.\But I still can't believe that Yamato likes me.\Well, I guess you might find it hard unless you hear her say it for yourself. response:	May I come in?
context: You always turned them down when they told you how they felt about you.\Suna, you're the manliest of men!\I'm sorry I said you didn't have a pair!\You definitely have a pair!\Yeah, yeah. I do.\But I still can't believe that Yamato likes me.\Well, I guess you might find it hard unless you hear her say it for yourself.\May I come in? response:	What's up?
context: Suna, you're the manliest of men!\I'm sorry I said you didn't have a pair!\You definitely have a pair!\Yeah, yeah. I do.\But I still can't believe that Yamato likes me.\Well, I guess you might find it hard unless you hear her say it for yourself.\May I come in?\What's up? response:	Someone named Yamato-san's here.
context: I'm sorry I said you didn't have a pair!\You definitely have a pair!\Yeah, yeah. I do.\But I still can't believe that Yamato likes me.\Well, I guess you might find it hard unless you hear her say it for yourself.\May I come in?\What's up?\Someone named Yamato-san's here. response:	Hide!
context: You definitely have a pair!\Yeah, yeah. I do.\But I still can't believe that Yamato likes me.\Well, I guess you might find it hard unless you hear her say it for yourself.\May I come in?\What's up?\Someone named Yamato-san's here.\Hide! response:	Where?
context: Yeah, yeah. I do.\But I still can't believe that Yamato likes me.\Well, I guess you might find it hard unless you hear her say it for yourself.\May I come in?\What's up?\Someone named Yamato-san's here.\Hide!\Where? response:	Man, you're huge.
context: But I still can't believe that Yamato likes me.\Well, I guess you might find it hard unless you hear her say it for yourself.\May I come in?\What's up?\Someone named Yamato-san's here.\Hide!\Where?\Man, you're huge. response:	Thank you.
context: Well, I guess you might find it hard unless you hear her say it for yourself.\May I come in?\What's up?\Someone named Yamato-san's here.\Hide!\Where?\Man, you're huge.\Thank you. response:	Hello.
context: May I come in?\What's up?\Someone named Yamato-san's here.\Hide!\Where?\Man, you're huge.\Thank you.\Hello. response:	Hi.
context: What's up?\Someone named Yamato-san's here.\Hide!\Where?\Man, you're huge.\Thank you.\Hello.\Hi. response:	I'm sorry I came without any notice.
context: Someone named Yamato-san's here.\Hide!\Where?\Man, you're huge.\Thank you.\Hello.\Hi.\I'm sorry I came without any notice. response:	Why don't you take a seat?
context: Hide!\Where?\Man, you're huge.\Thank you.\Hello.\Hi.\I'm sorry I came without any notice.\Why don't you take a seat? response:	Oh, okay.
context: Where?\Man, you're huge.\Thank you.\Hello.\Hi.\I'm sorry I came without any notice.\Why don't you take a seat?\Oh, okay. response:	Sunakawa-kun, I...
context: Man, you're huge.\Thank you.\Hello.\Hi.\I'm sorry I came without any notice.\Why don't you take a seat?\Oh, okay.\Sunakawa-kun, I... response:	I cried in front of Takeo-kun!
context: Thank you.\Hello.\Hi.\I'm sorry I came without any notice.\Why don't you take a seat?\Oh, okay.\Sunakawa-kun, I...\I cried in front of Takeo-kun! response:	What should I do?
context: Hello.\Hi.\I'm sorry I came without any notice.\Why don't you take a seat?\Oh, okay.\Sunakawa-kun, I...\I cried in front of Takeo-kun!\What should I do? response:	How can I explain it away?
context: Hi.\I'm sorry I came without any notice.\Why don't you take a seat?\Oh, okay.\Sunakawa-kun, I...\I cried in front of Takeo-kun!\What should I do?\How can I explain it away? response:	Takeo-kun looked really uncomfortable.
context: I'm sorry I came without any notice.\Why don't you take a seat?\Oh, okay.\Sunakawa-kun, I...\I cried in front of Takeo-kun!\What should I do?\How can I explain it away?\Takeo-kun looked really uncomfortable. response:	What should I do?
context: Why don't you take a seat?\Oh, okay.\Sunakawa-kun, I...\I cried in front of Takeo-kun!\What should I do?\How can I explain it away?\Takeo-kun looked really uncomfortable.\What should I do? response:	Why did you cry?
context: Oh, okay.\Sunakawa-kun, I...\I cried in front of Takeo-kun!\What should I do?\How can I explain it away?\Takeo-kun looked really uncomfortable.\What should I do?\Why did you cry? response:	Takeo-kun's always suggesting you...
context: Sunakawa-kun, I...\I cried in front of Takeo-kun!\What should I do?\How can I explain it away?\Takeo-kun looked really uncomfortable.\What should I do?\Why did you cry?\Takeo-kun's always suggesting you... response:	He's always talking about you...
context: I cried in front of Takeo-kun!\What should I do?\How can I explain it away?\Takeo-kun looked really uncomfortable.\What should I do?\Why did you cry?\Takeo-kun's always suggesting you...\He's always talking about you... response:	I thought he was turning me down in a roundabout way,
context: What should I do?\How can I explain it away?\Takeo-kun looked really uncomfortable.\What should I do?\Why did you cry?\Takeo-kun's always suggesting you...\He's always talking about you...\I thought he was turning me down in a roundabout way, response:	and that just got tough.
context: How can I explain it away?\Takeo-kun looked really uncomfortable.\What should I do?\Why did you cry?\Takeo-kun's always suggesting you...\He's always talking about you...\I thought he was turning me down in a roundabout way,\and that just got tough. response:	Then what are you going to do?
context: Takeo-kun looked really uncomfortable.\What should I do?\Why did you cry?\Takeo-kun's always suggesting you...\He's always talking about you...\I thought he was turning me down in a roundabout way,\and that just got tough.\Then what are you going to do? response:	Give up?
context: What should I do?\Why did you cry?\Takeo-kun's always suggesting you...\He's always talking about you...\I thought he was turning me down in a roundabout way,\and that just got tough.\Then what are you going to do?\Give up? response:	I don't want to.
context: Why did you cry?\Takeo-kun's always suggesting you...\He's always talking about you...\I thought he was turning me down in a roundabout way,\and that just got tough.\Then what are you going to do?\Give up?\I don't want to. response:	I'll keep trying!
context: Takeo-kun's always suggesting you...\He's always talking about you...\I thought he was turning me down in a roundabout way,\and that just got tough.\Then what are you going to do?\Give up?\I don't want to.\I'll keep trying! response:	I don't think I'll meet anyone else like Takeo-kun.
context: He's always talking about you...\I thought he was turning me down in a roundabout way,\and that just got tough.\Then what are you going to do?\Give up?\I don't want to.\I'll keep trying!\I don't think I'll meet anyone else like Takeo-kun. response:	Well, you may be right there.
context: I thought he was turning me down in a roundabout way,\and that just got tough.\Then what are you going to do?\Give up?\I don't want to.\I'll keep trying!\I don't think I'll meet anyone else like Takeo-kun.\Well, you may be right there. response:	I really, really like him!
context: and that just got tough.\Then what are you going to do?\Give up?\I don't want to.\I'll keep trying!\I don't think I'll meet anyone else like Takeo-kun.\Well, you may be right there.\I really, really like him! response:	Okay, say that again.
context: Then what are you going to do?\Give up?\I don't want to.\I'll keep trying!\I don't think I'll meet anyone else like Takeo-kun.\Well, you may be right there.\I really, really like him!\Okay, say that again. response:	Say that again, please.
context: Give up?\I don't want to.\I'll keep trying!\I don't think I'll meet anyone else like Takeo-kun.\Well, you may be right there.\I really, really like him!\Okay, say that again.\Say that again, please. response:	I like him!
context: I don't want to.\I'll keep trying!\I don't think I'll meet anyone else like Takeo-kun.\Well, you may be right there.\I really, really like him!\Okay, say that again.\Say that again, please.\I like him! response:	Like who?
context: I'll keep trying!\I don't think I'll meet anyone else like Takeo-kun.\Well, you may be right there.\I really, really like him!\Okay, say that again.\Say that again, please.\I like him!\Like who? response:	I like Takeo-kun!
context: I don't think I'll meet anyone else like Takeo-kun.\Well, you may be right there.\I really, really like him!\Okay, say that again.\Say that again, please.\I like him!\Like who?\I like Takeo-kun! response:	Say it one last time, so the point gets across.
context: Well, you may be right there.\I really, really like him!\Okay, say that again.\Say that again, please.\I like him!\Like who?\I like Takeo-kun!\Say it one last time, so the point gets across. response:	I really like Takeo-kun!
context: I really, really like him!\Okay, say that again.\Say that again, please.\I like him!\Like who?\I like Takeo-kun!\Say it one last time, so the point gets across.\I really like Takeo-kun! response:	Just to be sure, say it one more time.
context: Okay, say that again.\Say that again, please.\I like him!\Like who?\I like Takeo-kun!\Say it one last time, so the point gets across.\I really like Takeo-kun!\Just to be sure, say it one more time. response:	I like Takeo-kun!
context: Say that again, please.\I like him!\Like who?\I like Takeo-kun!\Say it one last time, so the point gets across.\I really like Takeo-kun!\Just to be sure, say it one more time.\I like Takeo-kun! response:	Got it?
context: I like him!\Like who?\I like Takeo-kun!\Say it one last time, so the point gets across.\I really like Takeo-kun!\Just to be sure, say it one more time.\I like Takeo-kun!\Got it? response:	Huh?
context: Like who?\I like Takeo-kun!\Say it one last time, so the point gets across.\I really like Takeo-kun!\Just to be sure, say it one more time.\I like Takeo-kun!\Got it?\Huh? response:	Come on, you tell her, too.
context: I like Takeo-kun!\Say it one last time, so the point gets across.\I really like Takeo-kun!\Just to be sure, say it one more time.\I like Takeo-kun!\Got it?\Huh?\Come on, you tell her, too. response:	What?
context: Say it one last time, so the point gets across.\I really like Takeo-kun!\Just to be sure, say it one more time.\I like Takeo-kun!\Got it?\Huh?\Come on, you tell her, too.\What? response:	Come out.
context: I really like Takeo-kun!\Just to be sure, say it one more time.\I like Takeo-kun!\Got it?\Huh?\Come on, you tell her, too.\What?\Come out. response:	Eh? Huh?
context: Just to be sure, say it one more time.\I like Takeo-kun!\Got it?\Huh?\Come on, you tell her, too.\What?\Come out.\Eh? Huh? response:	How?
context: I like Takeo-kun!\Got it?\Huh?\Come on, you tell her, too.\What?\Come out.\Eh? Huh?\How? response:	This is mean!
context: Got it?\Huh?\Come on, you tell her, too.\What?\Come out.\Eh? Huh?\How?\This is mean! response:	You manipulated me, Sunakawa-kun?
context: Huh?\Come on, you tell her, too.\What?\Come out.\Eh? Huh?\How?\This is mean!\You manipulated me, Sunakawa-kun? response:	He couldn't get it through his thick skull without hearing for himself.
context: Come on, you tell her, too.\What?\Come out.\Eh? Huh?\How?\This is mean!\You manipulated me, Sunakawa-kun?\He couldn't get it through his thick skull without hearing for himself. response:	I've liked you from the day we met!
context: What?\Come out.\Eh? Huh?\How?\This is mean!\You manipulated me, Sunakawa-kun?\He couldn't get it through his thick skull without hearing for himself.\I've liked you from the day we met! response:	I've liked you from the day we met!
context: Come out.\Eh? Huh?\How?\This is mean!\You manipulated me, Sunakawa-kun?\He couldn't get it through his thick skull without hearing for himself.\I've liked you from the day we met!\I've liked you from the day we met! response:	We Are Happy Thank You, Sunakawa-kun
context: Eh? Huh?\How?\This is mean!\You manipulated me, Sunakawa-kun?\He couldn't get it through his thick skull without hearing for himself.\I've liked you from the day we met!\I've liked you from the day we met!\We Are Happy Thank You, Sunakawa-kun response:	Uh...
context: How?\This is mean!\You manipulated me, Sunakawa-kun?\He couldn't get it through his thick skull without hearing for himself.\I've liked you from the day we met!\I've liked you from the day we met!\We Are Happy Thank You, Sunakawa-kun\Uh... response:	It's a sign of her gratitude.
context: This is mean!\You manipulated me, Sunakawa-kun?\He couldn't get it through his thick skull without hearing for himself.\I've liked you from the day we met!\I've liked you from the day we met!\We Are Happy Thank You, Sunakawa-kun\Uh...\It's a sign of her gratitude. response:	Sunakawa-kun, thank you! Thank you!
context: You manipulated me, Sunakawa-kun?\He couldn't get it through his thick skull without hearing for himself.\I've liked you from the day we met!\I've liked you from the day we met!\We Are Happy Thank You, Sunakawa-kun\Uh...\It's a sign of her gratitude.\Sunakawa-kun, thank you! Thank you! response:	Um, I have a friend who's really great.
context: He couldn't get it through his thick skull without hearing for himself.\I've liked you from the day we met!\I've liked you from the day we met!\We Are Happy Thank You, Sunakawa-kun\Uh...\It's a sign of her gratitude.\Sunakawa-kun, thank you! Thank you!\Um, I have a friend who's really great. response:	I have her pic here...
context: I've liked you from the day we met!\I've liked you from the day we met!\We Are Happy Thank You, Sunakawa-kun\Uh...\It's a sign of her gratitude.\Sunakawa-kun, thank you! Thank you!\Um, I have a friend who's really great.\I have her pic here... response:	You don't have to try to spread the love.
context: I've liked you from the day we met!\We Are Happy Thank You, Sunakawa-kun\Uh...\It's a sign of her gratitude.\Sunakawa-kun, thank you! Thank you!\Um, I have a friend who's really great.\I have her pic here...\You don't have to try to spread the love. response:	Stop!
context: We Are Happy Thank You, Sunakawa-kun\Uh...\It's a sign of her gratitude.\Sunakawa-kun, thank you! Thank you!\Um, I have a friend who's really great.\I have her pic here...\You don't have to try to spread the love.\Stop! response:	Suna,
context: Uh...\It's a sign of her gratitude.\Sunakawa-kun, thank you! Thank you!\Um, I have a friend who's really great.\I have her pic here...\You don't have to try to spread the love.\Stop!\Suna, response:	I see
context: It's a sign of her gratitude.\Sunakawa-kun, thank you! Thank you!\Um, I have a friend who's really great.\I have her pic here...\You don't have to try to spread the love.\Stop!\Suna,\I see response:	don't be so lonely.
context: Sunakawa-kun, thank you! Thank you!\Um, I have a friend who's really great.\I have her pic here...\You don't have to try to spread the love.\Stop!\Suna,\I see\don't be so lonely. response:	I'm not lonely.
context: Um, I have a friend who's really great.\I have her pic here...\You don't have to try to spread the love.\Stop!\Suna,\I see\don't be so lonely.\I'm not lonely. response:	Suna...
context: I have her pic here...\You don't have to try to spread the love.\Stop!\Suna,\I see\don't be so lonely.\I'm not lonely.\Suna... response:	I like seeing you happy.
context: You don't have to try to spread the love.\Stop!\Suna,\I see\don't be so lonely.\I'm not lonely.\Suna...\I like seeing you happy. response:	This cake looks like it has a fairy or something hiding inside...
context: Stop!\Suna,\I see\don't be so lonely.\I'm not lonely.\Suna...\I like seeing you happy.\This cake looks like it has a fairy or something hiding inside... response:	Suna, you really are like the Blue Ogre!
context: Suna,\I see\don't be so lonely.\I'm not lonely.\Suna...\I like seeing you happy.\This cake looks like it has a fairy or something hiding inside...\Suna, you really are like the Blue Ogre! response:	Where'd that come from?
context: I see\don't be so lonely.\I'm not lonely.\Suna...\I like seeing you happy.\This cake looks like it has a fairy or something hiding inside...\Suna, you really are like the Blue Ogre!\Where'd that come from? response:	Remember the kindergarten play?
context: don't be so lonely.\I'm not lonely.\Suna...\I like seeing you happy.\This cake looks like it has a fairy or something hiding inside...\Suna, you really are like the Blue Ogre!\Where'd that come from?\Remember the kindergarten play? response:	You were the Blue Ogre, and I was the Red Ogre.
context: I'm not lonely.\Suna...\I like seeing you happy.\This cake looks like it has a fairy or something hiding inside...\Suna, you really are like the Blue Ogre!\Where'd that come from?\Remember the kindergarten play?\You were the Blue Ogre, and I was the Red Ogre. response:	All the moms cried a river, watching you act out the two ogres' friendship!
context: Suna...\I like seeing you happy.\This cake looks like it has a fairy or something hiding inside...\Suna, you really are like the Blue Ogre!\Where'd that come from?\Remember the kindergarten play?\You were the Blue Ogre, and I was the Red Ogre.\All the moms cried a river, watching you act out the two ogres' friendship! response:	I don't remember any of that.
context: I like seeing you happy.\This cake looks like it has a fairy or something hiding inside...\Suna, you really are like the Blue Ogre!\Where'd that come from?\Remember the kindergarten play?\You were the Blue Ogre, and I was the Red Ogre.\All the moms cried a river, watching you act out the two ogres' friendship!\I don't remember any of that. response:	Well, I do!
context: This cake looks like it has a fairy or something hiding inside...\Suna, you really are like the Blue Ogre!\Where'd that come from?\Remember the kindergarten play?\You were the Blue Ogre, and I was the Red Ogre.\All the moms cried a river, watching you act out the two ogres' friendship!\I don't remember any of that.\Well, I do! response:	You mentioned that before.
context: Suna, you really are like the Blue Ogre!\Where'd that come from?\Remember the kindergarten play?\You were the Blue Ogre, and I was the Red Ogre.\All the moms cried a river, watching you act out the two ogres' friendship!\I don't remember any of that.\Well, I do!\You mentioned that before. response:	What's the story about?
context: Where'd that come from?\Remember the kindergarten play?\You were the Blue Ogre, and I was the Red Ogre.\All the moms cried a river, watching you act out the two ogres' friendship!\I don't remember any of that.\Well, I do!\You mentioned that before.\What's the story about? response:	Well...
context: Remember the kindergarten play?\You were the Blue Ogre, and I was the Red Ogre.\All the moms cried a river, watching you act out the two ogres' friendship!\I don't remember any of that.\Well, I do!\You mentioned that before.\What's the story about?\Well... response:	Once upon a time,
context: You were the Blue Ogre, and I was the Red Ogre.\All the moms cried a river, watching you act out the two ogres' friendship!\I don't remember any of that.\Well, I do!\You mentioned that before.\What's the story about?\Well...\Once upon a time, response:	The Red Ogre Who Cried
context: All the moms cried a river, watching you act out the two ogres' friendship!\I don't remember any of that.\Well, I do!\You mentioned that before.\What's the story about?\Well...\Once upon a time,\The Red Ogre Who Cried response:	a kind-hearted Red Ogre lived all by himself
context: I don't remember any of that.\Well, I do!\You mentioned that before.\What's the story about?\Well...\Once upon a time,\The Red Ogre Who Cried\a kind-hearted Red Ogre lived all by himself response:	in the mountains.
context: Well, I do!\You mentioned that before.\What's the story about?\Well...\Once upon a time,\The Red Ogre Who Cried\a kind-hearted Red Ogre lived all by himself\in the mountains. response:	The Red Ogre wanted to make friends with people,
context: You mentioned that before.\What's the story about?\Well...\Once upon a time,\The Red Ogre Who Cried\a kind-hearted Red Ogre lived all by himself\in the mountains.\The Red Ogre wanted to make friends with people, response:	but they were afraid of the ogre and kept their distance.
context: What's the story about?\Well...\Once upon a time,\The Red Ogre Who Cried\a kind-hearted Red Ogre lived all by himself\in the mountains.\The Red Ogre wanted to make friends with people,\but they were afraid of the ogre and kept their distance. response:	It made the Red Ogre sad.
context: Well...\Once upon a time,\The Red Ogre Who Cried\a kind-hearted Red Ogre lived all by himself\in the mountains.\The Red Ogre wanted to make friends with people,\but they were afraid of the ogre and kept their distance.\It made the Red Ogre sad. response:	But his friend, the Blue Ogre, tells him
context: Once upon a time,\The Red Ogre Who Cried\a kind-hearted Red Ogre lived all by himself\in the mountains.\The Red Ogre wanted to make friends with people,\but they were afraid of the ogre and kept their distance.\It made the Red Ogre sad.\But his friend, the Blue Ogre, tells him response:	that the Blue Ogre will go stir things up in the village,
context: The Red Ogre Who Cried\a kind-hearted Red Ogre lived all by himself\in the mountains.\The Red Ogre wanted to make friends with people,\but they were afraid of the ogre and kept their distance.\It made the Red Ogre sad.\But his friend, the Blue Ogre, tells him\that the Blue Ogre will go stir things up in the village, response:	and the Red Ogre should come beat him up.
context: a kind-hearted Red Ogre lived all by himself\in the mountains.\The Red Ogre wanted to make friends with people,\but they were afraid of the ogre and kept their distance.\It made the Red Ogre sad.\But his friend, the Blue Ogre, tells him\that the Blue Ogre will go stir things up in the village,\and the Red Ogre should come beat him up. response:	The Blue Ogre thought that'd change the people's opinion about the Red Ogre,
context: in the mountains.\The Red Ogre wanted to make friends with people,\but they were afraid of the ogre and kept their distance.\It made the Red Ogre sad.\But his friend, the Blue Ogre, tells him\that the Blue Ogre will go stir things up in the village,\and the Red Ogre should come beat him up.\The Blue Ogre thought that'd change the people's opinion about the Red Ogre, response:	and make them willing to be friends with him.
context: The Red Ogre wanted to make friends with people,\but they were afraid of the ogre and kept their distance.\It made the Red Ogre sad.\But his friend, the Blue Ogre, tells him\that the Blue Ogre will go stir things up in the village,\and the Red Ogre should come beat him up.\The Blue Ogre thought that'd change the people's opinion about the Red Ogre,\and make them willing to be friends with him. response:	The Blue Ogre went to the village,
context: but they were afraid of the ogre and kept their distance.\It made the Red Ogre sad.\But his friend, the Blue Ogre, tells him\that the Blue Ogre will go stir things up in the village,\and the Red Ogre should come beat him up.\The Blue Ogre thought that'd change the people's opinion about the Red Ogre,\and make them willing to be friends with him.\The Blue Ogre went to the village, response:	and went on a rampage, although he was careful not to hurt anyone.
context: It made the Red Ogre sad.\But his friend, the Blue Ogre, tells him\that the Blue Ogre will go stir things up in the village,\and the Red Ogre should come beat him up.\The Blue Ogre thought that'd change the people's opinion about the Red Ogre,\and make them willing to be friends with him.\The Blue Ogre went to the village,\and went on a rampage, although he was careful not to hurt anyone. response:	The Red Ogre pretended to beat the Blue Ogre.
context: But his friend, the Blue Ogre, tells him\that the Blue Ogre will go stir things up in the village,\and the Red Ogre should come beat him up.\The Blue Ogre thought that'd change the people's opinion about the Red Ogre,\and make them willing to be friends with him.\The Blue Ogre went to the village,\and went on a rampage, although he was careful not to hurt anyone.\The Red Ogre pretended to beat the Blue Ogre. response:	The Blue Ogre pretended to be defeated and fled.
context: that the Blue Ogre will go stir things up in the village,\and the Red Ogre should come beat him up.\The Blue Ogre thought that'd change the people's opinion about the Red Ogre,\and make them willing to be friends with him.\The Blue Ogre went to the village,\and went on a rampage, although he was careful not to hurt anyone.\The Red Ogre pretended to beat the Blue Ogre.\The Blue Ogre pretended to be defeated and fled. response:	Henceforth, the villagers trusted the Red Ogre
context: and the Red Ogre should come beat him up.\The Blue Ogre thought that'd change the people's opinion about the Red Ogre,\and make them willing to be friends with him.\The Blue Ogre went to the village,\and went on a rampage, although he was careful not to hurt anyone.\The Red Ogre pretended to beat the Blue Ogre.\The Blue Ogre pretended to be defeated and fled.\Henceforth, the villagers trusted the Red Ogre response:	and would come over to his place.
context: The Blue Ogre thought that'd change the people's opinion about the Red Ogre,\and make them willing to be friends with him.\The Blue Ogre went to the village,\and went on a rampage, although he was careful not to hurt anyone.\The Red Ogre pretended to beat the Blue Ogre.\The Blue Ogre pretended to be defeated and fled.\Henceforth, the villagers trusted the Red Ogre\and would come over to his place. response:	Now that he had human friends, the Red Ogre led a happy life.
context: and make them willing to be friends with him.\The Blue Ogre went to the village,\and went on a rampage, although he was careful not to hurt anyone.\The Red Ogre pretended to beat the Blue Ogre.\The Blue Ogre pretended to be defeated and fled.\Henceforth, the villagers trusted the Red Ogre\and would come over to his place.\Now that he had human friends, the Red Ogre led a happy life. response:	But one day, he became worried about the Blue Ogre, who'd stopped coming by,
context: The Blue Ogre went to the village,\and went on a rampage, although he was careful not to hurt anyone.\The Red Ogre pretended to beat the Blue Ogre.\The Blue Ogre pretended to be defeated and fled.\Henceforth, the villagers trusted the Red Ogre\and would come over to his place.\Now that he had human friends, the Red Ogre led a happy life.\But one day, he became worried about the Blue Ogre, who'd stopped coming by, response:	and he went to see him.
context: and went on a rampage, although he was careful not to hurt anyone.\The Red Ogre pretended to beat the Blue Ogre.\The Blue Ogre pretended to be defeated and fled.\Henceforth, the villagers trusted the Red Ogre\and would come over to his place.\Now that he had human friends, the Red Ogre led a happy life.\But one day, he became worried about the Blue Ogre, who'd stopped coming by,\and he went to see him. response:	The Red Ogre crossed entire mountains and valleys to reach the Blue Ogre's home.
context: The Red Ogre pretended to beat the Blue Ogre.\The Blue Ogre pretended to be defeated and fled.\Henceforth, the villagers trusted the Red Ogre\and would come over to his place.\Now that he had human friends, the Red Ogre led a happy life.\But one day, he became worried about the Blue Ogre, who'd stopped coming by,\and he went to see him.\The Red Ogre crossed entire mountains and valleys to reach the Blue Ogre's home. response:	But there,
context: The Blue Ogre pretended to be defeated and fled.\Henceforth, the villagers trusted the Red Ogre\and would come over to his place.\Now that he had human friends, the Red Ogre led a happy life.\But one day, he became worried about the Blue Ogre, who'd stopped coming by,\and he went to see him.\The Red Ogre crossed entire mountains and valleys to reach the Blue Ogre's home.\But there, response:	he found that the Blue Ogre had left on a journey,
context: Henceforth, the villagers trusted the Red Ogre\and would come over to his place.\Now that he had human friends, the Red Ogre led a happy life.\But one day, he became worried about the Blue Ogre, who'd stopped coming by,\and he went to see him.\The Red Ogre crossed entire mountains and valleys to reach the Blue Ogre's home.\But there,\he found that the Blue Ogre had left on a journey, response:	leaving behind a letter to the Red Ogre.
context: and would come over to his place.\Now that he had human friends, the Red Ogre led a happy life.\But one day, he became worried about the Blue Ogre, who'd stopped coming by,\and he went to see him.\The Red Ogre crossed entire mountains and valleys to reach the Blue Ogre's home.\But there,\he found that the Blue Ogre had left on a journey,\leaving behind a letter to the Red Ogre. response:	The letter said,
context: Now that he had human friends, the Red Ogre led a happy life.\But one day, he became worried about the Blue Ogre, who'd stopped coming by,\and he went to see him.\The Red Ogre crossed entire mountains and valleys to reach the Blue Ogre's home.\But there,\he found that the Blue Ogre had left on a journey,\leaving behind a letter to the Red Ogre.\The letter said, response:	You finally became friends with humans.
context: But one day, he became worried about the Blue Ogre, who'd stopped coming by,\and he went to see him.\The Red Ogre crossed entire mountains and valleys to reach the Blue Ogre's home.\But there,\he found that the Blue Ogre had left on a journey,\leaving behind a letter to the Red Ogre.\The letter said,\You finally became friends with humans. response:	If you're friendly to me,
context: and he went to see him.\The Red Ogre crossed entire mountains and valleys to reach the Blue Ogre's home.\But there,\he found that the Blue Ogre had left on a journey,\leaving behind a letter to the Red Ogre.\The letter said,\You finally became friends with humans.\If you're friendly to me, response:	they'll just come to mistrust you.
context: The Red Ogre crossed entire mountains and valleys to reach the Blue Ogre's home.\But there,\he found that the Blue Ogre had left on a journey,\leaving behind a letter to the Red Ogre.\The letter said,\You finally became friends with humans.\If you're friendly to me,\they'll just come to mistrust you. response:	The Blue Ogre had left the Red Ogre without saying anything.
context: But there,\he found that the Blue Ogre had left on a journey,\leaving behind a letter to the Red Ogre.\The letter said,\You finally became friends with humans.\If you're friendly to me,\they'll just come to mistrust you.\The Blue Ogre had left the Red Ogre without saying anything. response:	That's so sad.
context: he found that the Blue Ogre had left on a journey,\leaving behind a letter to the Red Ogre.\The letter said,\You finally became friends with humans.\If you're friendly to me,\they'll just come to mistrust you.\The Blue Ogre had left the Red Ogre without saying anything.\That's so sad. response:	Right?
context: leaving behind a letter to the Red Ogre.\The letter said,\You finally became friends with humans.\If you're friendly to me,\they'll just come to mistrust you.\The Blue Ogre had left the Red Ogre without saying anything.\That's so sad.\Right? response:	Isn't it awesome?
context: The letter said,\You finally became friends with humans.\If you're friendly to me,\they'll just come to mistrust you.\The Blue Ogre had left the Red Ogre without saying anything.\That's so sad.\Right?\Isn't it awesome? response:	The Blue Ogre's such a great guy!
context: You finally became friends with humans.\If you're friendly to me,\they'll just come to mistrust you.\The Blue Ogre had left the Red Ogre without saying anything.\That's so sad.\Right?\Isn't it awesome?\The Blue Ogre's such a great guy! response:	Yeah.
context: If you're friendly to me,\they'll just come to mistrust you.\The Blue Ogre had left the Red Ogre without saying anything.\That's so sad.\Right?\Isn't it awesome?\The Blue Ogre's such a great guy!\Yeah. response:	I don't think I could go that far, even for a friend.
context: they'll just come to mistrust you.\The Blue Ogre had left the Red Ogre without saying anything.\That's so sad.\Right?\Isn't it awesome?\The Blue Ogre's such a great guy!\Yeah.\I don't think I could go that far, even for a friend. response:	Right?
context: The Blue Ogre had left the Red Ogre without saying anything.\That's so sad.\Right?\Isn't it awesome?\The Blue Ogre's such a great guy!\Yeah.\I don't think I could go that far, even for a friend.\Right? response:	The Blue Ogre's way too nice!
context: That's so sad.\Right?\Isn't it awesome?\The Blue Ogre's such a great guy!\Yeah.\I don't think I could go that far, even for a friend.\Right?\The Blue Ogre's way too nice! response:	Yeah!
context: Right?\Isn't it awesome?\The Blue Ogre's such a great guy!\Yeah.\I don't think I could go that far, even for a friend.\Right?\The Blue Ogre's way too nice!\Yeah! response:	He's got way too much integrity!
context: Isn't it awesome?\The Blue Ogre's such a great guy!\Yeah.\I don't think I could go that far, even for a friend.\Right?\The Blue Ogre's way too nice!\Yeah!\He's got way too much integrity! response:	Yeah!
context: The Blue Ogre's such a great guy!\Yeah.\I don't think I could go that far, even for a friend.\Right?\The Blue Ogre's way too nice!\Yeah!\He's got way too much integrity!\Yeah! response:	Suna's awesome!
context: Yeah.\I don't think I could go that far, even for a friend.\Right?\The Blue Ogre's way too nice!\Yeah!\He's got way too much integrity!\Yeah!\Suna's awesome! response:	Yeah!
context: I don't think I could go that far, even for a friend.\Right?\The Blue Ogre's way too nice!\Yeah!\He's got way too much integrity!\Yeah!\Suna's awesome!\Yeah! response:	Yeah! Yeah!
context: Right?\The Blue Ogre's way too nice!\Yeah!\He's got way too much integrity!\Yeah!\Suna's awesome!\Yeah!\Yeah! Yeah! response:	I don't know about that.
context: The Blue Ogre's way too nice!\Yeah!\He's got way too much integrity!\Yeah!\Suna's awesome!\Yeah!\Yeah! Yeah!\I don't know about that. response:	Isn't that normal?
context: Yeah!\He's got way too much integrity!\Yeah!\Suna's awesome!\Yeah!\Yeah! Yeah!\I don't know about that.\Isn't that normal? response:	I mean, they were friends, right?
context: He's got way too much integrity!\Yeah!\Suna's awesome!\Yeah!\Yeah! Yeah!\I don't know about that.\Isn't that normal?\I mean, they were friends, right? response:	Who wouldn't want their friends to be happy?
context: Yeah!\Suna's awesome!\Yeah!\Yeah! Yeah!\I don't know about that.\Isn't that normal?\I mean, they were friends, right?\Who wouldn't want their friends to be happy? response:	That's just normal, man.
context: Suna's awesome!\Yeah!\Yeah! Yeah!\I don't know about that.\Isn't that normal?\I mean, they were friends, right?\Who wouldn't want their friends to be happy?\That's just normal, man. response:	It's nothing amazing.
context: Yeah!\Yeah! Yeah!\I don't know about that.\Isn't that normal?\I mean, they were friends, right?\Who wouldn't want their friends to be happy?\That's just normal, man.\It's nothing amazing. response:	Suna's...
context: Yeah! Yeah!\I don't know about that.\Isn't that normal?\I mean, they were friends, right?\Who wouldn't want their friends to be happy?\That's just normal, man.\It's nothing amazing.\Suna's... response:	Suna!
context: I don't know about that.\Isn't that normal?\I mean, they were friends, right?\Who wouldn't want their friends to be happy?\That's just normal, man.\It's nothing amazing.\Suna's...\Suna! response:	Suna might have always been keeping an eye out for me.
context: Isn't that normal?\I mean, they were friends, right?\Who wouldn't want their friends to be happy?\That's just normal, man.\It's nothing amazing.\Suna's...\Suna!\Suna might have always been keeping an eye out for me. response:	Takeo... can't breathe...
context: I mean, they were friends, right?\Who wouldn't want their friends to be happy?\That's just normal, man.\It's nothing amazing.\Suna's...\Suna!\Suna might have always been keeping an eye out for me.\Takeo... can't breathe... response:	Always...
context: Who wouldn't want their friends to be happy?\That's just normal, man.\It's nothing amazing.\Suna's...\Suna!\Suna might have always been keeping an eye out for me.\Takeo... can't breathe...\Always... response:	Since long ago.
context: That's just normal, man.\It's nothing amazing.\Suna's...\Suna!\Suna might have always been keeping an eye out for me.\Takeo... can't breathe...\Always...\Since long ago. response:	It's so nice. It's a bromance.
context: It's nothing amazing.\Suna's...\Suna!\Suna might have always been keeping an eye out for me.\Takeo... can't breathe...\Always...\Since long ago.\It's so nice. It's a bromance. response:	Bromance, huh?
context: Suna's...\Suna!\Suna might have always been keeping an eye out for me.\Takeo... can't breathe...\Always...\Since long ago.\It's so nice. It's a bromance.\Bromance, huh? response:	You're right about that.
context: Suna!\Suna might have always been keeping an eye out for me.\Takeo... can't breathe...\Always...\Since long ago.\It's so nice. It's a bromance.\Bromance, huh?\You're right about that. response:	I got asked a lot why we're even friends,
context: Suna might have always been keeping an eye out for me.\Takeo... can't breathe...\Always...\Since long ago.\It's so nice. It's a bromance.\Bromance, huh?\You're right about that.\I got asked a lot why we're even friends, response:	but I guess it wasn't only because we were neighbors.
context: Takeo... can't breathe...\Always...\Since long ago.\It's so nice. It's a bromance.\Bromance, huh?\You're right about that.\I got asked a lot why we're even friends,\but I guess it wasn't only because we were neighbors. response:	It's great!
context: Always...\Since long ago.\It's so nice. It's a bromance.\Bromance, huh?\You're right about that.\I got asked a lot why we're even friends,\but I guess it wasn't only because we were neighbors.\It's great! response:	This one's another winner!
context: Since long ago.\It's so nice. It's a bromance.\Bromance, huh?\You're right about that.\I got asked a lot why we're even friends,\but I guess it wasn't only because we were neighbors.\It's great!\This one's another winner! response:	I'm glad to hear that.
context: It's so nice. It's a bromance.\Bromance, huh?\You're right about that.\I got asked a lot why we're even friends,\but I guess it wasn't only because we were neighbors.\It's great!\This one's another winner!\I'm glad to hear that. response:	Here, have some tea.
context: Bromance, huh?\You're right about that.\I got asked a lot why we're even friends,\but I guess it wasn't only because we were neighbors.\It's great!\This one's another winner!\I'm glad to hear that.\Here, have some tea. response:	What kind is this?
context: You're right about that.\I got asked a lot why we're even friends,\but I guess it wasn't only because we were neighbors.\It's great!\This one's another winner!\I'm glad to hear that.\Here, have some tea.\What kind is this? response:	Um...
context: I got asked a lot why we're even friends,\but I guess it wasn't only because we were neighbors.\It's great!\This one's another winner!\I'm glad to hear that.\Here, have some tea.\What kind is this?\Um... response:	They're madelines.
context: but I guess it wasn't only because we were neighbors.\It's great!\This one's another winner!\I'm glad to hear that.\Here, have some tea.\What kind is this?\Um...\They're madelines. response:	Oh, madelines?
context: It's great!\This one's another winner!\I'm glad to hear that.\Here, have some tea.\What kind is this?\Um...\They're madelines.\Oh, madelines? response:	Takeo, Age 5
context: This one's another winner!\I'm glad to hear that.\Here, have some tea.\What kind is this?\Um...\They're madelines.\Oh, madelines?\Takeo, Age 5 response:	Let's go to the park!
context: I'm glad to hear that.\Here, have some tea.\What kind is this?\Um...\They're madelines.\Oh, madelines?\Takeo, Age 5\Let's go to the park! response:	Okay, I guess.
context: Here, have some tea.\What kind is this?\Um...\They're madelines.\Oh, madelines?\Takeo, Age 5\Let's go to the park!\Okay, I guess. response:	Yahoo!
context: What kind is this?\Um...\They're madelines.\Oh, madelines?\Takeo, Age 5\Let's go to the park!\Okay, I guess.\Yahoo! response:	Suna, look!
context: Um...\They're madelines.\Oh, madelines?\Takeo, Age 5\Let's go to the park!\Okay, I guess.\Yahoo!\Suna, look! response:	Transfo
context: They're madelines.\Oh, madelines?\Takeo, Age 5\Let's go to the park!\Okay, I guess.\Yahoo!\Suna, look!\Transfo response:	Did you see my mad skills just now?
context: Oh, madelines?\Takeo, Age 5\Let's go to the park!\Okay, I guess.\Yahoo!\Suna, look!\Transfo\Did you see my mad skills just now? response:	Achoo!
context: Takeo, Age 5\Let's go to the park!\Okay, I guess.\Yahoo!\Suna, look!\Transfo\Did you see my mad skills just now?\Achoo! response:	I wouldn't call those mad skills...
context: Let's go to the park!\Okay, I guess.\Yahoo!\Suna, look!\Transfo\Did you see my mad skills just now?\Achoo!\I wouldn't call those mad skills... response:	Orya!
context: Okay, I guess.\Yahoo!\Suna, look!\Transfo\Did you see my mad skills just now?\Achoo!\I wouldn't call those mad skills...\Orya! response:	Takeo, Age 10
context: Yahoo!\Suna, look!\Transfo\Did you see my mad skills just now?\Achoo!\I wouldn't call those mad skills...\Orya!\Takeo, Age 10 response:	Why is it that...
context: Suna, look!\Transfo\Did you see my mad skills just now?\Achoo!\I wouldn't call those mad skills...\Orya!\Takeo, Age 10\Why is it that... response:	Why do I always fall into this hole?
context: Transfo\Did you see my mad skills just now?\Achoo!\I wouldn't call those mad skills...\Orya!\Takeo, Age 10\Why is it that...\Why do I always fall into this hole? response:	Maybe because you aren't jumping over it?
context: Did you see my mad skills just now?\Achoo!\I wouldn't call those mad skills...\Orya!\Takeo, Age 10\Why is it that...\Why do I always fall into this hole?\Maybe because you aren't jumping over it? response:	You know, Takeo's always up close and personal.
context: Achoo!\I wouldn't call those mad skills...\Orya!\Takeo, Age 10\Why is it that...\Why do I always fall into this hole?\Maybe because you aren't jumping over it?\You know, Takeo's always up close and personal. response:	Sunakawa Ai (Junior High School Student)
context: I wouldn't call those mad skills...\Orya!\Takeo, Age 10\Why is it that...\Why do I always fall into this hole?\Maybe because you aren't jumping over it?\You know, Takeo's always up close and personal.\Sunakawa Ai (Junior High School Student) response:	Talk
context: Orya!\Takeo, Age 10\Why is it that...\Why do I always fall into this hole?\Maybe because you aren't jumping over it?\You know, Takeo's always up close and personal.\Sunakawa Ai (Junior High School Student)\Talk response:	Volume Brightness
context: Takeo, Age 10\Why is it that...\Why do I always fall into this hole?\Maybe because you aren't jumping over it?\You know, Takeo's always up close and personal.\Sunakawa Ai (Junior High School Student)\Talk\Volume Brightness response:	Step back.
context: Why is it that...\Why do I always fall into this hole?\Maybe because you aren't jumping over it?\You know, Takeo's always up close and personal.\Sunakawa Ai (Junior High School Student)\Talk\Volume Brightness\Step back. response:	Oh, right.
context: Why do I always fall into this hole?\Maybe because you aren't jumping over it?\You know, Takeo's always up close and personal.\Sunakawa Ai (Junior High School Student)\Talk\Volume Brightness\Step back.\Oh, right. response:	What, did something funny happen?
context: Maybe because you aren't jumping over it?\You know, Takeo's always up close and personal.\Sunakawa Ai (Junior High School Student)\Talk\Volume Brightness\Step back.\Oh, right.\What, did something funny happen? response:	No, it's nothing...
context: You know, Takeo's always up close and personal.\Sunakawa Ai (Junior High School Student)\Talk\Volume Brightness\Step back.\Oh, right.\What, did something funny happen?\No, it's nothing... response:	Bathroom break!
context: Sunakawa Ai (Junior High School Student)\Talk\Volume Brightness\Step back.\Oh, right.\What, did something funny happen?\No, it's nothing...\Bathroom break! response:	Okay.
context: Talk\Volume Brightness\Step back.\Oh, right.\What, did something funny happen?\No, it's nothing...\Bathroom break!\Okay. response:	Sometimes, Takeo-kun's so up close and personal, I don't know what to do.
context: Volume Brightness\Step back.\Oh, right.\What, did something funny happen?\No, it's nothing...\Bathroom break!\Okay.\Sometimes, Takeo-kun's so up close and personal, I don't know what to do. response:	It makes my heart skip a beat, you know?
context: Step back.\Oh, right.\What, did something funny happen?\No, it's nothing...\Bathroom break!\Okay.\Sometimes, Takeo-kun's so up close and personal, I don't know what to do.\It makes my heart skip a beat, you know? response:	Yeah, I don't know what to do, either.
context: Oh, right.\What, did something funny happen?\No, it's nothing...\Bathroom break!\Okay.\Sometimes, Takeo-kun's so up close and personal, I don't know what to do.\It makes my heart skip a beat, you know?\Yeah, I don't know what to do, either. response:	Because it's so friggin' hilarious.
context: What, did something funny happen?\No, it's nothing...\Bathroom break!\Okay.\Sometimes, Takeo-kun's so up close and personal, I don't know what to do.\It makes my heart skip a beat, you know?\Yeah, I don't know what to do, either.\Because it's so friggin' hilarious. response:	Huh?
context: No, it's nothing...\Bathroom break!\Okay.\Sometimes, Takeo-kun's so up close and personal, I don't know what to do.\It makes my heart skip a beat, you know?\Yeah, I don't know what to do, either.\Because it's so friggin' hilarious.\Huh? response:	What's the matter?
context: Bathroom break!\Okay.\Sometimes, Takeo-kun's so up close and personal, I don't know what to do.\It makes my heart skip a beat, you know?\Yeah, I don't know what to do, either.\Because it's so friggin' hilarious.\Huh?\What's the matter? response:	It's nothing.
context: Okay.\Sometimes, Takeo-kun's so up close and personal, I don't know what to do.\It makes my heart skip a beat, you know?\Yeah, I don't know what to do, either.\Because it's so friggin' hilarious.\Huh?\What's the matter?\It's nothing. response:	My Boyfriend
context: Sometimes, Takeo-kun's so up close and personal, I don't know what to do.\It makes my heart skip a beat, you know?\Yeah, I don't know what to do, either.\Because it's so friggin' hilarious.\Huh?\What's the matter?\It's nothing.\My Boyfriend response:	Next time: My Boyfriend.