context: I'm thinking of quitting the rental girlfriend job. response:	Ruka-chan
context: I'm thinking of quitting the rental girlfriend job.\Ruka-chan response:	LIVE Audio...
context: I'm thinking of quitting the rental girlfriend job.\Ruka-chan\LIVE Audio... response:	Hello?
context: I'm thinking of quitting the rental girlfriend job.\Ruka-chan\LIVE Audio...\Hello? response:	Kazuya-kun! What do you say we go on a date before work?
context: I'm thinking of quitting the rental girlfriend job.\Ruka-chan\LIVE Audio...\Hello?\Kazuya-kun! What do you say we go on a date before work? response:	A date? Oh, uh...
context: I'm thinking of quitting the rental girlfriend job.\Ruka-chan\LIVE Audio...\Hello?\Kazuya-kun! What do you say we go on a date before work?\A date? Oh, uh... response:	So I figure it's about time to move on.
context: I'm thinking of quitting the rental girlfriend job.\Ruka-chan\LIVE Audio...\Hello?\Kazuya-kun! What do you say we go on a date before work?\A date? Oh, uh...\So I figure it's about time to move on. response:	I can't keep using her as a crutch forever.
context: I'm thinking of quitting the rental girlfriend job.\Ruka-chan\LIVE Audio...\Hello?\Kazuya-kun! What do you say we go on a date before work?\A date? Oh, uh...\So I figure it's about time to move on.\I can't keep using her as a crutch forever. response:	Sure. Let's do it.
context: Ruka-chan\LIVE Audio...\Hello?\Kazuya-kun! What do you say we go on a date before work?\A date? Oh, uh...\So I figure it's about time to move on.\I can't keep using her as a crutch forever.\Sure. Let's do it. response:	Kazuya-kun!
context: LIVE Audio...\Hello?\Kazuya-kun! What do you say we go on a date before work?\A date? Oh, uh...\So I figure it's about time to move on.\I can't keep using her as a crutch forever.\Sure. Let's do it.\Kazuya-kun! response:	Yo...
context: Hello?\Kazuya-kun! What do you say we go on a date before work?\A date? Oh, uh...\So I figure it's about time to move on.\I can't keep using her as a crutch forever.\Sure. Let's do it.\Kazuya-kun!\Yo... response:	That girl's hella cute.
context: Kazuya-kun! What do you say we go on a date before work?\A date? Oh, uh...\So I figure it's about time to move on.\I can't keep using her as a crutch forever.\Sure. Let's do it.\Kazuya-kun!\Yo...\That girl's hella cute. response:	That's her boyfriend?
context: A date? Oh, uh...\So I figure it's about time to move on.\I can't keep using her as a crutch forever.\Sure. Let's do it.\Kazuya-kun!\Yo...\That girl's hella cute.\That's her boyfriend? response:	More like chimpanzee.
context: So I figure it's about time to move on.\I can't keep using her as a crutch forever.\Sure. Let's do it.\Kazuya-kun!\Yo...\That girl's hella cute.\That's her boyfriend?\More like chimpanzee. response:	I'm so glad I got to see you!
context: I can't keep using her as a crutch forever.\Sure. Let's do it.\Kazuya-kun!\Yo...\That girl's hella cute.\That's her boyfriend?\More like chimpanzee.\I'm so glad I got to see you! response:	We saw each other, like, two days ago.
context: Sure. Let's do it.\Kazuya-kun!\Yo...\That girl's hella cute.\That's her boyfriend?\More like chimpanzee.\I'm so glad I got to see you!\We saw each other, like, two days ago. response:	That's true.
context: Kazuya-kun!\Yo...\That girl's hella cute.\That's her boyfriend?\More like chimpanzee.\I'm so glad I got to see you!\We saw each other, like, two days ago.\That's true. response:	It's only been two days, and yet, why does this make me so happy?
context: Yo...\That girl's hella cute.\That's her boyfriend?\More like chimpanzee.\I'm so glad I got to see you!\We saw each other, like, two days ago.\That's true.\It's only been two days, and yet, why does this make me so happy? response:	Ta-da! What do you think?
context: That girl's hella cute.\That's her boyfriend?\More like chimpanzee.\I'm so glad I got to see you!\We saw each other, like, two days ago.\That's true.\It's only been two days, and yet, why does this make me so happy?\Ta-da! What do you think? response:	L-Looking good.
context: That's her boyfriend?\More like chimpanzee.\I'm so glad I got to see you!\We saw each other, like, two days ago.\That's true.\It's only been two days, and yet, why does this make me so happy?\Ta-da! What do you think?\L-Looking good. response:	Yay! Lavender's in this spring, y'know.
context: More like chimpanzee.\I'm so glad I got to see you!\We saw each other, like, two days ago.\That's true.\It's only been two days, and yet, why does this make me so happy?\Ta-da! What do you think?\L-Looking good.\Yay! Lavender's in this spring, y'know. response:	Now that you mention it, Mizuhara had a lavender scarf, too.
context: I'm so glad I got to see you!\We saw each other, like, two days ago.\That's true.\It's only been two days, and yet, why does this make me so happy?\Ta-da! What do you think?\L-Looking good.\Yay! Lavender's in this spring, y'know.\Now that you mention it, Mizuhara had a lavender scarf, too. response:	Gah! S-Sorry!
context: We saw each other, like, two days ago.\That's true.\It's only been two days, and yet, why does this make me so happy?\Ta-da! What do you think?\L-Looking good.\Yay! Lavender's in this spring, y'know.\Now that you mention it, Mizuhara had a lavender scarf, too.\Gah! S-Sorry! response:	It's fine. I know you still like her.
context: That's true.\It's only been two days, and yet, why does this make me so happy?\Ta-da! What do you think?\L-Looking good.\Yay! Lavender's in this spring, y'know.\Now that you mention it, Mizuhara had a lavender scarf, too.\Gah! S-Sorry!\It's fine. I know you still like her. response:	I've realized now that just forcing my love on you isn't gonna cut it.
context: It's only been two days, and yet, why does this make me so happy?\Ta-da! What do you think?\L-Looking good.\Yay! Lavender's in this spring, y'know.\Now that you mention it, Mizuhara had a lavender scarf, too.\Gah! S-Sorry!\It's fine. I know you still like her.\I've realized now that just forcing my love on you isn't gonna cut it. response:	'Cause I want you to fall in love with me for real.
context: Ta-da! What do you think?\L-Looking good.\Yay! Lavender's in this spring, y'know.\Now that you mention it, Mizuhara had a lavender scarf, too.\Gah! S-Sorry!\It's fine. I know you still like her.\I've realized now that just forcing my love on you isn't gonna cut it.\'Cause I want you to fall in love with me for real. response:	Ruka-chan...
context: L-Looking good.\Yay! Lavender's in this spring, y'know.\Now that you mention it, Mizuhara had a lavender scarf, too.\Gah! S-Sorry!\It's fine. I know you still like her.\I've realized now that just forcing my love on you isn't gonna cut it.\'Cause I want you to fall in love with me for real.\Ruka-chan... response:	She's a good girl.
context: Yay! Lavender's in this spring, y'know.\Now that you mention it, Mizuhara had a lavender scarf, too.\Gah! S-Sorry!\It's fine. I know you still like her.\I've realized now that just forcing my love on you isn't gonna cut it.\'Cause I want you to fall in love with me for real.\Ruka-chan...\She's a good girl. response:	Cheerful, determined, and passionate.
context: Now that you mention it, Mizuhara had a lavender scarf, too.\Gah! S-Sorry!\It's fine. I know you still like her.\I've realized now that just forcing my love on you isn't gonna cut it.\'Cause I want you to fall in love with me for real.\Ruka-chan...\She's a good girl.\Cheerful, determined, and passionate. response:	Sure, she may be a bit possessive,
context: Gah! S-Sorry!\It's fine. I know you still like her.\I've realized now that just forcing my love on you isn't gonna cut it.\'Cause I want you to fall in love with me for real.\Ruka-chan...\She's a good girl.\Cheerful, determined, and passionate.\Sure, she may be a bit possessive, response:	but that's something that should make any boyfriend happy.
context: It's fine. I know you still like her.\I've realized now that just forcing my love on you isn't gonna cut it.\'Cause I want you to fall in love with me for real.\Ruka-chan...\She's a good girl.\Cheerful, determined, and passionate.\Sure, she may be a bit possessive,\but that's something that should make any boyfriend happy. response:	How is she not good enough?
context: I've realized now that just forcing my love on you isn't gonna cut it.\'Cause I want you to fall in love with me for real.\Ruka-chan...\She's a good girl.\Cheerful, determined, and passionate.\Sure, she may be a bit possessive,\but that's something that should make any boyfriend happy.\How is she not good enough? response:	Karaoke Village
context: 'Cause I want you to fall in love with me for real.\Ruka-chan...\She's a good girl.\Cheerful, determined, and passionate.\Sure, she may be a bit possessive,\but that's something that should make any boyfriend happy.\How is she not good enough?\Karaoke Village response:	Uh... Sorry, but I have to refuse.
context: Ruka-chan...\She's a good girl.\Cheerful, determined, and passionate.\Sure, she may be a bit possessive,\but that's something that should make any boyfriend happy.\How is she not good enough?\Karaoke Village\Uh... Sorry, but I have to refuse. response:	Gah! I knew it'd be a no!
context: She's a good girl.\Cheerful, determined, and passionate.\Sure, she may be a bit possessive,\but that's something that should make any boyfriend happy.\How is she not good enough?\Karaoke Village\Uh... Sorry, but I have to refuse.\Gah! I knew it'd be a no! response:	You must have a boyfriend, right?
context: Cheerful, determined, and passionate.\Sure, she may be a bit possessive,\but that's something that should make any boyfriend happy.\How is she not good enough?\Karaoke Village\Uh... Sorry, but I have to refuse.\Gah! I knew it'd be a no!\You must have a boyfriend, right? response:	Do I have a boyfriend?
context: Sure, she may be a bit possessive,\but that's something that should make any boyfriend happy.\How is she not good enough?\Karaoke Village\Uh... Sorry, but I have to refuse.\Gah! I knew it'd be a no!\You must have a boyfriend, right?\Do I have a boyfriend? response:	Look at what you're making her say!
context: but that's something that should make any boyfriend happy.\How is she not good enough?\Karaoke Village\Uh... Sorry, but I have to refuse.\Gah! I knew it'd be a no!\You must have a boyfriend, right?\Do I have a boyfriend?\Look at what you're making her say! response:	I'll be your girlfriend until the time comes.
context: How is she not good enough?\Karaoke Village\Uh... Sorry, but I have to refuse.\Gah! I knew it'd be a no!\You must have a boyfriend, right?\Do I have a boyfriend?\Look at what you're making her say!\I'll be your girlfriend until the time comes. response:	I can't keep using Mizuhara as a crutch!
context: Karaoke Village\Uh... Sorry, but I have to refuse.\Gah! I knew it'd be a no!\You must have a boyfriend, right?\Do I have a boyfriend?\Look at what you're making her say!\I'll be your girlfriend until the time comes.\I can't keep using Mizuhara as a crutch! response:	I've gotta at least manage my own love life!
context: Uh... Sorry, but I have to refuse.\Gah! I knew it'd be a no!\You must have a boyfriend, right?\Do I have a boyfriend?\Look at what you're making her say!\I'll be your girlfriend until the time comes.\I can't keep using Mizuhara as a crutch!\I've gotta at least manage my own love life! response:	Bear with me, Ruka-chan!
context: Gah! I knew it'd be a no!\You must have a boyfriend, right?\Do I have a boyfriend?\Look at what you're making her say!\I'll be your girlfriend until the time comes.\I can't keep using Mizuhara as a crutch!\I've gotta at least manage my own love life!\Bear with me, Ruka-chan! response:	There's something I need to say.
context: You must have a boyfriend, right?\Do I have a boyfriend?\Look at what you're making her say!\I'll be your girlfriend until the time comes.\I can't keep using Mizuhara as a crutch!\I've gotta at least manage my own love life!\Bear with me, Ruka-chan!\There's something I need to say. response:	Kazuya-kun?
context: Do I have a boyfriend?\Look at what you're making her say!\I'll be your girlfriend until the time comes.\I can't keep using Mizuhara as a crutch!\I've gotta at least manage my own love life!\Bear with me, Ruka-chan!\There's something I need to say.\Kazuya-kun? response:	We agreed on a trial period, and now...
context: Look at what you're making her say!\I'll be your girlfriend until the time comes.\I can't keep using Mizuhara as a crutch!\I've gotta at least manage my own love life!\Bear with me, Ruka-chan!\There's something I need to say.\Kazuya-kun?\We agreed on a trial period, and now... response:	I want to make it official!
context: I'll be your girlfriend until the time comes.\I can't keep using Mizuhara as a crutch!\I've gotta at least manage my own love life!\Bear with me, Ruka-chan!\There's something I need to say.\Kazuya-kun?\We agreed on a trial period, and now...\I want to make it official! response:	Let's get this out of the way.
context: I can't keep using Mizuhara as a crutch!\I've gotta at least manage my own love life!\Bear with me, Ruka-chan!\There's something I need to say.\Kazuya-kun?\We agreed on a trial period, and now...\I want to make it official!\Let's get this out of the way. response:	I can't accept that.
context: I've gotta at least manage my own love life!\Bear with me, Ruka-chan!\There's something I need to say.\Kazuya-kun?\We agreed on a trial period, and now...\I want to make it official!\Let's get this out of the way.\I can't accept that. response:	Just take it.
context: Bear with me, Ruka-chan!\There's something I need to say.\Kazuya-kun?\We agreed on a trial period, and now...\I want to make it official!\Let's get this out of the way.\I can't accept that.\Just take it. response:	Come on! This won't be an enjoyable date with cash just lying on the table!
context: There's something I need to say.\Kazuya-kun?\We agreed on a trial period, and now...\I want to make it official!\Let's get this out of the way.\I can't accept that.\Just take it.\Come on! This won't be an enjoyable date with cash just lying on the table! response:	Put it away. Here.
context: Kazuya-kun?\We agreed on a trial period, and now...\I want to make it official!\Let's get this out of the way.\I can't accept that.\Just take it.\Come on! This won't be an enjoyable date with cash just lying on the table!\Put it away. Here. response:	How long have you known about my job?
context: We agreed on a trial period, and now...\I want to make it official!\Let's get this out of the way.\I can't accept that.\Just take it.\Come on! This won't be an enjoyable date with cash just lying on the table!\Put it away. Here.\How long have you known about my job? response:	For a week or two, I guess?
context: I want to make it official!\Let's get this out of the way.\I can't accept that.\Just take it.\Come on! This won't be an enjoyable date with cash just lying on the table!\Put it away. Here.\How long have you known about my job?\For a week or two, I guess? response:	I happened to look up rental girlfriends and found out.
context: Let's get this out of the way.\I can't accept that.\Just take it.\Come on! This won't be an enjoyable date with cash just lying on the table!\Put it away. Here.\How long have you known about my job?\For a week or two, I guess?\I happened to look up rental girlfriends and found out. response:	You're super popular, huh?
context: I can't accept that.\Just take it.\Come on! This won't be an enjoyable date with cash just lying on the table!\Put it away. Here.\How long have you known about my job?\For a week or two, I guess?\I happened to look up rental girlfriends and found out.\You're super popular, huh? response:	Rookie Batch
context: Just take it.\Come on! This won't be an enjoyable date with cash just lying on the table!\Put it away. Here.\How long have you known about my job?\For a week or two, I guess?\I happened to look up rental girlfriends and found out.\You're super popular, huh?\Rookie Batch response:	This Month Last Month Two Months Ago
context: Come on! This won't be an enjoyable date with cash just lying on the table!\Put it away. Here.\How long have you known about my job?\For a week or two, I guess?\I happened to look up rental girlfriends and found out.\You're super popular, huh?\Rookie Batch\This Month Last Month Two Months Ago response:	It says here that you're number one among the rookies.
context: Put it away. Here.\How long have you known about my job?\For a week or two, I guess?\I happened to look up rental girlfriends and found out.\You're super popular, huh?\Rookie Batch\This Month Last Month Two Months Ago\It says here that you're number one among the rookies. response:	Rookie Batch
context: How long have you known about my job?\For a week or two, I guess?\I happened to look up rental girlfriends and found out.\You're super popular, huh?\Rookie Batch\This Month Last Month Two Months Ago\It says here that you're number one among the rookies.\Rookie Batch response:	This Month Last Month Two Months Ago
context: For a week or two, I guess?\I happened to look up rental girlfriends and found out.\You're super popular, huh?\Rookie Batch\This Month Last Month Two Months Ago\It says here that you're number one among the rookies.\Rookie Batch\This Month Last Month Two Months Ago response:	What do you usually sing at karaoke?
context: I happened to look up rental girlfriends and found out.\You're super popular, huh?\Rookie Batch\This Month Last Month Two Months Ago\It says here that you're number one among the rookies.\Rookie Batch\This Month Last Month Two Months Ago\What do you usually sing at karaoke? response:	It depends on the client.
context: You're super popular, huh?\Rookie Batch\This Month Last Month Two Months Ago\It says here that you're number one among the rookies.\Rookie Batch\This Month Last Month Two Months Ago\What do you usually sing at karaoke?\It depends on the client. response:	It'd be pointless to sing a song they don't know.
context: Rookie Batch\This Month Last Month Two Months Ago\It says here that you're number one among the rookies.\Rookie Batch\This Month Last Month Two Months Ago\What do you usually sing at karaoke?\It depends on the client.\It'd be pointless to sing a song they don't know. response:	Wow, you're versatile, huh? Then...
context: This Month Last Month Two Months Ago\It says here that you're number one among the rookies.\Rookie Batch\This Month Last Month Two Months Ago\What do you usually sing at karaoke?\It depends on the client.\It'd be pointless to sing a song they don't know.\Wow, you're versatile, huh? Then... response:	How about when you're with someone around your age?
context: It says here that you're number one among the rookies.\Rookie Batch\This Month Last Month Two Months Ago\What do you usually sing at karaoke?\It depends on the client.\It'd be pointless to sing a song they don't know.\Wow, you're versatile, huh? Then...\How about when you're with someone around your age? response:	You know, like Kazu-kun.
context: Rookie Batch\This Month Last Month Two Months Ago\What do you usually sing at karaoke?\It depends on the client.\It'd be pointless to sing a song they don't know.\Wow, you're versatile, huh? Then...\How about when you're with someone around your age?\You know, like Kazu-kun. response:	I've never been to karaoke with Kazuya-san.
context: This Month Last Month Two Months Ago\What do you usually sing at karaoke?\It depends on the client.\It'd be pointless to sing a song they don't know.\Wow, you're versatile, huh? Then...\How about when you're with someone around your age?\You know, like Kazu-kun.\I've never been to karaoke with Kazuya-san. response:	But if I did, I would probably go with the peggies or halca.
context: What do you usually sing at karaoke?\It depends on the client.\It'd be pointless to sing a song they don't know.\Wow, you're versatile, huh? Then...\How about when you're with someone around your age?\You know, like Kazu-kun.\I've never been to karaoke with Kazuya-san.\But if I did, I would probably go with the peggies or halca. response:	the peggies are great! I love them, too!
context: It depends on the client.\It'd be pointless to sing a song they don't know.\Wow, you're versatile, huh? Then...\How about when you're with someone around your age?\You know, like Kazu-kun.\I've never been to karaoke with Kazuya-san.\But if I did, I would probably go with the peggies or halca.\the peggies are great! I love them, too! response:	Sing one for me.
context: It'd be pointless to sing a song they don't know.\Wow, you're versatile, huh? Then...\How about when you're with someone around your age?\You know, like Kazu-kun.\I've never been to karaoke with Kazuya-san.\But if I did, I would probably go with the peggies or halca.\the peggies are great! I love them, too!\Sing one for me. response:	Centimeter queued
context: Wow, you're versatile, huh? Then...\How about when you're with someone around your age?\You know, like Kazu-kun.\I've never been to karaoke with Kazuya-san.\But if I did, I would probably go with the peggies or halca.\the peggies are great! I love them, too!\Sing one for me.\Centimeter queued response:	Would you mind telling me why you booked this date?
context: How about when you're with someone around your age?\You know, like Kazu-kun.\I've never been to karaoke with Kazuya-san.\But if I did, I would probably go with the peggies or halca.\the peggies are great! I love them, too!\Sing one for me.\Centimeter queued\Would you mind telling me why you booked this date? response:	I can't imagine this is just about karaoke.
context: You know, like Kazu-kun.\I've never been to karaoke with Kazuya-san.\But if I did, I would probably go with the peggies or halca.\the peggies are great! I love them, too!\Sing one for me.\Centimeter queued\Would you mind telling me why you booked this date?\I can't imagine this is just about karaoke. response:	Sing. For. Me.
context: I've never been to karaoke with Kazuya-san.\But if I did, I would probably go with the peggies or halca.\the peggies are great! I love them, too!\Sing one for me.\Centimeter queued\Would you mind telling me why you booked this date?\I can't imagine this is just about karaoke.\Sing. For. Me. response:	What the hell?
context: But if I did, I would probably go with the peggies or halca.\the peggies are great! I love them, too!\Sing one for me.\Centimeter queued\Would you mind telling me why you booked this date?\I can't imagine this is just about karaoke.\Sing. For. Me.\What the hell? response:	Why are Mami-chan and Mizuhara together?
context: the peggies are great! I love them, too!\Sing one for me.\Centimeter queued\Would you mind telling me why you booked this date?\I can't imagine this is just about karaoke.\Sing. For. Me.\What the hell?\Why are Mami-chan and Mizuhara together? response:	They don't have each other's contact info. Did they run into each other?
context: Sing one for me.\Centimeter queued\Would you mind telling me why you booked this date?\I can't imagine this is just about karaoke.\Sing. For. Me.\What the hell?\Why are Mami-chan and Mizuhara together?\They don't have each other's contact info. Did they run into each other? response:	And even if they did, would they randomly decide to go to karaoke?
context: Centimeter queued\Would you mind telling me why you booked this date?\I can't imagine this is just about karaoke.\Sing. For. Me.\What the hell?\Why are Mami-chan and Mizuhara together?\They don't have each other's contact info. Did they run into each other?\And even if they did, would they randomly decide to go to karaoke? response:	She must've realized something was off last time.
context: Would you mind telling me why you booked this date?\I can't imagine this is just about karaoke.\Sing. For. Me.\What the hell?\Why are Mami-chan and Mizuhara together?\They don't have each other's contact info. Did they run into each other?\And even if they did, would they randomly decide to go to karaoke?\She must've realized something was off last time. response:	Wait... Did she rent her?
context: I can't imagine this is just about karaoke.\Sing. For. Me.\What the hell?\Why are Mami-chan and Mizuhara together?\They don't have each other's contact info. Did they run into each other?\And even if they did, would they randomly decide to go to karaoke?\She must've realized something was off last time.\Wait... Did she rent her? response:	Does she know Mizuhara's a rental girlfriend?!
context: Sing. For. Me.\What the hell?\Why are Mami-chan and Mizuhara together?\They don't have each other's contact info. Did they run into each other?\And even if they did, would they randomly decide to go to karaoke?\She must've realized something was off last time.\Wait... Did she rent her?\Does she know Mizuhara's a rental girlfriend?! response:	Kazuya-kun?
context: What the hell?\Why are Mami-chan and Mizuhara together?\They don't have each other's contact info. Did they run into each other?\And even if they did, would they randomly decide to go to karaoke?\She must've realized something was off last time.\Wait... Did she rent her?\Does she know Mizuhara's a rental girlfriend?!\Kazuya-kun? response:	What are you doing?
context: Why are Mami-chan and Mizuhara together?\They don't have each other's contact info. Did they run into each other?\And even if they did, would they randomly decide to go to karaoke?\She must've realized something was off last time.\Wait... Did she rent her?\Does she know Mizuhara's a rental girlfriend?!\Kazuya-kun?\What are you doing? response:	Is something up with this room?
context: They don't have each other's contact info. Did they run into each other?\And even if they did, would they randomly decide to go to karaoke?\She must've realized something was off last time.\Wait... Did she rent her?\Does she know Mizuhara's a rental girlfriend?!\Kazuya-kun?\What are you doing?\Is something up with this room? response:	N-No, nothing!
context: And even if they did, would they randomly decide to go to karaoke?\She must've realized something was off last time.\Wait... Did she rent her?\Does she know Mizuhara's a rental girlfriend?!\Kazuya-kun?\What are you doing?\Is something up with this room?\N-No, nothing! response:	Let's get back to work before the manager shows up!
context: She must've realized something was off last time.\Wait... Did she rent her?\Does she know Mizuhara's a rental girlfriend?!\Kazuya-kun?\What are you doing?\Is something up with this room?\N-No, nothing!\Let's get back to work before the manager shows up! response:	Wow! You're a really good singer!
context: Wait... Did she rent her?\Does she know Mizuhara's a rental girlfriend?!\Kazuya-kun?\What are you doing?\Is something up with this room?\N-No, nothing!\Let's get back to work before the manager shows up!\Wow! You're a really good singer! response:	And Kazu-kun's never heard you sing? He's totally missing out!
context: Does she know Mizuhara's a rental girlfriend?!\Kazuya-kun?\What are you doing?\Is something up with this room?\N-No, nothing!\Let's get back to work before the manager shows up!\Wow! You're a really good singer!\And Kazu-kun's never heard you sing? He's totally missing out! response:	Where do you go with him?
context: Kazuya-kun?\What are you doing?\Is something up with this room?\N-No, nothing!\Let's get back to work before the manager shows up!\Wow! You're a really good singer!\And Kazu-kun's never heard you sing? He's totally missing out!\Where do you go with him? response:	I'm afraid I can't discuss that.
context: What are you doing?\Is something up with this room?\N-No, nothing!\Let's get back to work before the manager shows up!\Wow! You're a really good singer!\And Kazu-kun's never heard you sing? He's totally missing out!\Where do you go with him?\I'm afraid I can't discuss that. response:	Ah, protecting your client's confidentiality? How cool.
context: Is something up with this room?\N-No, nothing!\Let's get back to work before the manager shows up!\Wow! You're a really good singer!\And Kazu-kun's never heard you sing? He's totally missing out!\Where do you go with him?\I'm afraid I can't discuss that.\Ah, protecting your client's confidentiality? How cool. response:	Yeah, no.
context: N-No, nothing!\Let's get back to work before the manager shows up!\Wow! You're a really good singer!\And Kazu-kun's never heard you sing? He's totally missing out!\Where do you go with him?\I'm afraid I can't discuss that.\Ah, protecting your client's confidentiality? How cool.\Yeah, no. response:	I can't focus on anything right now.
context: Let's get back to work before the manager shows up!\Wow! You're a really good singer!\And Kazu-kun's never heard you sing? He's totally missing out!\Where do you go with him?\I'm afraid I can't discuss that.\Ah, protecting your client's confidentiality? How cool.\Yeah, no.\I can't focus on anything right now. response:	What are they talking about in there? My brain's about to explode!
context: Wow! You're a really good singer!\And Kazu-kun's never heard you sing? He's totally missing out!\Where do you go with him?\I'm afraid I can't discuss that.\Ah, protecting your client's confidentiality? How cool.\Yeah, no.\I can't focus on anything right now.\What are they talking about in there? My brain's about to explode! response:	I have to return your money.
context: And Kazu-kun's never heard you sing? He's totally missing out!\Where do you go with him?\I'm afraid I can't discuss that.\Ah, protecting your client's confidentiality? How cool.\Yeah, no.\I can't focus on anything right now.\What are they talking about in there? My brain's about to explode!\I have to return your money. response:	Money? So I was right!
context: Where do you go with him?\I'm afraid I can't discuss that.\Ah, protecting your client's confidentiality? How cool.\Yeah, no.\I can't focus on anything right now.\What are they talking about in there? My brain's about to explode!\I have to return your money.\Money? So I was right! response:	I don't think I'm doing my job as a girlfriend right now.
context: I'm afraid I can't discuss that.\Ah, protecting your client's confidentiality? How cool.\Yeah, no.\I can't focus on anything right now.\What are they talking about in there? My brain's about to explode!\I have to return your money.\Money? So I was right!\I don't think I'm doing my job as a girlfriend right now. response:	I don't deserve to be paid for this.
context: Ah, protecting your client's confidentiality? How cool.\Yeah, no.\I can't focus on anything right now.\What are they talking about in there? My brain's about to explode!\I have to return your money.\Money? So I was right!\I don't think I'm doing my job as a girlfriend right now.\I don't deserve to be paid for this. response:	What are you talking about?
context: Yeah, no.\I can't focus on anything right now.\What are they talking about in there? My brain's about to explode!\I have to return your money.\Money? So I was right!\I don't think I'm doing my job as a girlfriend right now.\I don't deserve to be paid for this.\What are you talking about? response:	You're doing fine. You're plenty cute as you are.
context: I can't focus on anything right now.\What are they talking about in there? My brain's about to explode!\I have to return your money.\Money? So I was right!\I don't think I'm doing my job as a girlfriend right now.\I don't deserve to be paid for this.\What are you talking about?\You're doing fine. You're plenty cute as you are. response:	Besides, I wanted to meet the real you, anyway.
context: What are they talking about in there? My brain's about to explode!\I have to return your money.\Money? So I was right!\I don't think I'm doing my job as a girlfriend right now.\I don't deserve to be paid for this.\What are you talking about?\You're doing fine. You're plenty cute as you are.\Besides, I wanted to meet the real you, anyway. response:	Brilliant.
context: I have to return your money.\Money? So I was right!\I don't think I'm doing my job as a girlfriend right now.\I don't deserve to be paid for this.\What are you talking about?\You're doing fine. You're plenty cute as you are.\Besides, I wanted to meet the real you, anyway.\Brilliant. response:	You've played the role of Kazu-kun's girlfriend perfectly for a whole year.
context: Money? So I was right!\I don't think I'm doing my job as a girlfriend right now.\I don't deserve to be paid for this.\What are you talking about?\You're doing fine. You're plenty cute as you are.\Besides, I wanted to meet the real you, anyway.\Brilliant.\You've played the role of Kazu-kun's girlfriend perfectly for a whole year. response:	You totally had me.
context: I don't think I'm doing my job as a girlfriend right now.\I don't deserve to be paid for this.\What are you talking about?\You're doing fine. You're plenty cute as you are.\Besides, I wanted to meet the real you, anyway.\Brilliant.\You've played the role of Kazu-kun's girlfriend perfectly for a whole year.\You totally had me. response:	That's so impressive. Just consider that your prize money.
context: I don't deserve to be paid for this.\What are you talking about?\You're doing fine. You're plenty cute as you are.\Besides, I wanted to meet the real you, anyway.\Brilliant.\You've played the role of Kazu-kun's girlfriend perfectly for a whole year.\You totally had me.\That's so impressive. Just consider that your prize money. response:	Sorry about the unpleasant surprise today.
context: What are you talking about?\You're doing fine. You're plenty cute as you are.\Besides, I wanted to meet the real you, anyway.\Brilliant.\You've played the role of Kazu-kun's girlfriend perfectly for a whole year.\You totally had me.\That's so impressive. Just consider that your prize money.\Sorry about the unpleasant surprise today. response:	But now I know what a rental girlfriend is all about.
context: You're doing fine. You're plenty cute as you are.\Besides, I wanted to meet the real you, anyway.\Brilliant.\You've played the role of Kazu-kun's girlfriend perfectly for a whole year.\You totally had me.\That's so impressive. Just consider that your prize money.\Sorry about the unpleasant surprise today.\But now I know what a rental girlfriend is all about. response:	And I have zero intention of criticizing your line of work.
context: Besides, I wanted to meet the real you, anyway.\Brilliant.\You've played the role of Kazu-kun's girlfriend perfectly for a whole year.\You totally had me.\That's so impressive. Just consider that your prize money.\Sorry about the unpleasant surprise today.\But now I know what a rental girlfriend is all about.\And I have zero intention of criticizing your line of work. response:	But let me just say one thing.
context: Brilliant.\You've played the role of Kazu-kun's girlfriend perfectly for a whole year.\You totally had me.\That's so impressive. Just consider that your prize money.\Sorry about the unpleasant surprise today.\But now I know what a rental girlfriend is all about.\And I have zero intention of criticizing your line of work.\But let me just say one thing. response:	Mizuhara Chizuru
context: You've played the role of Kazu-kun's girlfriend perfectly for a whole year.\You totally had me.\That's so impressive. Just consider that your prize money.\Sorry about the unpleasant surprise today.\But now I know what a rental girlfriend is all about.\And I have zero intention of criticizing your line of work.\But let me just say one thing.\Mizuhara Chizuru response:	A pure and refined high-class girlfriend
context: You totally had me.\That's so impressive. Just consider that your prize money.\Sorry about the unpleasant surprise today.\But now I know what a rental girlfriend is all about.\And I have zero intention of criticizing your line of work.\But let me just say one thing.\Mizuhara Chizuru\A pure and refined high-class girlfriend response:	Drop this fake couple business right now.
context: That's so impressive. Just consider that your prize money.\Sorry about the unpleasant surprise today.\But now I know what a rental girlfriend is all about.\And I have zero intention of criticizing your line of work.\But let me just say one thing.\Mizuhara Chizuru\A pure and refined high-class girlfriend\Drop this fake couple business right now. response:	I mean, the people at college seriously believe it's real.
context: Sorry about the unpleasant surprise today.\But now I know what a rental girlfriend is all about.\And I have zero intention of criticizing your line of work.\But let me just say one thing.\Mizuhara Chizuru\A pure and refined high-class girlfriend\Drop this fake couple business right now.\I mean, the people at college seriously believe it's real. response:	I can't watch it go on.
context: But now I know what a rental girlfriend is all about.\And I have zero intention of criticizing your line of work.\But let me just say one thing.\Mizuhara Chizuru\A pure and refined high-class girlfriend\Drop this fake couple business right now.\I mean, the people at college seriously believe it's real.\I can't watch it go on. response:	I feel sorry for Kazu-kun, too.
context: And I have zero intention of criticizing your line of work.\But let me just say one thing.\Mizuhara Chizuru\A pure and refined high-class girlfriend\Drop this fake couple business right now.\I mean, the people at college seriously believe it's real.\I can't watch it go on.\I feel sorry for Kazu-kun, too. response:	As long as he has a rental girlfriend, he'll never find a real one.
context: But let me just say one thing.\Mizuhara Chizuru\A pure and refined high-class girlfriend\Drop this fake couple business right now.\I mean, the people at college seriously believe it's real.\I can't watch it go on.\I feel sorry for Kazu-kun, too.\As long as he has a rental girlfriend, he'll never find a real one. response:	And this... loveless relationship of yours,
context: Mizuhara Chizuru\A pure and refined high-class girlfriend\Drop this fake couple business right now.\I mean, the people at college seriously believe it's real.\I can't watch it go on.\I feel sorry for Kazu-kun, too.\As long as he has a rental girlfriend, he'll never find a real one.\And this... loveless relationship of yours, response:	his paying money to show you off as his girlfriend,
context: A pure and refined high-class girlfriend\Drop this fake couple business right now.\I mean, the people at college seriously believe it's real.\I can't watch it go on.\I feel sorry for Kazu-kun, too.\As long as he has a rental girlfriend, he'll never find a real one.\And this... loveless relationship of yours,\his paying money to show you off as his girlfriend, response:	and your fake-ass smile...
context: Drop this fake couple business right now.\I mean, the people at college seriously believe it's real.\I can't watch it go on.\I feel sorry for Kazu-kun, too.\As long as he has a rental girlfriend, he'll never find a real one.\And this... loveless relationship of yours,\his paying money to show you off as his girlfriend,\and your fake-ass smile... response:	It all pisses me off just a teensy bit.
context: I mean, the people at college seriously believe it's real.\I can't watch it go on.\I feel sorry for Kazu-kun, too.\As long as he has a rental girlfriend, he'll never find a real one.\And this... loveless relationship of yours,\his paying money to show you off as his girlfriend,\and your fake-ass smile...\It all pisses me off just a teensy bit. response:	Thank you! Come again!
context: I can't watch it go on.\I feel sorry for Kazu-kun, too.\As long as he has a rental girlfriend, he'll never find a real one.\And this... loveless relationship of yours,\his paying money to show you off as his girlfriend,\and your fake-ass smile...\It all pisses me off just a teensy bit.\Thank you! Come again! response:	Karaoke Village
context: I feel sorry for Kazu-kun, too.\As long as he has a rental girlfriend, he'll never find a real one.\And this... loveless relationship of yours,\his paying money to show you off as his girlfriend,\and your fake-ass smile...\It all pisses me off just a teensy bit.\Thank you! Come again!\Karaoke Village response:	Kazuya-kun, what were you about to say earlier?
context: As long as he has a rental girlfriend, he'll never find a real one.\And this... loveless relationship of yours,\his paying money to show you off as his girlfriend,\and your fake-ass smile...\It all pisses me off just a teensy bit.\Thank you! Come again!\Karaoke Village\Kazuya-kun, what were you about to say earlier? response:	Sorry, Ruka-chan.
context: And this... loveless relationship of yours,\his paying money to show you off as his girlfriend,\and your fake-ass smile...\It all pisses me off just a teensy bit.\Thank you! Come again!\Karaoke Village\Kazuya-kun, what were you about to say earlier?\Sorry, Ruka-chan. response:	Not right now.
context: his paying money to show you off as his girlfriend,\and your fake-ass smile...\It all pisses me off just a teensy bit.\Thank you! Come again!\Karaoke Village\Kazuya-kun, what were you about to say earlier?\Sorry, Ruka-chan.\Not right now. response:	She knew!
context: and your fake-ass smile...\It all pisses me off just a teensy bit.\Thank you! Come again!\Karaoke Village\Kazuya-kun, what were you about to say earlier?\Sorry, Ruka-chan.\Not right now.\She knew! response:	I have to return your money.
context: It all pisses me off just a teensy bit.\Thank you! Come again!\Karaoke Village\Kazuya-kun, what were you about to say earlier?\Sorry, Ruka-chan.\Not right now.\She knew!\I have to return your money. response:	There did seem to be money involved.
context: Thank you! Come again!\Karaoke Village\Kazuya-kun, what were you about to say earlier?\Sorry, Ruka-chan.\Not right now.\She knew!\I have to return your money.\There did seem to be money involved. response:	It all pisses me off just a teensy bit.
context: Karaoke Village\Kazuya-kun, what were you about to say earlier?\Sorry, Ruka-chan.\Not right now.\She knew!\I have to return your money.\There did seem to be money involved.\It all pisses me off just a teensy bit. response:	And Mami-chan seemed mad!
context: Kazuya-kun, what were you about to say earlier?\Sorry, Ruka-chan.\Not right now.\She knew!\I have to return your money.\There did seem to be money involved.\It all pisses me off just a teensy bit.\And Mami-chan seemed mad! response:	So did she rent Mizuhara after finding out we were lying?
context: Sorry, Ruka-chan.\Not right now.\She knew!\I have to return your money.\There did seem to be money involved.\It all pisses me off just a teensy bit.\And Mami-chan seemed mad!\So did she rent Mizuhara after finding out we were lying? response:	Mizuhara's not in the wrong here.
context: Not right now.\She knew!\I have to return your money.\There did seem to be money involved.\It all pisses me off just a teensy bit.\And Mami-chan seemed mad!\So did she rent Mizuhara after finding out we were lying?\Mizuhara's not in the wrong here. response:	I am!
context: She knew!\I have to return your money.\There did seem to be money involved.\It all pisses me off just a teensy bit.\And Mami-chan seemed mad!\So did she rent Mizuhara after finding out we were lying?\Mizuhara's not in the wrong here.\I am! response:	She's just going along with my scheme out of pity!
context: I have to return your money.\There did seem to be money involved.\It all pisses me off just a teensy bit.\And Mami-chan seemed mad!\So did she rent Mizuhara after finding out we were lying?\Mizuhara's not in the wrong here.\I am!\She's just going along with my scheme out of pity! response:	I can't let her take all the heat!
context: There did seem to be money involved.\It all pisses me off just a teensy bit.\And Mami-chan seemed mad!\So did she rent Mizuhara after finding out we were lying?\Mizuhara's not in the wrong here.\I am!\She's just going along with my scheme out of pity!\I can't let her take all the heat! response:	Glug glug glug glug
context: It all pisses me off just a teensy bit.\And Mami-chan seemed mad!\So did she rent Mizuhara after finding out we were lying?\Mizuhara's not in the wrong here.\I am!\She's just going along with my scheme out of pity!\I can't let her take all the heat!\Glug glug glug glug response:	What's wrong with you, Kinoshita?!
context: And Mami-chan seemed mad!\So did she rent Mizuhara after finding out we were lying?\Mizuhara's not in the wrong here.\I am!\She's just going along with my scheme out of pity!\I can't let her take all the heat!\Glug glug glug glug\What's wrong with you, Kinoshita?! response:	Did you throw up?
context: So did she rent Mizuhara after finding out we were lying?\Mizuhara's not in the wrong here.\I am!\She's just going along with my scheme out of pity!\I can't let her take all the heat!\Glug glug glug glug\What's wrong with you, Kinoshita?!\Did you throw up? response:	Kazuya-kun?!
context: Mizuhara's not in the wrong here.\I am!\She's just going along with my scheme out of pity!\I can't let her take all the heat!\Glug glug glug glug\What's wrong with you, Kinoshita?!\Did you throw up?\Kazuya-kun?! response:	U g h...
context: I am!\She's just going along with my scheme out of pity!\I can't let her take all the heat!\Glug glug glug glug\What's wrong with you, Kinoshita?!\Did you throw up?\Kazuya-kun?!\U g h... response:	I'm sorry... I just got sick all of a sudden...
context: She's just going along with my scheme out of pity!\I can't let her take all the heat!\Glug glug glug glug\What's wrong with you, Kinoshita?!\Did you throw up?\Kazuya-kun?!\U g h...\I'm sorry... I just got sick all of a sudden... response:	Are you okay?!
context: I can't let her take all the heat!\Glug glug glug glug\What's wrong with you, Kinoshita?!\Did you throw up?\Kazuya-kun?!\U g h...\I'm sorry... I just got sick all of a sudden...\Are you okay?! response:	Don't apologize! Is it the flu?! Go on home already!
context: Glug glug glug glug\What's wrong with you, Kinoshita?!\Did you throw up?\Kazuya-kun?!\U g h...\I'm sorry... I just got sick all of a sudden...\Are you okay?!\Don't apologize! Is it the flu?! Go on home already! response:	Thank you. I'll go see a doctor.
context: What's wrong with you, Kinoshita?!\Did you throw up?\Kazuya-kun?!\U g h...\I'm sorry... I just got sick all of a sudden...\Are you okay?!\Don't apologize! Is it the flu?! Go on home already!\Thank you. I'll go see a doctor. response:	I'll take you there!
context: Did you throw up?\Kazuya-kun?!\U g h...\I'm sorry... I just got sick all of a sudden...\Are you okay?!\Don't apologize! Is it the flu?! Go on home already!\Thank you. I'll go see a doctor.\I'll take you there! response:	Nah.
context: Kazuya-kun?!\U g h...\I'm sorry... I just got sick all of a sudden...\Are you okay?!\Don't apologize! Is it the flu?! Go on home already!\Thank you. I'll go see a doctor.\I'll take you there!\Nah. response:	I don't want to pass it on to you, and we can't both take off work at once.
context: U g h...\I'm sorry... I just got sick all of a sudden...\Are you okay?!\Don't apologize! Is it the flu?! Go on home already!\Thank you. I'll go see a doctor.\I'll take you there!\Nah.\I don't want to pass it on to you, and we can't both take off work at once. response:	Kazuya-kun...
context: I'm sorry... I just got sick all of a sudden...\Are you okay?!\Don't apologize! Is it the flu?! Go on home already!\Thank you. I'll go see a doctor.\I'll take you there!\Nah.\I don't want to pass it on to you, and we can't both take off work at once.\Kazuya-kun... response:	I'm sorry.
context: Are you okay?!\Don't apologize! Is it the flu?! Go on home already!\Thank you. I'll go see a doctor.\I'll take you there!\Nah.\I don't want to pass it on to you, and we can't both take off work at once.\Kazuya-kun...\I'm sorry. response:	Which way did they go?!
context: Don't apologize! Is it the flu?! Go on home already!\Thank you. I'll go see a doctor.\I'll take you there!\Nah.\I don't want to pass it on to you, and we can't both take off work at once.\Kazuya-kun...\I'm sorry.\Which way did they go?! response:	The station? They can't have gotten too far!
context: Thank you. I'll go see a doctor.\I'll take you there!\Nah.\I don't want to pass it on to you, and we can't both take off work at once.\Kazuya-kun...\I'm sorry.\Which way did they go?!\The station? They can't have gotten too far! response:	This is all on me!
context: I'll take you there!\Nah.\I don't want to pass it on to you, and we can't both take off work at once.\Kazuya-kun...\I'm sorry.\Which way did they go?!\The station? They can't have gotten too far!\This is all on me! response:	Drop this fake couple business right now.
context: Nah.\I don't want to pass it on to you, and we can't both take off work at once.\Kazuya-kun...\I'm sorry.\Which way did they go?!\The station? They can't have gotten too far!\This is all on me!\Drop this fake couple business right now. response:	It's all on me for trying to act cool in front of my friends!
context: I don't want to pass it on to you, and we can't both take off work at once.\Kazuya-kun...\I'm sorry.\Which way did they go?!\The station? They can't have gotten too far!\This is all on me!\Drop this fake couple business right now.\It's all on me for trying to act cool in front of my friends! response:	Mizuhara's about to quit the business, too.
context: Kazuya-kun...\I'm sorry.\Which way did they go?!\The station? They can't have gotten too far!\This is all on me!\Drop this fake couple business right now.\It's all on me for trying to act cool in front of my friends!\Mizuhara's about to quit the business, too. response:	Why'd this have to happen right before it all ended?!
context: I'm sorry.\Which way did they go?!\The station? They can't have gotten too far!\This is all on me!\Drop this fake couple business right now.\It's all on me for trying to act cool in front of my friends!\Mizuhara's about to quit the business, too.\Why'd this have to happen right before it all ended?! response:	Sorry, Mizuhara...
context: Which way did they go?!\The station? They can't have gotten too far!\This is all on me!\Drop this fake couple business right now.\It's all on me for trying to act cool in front of my friends!\Mizuhara's about to quit the business, too.\Why'd this have to happen right before it all ended?!\Sorry, Mizuhara... response:	I'm so sorry!
context: The station? They can't have gotten too far!\This is all on me!\Drop this fake couple business right now.\It's all on me for trying to act cool in front of my friends!\Mizuhara's about to quit the business, too.\Why'd this have to happen right before it all ended?!\Sorry, Mizuhara...\I'm so sorry! response:	F-Found them.
context: This is all on me!\Drop this fake couple business right now.\It's all on me for trying to act cool in front of my friends!\Mizuhara's about to quit the business, too.\Why'd this have to happen right before it all ended?!\Sorry, Mizuhara...\I'm so sorry!\F-Found them. response:	Rent - a - Girlfriend
context: Drop this fake couple business right now.\It's all on me for trying to act cool in front of my friends!\Mizuhara's about to quit the business, too.\Why'd this have to happen right before it all ended?!\Sorry, Mizuhara...\I'm so sorry!\F-Found them.\Rent - a - Girlfriend response:	Mizuhara!
context: It's all on me for trying to act cool in front of my friends!\Mizuhara's about to quit the business, too.\Why'd this have to happen right before it all ended?!\Sorry, Mizuhara...\I'm so sorry!\F-Found them.\Rent - a - Girlfriend\Mizuhara! response:	Don't be seen
context: Mizuhara's about to quit the business, too.\Why'd this have to happen right before it all ended?!\Sorry, Mizuhara...\I'm so sorry!\F-Found them.\Rent - a - Girlfriend\Mizuhara!\Don't be seen response:	Don't be seen
context: Why'd this have to happen right before it all ended?!\Sorry, Mizuhara...\I'm so sorry!\F-Found them.\Rent - a - Girlfriend\Mizuhara!\Don't be seen\Don't be seen response:	I'm good from here.
context: Sorry, Mizuhara...\I'm so sorry!\F-Found them.\Rent - a - Girlfriend\Mizuhara!\Don't be seen\Don't be seen\I'm good from here. response:	Again, sorry about the nasty surprise.
context: I'm so sorry!\F-Found them.\Rent - a - Girlfriend\Mizuhara!\Don't be seen\Don't be seen\I'm good from here.\Again, sorry about the nasty surprise. response:	But hey, nothing wrong with a girl renting you, right?
context: F-Found them.\Rent - a - Girlfriend\Mizuhara!\Don't be seen\Don't be seen\I'm good from here.\Again, sorry about the nasty surprise.\But hey, nothing wrong with a girl renting you, right? response:	Has it happened before?
context: Rent - a - Girlfriend\Mizuhara!\Don't be seen\Don't be seen\I'm good from here.\Again, sorry about the nasty surprise.\But hey, nothing wrong with a girl renting you, right?\Has it happened before? response:	No, not with me.
context: Mizuhara!\Don't be seen\Don't be seen\I'm good from here.\Again, sorry about the nasty surprise.\But hey, nothing wrong with a girl renting you, right?\Has it happened before?\No, not with me. response:	Well, that's unexpected, with so many lonely people around nowadays.
context: Don't be seen\Don't be seen\I'm good from here.\Again, sorry about the nasty surprise.\But hey, nothing wrong with a girl renting you, right?\Has it happened before?\No, not with me.\Well, that's unexpected, with so many lonely people around nowadays. response:	To be clear, I'm not about to reject your line of work.
context: Don't be seen\I'm good from here.\Again, sorry about the nasty surprise.\But hey, nothing wrong with a girl renting you, right?\Has it happened before?\No, not with me.\Well, that's unexpected, with so many lonely people around nowadays.\To be clear, I'm not about to reject your line of work. response:	I just thought it'd be weird not to let you know that I know.
context: I'm good from here.\Again, sorry about the nasty surprise.\But hey, nothing wrong with a girl renting you, right?\Has it happened before?\No, not with me.\Well, that's unexpected, with so many lonely people around nowadays.\To be clear, I'm not about to reject your line of work.\I just thought it'd be weird not to let you know that I know. response:	Don't worry. I won't tell anyone at college.
context: Again, sorry about the nasty surprise.\But hey, nothing wrong with a girl renting you, right?\Has it happened before?\No, not with me.\Well, that's unexpected, with so many lonely people around nowadays.\To be clear, I'm not about to reject your line of work.\I just thought it'd be weird not to let you know that I know.\Don't worry. I won't tell anyone at college. response:	I got my point across, and I had fun along the way.
context: But hey, nothing wrong with a girl renting you, right?\Has it happened before?\No, not with me.\Well, that's unexpected, with so many lonely people around nowadays.\To be clear, I'm not about to reject your line of work.\I just thought it'd be weird not to let you know that I know.\Don't worry. I won't tell anyone at college.\I got my point across, and I had fun along the way. response:	You're so cute.
context: Has it happened before?\No, not with me.\Well, that's unexpected, with so many lonely people around nowadays.\To be clear, I'm not about to reject your line of work.\I just thought it'd be weird not to let you know that I know.\Don't worry. I won't tell anyone at college.\I got my point across, and I had fun along the way.\You're so cute. response:	I bet you have all the boys up in seventh heaven.
context: No, not with me.\Well, that's unexpected, with so many lonely people around nowadays.\To be clear, I'm not about to reject your line of work.\I just thought it'd be weird not to let you know that I know.\Don't worry. I won't tell anyone at college.\I got my point across, and I had fun along the way.\You're so cute.\I bet you have all the boys up in seventh heaven. response:	Well, later.
context: Well, that's unexpected, with so many lonely people around nowadays.\To be clear, I'm not about to reject your line of work.\I just thought it'd be weird not to let you know that I know.\Don't worry. I won't tell anyone at college.\I got my point across, and I had fun along the way.\You're so cute.\I bet you have all the boys up in seventh heaven.\Well, later. response:	How do you feel?
context: To be clear, I'm not about to reject your line of work.\I just thought it'd be weird not to let you know that I know.\Don't worry. I won't tell anyone at college.\I got my point across, and I had fun along the way.\You're so cute.\I bet you have all the boys up in seventh heaven.\Well, later.\How do you feel? response:	About Kazuya-san.
context: I just thought it'd be weird not to let you know that I know.\Don't worry. I won't tell anyone at college.\I got my point across, and I had fun along the way.\You're so cute.\I bet you have all the boys up in seventh heaven.\Well, later.\How do you feel?\About Kazuya-san. response:	He has mentioned to me that he swore he'd make you happy...
context: Don't worry. I won't tell anyone at college.\I got my point across, and I had fun along the way.\You're so cute.\I bet you have all the boys up in seventh heaven.\Well, later.\How do you feel?\About Kazuya-san.\He has mentioned to me that he swore he'd make you happy... response:	That you aren't someone he could just forget.
context: I got my point across, and I had fun along the way.\You're so cute.\I bet you have all the boys up in seventh heaven.\Well, later.\How do you feel?\About Kazuya-san.\He has mentioned to me that he swore he'd make you happy...\That you aren't someone he could just forget. response:	Deleting those feelings so easily just seems shallow to me.
context: You're so cute.\I bet you have all the boys up in seventh heaven.\Well, later.\How do you feel?\About Kazuya-san.\He has mentioned to me that he swore he'd make you happy...\That you aren't someone he could just forget.\Deleting those feelings so easily just seems shallow to me. response:	I'm such scum, huh?
context: I bet you have all the boys up in seventh heaven.\Well, later.\How do you feel?\About Kazuya-san.\He has mentioned to me that he swore he'd make you happy...\That you aren't someone he could just forget.\Deleting those feelings so easily just seems shallow to me.\I'm such scum, huh? response:	Getting all pathetic over something that's in the past...
context: Well, later.\How do you feel?\About Kazuya-san.\He has mentioned to me that he swore he'd make you happy...\That you aren't someone he could just forget.\Deleting those feelings so easily just seems shallow to me.\I'm such scum, huh?\Getting all pathetic over something that's in the past... response:	I'm sure you still hold a special place in his heart.
context: How do you feel?\About Kazuya-san.\He has mentioned to me that he swore he'd make you happy...\That you aren't someone he could just forget.\Deleting those feelings so easily just seems shallow to me.\I'm such scum, huh?\Getting all pathetic over something that's in the past...\I'm sure you still hold a special place in his heart. response:	And you?
context: About Kazuya-san.\He has mentioned to me that he swore he'd make you happy...\That you aren't someone he could just forget.\Deleting those feelings so easily just seems shallow to me.\I'm such scum, huh?\Getting all pathetic over something that's in the past...\I'm sure you still hold a special place in his heart.\And you? response:	How do you feel about him?
context: He has mentioned to me that he swore he'd make you happy...\That you aren't someone he could just forget.\Deleting those feelings so easily just seems shallow to me.\I'm such scum, huh?\Getting all pathetic over something that's in the past...\I'm sure you still hold a special place in his heart.\And you?\How do you feel about him? response:	What do you mean?
context: That you aren't someone he could just forget.\Deleting those feelings so easily just seems shallow to me.\I'm such scum, huh?\Getting all pathetic over something that's in the past...\I'm sure you still hold a special place in his heart.\And you?\How do you feel about him?\What do you mean? response:	I mean, it's been a year.
context: Deleting those feelings so easily just seems shallow to me.\I'm such scum, huh?\Getting all pathetic over something that's in the past...\I'm sure you still hold a special place in his heart.\And you?\How do you feel about him?\What do you mean?\I mean, it's been a year. response:	You've played his girlfriend for an entire year.
context: I'm such scum, huh?\Getting all pathetic over something that's in the past...\I'm sure you still hold a special place in his heart.\And you?\How do you feel about him?\What do you mean?\I mean, it's been a year.\You've played his girlfriend for an entire year. response:	Does your agency know about this?
context: Getting all pathetic over something that's in the past...\I'm sure you still hold a special place in his heart.\And you?\How do you feel about him?\What do you mean?\I mean, it's been a year.\You've played his girlfriend for an entire year.\Does your agency know about this? response:	You could've fallen for him while being his rental girlfriend.
context: I'm sure you still hold a special place in his heart.\And you?\How do you feel about him?\What do you mean?\I mean, it's been a year.\You've played his girlfriend for an entire year.\Does your agency know about this?\You could've fallen for him while being his rental girlfriend. response:	It's possible, isn't it?
context: And you?\How do you feel about him?\What do you mean?\I mean, it's been a year.\You've played his girlfriend for an entire year.\Does your agency know about this?\You could've fallen for him while being his rental girlfriend.\It's possible, isn't it? response:	He's my boyfriend!
context: How do you feel about him?\What do you mean?\I mean, it's been a year.\You've played his girlfriend for an entire year.\Does your agency know about this?\You could've fallen for him while being his rental girlfriend.\It's possible, isn't it?\He's my boyfriend! response:	Wow. Way to dodge the question.
context: What do you mean?\I mean, it's been a year.\You've played his girlfriend for an entire year.\Does your agency know about this?\You could've fallen for him while being his rental girlfriend.\It's possible, isn't it?\He's my boyfriend!\Wow. Way to dodge the question. response:	Is that part of your shtick, too?
context: I mean, it's been a year.\You've played his girlfriend for an entire year.\Does your agency know about this?\You could've fallen for him while being his rental girlfriend.\It's possible, isn't it?\He's my boyfriend!\Wow. Way to dodge the question.\Is that part of your shtick, too? response:	Well, you must have your reasons. I'm not gonna poke and pry.
context: You've played his girlfriend for an entire year.\Does your agency know about this?\You could've fallen for him while being his rental girlfriend.\It's possible, isn't it?\He's my boyfriend!\Wow. Way to dodge the question.\Is that part of your shtick, too?\Well, you must have your reasons. I'm not gonna poke and pry. response:	But hey, you're only human, right?
context: Does your agency know about this?\You could've fallen for him while being his rental girlfriend.\It's possible, isn't it?\He's my boyfriend!\Wow. Way to dodge the question.\Is that part of your shtick, too?\Well, you must have your reasons. I'm not gonna poke and pry.\But hey, you're only human, right? response:	That's enough.
context: You could've fallen for him while being his rental girlfriend.\It's possible, isn't it?\He's my boyfriend!\Wow. Way to dodge the question.\Is that part of your shtick, too?\Well, you must have your reasons. I'm not gonna poke and pry.\But hey, you're only human, right?\That's enough. response:	I just thought it was a possibility.
context: It's possible, isn't it?\He's my boyfriend!\Wow. Way to dodge the question.\Is that part of your shtick, too?\Well, you must have your reasons. I'm not gonna poke and pry.\But hey, you're only human, right?\That's enough.\I just thought it was a possibility. response:	You've done enough, Mizuhara.
context: He's my boyfriend!\Wow. Way to dodge the question.\Is that part of your shtick, too?\Well, you must have your reasons. I'm not gonna poke and pry.\But hey, you're only human, right?\That's enough.\I just thought it was a possibility.\You've done enough, Mizuhara. response:	Goodbye.
context: Wow. Way to dodge the question.\Is that part of your shtick, too?\Well, you must have your reasons. I'm not gonna poke and pry.\But hey, you're only human, right?\That's enough.\I just thought it was a possibility.\You've done enough, Mizuhara.\Goodbye. response:	You have no idea how much I liked Mami-chan,
context: Is that part of your shtick, too?\Well, you must have your reasons. I'm not gonna poke and pry.\But hey, you're only human, right?\That's enough.\I just thought it was a possibility.\You've done enough, Mizuhara.\Goodbye.\You have no idea how much I liked Mami-chan, response:	or how hurt I was when she dumped me!
context: Well, you must have your reasons. I'm not gonna poke and pry.\But hey, you're only human, right?\That's enough.\I just thought it was a possibility.\You've done enough, Mizuhara.\Goodbye.\You have no idea how much I liked Mami-chan,\or how hurt I was when she dumped me! response:	I'm so sorry, Mizuhara.
context: But hey, you're only human, right?\That's enough.\I just thought it was a possibility.\You've done enough, Mizuhara.\Goodbye.\You have no idea how much I liked Mami-chan,\or how hurt I was when she dumped me!\I'm so sorry, Mizuhara. response:	I really don't know what's wrong with me.
context: That's enough.\I just thought it was a possibility.\You've done enough, Mizuhara.\Goodbye.\You have no idea how much I liked Mami-chan,\or how hurt I was when she dumped me!\I'm so sorry, Mizuhara.\I really don't know what's wrong with me. response:	Wait.
context: I just thought it was a possibility.\You've done enough, Mizuhara.\Goodbye.\You have no idea how much I liked Mami-chan,\or how hurt I was when she dumped me!\I'm so sorry, Mizuhara.\I really don't know what's wrong with me.\Wait. response:	Wait, please!
context: You've done enough, Mizuhara.\Goodbye.\You have no idea how much I liked Mami-chan,\or how hurt I was when she dumped me!\I'm so sorry, Mizuhara.\I really don't know what's wrong with me.\Wait.\Wait, please! response:	We're not done here!
context: Goodbye.\You have no idea how much I liked Mami-chan,\or how hurt I was when she dumped me!\I'm so sorry, Mizuhara.\I really don't know what's wrong with me.\Wait.\Wait, please!\We're not done here! response:	Give it some more thought!
context: You have no idea how much I liked Mami-chan,\or how hurt I was when she dumped me!\I'm so sorry, Mizuhara.\I really don't know what's wrong with me.\Wait.\Wait, please!\We're not done here!\Give it some more thought! response:	Give him a chance!
context: or how hurt I was when she dumped me!\I'm so sorry, Mizuhara.\I really don't know what's wrong with me.\Wait.\Wait, please!\We're not done here!\Give it some more thought!\Give him a chance! response:	Being a rental girlfriend helped me realize just how important love really is,
context: I'm so sorry, Mizuhara.\I really don't know what's wrong with me.\Wait.\Wait, please!\We're not done here!\Give it some more thought!\Give him a chance!\Being a rental girlfriend helped me realize just how important love really is, response:	and how difficult it really is to fall in love with someone!
context: I really don't know what's wrong with me.\Wait.\Wait, please!\We're not done here!\Give it some more thought!\Give him a chance!\Being a rental girlfriend helped me realize just how important love really is,\and how difficult it really is to fall in love with someone! response:	Have you ever faced his feelings for you head-on and in good faith?
context: Wait.\Wait, please!\We're not done here!\Give it some more thought!\Give him a chance!\Being a rental girlfriend helped me realize just how important love really is,\and how difficult it really is to fall in love with someone!\Have you ever faced his feelings for you head-on and in good faith? response:	Have you ever seriously tried to engage with his love for you?
context: Wait, please!\We're not done here!\Give it some more thought!\Give him a chance!\Being a rental girlfriend helped me realize just how important love really is,\and how difficult it really is to fall in love with someone!\Have you ever faced his feelings for you head-on and in good faith?\Have you ever seriously tried to engage with his love for you? response:	Have you...
context: We're not done here!\Give it some more thought!\Give him a chance!\Being a rental girlfriend helped me realize just how important love really is,\and how difficult it really is to fall in love with someone!\Have you ever faced his feelings for you head-on and in good faith?\Have you ever seriously tried to engage with his love for you?\Have you... response:	ever considered that he could be the one to make you happy for life?
context: Give it some more thought!\Give him a chance!\Being a rental girlfriend helped me realize just how important love really is,\and how difficult it really is to fall in love with someone!\Have you ever faced his feelings for you head-on and in good faith?\Have you ever seriously tried to engage with his love for you?\Have you...\ever considered that he could be the one to make you happy for life? response:	Buzz off.
context: Give him a chance!\Being a rental girlfriend helped me realize just how important love really is,\and how difficult it really is to fall in love with someone!\Have you ever faced his feelings for you head-on and in good faith?\Have you ever seriously tried to engage with his love for you?\Have you...\ever considered that he could be the one to make you happy for life?\Buzz off. response:	That's between him and me.
context: Being a rental girlfriend helped me realize just how important love really is,\and how difficult it really is to fall in love with someone!\Have you ever faced his feelings for you head-on and in good faith?\Have you ever seriously tried to engage with his love for you?\Have you...\ever considered that he could be the one to make you happy for life?\Buzz off.\That's between him and me. response:	Kinoshita
context: and how difficult it really is to fall in love with someone!\Have you ever faced his feelings for you head-on and in good faith?\Have you ever seriously tried to engage with his love for you?\Have you...\ever considered that he could be the one to make you happy for life?\Buzz off.\That's between him and me.\Kinoshita response:	Kinoshita
context: Have you ever faced his feelings for you head-on and in good faith?\Have you ever seriously tried to engage with his love for you?\Have you...\ever considered that he could be the one to make you happy for life?\Buzz off.\That's between him and me.\Kinoshita\Kinoshita response:	Hey.
context: Have you ever seriously tried to engage with his love for you?\Have you...\ever considered that he could be the one to make you happy for life?\Buzz off.\That's between him and me.\Kinoshita\Kinoshita\Hey. response:	You're in my way.
context: Have you...\ever considered that he could be the one to make you happy for life?\Buzz off.\That's between him and me.\Kinoshita\Kinoshita\Hey.\You're in my way. response:	S-Sorry.
context: ever considered that he could be the one to make you happy for life?\Buzz off.\That's between him and me.\Kinoshita\Kinoshita\Hey.\You're in my way.\S-Sorry. response:	And thanks.
context: Buzz off.\That's between him and me.\Kinoshita\Kinoshita\Hey.\You're in my way.\S-Sorry.\And thanks. response:	I saw the whole thing... with Mami-chan.
context: That's between him and me.\Kinoshita\Kinoshita\Hey.\You're in my way.\S-Sorry.\And thanks.\I saw the whole thing... with Mami-chan. response:	What?!
context: Kinoshita\Kinoshita\Hey.\You're in my way.\S-Sorry.\And thanks.\I saw the whole thing... with Mami-chan.\What?! response:	What do you mean, you saw it?!
context: Kinoshita\Hey.\You're in my way.\S-Sorry.\And thanks.\I saw the whole thing... with Mami-chan.\What?!\What do you mean, you saw it?! response:	Ichinose
context: Hey.\You're in my way.\S-Sorry.\And thanks.\I saw the whole thing... with Mami-chan.\What?!\What do you mean, you saw it?!\Ichinose response:	I wasn't stalking or anything!
context: You're in my way.\S-Sorry.\And thanks.\I saw the whole thing... with Mami-chan.\What?!\What do you mean, you saw it?!\Ichinose\I wasn't stalking or anything! response:	I wasn't stalking or anything!!
context: S-Sorry.\And thanks.\I saw the whole thing... with Mami-chan.\What?!\What do you mean, you saw it?!\Ichinose\I wasn't stalking or anything!\I wasn't stalking or anything!! response:	I work at that karaoke place!
context: And thanks.\I saw the whole thing... with Mami-chan.\What?!\What do you mean, you saw it?!\Ichinose\I wasn't stalking or anything!\I wasn't stalking or anything!!\I work at that karaoke place! response:	You work there!?
context: I saw the whole thing... with Mami-chan.\What?!\What do you mean, you saw it?!\Ichinose\I wasn't stalking or anything!\I wasn't stalking or anything!!\I work at that karaoke place!\You work there!? response:	You work there?!
context: What?!\What do you mean, you saw it?!\Ichinose\I wasn't stalking or anything!\I wasn't stalking or anything!!\I work at that karaoke place!\You work there!?\You work there?! response:	I spotted you two there, and... you know...
context: What do you mean, you saw it?!\Ichinose\I wasn't stalking or anything!\I wasn't stalking or anything!!\I work at that karaoke place!\You work there!?\You work there?!\I spotted you two there, and... you know... response:	Thank you. You spoke up for me when I don't have the guts to.
context: Ichinose\I wasn't stalking or anything!\I wasn't stalking or anything!!\I work at that karaoke place!\You work there!?\You work there?!\I spotted you two there, and... you know...\Thank you. You spoke up for me when I don't have the guts to. response:	I have to apologize to you, then.
context: I wasn't stalking or anything!\I wasn't stalking or anything!!\I work at that karaoke place!\You work there!?\You work there?!\I spotted you two there, and... you know...\Thank you. You spoke up for me when I don't have the guts to.\I have to apologize to you, then. response:	I couldn't get you a girlfriend.
context: I wasn't stalking or anything!!\I work at that karaoke place!\You work there!?\You work there?!\I spotted you two there, and... you know...\Thank you. You spoke up for me when I don't have the guts to.\I have to apologize to you, then.\I couldn't get you a girlfriend. response:	I tried everything I could, but it was too tall an order for me.
context: I work at that karaoke place!\You work there!?\You work there?!\I spotted you two there, and... you know...\Thank you. You spoke up for me when I don't have the guts to.\I have to apologize to you, then.\I couldn't get you a girlfriend.\I tried everything I could, but it was too tall an order for me. response:	Why are you apologizing?
context: You work there!?\You work there?!\I spotted you two there, and... you know...\Thank you. You spoke up for me when I don't have the guts to.\I have to apologize to you, then.\I couldn't get you a girlfriend.\I tried everything I could, but it was too tall an order for me.\Why are you apologizing? response:	I believe not moving on is a form of love, too.
context: You work there?!\I spotted you two there, and... you know...\Thank you. You spoke up for me when I don't have the guts to.\I have to apologize to you, then.\I couldn't get you a girlfriend.\I tried everything I could, but it was too tall an order for me.\Why are you apologizing?\I believe not moving on is a form of love, too. response:	Everyone has regrets in life.
context: I spotted you two there, and... you know...\Thank you. You spoke up for me when I don't have the guts to.\I have to apologize to you, then.\I couldn't get you a girlfriend.\I tried everything I could, but it was too tall an order for me.\Why are you apologizing?\I believe not moving on is a form of love, too.\Everyone has regrets in life. response:	Why are you taking this so seriously outside of your job?
context: Thank you. You spoke up for me when I don't have the guts to.\I have to apologize to you, then.\I couldn't get you a girlfriend.\I tried everything I could, but it was too tall an order for me.\Why are you apologizing?\I believe not moving on is a form of love, too.\Everyone has regrets in life.\Why are you taking this so seriously outside of your job? response:	It's one thing to forget about them, but coming to terms with them isn't easy.
context: I have to apologize to you, then.\I couldn't get you a girlfriend.\I tried everything I could, but it was too tall an order for me.\Why are you apologizing?\I believe not moving on is a form of love, too.\Everyone has regrets in life.\Why are you taking this so seriously outside of your job?\It's one thing to forget about them, but coming to terms with them isn't easy. response:	Why are you putting my feelings first?
context: I couldn't get you a girlfriend.\I tried everything I could, but it was too tall an order for me.\Why are you apologizing?\I believe not moving on is a form of love, too.\Everyone has regrets in life.\Why are you taking this so seriously outside of your job?\It's one thing to forget about them, but coming to terms with them isn't easy.\Why are you putting my feelings first? response:	Have you ever faced his feelings for you head-on and in good faith?
context: I tried everything I could, but it was too tall an order for me.\Why are you apologizing?\I believe not moving on is a form of love, too.\Everyone has regrets in life.\Why are you taking this so seriously outside of your job?\It's one thing to forget about them, but coming to terms with them isn't easy.\Why are you putting my feelings first?\Have you ever faced his feelings for you head-on and in good faith? response:	I'm just a moron who did this to himself... so why?!
context: Why are you apologizing?\I believe not moving on is a form of love, too.\Everyone has regrets in life.\Why are you taking this so seriously outside of your job?\It's one thing to forget about them, but coming to terms with them isn't easy.\Why are you putting my feelings first?\Have you ever faced his feelings for you head-on and in good faith?\I'm just a moron who did this to himself... so why?! response:	Have you ever considered that he could be the one to make you happy for life?
context: I believe not moving on is a form of love, too.\Everyone has regrets in life.\Why are you taking this so seriously outside of your job?\It's one thing to forget about them, but coming to terms with them isn't easy.\Why are you putting my feelings first?\Have you ever faced his feelings for you head-on and in good faith?\I'm just a moron who did this to himself... so why?!\Have you ever considered that he could be the one to make you happy for life? response:	Yeah, I really do love you.
context: Everyone has regrets in life.\Why are you taking this so seriously outside of your job?\It's one thing to forget about them, but coming to terms with them isn't easy.\Why are you putting my feelings first?\Have you ever faced his feelings for you head-on and in good faith?\I'm just a moron who did this to himself... so why?!\Have you ever considered that he could be the one to make you happy for life?\Yeah, I really do love you. response:	We're trying to get you a real girlfriend,
context: Why are you taking this so seriously outside of your job?\It's one thing to forget about them, but coming to terms with them isn't easy.\Why are you putting my feelings first?\Have you ever faced his feelings for you head-on and in good faith?\I'm just a moron who did this to himself... so why?!\Have you ever considered that he could be the one to make you happy for life?\Yeah, I really do love you.\We're trying to get you a real girlfriend, response:	I love your long, black hair.
context: It's one thing to forget about them, but coming to terms with them isn't easy.\Why are you putting my feelings first?\Have you ever faced his feelings for you head-on and in good faith?\I'm just a moron who did this to himself... so why?!\Have you ever considered that he could be the one to make you happy for life?\Yeah, I really do love you.\We're trying to get you a real girlfriend,\I love your long, black hair. response:	so your feelings take top priority. That won't change.
context: Why are you putting my feelings first?\Have you ever faced his feelings for you head-on and in good faith?\I'm just a moron who did this to himself... so why?!\Have you ever considered that he could be the one to make you happy for life?\Yeah, I really do love you.\We're trying to get you a real girlfriend,\I love your long, black hair.\so your feelings take top priority. That won't change. response:	I love your long legs.
context: Have you ever faced his feelings for you head-on and in good faith?\I'm just a moron who did this to himself... so why?!\Have you ever considered that he could be the one to make you happy for life?\Yeah, I really do love you.\We're trying to get you a real girlfriend,\I love your long, black hair.\so your feelings take top priority. That won't change.\I love your long legs. response:	You're blunt as all hell, but also too nice for your own good.
context: I'm just a moron who did this to himself... so why?!\Have you ever considered that he could be the one to make you happy for life?\Yeah, I really do love you.\We're trying to get you a real girlfriend,\I love your long, black hair.\so your feelings take top priority. That won't change.\I love your long legs.\You're blunt as all hell, but also too nice for your own good. response:	And you're a harsh critic,
context: Have you ever considered that he could be the one to make you happy for life?\Yeah, I really do love you.\We're trying to get you a real girlfriend,\I love your long, black hair.\so your feelings take top priority. That won't change.\I love your long legs.\You're blunt as all hell, but also too nice for your own good.\And you're a harsh critic, response:	but you also show more empathy than anyone else.
context: Yeah, I really do love you.\We're trying to get you a real girlfriend,\I love your long, black hair.\so your feelings take top priority. That won't change.\I love your long legs.\You're blunt as all hell, but also too nice for your own good.\And you're a harsh critic,\but you also show more empathy than anyone else. response:	You do have that thing with Ruka-chan...
context: We're trying to get you a real girlfriend,\I love your long, black hair.\so your feelings take top priority. That won't change.\I love your long legs.\You're blunt as all hell, but also too nice for your own good.\And you're a harsh critic,\but you also show more empathy than anyone else.\You do have that thing with Ruka-chan... response:	But if you still can't forget about Mami-san,
context: I love your long, black hair.\so your feelings take top priority. That won't change.\I love your long legs.\You're blunt as all hell, but also too nice for your own good.\And you're a harsh critic,\but you also show more empathy than anyone else.\You do have that thing with Ruka-chan...\But if you still can't forget about Mami-san, response:	it might be a good idea to ask her out again, at least to get some closure.
context: so your feelings take top priority. That won't change.\I love your long legs.\You're blunt as all hell, but also too nice for your own good.\And you're a harsh critic,\but you also show more empathy than anyone else.\You do have that thing with Ruka-chan...\But if you still can't forget about Mami-san,\it might be a good idea to ask her out again, at least to get some closure. response:	As problematic as it may be, every time I see you, I can't help but feel
context: I love your long legs.\You're blunt as all hell, but also too nice for your own good.\And you're a harsh critic,\but you also show more empathy than anyone else.\You do have that thing with Ruka-chan...\But if you still can't forget about Mami-san,\it might be a good idea to ask her out again, at least to get some closure.\As problematic as it may be, every time I see you, I can't help but feel response:	that life would be so good if you were my girlfriend!
context: You're blunt as all hell, but also too nice for your own good.\And you're a harsh critic,\but you also show more empathy than anyone else.\You do have that thing with Ruka-chan...\But if you still can't forget about Mami-san,\it might be a good idea to ask her out again, at least to get some closure.\As problematic as it may be, every time I see you, I can't help but feel\that life would be so good if you were my girlfriend! response:	Of course, I understand if you can't work up the courage immediately.
context: And you're a harsh critic,\but you also show more empathy than anyone else.\You do have that thing with Ruka-chan...\But if you still can't forget about Mami-san,\it might be a good idea to ask her out again, at least to get some closure.\As problematic as it may be, every time I see you, I can't help but feel\that life would be so good if you were my girlfriend!\Of course, I understand if you can't work up the courage immediately. response:	I'll be there for you all the way, as your rental girlfriend.
context: but you also show more empathy than anyone else.\You do have that thing with Ruka-chan...\But if you still can't forget about Mami-san,\it might be a good idea to ask her out again, at least to get some closure.\As problematic as it may be, every time I see you, I can't help but feel\that life would be so good if you were my girlfriend!\Of course, I understand if you can't work up the courage immediately.\I'll be there for you all the way, as your rental girlfriend. response:	You're the one I want!
context: You do have that thing with Ruka-chan...\But if you still can't forget about Mami-san,\it might be a good idea to ask her out again, at least to get some closure.\As problematic as it may be, every time I see you, I can't help but feel\that life would be so good if you were my girlfriend!\Of course, I understand if you can't work up the courage immediately.\I'll be there for you all the way, as your rental girlfriend.\You're the one I want! response:	It's gotta be you!
context: But if you still can't forget about Mami-san,\it might be a good idea to ask her out again, at least to get some closure.\As problematic as it may be, every time I see you, I can't help but feel\that life would be so good if you were my girlfriend!\Of course, I understand if you can't work up the courage immediately.\I'll be there for you all the way, as your rental girlfriend.\You're the one I want!\It's gotta be you! response:	Rent-a-Girlfriend
context: it might be a good idea to ask her out again, at least to get some closure.\As problematic as it may be, every time I see you, I can't help but feel\that life would be so good if you were my girlfriend!\Of course, I understand if you can't work up the courage immediately.\I'll be there for you all the way, as your rental girlfriend.\You're the one I want!\It's gotta be you!\Rent-a-Girlfriend response:	I'm the one you want?
context: As problematic as it may be, every time I see you, I can't help but feel\that life would be so good if you were my girlfriend!\Of course, I understand if you can't work up the courage immediately.\I'll be there for you all the way, as your rental girlfriend.\You're the one I want!\It's gotta be you!\Rent-a-Girlfriend\I'm the one you want? response:	What's that supposed to mean?
context: that life would be so good if you were my girlfriend!\Of course, I understand if you can't work up the courage immediately.\I'll be there for you all the way, as your rental girlfriend.\You're the one I want!\It's gotta be you!\Rent-a-Girlfriend\I'm the one you want?\What's that supposed to mean? response:	As...
context: Of course, I understand if you can't work up the courage immediately.\I'll be there for you all the way, as your rental girlfriend.\You're the one I want!\It's gotta be you!\Rent-a-Girlfriend\I'm the one you want?\What's that supposed to mean?\As... response:	As my girlfriend! Rental, of course.
context: I'll be there for you all the way, as your rental girlfriend.\You're the one I want!\It's gotta be you!\Rent-a-Girlfriend\I'm the one you want?\What's that supposed to mean?\As...\As my girlfriend! Rental, of course. response:	You're the only one I ever want to rent.
context: You're the one I want!\It's gotta be you!\Rent-a-Girlfriend\I'm the one you want?\What's that supposed to mean?\As...\As my girlfriend! Rental, of course.\You're the only one I ever want to rent. response:	So I'm gonna be sad when you quit!
context: It's gotta be you!\Rent-a-Girlfriend\I'm the one you want?\What's that supposed to mean?\As...\As my girlfriend! Rental, of course.\You're the only one I ever want to rent.\So I'm gonna be sad when you quit! response:	Oh, that's what you meant?
context: Rent-a-Girlfriend\I'm the one you want?\What's that supposed to mean?\As...\As my girlfriend! Rental, of course.\You're the only one I ever want to rent.\So I'm gonna be sad when you quit!\Oh, that's what you meant? response:	Quit being misleading!
context: I'm the one you want?\What's that supposed to mean?\As...\As my girlfriend! Rental, of course.\You're the only one I ever want to rent.\So I'm gonna be sad when you quit!\Oh, that's what you meant?\Quit being misleading! response:	And at the worst time, too
context: What's that supposed to mean?\As...\As my girlfriend! Rental, of course.\You're the only one I ever want to rent.\So I'm gonna be sad when you quit!\Oh, that's what you meant?\Quit being misleading!\And at the worst time, too response:	M-My bad.
context: As...\As my girlfriend! Rental, of course.\You're the only one I ever want to rent.\So I'm gonna be sad when you quit!\Oh, that's what you meant?\Quit being misleading!\And at the worst time, too\M-My bad. response:	Sorry about that, then.
context: As my girlfriend! Rental, of course.\You're the only one I ever want to rent.\So I'm gonna be sad when you quit!\Oh, that's what you meant?\Quit being misleading!\And at the worst time, too\M-My bad.\Sorry about that, then. response:	I'm grateful that you're giving me such importance, though
context: You're the only one I ever want to rent.\So I'm gonna be sad when you quit!\Oh, that's what you meant?\Quit being misleading!\And at the worst time, too\M-My bad.\Sorry about that, then.\I'm grateful that you're giving me such importance, though response:	I only started this job to help my acting dream.
context: So I'm gonna be sad when you quit!\Oh, that's what you meant?\Quit being misleading!\And at the worst time, too\M-My bad.\Sorry about that, then.\I'm grateful that you're giving me such importance, though\I only started this job to help my acting dream. response:	If I get more acting gigs, I'm going to have to quit.
context: Oh, that's what you meant?\Quit being misleading!\And at the worst time, too\M-My bad.\Sorry about that, then.\I'm grateful that you're giving me such importance, though\I only started this job to help my acting dream.\If I get more acting gigs, I'm going to have to quit. response:	I-I see! Yeah, that makes sense!
context: Quit being misleading!\And at the worst time, too\M-My bad.\Sorry about that, then.\I'm grateful that you're giving me such importance, though\I only started this job to help my acting dream.\If I get more acting gigs, I'm going to have to quit.\I-I see! Yeah, that makes sense! response:	Later! And remember, lack of sleep is bad for the skin!
context: And at the worst time, too\M-My bad.\Sorry about that, then.\I'm grateful that you're giving me such importance, though\I only started this job to help my acting dream.\If I get more acting gigs, I'm going to have to quit.\I-I see! Yeah, that makes sense!\Later! And remember, lack of sleep is bad for the skin! response:	Excuse me?
context: M-My bad.\Sorry about that, then.\I'm grateful that you're giving me such importance, though\I only started this job to help my acting dream.\If I get more acting gigs, I'm going to have to quit.\I-I see! Yeah, that makes sense!\Later! And remember, lack of sleep is bad for the skin!\Excuse me? response:	Sweet dreams!
context: Sorry about that, then.\I'm grateful that you're giving me such importance, though\I only started this job to help my acting dream.\If I get more acting gigs, I'm going to have to quit.\I-I see! Yeah, that makes sense!\Later! And remember, lack of sleep is bad for the skin!\Excuse me?\Sweet dreams! response:	Yikes, I went and told her I want her!
context: I'm grateful that you're giving me such importance, though\I only started this job to help my acting dream.\If I get more acting gigs, I'm going to have to quit.\I-I see! Yeah, that makes sense!\Later! And remember, lack of sleep is bad for the skin!\Excuse me?\Sweet dreams!\Yikes, I went and told her I want her! response:	As a rental girlfriend, my ass! That was so forced!
context: I only started this job to help my acting dream.\If I get more acting gigs, I'm going to have to quit.\I-I see! Yeah, that makes sense!\Later! And remember, lack of sleep is bad for the skin!\Excuse me?\Sweet dreams!\Yikes, I went and told her I want her!\As a rental girlfriend, my ass! That was so forced! response:	I hope she didn't find that fishy.
context: If I get more acting gigs, I'm going to have to quit.\I-I see! Yeah, that makes sense!\Later! And remember, lack of sleep is bad for the skin!\Excuse me?\Sweet dreams!\Yikes, I went and told her I want her!\As a rental girlfriend, my ass! That was so forced!\I hope she didn't find that fishy. response:	I couldn't have made it more obvious that I wanna date her for real!
context: I-I see! Yeah, that makes sense!\Later! And remember, lack of sleep is bad for the skin!\Excuse me?\Sweet dreams!\Yikes, I went and told her I want her!\As a rental girlfriend, my ass! That was so forced!\I hope she didn't find that fishy.\I couldn't have made it more obvious that I wanna date her for real! response:	I might be 1 in the global Needs to Be Put in Place ranking!
context: Later! And remember, lack of sleep is bad for the skin!\Excuse me?\Sweet dreams!\Yikes, I went and told her I want her!\As a rental girlfriend, my ass! That was so forced!\I hope she didn't find that fishy.\I couldn't have made it more obvious that I wanna date her for real!\I might be 1 in the global Needs to Be Put in Place ranking! response:	Seeing her pleading with Mami-chan brought back my feelings for her!
context: Excuse me?\Sweet dreams!\Yikes, I went and told her I want her!\As a rental girlfriend, my ass! That was so forced!\I hope she didn't find that fishy.\I couldn't have made it more obvious that I wanna date her for real!\I might be 1 in the global Needs to Be Put in Place ranking!\Seeing her pleading with Mami-chan brought back my feelings for her! response:	that Mizuhara's an incredibly nice girl, and that she's not into me or anything.
context: Sweet dreams!\Yikes, I went and told her I want her!\As a rental girlfriend, my ass! That was so forced!\I hope she didn't find that fishy.\I couldn't have made it more obvious that I wanna date her for real!\I might be 1 in the global Needs to Be Put in Place ranking!\Seeing her pleading with Mami-chan brought back my feelings for her!\that Mizuhara's an incredibly nice girl, and that she's not into me or anything. response:	Besides,
context: Yikes, I went and told her I want her!\As a rental girlfriend, my ass! That was so forced!\I hope she didn't find that fishy.\I couldn't have made it more obvious that I wanna date her for real!\I might be 1 in the global Needs to Be Put in Place ranking!\Seeing her pleading with Mami-chan brought back my feelings for her!\that Mizuhara's an incredibly nice girl, and that she's not into me or anything.\Besides, response:	she's gonna quit her job as a rental girlfriend.
context: As a rental girlfriend, my ass! That was so forced!\I hope she didn't find that fishy.\I couldn't have made it more obvious that I wanna date her for real!\I might be 1 in the global Needs to Be Put in Place ranking!\Seeing her pleading with Mami-chan brought back my feelings for her!\that Mizuhara's an incredibly nice girl, and that she's not into me or anything.\Besides,\she's gonna quit her job as a rental girlfriend. response:	Once she does,
context: I hope she didn't find that fishy.\I couldn't have made it more obvious that I wanna date her for real!\I might be 1 in the global Needs to Be Put in Place ranking!\Seeing her pleading with Mami-chan brought back my feelings for her!\that Mizuhara's an incredibly nice girl, and that she's not into me or anything.\Besides,\she's gonna quit her job as a rental girlfriend.\Once she does, response:	I might never see her again.
context: I couldn't have made it more obvious that I wanna date her for real!\I might be 1 in the global Needs to Be Put in Place ranking!\Seeing her pleading with Mami-chan brought back my feelings for her!\that Mizuhara's an incredibly nice girl, and that she's not into me or anything.\Besides,\she's gonna quit her job as a rental girlfriend.\Once she does,\I might never see her again. response:	Man, when did I set my love life to hard mode?
context: I might be 1 in the global Needs to Be Put in Place ranking!\Seeing her pleading with Mami-chan brought back my feelings for her!\that Mizuhara's an incredibly nice girl, and that she's not into me or anything.\Besides,\she's gonna quit her job as a rental girlfriend.\Once she does,\I might never see her again.\Man, when did I set my love life to hard mode? response:	What the heck...
context: Seeing her pleading with Mami-chan brought back my feelings for her!\that Mizuhara's an incredibly nice girl, and that she's not into me or anything.\Besides,\she's gonna quit her job as a rental girlfriend.\Once she does,\I might never see her again.\Man, when did I set my love life to hard mode?\What the heck... response:	was that all about?
context: that Mizuhara's an incredibly nice girl, and that she's not into me or anything.\Besides,\she's gonna quit her job as a rental girlfriend.\Once she does,\I might never see her again.\Man, when did I set my love life to hard mode?\What the heck...\was that all about? response:	You're the one I want! It's gotta be you!
context: Besides,\she's gonna quit her job as a rental girlfriend.\Once she does,\I might never see her again.\Man, when did I set my love life to hard mode?\What the heck...\was that all about?\You're the one I want! It's gotta be you! response:	Dumbass.
context: she's gonna quit her job as a rental girlfriend.\Once she does,\I might never see her again.\Man, when did I set my love life to hard mode?\What the heck...\was that all about?\You're the one I want! It's gotta be you!\Dumbass. response:	Tokyo Underground
context: Once she does,\I might never see her again.\Man, when did I set my love life to hard mode?\What the heck...\was that all about?\You're the one I want! It's gotta be you!\Dumbass.\Tokyo Underground response:	Ikebukuro Station
context: I might never see her again.\Man, when did I set my love life to hard mode?\What the heck...\was that all about?\You're the one I want! It's gotta be you!\Dumbass.\Tokyo Underground\Ikebukuro Station response:	This is the story of a tomboy princess in the Edo era, and her servants. Together with a magical bird, they bring you a bizarre-yet-delightful tale that is sure to move you. And it starts... right now.
context: Man, when did I set my love life to hard mode?\What the heck...\was that all about?\You're the one I want! It's gotta be you!\Dumbass.\Tokyo Underground\Ikebukuro Station\This is the story of a tomboy princess in the Edo era, and her servants. Together with a magical bird, they bring you a bizarre-yet-delightful tale that is sure to move you. And it starts... right now. response:	Princess Heron
context: What the heck...\was that all about?\You're the one I want! It's gotta be you!\Dumbass.\Tokyo Underground\Ikebukuro Station\This is the story of a tomboy princess in the Edo era, and her servants. Together with a magical bird, they bring you a bizarre-yet-delightful tale that is sure to move you. And it starts... right now.\Princess Heron response:	Boring.
context: was that all about?\You're the one I want! It's gotta be you!\Dumbass.\Tokyo Underground\Ikebukuro Station\This is the story of a tomboy princess in the Edo era, and her servants. Together with a magical bird, they bring you a bizarre-yet-delightful tale that is sure to move you. And it starts... right now.\Princess Heron\Boring. response:	Have a gem of a time with Diamond
context: You're the one I want! It's gotta be you!\Dumbass.\Tokyo Underground\Ikebukuro Station\This is the story of a tomboy princess in the Edo era, and her servants. Together with a magical bird, they bring you a bizarre-yet-delightful tale that is sure to move you. And it starts... right now.\Princess Heron\Boring.\Have a gem of a time with Diamond response:	We warmly await your return.