context: OP response:	ED
context: OP\ED response:	The blue moon illuminated
context: OP\ED\The blue moon illuminated response:	your wandering shadow.
context: OP\ED\The blue moon illuminated\your wandering shadow. response:	I could never tell you all I wanted to say.
context: OP\ED\The blue moon illuminated\your wandering shadow.\I could never tell you all I wanted to say. response:	It was so very frustrating.
context: OP\ED\The blue moon illuminated\your wandering shadow.\I could never tell you all I wanted to say.\It was so very frustrating. response:	I think about your faked smile,
context: OP\ED\The blue moon illuminated\your wandering shadow.\I could never tell you all I wanted to say.\It was so very frustrating.\I think about your faked smile, response:	and forget all the hot tears we shed.
context: OP\ED\The blue moon illuminated\your wandering shadow.\I could never tell you all I wanted to say.\It was so very frustrating.\I think about your faked smile,\and forget all the hot tears we shed. response:	What do these empty husks,
context: ED\The blue moon illuminated\your wandering shadow.\I could never tell you all I wanted to say.\It was so very frustrating.\I think about your faked smile,\and forget all the hot tears we shed.\What do these empty husks, response:	those empty eyes of yours, reflect, my dear?
context: The blue moon illuminated\your wandering shadow.\I could never tell you all I wanted to say.\It was so very frustrating.\I think about your faked smile,\and forget all the hot tears we shed.\What do these empty husks,\those empty eyes of yours, reflect, my dear? response:	The transient quarter moon
context: your wandering shadow.\I could never tell you all I wanted to say.\It was so very frustrating.\I think about your faked smile,\and forget all the hot tears we shed.\What do these empty husks,\those empty eyes of yours, reflect, my dear?\The transient quarter moon response:	hides in a rift in the clouds,
context: I could never tell you all I wanted to say.\It was so very frustrating.\I think about your faked smile,\and forget all the hot tears we shed.\What do these empty husks,\those empty eyes of yours, reflect, my dear?\The transient quarter moon\hides in a rift in the clouds, response:	as darkness seeps up from the ground.
context: It was so very frustrating.\I think about your faked smile,\and forget all the hot tears we shed.\What do these empty husks,\those empty eyes of yours, reflect, my dear?\The transient quarter moon\hides in a rift in the clouds,\as darkness seeps up from the ground. response:	Tell me the truth, please.
context: I think about your faked smile,\and forget all the hot tears we shed.\What do these empty husks,\those empty eyes of yours, reflect, my dear?\The transient quarter moon\hides in a rift in the clouds,\as darkness seeps up from the ground.\Tell me the truth, please. response:	Are you so despondent
context: and forget all the hot tears we shed.\What do these empty husks,\those empty eyes of yours, reflect, my dear?\The transient quarter moon\hides in a rift in the clouds,\as darkness seeps up from the ground.\Tell me the truth, please.\Are you so despondent response:	that you still sit alone, sighing?
context: What do these empty husks,\those empty eyes of yours, reflect, my dear?\The transient quarter moon\hides in a rift in the clouds,\as darkness seeps up from the ground.\Tell me the truth, please.\Are you so despondent\that you still sit alone, sighing? response:	Without you, I just cant smile.
context: those empty eyes of yours, reflect, my dear?\The transient quarter moon\hides in a rift in the clouds,\as darkness seeps up from the ground.\Tell me the truth, please.\Are you so despondent\that you still sit alone, sighing?\Without you, I just cant smile. response:	I walk this banal town,
context: The transient quarter moon\hides in a rift in the clouds,\as darkness seeps up from the ground.\Tell me the truth, please.\Are you so despondent\that you still sit alone, sighing?\Without you, I just cant smile.\I walk this banal town, response:	feeling such intense emotions.
context: hides in a rift in the clouds,\as darkness seeps up from the ground.\Tell me the truth, please.\Are you so despondent\that you still sit alone, sighing?\Without you, I just cant smile.\I walk this banal town,\feeling such intense emotions. response:	I know that if I could treasure them and live on,
context: as darkness seeps up from the ground.\Tell me the truth, please.\Are you so despondent\that you still sit alone, sighing?\Without you, I just cant smile.\I walk this banal town,\feeling such intense emotions.\I know that if I could treasure them and live on, response:	I would need nothing else.
context: Tell me the truth, please.\Are you so despondent\that you still sit alone, sighing?\Without you, I just cant smile.\I walk this banal town,\feeling such intense emotions.\I know that if I could treasure them and live on,\I would need nothing else. response:	The summer flowers that bloomed in the sky
context: Are you so despondent\that you still sit alone, sighing?\Without you, I just cant smile.\I walk this banal town,\feeling such intense emotions.\I know that if I could treasure them and live on,\I would need nothing else.\The summer flowers that bloomed in the sky response:	Come falling down, dancing in the wind.
context: that you still sit alone, sighing?\Without you, I just cant smile.\I walk this banal town,\feeling such intense emotions.\I know that if I could treasure them and live on,\I would need nothing else.\The summer flowers that bloomed in the sky\Come falling down, dancing in the wind. response:	I can barely recall the night sky
context: Without you, I just cant smile.\I walk this banal town,\feeling such intense emotions.\I know that if I could treasure them and live on,\I would need nothing else.\The summer flowers that bloomed in the sky\Come falling down, dancing in the wind.\I can barely recall the night sky response:	where they all came tumbling down,
context: I walk this banal town,\feeling such intense emotions.\I know that if I could treasure them and live on,\I would need nothing else.\The summer flowers that bloomed in the sky\Come falling down, dancing in the wind.\I can barely recall the night sky\where they all came tumbling down, response:	so what I can still recall is all the more precious.
context: feeling such intense emotions.\I know that if I could treasure them and live on,\I would need nothing else.\The summer flowers that bloomed in the sky\Come falling down, dancing in the wind.\I can barely recall the night sky\where they all came tumbling down,\so what I can still recall is all the more precious. response:	Ghost Cat
context: I know that if I could treasure them and live on,\I would need nothing else.\The summer flowers that bloomed in the sky\Come falling down, dancing in the wind.\I can barely recall the night sky\where they all came tumbling down,\so what I can still recall is all the more precious.\Ghost Cat response:	Finale
context: I would need nothing else.\The summer flowers that bloomed in the sky\Come falling down, dancing in the wind.\I can barely recall the night sky\where they all came tumbling down,\so what I can still recall is all the more precious.\Ghost Cat\Finale response:	Morning News
context: The summer flowers that bloomed in the sky\Come falling down, dancing in the wind.\I can barely recall the night sky\where they all came tumbling down,\so what I can still recall is all the more precious.\Ghost Cat\Finale\Morning News response:	Kisshou Hotel
context: Come falling down, dancing in the wind.\I can barely recall the night sky\where they all came tumbling down,\so what I can still recall is all the more precious.\Ghost Cat\Finale\Morning News\Kisshou Hotel response:	CanCan Cafe
context: I can barely recall the night sky\where they all came tumbling down,\so what I can still recall is all the more precious.\Ghost Cat\Finale\Morning News\Kisshou Hotel\CanCan Cafe response:	City Hall
context: where they all came tumbling down,\so what I can still recall is all the more precious.\Ghost Cat\Finale\Morning News\Kisshou Hotel\CanCan Cafe\City Hall response:	Konata Inn
context: so what I can still recall is all the more precious.\Ghost Cat\Finale\Morning News\Kisshou Hotel\CanCan Cafe\City Hall\Konata Inn response:	I cannot believe that old hag.
context: Ghost Cat\Finale\Morning News\Kisshou Hotel\CanCan Cafe\City Hall\Konata Inn\I cannot believe that old hag. response:	I cannot just watch over an invalid
context: Finale\Morning News\Kisshou Hotel\CanCan Cafe\City Hall\Konata Inn\I cannot believe that old hag.\I cannot just watch over an invalid response:	for the rest of my life
context: Morning News\Kisshou Hotel\CanCan Cafe\City Hall\Konata Inn\I cannot believe that old hag.\I cannot just watch over an invalid\for the rest of my life response:	Thanks to her
context: Kisshou Hotel\CanCan Cafe\City Hall\Konata Inn\I cannot believe that old hag.\I cannot just watch over an invalid\for the rest of my life\Thanks to her response:	I cannot do what I want to.
context: CanCan Cafe\City Hall\Konata Inn\I cannot believe that old hag.\I cannot just watch over an invalid\for the rest of my life\Thanks to her\I cannot do what I want to. response:	Setsuko. Aah! No! No!
context: City Hall\Konata Inn\I cannot believe that old hag.\I cannot just watch over an invalid\for the rest of my life\Thanks to her\I cannot do what I want to.\Setsuko. Aah! No! No! response:	I will never be able to get ahead.
context: Konata Inn\I cannot believe that old hag.\I cannot just watch over an invalid\for the rest of my life\Thanks to her\I cannot do what I want to.\Setsuko. Aah! No! No!\I will never be able to get ahead. response:	CanCan Cafe
context: I cannot believe that old hag.\I cannot just watch over an invalid\for the rest of my life\Thanks to her\I cannot do what I want to.\Setsuko. Aah! No! No!\I will never be able to get ahead.\CanCan Cafe response:	Moria never looks at the article.
context: I cannot just watch over an invalid\for the rest of my life\Thanks to her\I cannot do what I want to.\Setsuko. Aah! No! No!\I will never be able to get ahead.\CanCan Cafe\Moria never looks at the article. response:	Just lights a match
context: for the rest of my life\Thanks to her\I cannot do what I want to.\Setsuko. Aah! No! No!\I will never be able to get ahead.\CanCan Cafe\Moria never looks at the article.\Just lights a match response:	Sanson Milk Delivery
context: Thanks to her\I cannot do what I want to.\Setsuko. Aah! No! No!\I will never be able to get ahead.\CanCan Cafe\Moria never looks at the article.\Just lights a match\Sanson Milk Delivery response:	Afterword
context: I cannot do what I want to.\Setsuko. Aah! No! No!\I will never be able to get ahead.\CanCan Cafe\Moria never looks at the article.\Just lights a match\Sanson Milk Delivery\Afterword response:	Lady Reporters Death Still Suspicious
context: Setsuko. Aah! No! No!\I will never be able to get ahead.\CanCan Cafe\Moria never looks at the article.\Just lights a match\Sanson Milk Delivery\Afterword\Lady Reporters Death Still Suspicious response:	Morning News employee involved
context: I will never be able to get ahead.\CanCan Cafe\Moria never looks at the article.\Just lights a match\Sanson Milk Delivery\Afterword\Lady Reporters Death Still Suspicious\Morning News employee involved response:	Mayor missing along with Morning News reporter.
context: CanCan Cafe\Moria never looks at the article.\Just lights a match\Sanson Milk Delivery\Afterword\Lady Reporters Death Still Suspicious\Morning News employee involved\Mayor missing along with Morning News reporter. response:	Lady Reporters Death Still Suspicious
context: Moria never looks at the article.\Just lights a match\Sanson Milk Delivery\Afterword\Lady Reporters Death Still Suspicious\Morning News employee involved\Mayor missing along with Morning News reporter.\Lady Reporters Death Still Suspicious response:	Morning News employee involved
context: Just lights a match\Sanson Milk Delivery\Afterword\Lady Reporters Death Still Suspicious\Morning News employee involved\Mayor missing along with Morning News reporter.\Lady Reporters Death Still Suspicious\Morning News employee involved response:	Mayor missing along with Morning News reporter.
context: Sanson Milk Delivery\Afterword\Lady Reporters Death Still Suspicious\Morning News employee involved\Mayor missing along with Morning News reporter.\Lady Reporters Death Still Suspicious\Morning News employee involved\Mayor missing along with Morning News reporter. response:	Thank you,hhhhhhhhhhhhhhhhhhhhheveryone.
context: Afterword\Lady Reporters Death Still Suspicious\Morning News employee involved\Mayor missing along with Morning News reporter.\Lady Reporters Death Still Suspicious\Morning News employee involved\Mayor missing along with Morning News reporter.\Thank you,hhhhhhhhhhhhhhhhhhhhheveryone. response:	Hey, where did all the other passengers go?
context: Lady Reporters Death Still Suspicious\Morning News employee involved\Mayor missing along with Morning News reporter.\Lady Reporters Death Still Suspicious\Morning News employee involved\Mayor missing along with Morning News reporter.\Thank you,hhhhhhhhhhhhhhhhhhhhheveryone.\Hey, where did all the other passengers go? response:	They got off.
context: Morning News employee involved\Mayor missing along with Morning News reporter.\Lady Reporters Death Still Suspicious\Morning News employee involved\Mayor missing along with Morning News reporter.\Thank you,hhhhhhhhhhhhhhhhhhhhheveryone.\Hey, where did all the other passengers go?\They got off. response:	Got
context: Mayor missing along with Morning News reporter.\Lady Reporters Death Still Suspicious\Morning News employee involved\Mayor missing along with Morning News reporter.\Thank you,hhhhhhhhhhhhhhhhhhhhheveryone.\Hey, where did all the other passengers go?\They got off.\Got response:	Now, its your turn.
context: Lady Reporters Death Still Suspicious\Morning News employee involved\Mayor missing along with Morning News reporter.\Thank you,hhhhhhhhhhhhhhhhhhhhheveryone.\Hey, where did all the other passengers go?\They got off.\Got\Now, its your turn. response:	Theyre all waiting for you.
context: Morning News employee involved\Mayor missing along with Morning News reporter.\Thank you,hhhhhhhhhhhhhhhhhhhhheveryone.\Hey, where did all the other passengers go?\They got off.\Got\Now, its your turn.\Theyre all waiting for you. response:	This train will never stop.
context: Mayor missing along with Morning News reporter.\Thank you,hhhhhhhhhhhhhhhhhhhhheveryone.\Hey, where did all the other passengers go?\They got off.\Got\Now, its your turn.\Theyre all waiting for you.\This train will never stop. response:	I dont care!
context: Thank you,hhhhhhhhhhhhhhhhhhhhheveryone.\Hey, where did all the other passengers go?\They got off.\Got\Now, its your turn.\Theyre all waiting for you.\This train will never stop.\I dont care! response:	Then, youll stay here
context: Hey, where did all the other passengers go?\They got off.\Got\Now, its your turn.\Theyre all waiting for you.\This train will never stop.\I dont care!\Then, youll stay here response:	No! I wont!
context: They got off.\Got\Now, its your turn.\Theyre all waiting for you.\This train will never stop.\I dont care!\Then, youll stay here\No! I wont! response:	No! I wont!
context: Got\Now, its your turn.\Theyre all waiting for you.\This train will never stop.\I dont care!\Then, youll stay here\No! I wont!\No! I wont! response:	Do something about this.
context: Now, its your turn.\Theyre all waiting for you.\This train will never stop.\I dont care!\Then, youll stay here\No! I wont!\No! I wont!\Do something about this. response:	Surely you can help!
context: Theyre all waiting for you.\This train will never stop.\I dont care!\Then, youll stay here\No! I wont!\No! I wont!\Do something about this.\Surely you can help! response:	How did it come to this?
context: This train will never stop.\I dont care!\Then, youll stay here\No! I wont!\No! I wont!\Do something about this.\Surely you can help!\How did it come to this? response:	I just wanted to help her.
context: I dont care!\Then, youll stay here\No! I wont!\No! I wont!\Do something about this.\Surely you can help!\How did it come to this?\I just wanted to help her. response:	Help Setsuko-san?
context: Then, youll stay here\No! I wont!\No! I wont!\Do something about this.\Surely you can help!\How did it come to this?\I just wanted to help her.\Help Setsuko-san? response:	Thats right!
context: No! I wont!\No! I wont!\Do something about this.\Surely you can help!\How did it come to this?\I just wanted to help her.\Help Setsuko-san?\Thats right! response:	I felt so sorry that shed been killed!
context: No! I wont!\Do something about this.\Surely you can help!\How did it come to this?\I just wanted to help her.\Help Setsuko-san?\Thats right!\I felt so sorry that shed been killed! response:	Ichikawa.
context: Do something about this.\Surely you can help!\How did it come to this?\I just wanted to help her.\Help Setsuko-san?\Thats right!\I felt so sorry that shed been killed!\Ichikawa. response:	Moria-san.
context: Surely you can help!\How did it come to this?\I just wanted to help her.\Help Setsuko-san?\Thats right!\I felt so sorry that shed been killed!\Ichikawa.\Moria-san. response:	Youre terrible.
context: How did it come to this?\I just wanted to help her.\Help Setsuko-san?\Thats right!\I felt so sorry that shed been killed!\Ichikawa.\Moria-san.\Youre terrible. response:	Show him. Show him.
context: I just wanted to help her.\Help Setsuko-san?\Thats right!\I felt so sorry that shed been killed!\Ichikawa.\Moria-san.\Youre terrible.\Show him. Show him. response:	Show him. Show him.
context: Help Setsuko-san?\Thats right!\I felt so sorry that shed been killed!\Ichikawa.\Moria-san.\Youre terrible.\Show him. Show him.\Show him. Show him. response:	Show him.
context: Thats right!\I felt so sorry that shed been killed!\Ichikawa.\Moria-san.\Youre terrible.\Show him. Show him.\Show him. Show him.\Show him. response:	This is
context: I felt so sorry that shed been killed!\Ichikawa.\Moria-san.\Youre terrible.\Show him. Show him.\Show him. Show him.\Show him.\This is response:	Show him.
context: Ichikawa.\Moria-san.\Youre terrible.\Show him. Show him.\Show him. Show him.\Show him.\This is\Show him. response:	Are the cats doing this?
context: Moria-san.\Youre terrible.\Show him. Show him.\Show him. Show him.\Show him.\This is\Show him.\Are the cats doing this? response:	Show him.
context: Youre terrible.\Show him. Show him.\Show him. Show him.\Show him.\This is\Show him.\Are the cats doing this?\Show him. response:	Stop!
context: Show him. Show him.\Show him. Show him.\Show him.\This is\Show him.\Are the cats doing this?\Show him.\Stop! response:	Memories are tied to a single place.
context: Show him. Show him.\Show him.\This is\Show him.\Are the cats doing this?\Show him.\Stop!\Memories are tied to a single place. response:	Memory brings about Regret,
context: Show him.\This is\Show him.\Are the cats doing this?\Show him.\Stop!\Memories are tied to a single place.\Memory brings about Regret, response:	and it is through Regret that fates intertwine.
context: This is\Show him.\Are the cats doing this?\Show him.\Stop!\Memories are tied to a single place.\Memory brings about Regret,\and it is through Regret that fates intertwine. response:	All is turned upside-down.
context: Show him.\Are the cats doing this?\Show him.\Stop!\Memories are tied to a single place.\Memory brings about Regret,\and it is through Regret that fates intertwine.\All is turned upside-down. response:	Its all your fault!
context: Are the cats doing this?\Show him.\Stop!\Memories are tied to a single place.\Memory brings about Regret,\and it is through Regret that fates intertwine.\All is turned upside-down.\Its all your fault! response:	With Form, Truth and Regret, all can be revealed.
context: Show him.\Stop!\Memories are tied to a single place.\Memory brings about Regret,\and it is through Regret that fates intertwine.\All is turned upside-down.\Its all your fault!\With Form, Truth and Regret, all can be revealed. response:	Will you show me
context: Stop!\Memories are tied to a single place.\Memory brings about Regret,\and it is through Regret that fates intertwine.\All is turned upside-down.\Its all your fault!\With Form, Truth and Regret, all can be revealed.\Will you show me response:	the reason for
context: Memories are tied to a single place.\Memory brings about Regret,\and it is through Regret that fates intertwine.\All is turned upside-down.\Its all your fault!\With Form, Truth and Regret, all can be revealed.\Will you show me\the reason for response:	your Regret?
context: Memory brings about Regret,\and it is through Regret that fates intertwine.\All is turned upside-down.\Its all your fault!\With Form, Truth and Regret, all can be revealed.\Will you show me\the reason for\your Regret? response:	Huh? What was that?
context: and it is through Regret that fates intertwine.\All is turned upside-down.\Its all your fault!\With Form, Truth and Regret, all can be revealed.\Will you show me\the reason for\your Regret?\Huh? What was that? response:	Mayor Fukuda is corrupt!
context: All is turned upside-down.\Its all your fault!\With Form, Truth and Regret, all can be revealed.\Will you show me\the reason for\your Regret?\Huh? What was that?\Mayor Fukuda is corrupt! response:	I have proof.
context: Its all your fault!\With Form, Truth and Regret, all can be revealed.\Will you show me\the reason for\your Regret?\Huh? What was that?\Mayor Fukuda is corrupt!\I have proof. response:	Lets hear what you have to say.
context: With Form, Truth and Regret, all can be revealed.\Will you show me\the reason for\your Regret?\Huh? What was that?\Mayor Fukuda is corrupt!\I have proof.\Lets hear what you have to say. response:	Moria-san?
context: Will you show me\the reason for\your Regret?\Huh? What was that?\Mayor Fukuda is corrupt!\I have proof.\Lets hear what you have to say.\Moria-san? response:	Is this information reliable?
context: the reason for\your Regret?\Huh? What was that?\Mayor Fukuda is corrupt!\I have proof.\Lets hear what you have to say.\Moria-san?\Is this information reliable? response:	Of course!
context: your Regret?\Huh? What was that?\Mayor Fukuda is corrupt!\I have proof.\Lets hear what you have to say.\Moria-san?\Is this information reliable?\Of course! response:	I have it on good authority that the mayor is meeting with executives
context: Huh? What was that?\Mayor Fukuda is corrupt!\I have proof.\Lets hear what you have to say.\Moria-san?\Is this information reliable?\Of course!\I have it on good authority that the mayor is meeting with executives response:	from the railroad company on a regular basis.
context: Mayor Fukuda is corrupt!\I have proof.\Lets hear what you have to say.\Moria-san?\Is this information reliable?\Of course!\I have it on good authority that the mayor is meeting with executives\from the railroad company on a regular basis. response:	Well, theres nothing illegal about that.
context: I have proof.\Lets hear what you have to say.\Moria-san?\Is this information reliable?\Of course!\I have it on good authority that the mayor is meeting with executives\from the railroad company on a regular basis.\Well, theres nothing illegal about that. response:	But dont you think it unlikely
context: Lets hear what you have to say.\Moria-san?\Is this information reliable?\Of course!\I have it on good authority that the mayor is meeting with executives\from the railroad company on a regular basis.\Well, theres nothing illegal about that.\But dont you think it unlikely response:	Im sorry, Ichikawa, but were not a tabloid.
context: Moria-san?\Is this information reliable?\Of course!\I have it on good authority that the mayor is meeting with executives\from the railroad company on a regular basis.\Well, theres nothing illegal about that.\But dont you think it unlikely\Im sorry, Ichikawa, but were not a tabloid. response:	that theyre just making small talk?
context: Is this information reliable?\Of course!\I have it on good authority that the mayor is meeting with executives\from the railroad company on a regular basis.\Well, theres nothing illegal about that.\But dont you think it unlikely\Im sorry, Ichikawa, but were not a tabloid.\that theyre just making small talk? response:	Thats not enough information for a proper article.
context: Of course!\I have it on good authority that the mayor is meeting with executives\from the railroad company on a regular basis.\Well, theres nothing illegal about that.\But dont you think it unlikely\Im sorry, Ichikawa, but were not a tabloid.\that theyre just making small talk?\Thats not enough information for a proper article. response:	I think youre just jealous!
context: I have it on good authority that the mayor is meeting with executives\from the railroad company on a regular basis.\Well, theres nothing illegal about that.\But dont you think it unlikely\Im sorry, Ichikawa, but were not a tabloid.\that theyre just making small talk?\Thats not enough information for a proper article.\I think youre just jealous! response:	Jealous of who?
context: from the railroad company on a regular basis.\Well, theres nothing illegal about that.\But dont you think it unlikely\Im sorry, Ichikawa, but were not a tabloid.\that theyre just making small talk?\Thats not enough information for a proper article.\I think youre just jealous!\Jealous of who? response:	Youre jealous of me, Moria-san.
context: Well, theres nothing illegal about that.\But dont you think it unlikely\Im sorry, Ichikawa, but were not a tabloid.\that theyre just making small talk?\Thats not enough information for a proper article.\I think youre just jealous!\Jealous of who?\Youre jealous of me, Moria-san. response:	Ridiculous!
context: But dont you think it unlikely\Im sorry, Ichikawa, but were not a tabloid.\that theyre just making small talk?\Thats not enough information for a proper article.\I think youre just jealous!\Jealous of who?\Youre jealous of me, Moria-san.\Ridiculous! response:	Youre jealous that I got such a huge story.
context: Im sorry, Ichikawa, but were not a tabloid.\that theyre just making small talk?\Thats not enough information for a proper article.\I think youre just jealous!\Jealous of who?\Youre jealous of me, Moria-san.\Ridiculous!\Youre jealous that I got such a huge story. response:	Its not a story at all!
context: that theyre just making small talk?\Thats not enough information for a proper article.\I think youre just jealous!\Jealous of who?\Youre jealous of me, Moria-san.\Ridiculous!\Youre jealous that I got such a huge story.\Its not a story at all! response:	Theres nothing to be jealous about.
context: Thats not enough information for a proper article.\I think youre just jealous!\Jealous of who?\Youre jealous of me, Moria-san.\Ridiculous!\Youre jealous that I got such a huge story.\Its not a story at all!\Theres nothing to be jealous about. response:	We cant publish it.
context: I think youre just jealous!\Jealous of who?\Youre jealous of me, Moria-san.\Ridiculous!\Youre jealous that I got such a huge story.\Its not a story at all!\Theres nothing to be jealous about.\We cant publish it. response:	Looks like it was a mistake to send you into the field.
context: Jealous of who?\Youre jealous of me, Moria-san.\Ridiculous!\Youre jealous that I got such a huge story.\Its not a story at all!\Theres nothing to be jealous about.\We cant publish it.\Looks like it was a mistake to send you into the field. response:	You bit off more than you could chew. Im putting you back on the advice column.
context: Youre jealous of me, Moria-san.\Ridiculous!\Youre jealous that I got such a huge story.\Its not a story at all!\Theres nothing to be jealous about.\We cant publish it.\Looks like it was a mistake to send you into the field.\You bit off more than you could chew. Im putting you back on the advice column. response:	You cant!
context: Ridiculous!\Youre jealous that I got such a huge story.\Its not a story at all!\Theres nothing to be jealous about.\We cant publish it.\Looks like it was a mistake to send you into the field.\You bit off more than you could chew. Im putting you back on the advice column.\You cant! response:	Im not giving up on this!
context: Youre jealous that I got such a huge story.\Its not a story at all!\Theres nothing to be jealous about.\We cant publish it.\Looks like it was a mistake to send you into the field.\You bit off more than you could chew. Im putting you back on the advice column.\You cant!\Im not giving up on this! response:	Ill get to the bottom of this. Mark my words!
context: Its not a story at all!\Theres nothing to be jealous about.\We cant publish it.\Looks like it was a mistake to send you into the field.\You bit off more than you could chew. Im putting you back on the advice column.\You cant!\Im not giving up on this!\Ill get to the bottom of this. Mark my words! response:	Dont get me wrong, Ichikawa.
context: Theres nothing to be jealous about.\We cant publish it.\Looks like it was a mistake to send you into the field.\You bit off more than you could chew. Im putting you back on the advice column.\You cant!\Im not giving up on this!\Ill get to the bottom of this. Mark my words!\Dont get me wrong, Ichikawa. response:	I think youre a great
context: We cant publish it.\Looks like it was a mistake to send you into the field.\You bit off more than you could chew. Im putting you back on the advice column.\You cant!\Im not giving up on this!\Ill get to the bottom of this. Mark my words!\Dont get me wrong, Ichikawa.\I think youre a great response:	Whoo, yeah! Here it comes!
context: Looks like it was a mistake to send you into the field.\You bit off more than you could chew. Im putting you back on the advice column.\You cant!\Im not giving up on this!\Ill get to the bottom of this. Mark my words!\Dont get me wrong, Ichikawa.\I think youre a great\Whoo, yeah! Here it comes! response:	Whats this?
context: You bit off more than you could chew. Im putting you back on the advice column.\You cant!\Im not giving up on this!\Ill get to the bottom of this. Mark my words!\Dont get me wrong, Ichikawa.\I think youre a great\Whoo, yeah! Here it comes!\Whats this? response:	A woman peeping at me?
context: You cant!\Im not giving up on this!\Ill get to the bottom of this. Mark my words!\Dont get me wrong, Ichikawa.\I think youre a great\Whoo, yeah! Here it comes!\Whats this?\A woman peeping at me? response:	I wont
context: Im not giving up on this!\Ill get to the bottom of this. Mark my words!\Dont get me wrong, Ichikawa.\I think youre a great\Whoo, yeah! Here it comes!\Whats this?\A woman peeping at me?\I wont response:	I wont let them beat me.
context: Ill get to the bottom of this. Mark my words!\Dont get me wrong, Ichikawa.\I think youre a great\Whoo, yeah! Here it comes!\Whats this?\A woman peeping at me?\I wont\I wont let them beat me. response:	Yes, thank you.
context: Dont get me wrong, Ichikawa.\I think youre a great\Whoo, yeah! Here it comes!\Whats this?\A woman peeping at me?\I wont\I wont let them beat me.\Yes, thank you. response:	Thank you. Thank you.
context: I think youre a great\Whoo, yeah! Here it comes!\Whats this?\A woman peeping at me?\I wont\I wont let them beat me.\Yes, thank you.\Thank you. Thank you. response:	Yes, indeed, I look forward to it.
context: Whoo, yeah! Here it comes!\Whats this?\A woman peeping at me?\I wont\I wont let them beat me.\Yes, thank you.\Thank you. Thank you.\Yes, indeed, I look forward to it. response:	I see.
context: Whats this?\A woman peeping at me?\I wont\I wont let them beat me.\Yes, thank you.\Thank you. Thank you.\Yes, indeed, I look forward to it.\I see. response:	Is this still not enough?
context: A woman peeping at me?\I wont\I wont let them beat me.\Yes, thank you.\Thank you. Thank you.\Yes, indeed, I look forward to it.\I see.\Is this still not enough? response:	Just as I thought.
context: I wont\I wont let them beat me.\Yes, thank you.\Thank you. Thank you.\Yes, indeed, I look forward to it.\I see.\Is this still not enough?\Just as I thought. response:	I knew you could do it.
context: I wont let them beat me.\Yes, thank you.\Thank you. Thank you.\Yes, indeed, I look forward to it.\I see.\Is this still not enough?\Just as I thought.\I knew you could do it. response:	Im sorry for being so hard on you.
context: Yes, thank you.\Thank you. Thank you.\Yes, indeed, I look forward to it.\I see.\Is this still not enough?\Just as I thought.\I knew you could do it.\Im sorry for being so hard on you. response:	Forgive me, Ichikawa.
context: Thank you. Thank you.\Yes, indeed, I look forward to it.\I see.\Is this still not enough?\Just as I thought.\I knew you could do it.\Im sorry for being so hard on you.\Forgive me, Ichikawa. response:	Thats right! I knew she had it in her!
context: Yes, indeed, I look forward to it.\I see.\Is this still not enough?\Just as I thought.\I knew you could do it.\Im sorry for being so hard on you.\Forgive me, Ichikawa.\Thats right! I knew she had it in her! response:	Thats why I was so hard on her!
context: I see.\Is this still not enough?\Just as I thought.\I knew you could do it.\Im sorry for being so hard on you.\Forgive me, Ichikawa.\Thats right! I knew she had it in her!\Thats why I was so hard on her! response:	When did it happen?
context: Is this still not enough?\Just as I thought.\I knew you could do it.\Im sorry for being so hard on you.\Forgive me, Ichikawa.\Thats right! I knew she had it in her!\Thats why I was so hard on her!\When did it happen? response:	Last night.
context: Just as I thought.\I knew you could do it.\Im sorry for being so hard on you.\Forgive me, Ichikawa.\Thats right! I knew she had it in her!\Thats why I was so hard on her!\When did it happen?\Last night. response:	And you developed the shots yourself?
context: I knew you could do it.\Im sorry for being so hard on you.\Forgive me, Ichikawa.\Thats right! I knew she had it in her!\Thats why I was so hard on her!\When did it happen?\Last night.\And you developed the shots yourself? response:	Yes.
context: Im sorry for being so hard on you.\Forgive me, Ichikawa.\Thats right! I knew she had it in her!\Thats why I was so hard on her!\When did it happen?\Last night.\And you developed the shots yourself?\Yes. response:	Where is the film?
context: Forgive me, Ichikawa.\Thats right! I knew she had it in her!\Thats why I was so hard on her!\When did it happen?\Last night.\And you developed the shots yourself?\Yes.\Where is the film? response:	In here.
context: Thats right! I knew she had it in her!\Thats why I was so hard on her!\When did it happen?\Last night.\And you developed the shots yourself?\Yes.\Where is the film?\In here. response:	Hey,
context: Thats why I was so hard on her!\When did it happen?\Last night.\And you developed the shots yourself?\Yes.\Where is the film?\In here.\Hey, response:	lets go out.
context: When did it happen?\Last night.\And you developed the shots yourself?\Yes.\Where is the film?\In here.\Hey,\lets go out. response:	But
context: Last night.\And you developed the shots yourself?\Yes.\Where is the film?\In here.\Hey,\lets go out.\But response:	This is a huge scoop.
context: And you developed the shots yourself?\Yes.\Where is the film?\In here.\Hey,\lets go out.\But\This is a huge scoop. response:	We cant let afford to let anyone know about this.
context: Yes.\Where is the film?\In here.\Hey,\lets go out.\But\This is a huge scoop.\We cant let afford to let anyone know about this. response:	Not even one of our co-workers.
context: Where is the film?\In here.\Hey,\lets go out.\But\This is a huge scoop.\We cant let afford to let anyone know about this.\Not even one of our co-workers. response:	Heres the mayor with Touto Railways Board of Directors.
context: In here.\Hey,\lets go out.\But\This is a huge scoop.\We cant let afford to let anyone know about this.\Not even one of our co-workers.\Heres the mayor with Touto Railways Board of Directors. response:	Here he is with Nohinbashi Construction.
context: Hey,\lets go out.\But\This is a huge scoop.\We cant let afford to let anyone know about this.\Not even one of our co-workers.\Heres the mayor with Touto Railways Board of Directors.\Here he is with Nohinbashi Construction. response:	They met at Kisshou Hotel in Kajima.
context: lets go out.\But\This is a huge scoop.\We cant let afford to let anyone know about this.\Not even one of our co-workers.\Heres the mayor with Touto Railways Board of Directors.\Here he is with Nohinbashi Construction.\They met at Kisshou Hotel in Kajima. response:	The mayor recently passed a city ordinance at the rail companys request.
context: But\This is a huge scoop.\We cant let afford to let anyone know about this.\Not even one of our co-workers.\Heres the mayor with Touto Railways Board of Directors.\Here he is with Nohinbashi Construction.\They met at Kisshou Hotel in Kajima.\The mayor recently passed a city ordinance at the rail companys request. response:	I believe he received a considerable bribe in return.
context: This is a huge scoop.\We cant let afford to let anyone know about this.\Not even one of our co-workers.\Heres the mayor with Touto Railways Board of Directors.\Here he is with Nohinbashi Construction.\They met at Kisshou Hotel in Kajima.\The mayor recently passed a city ordinance at the rail companys request.\I believe he received a considerable bribe in return. response:	Where does he bank?
context: We cant let afford to let anyone know about this.\Not even one of our co-workers.\Heres the mayor with Touto Railways Board of Directors.\Here he is with Nohinbashi Construction.\They met at Kisshou Hotel in Kajima.\The mayor recently passed a city ordinance at the rail companys request.\I believe he received a considerable bribe in return.\Where does he bank? response:	The Ichii Bank.
context: Not even one of our co-workers.\Heres the mayor with Touto Railways Board of Directors.\Here he is with Nohinbashi Construction.\They met at Kisshou Hotel in Kajima.\The mayor recently passed a city ordinance at the rail companys request.\I believe he received a considerable bribe in return.\Where does he bank?\The Ichii Bank. response:	The mayors uncle is its president.
context: Heres the mayor with Touto Railways Board of Directors.\Here he is with Nohinbashi Construction.\They met at Kisshou Hotel in Kajima.\The mayor recently passed a city ordinance at the rail companys request.\I believe he received a considerable bribe in return.\Where does he bank?\The Ichii Bank.\The mayors uncle is its president. response:	I see.
context: Here he is with Nohinbashi Construction.\They met at Kisshou Hotel in Kajima.\The mayor recently passed a city ordinance at the rail companys request.\I believe he received a considerable bribe in return.\Where does he bank?\The Ichii Bank.\The mayors uncle is its president.\I see. response:	This is more than enough information to move on.
context: They met at Kisshou Hotel in Kajima.\The mayor recently passed a city ordinance at the rail companys request.\I believe he received a considerable bribe in return.\Where does he bank?\The Ichii Bank.\The mayors uncle is its president.\I see.\This is more than enough information to move on. response:	This is front page material.
context: The mayor recently passed a city ordinance at the rail companys request.\I believe he received a considerable bribe in return.\Where does he bank?\The Ichii Bank.\The mayors uncle is its president.\I see.\This is more than enough information to move on.\This is front page material. response:	Have it on my desk tomorrow night. Well run it the next morning.
context: I believe he received a considerable bribe in return.\Where does he bank?\The Ichii Bank.\The mayors uncle is its president.\I see.\This is more than enough information to move on.\This is front page material.\Have it on my desk tomorrow night. Well run it the next morning. response:	Its not much time, but can you make it?
context: Where does he bank?\The Ichii Bank.\The mayors uncle is its president.\I see.\This is more than enough information to move on.\This is front page material.\Have it on my desk tomorrow night. Well run it the next morning.\Its not much time, but can you make it? response:	You want me to write the whole article?
context: The Ichii Bank.\The mayors uncle is its president.\I see.\This is more than enough information to move on.\This is front page material.\Have it on my desk tomorrow night. Well run it the next morning.\Its not much time, but can you make it?\You want me to write the whole article? response:	Of course!
context: The mayors uncle is its president.\I see.\This is more than enough information to move on.\This is front page material.\Have it on my desk tomorrow night. Well run it the next morning.\Its not much time, but can you make it?\You want me to write the whole article?\Of course! response:	You did all the work, so you should reap the benefits.
context: I see.\This is more than enough information to move on.\This is front page material.\Have it on my desk tomorrow night. Well run it the next morning.\Its not much time, but can you make it?\You want me to write the whole article?\Of course!\You did all the work, so you should reap the benefits. response:	Thank you so much!
context: This is more than enough information to move on.\This is front page material.\Have it on my desk tomorrow night. Well run it the next morning.\Its not much time, but can you make it?\You want me to write the whole article?\Of course!\You did all the work, so you should reap the benefits.\Thank you so much! response:	I misjudged you, Moria-san.
context: This is front page material.\Have it on my desk tomorrow night. Well run it the next morning.\Its not much time, but can you make it?\You want me to write the whole article?\Of course!\You did all the work, so you should reap the benefits.\Thank you so much!\I misjudged you, Moria-san. response:	I was sure you thought of me as a weak, worthless woman,
context: Have it on my desk tomorrow night. Well run it the next morning.\Its not much time, but can you make it?\You want me to write the whole article?\Of course!\You did all the work, so you should reap the benefits.\Thank you so much!\I misjudged you, Moria-san.\I was sure you thought of me as a weak, worthless woman, response:	and that only a man could become a real reporter.
context: Its not much time, but can you make it?\You want me to write the whole article?\Of course!\You did all the work, so you should reap the benefits.\Thank you so much!\I misjudged you, Moria-san.\I was sure you thought of me as a weak, worthless woman,\and that only a man could become a real reporter. response:	I just thought that
context: You want me to write the whole article?\Of course!\You did all the work, so you should reap the benefits.\Thank you so much!\I misjudged you, Moria-san.\I was sure you thought of me as a weak, worthless woman,\and that only a man could become a real reporter.\I just thought that response:	You couldnt be more wrong!
context: Of course!\You did all the work, so you should reap the benefits.\Thank you so much!\I misjudged you, Moria-san.\I was sure you thought of me as a weak, worthless woman,\and that only a man could become a real reporter.\I just thought that\You couldnt be more wrong! response:	Thank goodness!
context: You did all the work, so you should reap the benefits.\Thank you so much!\I misjudged you, Moria-san.\I was sure you thought of me as a weak, worthless woman,\and that only a man could become a real reporter.\I just thought that\You couldnt be more wrong!\Thank goodness! response:	Im finally a real newswoman.
context: Thank you so much!\I misjudged you, Moria-san.\I was sure you thought of me as a weak, worthless woman,\and that only a man could become a real reporter.\I just thought that\You couldnt be more wrong!\Thank goodness!\Im finally a real newswoman. response:	Do you know where Hichiriki Zakas Konata Inn is?
context: I misjudged you, Moria-san.\I was sure you thought of me as a weak, worthless woman,\and that only a man could become a real reporter.\I just thought that\You couldnt be more wrong!\Thank goodness!\Im finally a real newswoman.\Do you know where Hichiriki Zakas Konata Inn is? response:	Write it there.
context: I was sure you thought of me as a weak, worthless woman,\and that only a man could become a real reporter.\I just thought that\You couldnt be more wrong!\Thank goodness!\Im finally a real newswoman.\Do you know where Hichiriki Zakas Konata Inn is?\Write it there. response:	To prevent any leaks?
context: and that only a man could become a real reporter.\I just thought that\You couldnt be more wrong!\Thank goodness!\Im finally a real newswoman.\Do you know where Hichiriki Zakas Konata Inn is?\Write it there.\To prevent any leaks? response:	Thats right.
context: I just thought that\You couldnt be more wrong!\Thank goodness!\Im finally a real newswoman.\Do you know where Hichiriki Zakas Konata Inn is?\Write it there.\To prevent any leaks?\Thats right. response:	We cant let anyone know about this article.
context: You couldnt be more wrong!\Thank goodness!\Im finally a real newswoman.\Do you know where Hichiriki Zakas Konata Inn is?\Write it there.\To prevent any leaks?\Thats right.\We cant let anyone know about this article. response:	Ill put it on the page myself.
context: Thank goodness!\Im finally a real newswoman.\Do you know where Hichiriki Zakas Konata Inn is?\Write it there.\To prevent any leaks?\Thats right.\We cant let anyone know about this article.\Ill put it on the page myself. response:	Understand?
context: Im finally a real newswoman.\Do you know where Hichiriki Zakas Konata Inn is?\Write it there.\To prevent any leaks?\Thats right.\We cant let anyone know about this article.\Ill put it on the page myself.\Understand? response:	Yes!
context: Do you know where Hichiriki Zakas Konata Inn is?\Write it there.\To prevent any leaks?\Thats right.\We cant let anyone know about this article.\Ill put it on the page myself.\Understand?\Yes! response:	Yes, the very same.
context: Write it there.\To prevent any leaks?\Thats right.\We cant let anyone know about this article.\Ill put it on the page myself.\Understand?\Yes!\Yes, the very same. response:	Yes. Actually, I have a proposition for you.
context: To prevent any leaks?\Thats right.\We cant let anyone know about this article.\Ill put it on the page myself.\Understand?\Yes!\Yes, the very same.\Yes. Actually, I have a proposition for you. response:	No, its not very pleasant at all.
context: Thats right.\We cant let anyone know about this article.\Ill put it on the page myself.\Understand?\Yes!\Yes, the very same.\Yes. Actually, I have a proposition for you.\No, its not very pleasant at all. response:	No reason to meet anywhere else, is there?
context: We cant let anyone know about this article.\Ill put it on the page myself.\Understand?\Yes!\Yes, the very same.\Yes. Actually, I have a proposition for you.\No, its not very pleasant at all.\No reason to meet anywhere else, is there? response:	Ill come to you.
context: Ill put it on the page myself.\Understand?\Yes!\Yes, the very same.\Yes. Actually, I have a proposition for you.\No, its not very pleasant at all.\No reason to meet anywhere else, is there?\Ill come to you. response:	Her Regret is close.
context: Understand?\Yes!\Yes, the very same.\Yes. Actually, I have a proposition for you.\No, its not very pleasant at all.\No reason to meet anywhere else, is there?\Ill come to you.\Her Regret is close. response:	Her Regret is close.
context: Yes!\Yes, the very same.\Yes. Actually, I have a proposition for you.\No, its not very pleasant at all.\No reason to meet anywhere else, is there?\Ill come to you.\Her Regret is close.\Her Regret is close. response:	You promise to help me?
context: Yes, the very same.\Yes. Actually, I have a proposition for you.\No, its not very pleasant at all.\No reason to meet anywhere else, is there?\Ill come to you.\Her Regret is close.\Her Regret is close.\You promise to help me? response:	Please, Im begging you. I want to be famous!
context: Yes. Actually, I have a proposition for you.\No, its not very pleasant at all.\No reason to meet anywhere else, is there?\Ill come to you.\Her Regret is close.\Her Regret is close.\You promise to help me?\Please, Im begging you. I want to be famous! response:	I couldnt stand to rot away here the rest of my life!
context: No, its not very pleasant at all.\No reason to meet anywhere else, is there?\Ill come to you.\Her Regret is close.\Her Regret is close.\You promise to help me?\Please, Im begging you. I want to be famous!\I couldnt stand to rot away here the rest of my life! response:	Are you the man I spoke to?
context: No reason to meet anywhere else, is there?\Ill come to you.\Her Regret is close.\Her Regret is close.\You promise to help me?\Please, Im begging you. I want to be famous!\I couldnt stand to rot away here the rest of my life!\Are you the man I spoke to? response:	I actually had fun last night, for once.
context: Ill come to you.\Her Regret is close.\Her Regret is close.\You promise to help me?\Please, Im begging you. I want to be famous!\I couldnt stand to rot away here the rest of my life!\Are you the man I spoke to?\I actually had fun last night, for once. response:	Hello, Konata Inn.
context: Her Regret is close.\Her Regret is close.\You promise to help me?\Please, Im begging you. I want to be famous!\I couldnt stand to rot away here the rest of my life!\Are you the man I spoke to?\I actually had fun last night, for once.\Hello, Konata Inn. response:	Youve got to be kidding me.
context: Her Regret is close.\You promise to help me?\Please, Im begging you. I want to be famous!\I couldnt stand to rot away here the rest of my life!\Are you the man I spoke to?\I actually had fun last night, for once.\Hello, Konata Inn.\Youve got to be kidding me. response:	You have a telephone call.
context: You promise to help me?\Please, Im begging you. I want to be famous!\I couldnt stand to rot away here the rest of my life!\Are you the man I spoke to?\I actually had fun last night, for once.\Hello, Konata Inn.\Youve got to be kidding me.\You have a telephone call. response:	All right.
context: Please, Im begging you. I want to be famous!\I couldnt stand to rot away here the rest of my life!\Are you the man I spoke to?\I actually had fun last night, for once.\Hello, Konata Inn.\Youve got to be kidding me.\You have a telephone call.\All right. response:	Ah.
context: I couldnt stand to rot away here the rest of my life!\Are you the man I spoke to?\I actually had fun last night, for once.\Hello, Konata Inn.\Youve got to be kidding me.\You have a telephone call.\All right.\Ah. response:	Working here,
context: Are you the man I spoke to?\I actually had fun last night, for once.\Hello, Konata Inn.\Youve got to be kidding me.\You have a telephone call.\All right.\Ah.\Working here, response:	Pitiful, isnt it?
context: I actually had fun last night, for once.\Hello, Konata Inn.\Youve got to be kidding me.\You have a telephone call.\All right.\Ah.\Working here,\Pitiful, isnt it? response:	I was so glad.
context: Hello, Konata Inn.\Youve got to be kidding me.\You have a telephone call.\All right.\Ah.\Working here,\Pitiful, isnt it?\I was so glad. response:	Im different from that loser.
context: Youve got to be kidding me.\You have a telephone call.\All right.\Ah.\Working here,\Pitiful, isnt it?\I was so glad.\Im different from that loser. response:	Im a newswoman.
context: You have a telephone call.\All right.\Ah.\Working here,\Pitiful, isnt it?\I was so glad.\Im different from that loser.\Im a newswoman. response:	This is Ichikawa.
context: All right.\Ah.\Working here,\Pitiful, isnt it?\I was so glad.\Im different from that loser.\Im a newswoman.\This is Ichikawa. response:	Huh?
context: Ah.\Working here,\Pitiful, isnt it?\I was so glad.\Im different from that loser.\Im a newswoman.\This is Ichikawa.\Huh? response:	Why is that?
context: Working here,\Pitiful, isnt it?\I was so glad.\Im different from that loser.\Im a newswoman.\This is Ichikawa.\Huh?\Why is that? response:	Yes, I understand.
context: Pitiful, isnt it?\I was so glad.\Im different from that loser.\Im a newswoman.\This is Ichikawa.\Huh?\Why is that?\Yes, I understand. response:	Its true!
context: I was so glad.\Im different from that loser.\Im a newswoman.\This is Ichikawa.\Huh?\Why is that?\Yes, I understand.\Its true! response:	People have asked me if I wanted to be a singer.
context: Im different from that loser.\Im a newswoman.\This is Ichikawa.\Huh?\Why is that?\Yes, I understand.\Its true!\People have asked me if I wanted to be a singer. response:	Aw, I remember that.
context: Im a newswoman.\This is Ichikawa.\Huh?\Why is that?\Yes, I understand.\Its true!\People have asked me if I wanted to be a singer.\Aw, I remember that. response:	I wonder what happened.
context: This is Ichikawa.\Huh?\Why is that?\Yes, I understand.\Its true!\People have asked me if I wanted to be a singer.\Aw, I remember that.\I wonder what happened. response:	Moria-san!
context: Huh?\Why is that?\Yes, I understand.\Its true!\People have asked me if I wanted to be a singer.\Aw, I remember that.\I wonder what happened.\Moria-san! response:	Youre sure you werent followed?
context: Why is that?\Yes, I understand.\Its true!\People have asked me if I wanted to be a singer.\Aw, I remember that.\I wonder what happened.\Moria-san!\Youre sure you werent followed? response:	Yes.
context: Yes, I understand.\Its true!\People have asked me if I wanted to be a singer.\Aw, I remember that.\I wonder what happened.\Moria-san!\Youre sure you werent followed?\Yes. response:	Whats wrong, Moria-san?
context: Its true!\People have asked me if I wanted to be a singer.\Aw, I remember that.\I wonder what happened.\Moria-san!\Youre sure you werent followed?\Yes.\Whats wrong, Moria-san? response:	Why do you look so afraid?
context: People have asked me if I wanted to be a singer.\Aw, I remember that.\I wonder what happened.\Moria-san!\Youre sure you werent followed?\Yes.\Whats wrong, Moria-san?\Why do you look so afraid? response:	Were in danger.
context: Aw, I remember that.\I wonder what happened.\Moria-san!\Youre sure you werent followed?\Yes.\Whats wrong, Moria-san?\Why do you look so afraid?\Were in danger. response:	Oh, poppycock.
context: I wonder what happened.\Moria-san!\Youre sure you werent followed?\Yes.\Whats wrong, Moria-san?\Why do you look so afraid?\Were in danger.\Oh, poppycock. response:	Its not as though well be killed or anything.
context: Moria-san!\Youre sure you werent followed?\Yes.\Whats wrong, Moria-san?\Why do you look so afraid?\Were in danger.\Oh, poppycock.\Its not as though well be killed or anything. response:	I just went to see if she was all right!
context: Youre sure you werent followed?\Yes.\Whats wrong, Moria-san?\Why do you look so afraid?\Were in danger.\Oh, poppycock.\Its not as though well be killed or anything.\I just went to see if she was all right! response:	Theres no hurry.
context: Yes.\Whats wrong, Moria-san?\Why do you look so afraid?\Were in danger.\Oh, poppycock.\Its not as though well be killed or anything.\I just went to see if she was all right!\Theres no hurry. response:	Wheres the article?
context: Whats wrong, Moria-san?\Why do you look so afraid?\Were in danger.\Oh, poppycock.\Its not as though well be killed or anything.\I just went to see if she was all right!\Theres no hurry.\Wheres the article? response:	I have it with me.
context: Why do you look so afraid?\Were in danger.\Oh, poppycock.\Its not as though well be killed or anything.\I just went to see if she was all right!\Theres no hurry.\Wheres the article?\I have it with me. response:	Are you going to read it here?
context: Were in danger.\Oh, poppycock.\Its not as though well be killed or anything.\I just went to see if she was all right!\Theres no hurry.\Wheres the article?\I have it with me.\Are you going to read it here? response:	Yes.
context: Oh, poppycock.\Its not as though well be killed or anything.\I just went to see if she was all right!\Theres no hurry.\Wheres the article?\I have it with me.\Are you going to read it here?\Yes. response:	Whats wrong?
context: Its not as though well be killed or anything.\I just went to see if she was all right!\Theres no hurry.\Wheres the article?\I have it with me.\Are you going to read it here?\Yes.\Whats wrong? response:	Nothing.
context: I just went to see if she was all right!\Theres no hurry.\Wheres the article?\I have it with me.\Are you going to read it here?\Yes.\Whats wrong?\Nothing. response:	What are you doing?
context: Theres no hurry.\Wheres the article?\I have it with me.\Are you going to read it here?\Yes.\Whats wrong?\Nothing.\What are you doing? response:	I cant let this out.
context: Wheres the article?\I have it with me.\Are you going to read it here?\Yes.\Whats wrong?\Nothing.\What are you doing?\I cant let this out. response:	Why not?
context: I have it with me.\Are you going to read it here?\Yes.\Whats wrong?\Nothing.\What are you doing?\I cant let this out.\Why not? response:	Just following orders.
context: Are you going to read it here?\Yes.\Whats wrong?\Nothing.\What are you doing?\I cant let this out.\Why not?\Just following orders. response:	Whose orders?
context: Yes.\Whats wrong?\Nothing.\What are you doing?\I cant let this out.\Why not?\Just following orders.\Whose orders? response:	Masao!
context: Whats wrong?\Nothing.\What are you doing?\I cant let this out.\Why not?\Just following orders.\Whose orders?\Masao! response:	Masao, are you up?
context: Nothing.\What are you doing?\I cant let this out.\Why not?\Just following orders.\Whose orders?\Masao!\Masao, are you up? response:	Moria-san, you cant do this!
context: What are you doing?\I cant let this out.\Why not?\Just following orders.\Whose orders?\Masao!\Masao, are you up?\Moria-san, you cant do this! response:	You have no right to do this!
context: I cant let this out.\Why not?\Just following orders.\Whose orders?\Masao!\Masao, are you up?\Moria-san, you cant do this!\You have no right to do this! response:	Ill tell our superiors!
context: Why not?\Just following orders.\Whose orders?\Masao!\Masao, are you up?\Moria-san, you cant do this!\You have no right to do this!\Ill tell our superiors! response:	No use. Ive already spoken to them.
context: Just following orders.\Whose orders?\Masao!\Masao, are you up?\Moria-san, you cant do this!\You have no right to do this!\Ill tell our superiors!\No use. Ive already spoken to them. response:	Youre lying!
context: Whose orders?\Masao!\Masao, are you up?\Moria-san, you cant do this!\You have no right to do this!\Ill tell our superiors!\No use. Ive already spoken to them.\Youre lying! response:	No, Im not.
context: Masao!\Masao, are you up?\Moria-san, you cant do this!\You have no right to do this!\Ill tell our superiors!\No use. Ive already spoken to them.\Youre lying!\No, Im not. response:	You planned this from the beginning!
context: Masao, are you up?\Moria-san, you cant do this!\You have no right to do this!\Ill tell our superiors!\No use. Ive already spoken to them.\Youre lying!\No, Im not.\You planned this from the beginning! response:	You were always going to steal my
context: Moria-san, you cant do this!\You have no right to do this!\Ill tell our superiors!\No use. Ive already spoken to them.\Youre lying!\No, Im not.\You planned this from the beginning!\You were always going to steal my response:	Im sorry. I had to do it.
context: You have no right to do this!\Ill tell our superiors!\No use. Ive already spoken to them.\Youre lying!\No, Im not.\You planned this from the beginning!\You were always going to steal my\Im sorry. I had to do it. response:	You coward! You snake!
context: Ill tell our superiors!\No use. Ive already spoken to them.\Youre lying!\No, Im not.\You planned this from the beginning!\You were always going to steal my\Im sorry. I had to do it.\You coward! You snake! response:	You planned it from the beginning?
context: No use. Ive already spoken to them.\Youre lying!\No, Im not.\You planned this from the beginning!\You were always going to steal my\Im sorry. I had to do it.\You coward! You snake!\You planned it from the beginning? response:	Ill talk her out of it.
context: Youre lying!\No, Im not.\You planned this from the beginning!\You were always going to steal my\Im sorry. I had to do it.\You coward! You snake!\You planned it from the beginning?\Ill talk her out of it. response:	How?
context: No, Im not.\You planned this from the beginning!\You were always going to steal my\Im sorry. I had to do it.\You coward! You snake!\You planned it from the beginning?\Ill talk her out of it.\How? response:	Ill tell the Chief Editor! Ill get you fired!
context: You planned this from the beginning!\You were always going to steal my\Im sorry. I had to do it.\You coward! You snake!\You planned it from the beginning?\Ill talk her out of it.\How?\Ill tell the Chief Editor! Ill get you fired! response:	This could be quite a problem.
context: You were always going to steal my\Im sorry. I had to do it.\You coward! You snake!\You planned it from the beginning?\Ill talk her out of it.\How?\Ill tell the Chief Editor! Ill get you fired!\This could be quite a problem. response:	Well, its not really my concern.
context: Im sorry. I had to do it.\You coward! You snake!\You planned it from the beginning?\Ill talk her out of it.\How?\Ill tell the Chief Editor! Ill get you fired!\This could be quite a problem.\Well, its not really my concern. response:	At any rate, Ill leave it to you.
context: You coward! You snake!\You planned it from the beginning?\Ill talk her out of it.\How?\Ill tell the Chief Editor! Ill get you fired!\This could be quite a problem.\Well, its not really my concern.\At any rate, Ill leave it to you. response:	Damn you!
context: You planned it from the beginning?\Ill talk her out of it.\How?\Ill tell the Chief Editor! Ill get you fired!\This could be quite a problem.\Well, its not really my concern.\At any rate, Ill leave it to you.\Damn you! response:	Damn you! Damn you! Damn you!
context: Ill talk her out of it.\How?\Ill tell the Chief Editor! Ill get you fired!\This could be quite a problem.\Well, its not really my concern.\At any rate, Ill leave it to you.\Damn you!\Damn you! Damn you! Damn you! response:	You think Im jealous of you?
context: How?\Ill tell the Chief Editor! Ill get you fired!\This could be quite a problem.\Well, its not really my concern.\At any rate, Ill leave it to you.\Damn you!\Damn you! Damn you! Damn you!\You think Im jealous of you? response:	Dont make me laugh.
context: Ill tell the Chief Editor! Ill get you fired!\This could be quite a problem.\Well, its not really my concern.\At any rate, Ill leave it to you.\Damn you!\Damn you! Damn you! Damn you!\You think Im jealous of you?\Dont make me laugh. response:	I wouldnt do this over such petty concerns.
context: This could be quite a problem.\Well, its not really my concern.\At any rate, Ill leave it to you.\Damn you!\Damn you! Damn you! Damn you!\You think Im jealous of you?\Dont make me laugh.\I wouldnt do this over such petty concerns. response:	Damn you! Damn you! Damn you!
context: Well, its not really my concern.\At any rate, Ill leave it to you.\Damn you!\Damn you! Damn you! Damn you!\You think Im jealous of you?\Dont make me laugh.\I wouldnt do this over such petty concerns.\Damn you! Damn you! Damn you! response:	Youre a woman to the end, never able to catch on when it really counts.
context: At any rate, Ill leave it to you.\Damn you!\Damn you! Damn you! Damn you!\You think Im jealous of you?\Dont make me laugh.\I wouldnt do this over such petty concerns.\Damn you! Damn you! Damn you!\Youre a woman to the end, never able to catch on when it really counts. response:	I was watching her from a much higher position.
context: Damn you!\Damn you! Damn you! Damn you!\You think Im jealous of you?\Dont make me laugh.\I wouldnt do this over such petty concerns.\Damn you! Damn you! Damn you!\Youre a woman to the end, never able to catch on when it really counts.\I was watching her from a much higher position. response:	What do you mean?
context: Damn you! Damn you! Damn you!\You think Im jealous of you?\Dont make me laugh.\I wouldnt do this over such petty concerns.\Damn you! Damn you! Damn you!\Youre a woman to the end, never able to catch on when it really counts.\I was watching her from a much higher position.\What do you mean? response:	You must not hesitate in executing this order.
context: You think Im jealous of you?\Dont make me laugh.\I wouldnt do this over such petty concerns.\Damn you! Damn you! Damn you!\Youre a woman to the end, never able to catch on when it really counts.\I was watching her from a much higher position.\What do you mean?\You must not hesitate in executing this order. response:	You understand?
context: Dont make me laugh.\I wouldnt do this over such petty concerns.\Damn you! Damn you! Damn you!\Youre a woman to the end, never able to catch on when it really counts.\I was watching her from a much higher position.\What do you mean?\You must not hesitate in executing this order.\You understand? response:	We cant have this turning into a scandal.
context: I wouldnt do this over such petty concerns.\Damn you! Damn you! Damn you!\Youre a woman to the end, never able to catch on when it really counts.\I was watching her from a much higher position.\What do you mean?\You must not hesitate in executing this order.\You understand?\We cant have this turning into a scandal. response:	Youre working for Mayor Fukuda?
context: Damn you! Damn you! Damn you!\Youre a woman to the end, never able to catch on when it really counts.\I was watching her from a much higher position.\What do you mean?\You must not hesitate in executing this order.\You understand?\We cant have this turning into a scandal.\Youre working for Mayor Fukuda? response:	How dare you? How dare you?
context: Youre a woman to the end, never able to catch on when it really counts.\I was watching her from a much higher position.\What do you mean?\You must not hesitate in executing this order.\You understand?\We cant have this turning into a scandal.\Youre working for Mayor Fukuda?\How dare you? How dare you? response:	Yes, you women are so blind.
context: I was watching her from a much higher position.\What do you mean?\You must not hesitate in executing this order.\You understand?\We cant have this turning into a scandal.\Youre working for Mayor Fukuda?\How dare you? How dare you?\Yes, you women are so blind. response:	How dare you?
context: What do you mean?\You must not hesitate in executing this order.\You understand?\We cant have this turning into a scandal.\Youre working for Mayor Fukuda?\How dare you? How dare you?\Yes, you women are so blind.\How dare you? response:	You have no ability to read a situation.
context: You must not hesitate in executing this order.\You understand?\We cant have this turning into a scandal.\Youre working for Mayor Fukuda?\How dare you? How dare you?\Yes, you women are so blind.\How dare you?\You have no ability to read a situation. response:	Ill kill you!
context: You understand?\We cant have this turning into a scandal.\Youre working for Mayor Fukuda?\How dare you? How dare you?\Yes, you women are so blind.\How dare you?\You have no ability to read a situation.\Ill kill you! response:	You never wanted to print the article.
context: We cant have this turning into a scandal.\Youre working for Mayor Fukuda?\How dare you? How dare you?\Yes, you women are so blind.\How dare you?\You have no ability to read a situation.\Ill kill you!\You never wanted to print the article. response:	You never wanted to print the article.
context: Youre working for Mayor Fukuda?\How dare you? How dare you?\Yes, you women are so blind.\How dare you?\You have no ability to read a situation.\Ill kill you!\You never wanted to print the article.\You never wanted to print the article. response:	Youll take orders from me now.
context: How dare you? How dare you?\Yes, you women are so blind.\How dare you?\You have no ability to read a situation.\Ill kill you!\You never wanted to print the article.\You never wanted to print the article.\Youll take orders from me now. response:	Ill have it printed somewhere else!
context: Yes, you women are so blind.\How dare you?\You have no ability to read a situation.\Ill kill you!\You never wanted to print the article.\You never wanted to print the article.\Youll take orders from me now.\Ill have it printed somewhere else! response:	I still have the proof!
context: How dare you?\You have no ability to read a situation.\Ill kill you!\You never wanted to print the article.\You never wanted to print the article.\Youll take orders from me now.\Ill have it printed somewhere else!\I still have the proof! response:	Ive fooled you!
context: You have no ability to read a situation.\Ill kill you!\You never wanted to print the article.\You never wanted to print the article.\Youll take orders from me now.\Ill have it printed somewhere else!\I still have the proof!\Ive fooled you! response:	Where is it?
context: Ill kill you!\You never wanted to print the article.\You never wanted to print the article.\Youll take orders from me now.\Ill have it printed somewhere else!\I still have the proof!\Ive fooled you!\Where is it? response:	Give it to me!
context: You never wanted to print the article.\You never wanted to print the article.\Youll take orders from me now.\Ill have it printed somewhere else!\I still have the proof!\Ive fooled you!\Where is it?\Give it to me! response:	Ill never give it up!
context: You never wanted to print the article.\Youll take orders from me now.\Ill have it printed somewhere else!\I still have the proof!\Ive fooled you!\Where is it?\Give it to me!\Ill never give it up! response:	This is the only time I really feel alive.
context: Youll take orders from me now.\Ill have it printed somewhere else!\I still have the proof!\Ive fooled you!\Where is it?\Give it to me!\Ill never give it up!\This is the only time I really feel alive. response:	The people wont allow this!
context: Ill have it printed somewhere else!\I still have the proof!\Ive fooled you!\Where is it?\Give it to me!\Ill never give it up!\This is the only time I really feel alive.\The people wont allow this! response:	Stop it! Stop it!
context: I still have the proof!\Ive fooled you!\Where is it?\Give it to me!\Ill never give it up!\This is the only time I really feel alive.\The people wont allow this!\Stop it! Stop it! response:	That old hag
context: Ive fooled you!\Where is it?\Give it to me!\Ill never give it up!\This is the only time I really feel alive.\The people wont allow this!\Stop it! Stop it!\That old hag response:	I wish she would just die!
context: Where is it?\Give it to me!\Ill never give it up!\This is the only time I really feel alive.\The people wont allow this!\Stop it! Stop it!\That old hag\I wish she would just die! response:	You really are a stupid woman.
context: Give it to me!\Ill never give it up!\This is the only time I really feel alive.\The people wont allow this!\Stop it! Stop it!\That old hag\I wish she would just die!\You really are a stupid woman. response:	I gave you fair warning.
context: Ill never give it up!\This is the only time I really feel alive.\The people wont allow this!\Stop it! Stop it!\That old hag\I wish she would just die!\You really are a stupid woman.\I gave you fair warning. response:	You made me
context: This is the only time I really feel alive.\The people wont allow this!\Stop it! Stop it!\That old hag\I wish she would just die!\You really are a stupid woman.\I gave you fair warning.\You made me response:	Made me kill you?
context: The people wont allow this!\Stop it! Stop it!\That old hag\I wish she would just die!\You really are a stupid woman.\I gave you fair warning.\You made me\Made me kill you? response:	Made me kill you?
context: Stop it! Stop it!\That old hag\I wish she would just die!\You really are a stupid woman.\I gave you fair warning.\You made me\Made me kill you?\Made me kill you? response:	So sorry.
context: That old hag\I wish she would just die!\You really are a stupid woman.\I gave you fair warning.\You made me\Made me kill you?\Made me kill you?\So sorry. response:	Its nothing.
context: I wish she would just die!\You really are a stupid woman.\I gave you fair warning.\You made me\Made me kill you?\Made me kill you?\So sorry.\Its nothing. response:	A woman reporter bit off more than she could chew, and committed suicide after having her dreams shattered.
context: You really are a stupid woman.\I gave you fair warning.\You made me\Made me kill you?\Made me kill you?\So sorry.\Its nothing.\A woman reporter bit off more than she could chew, and committed suicide after having her dreams shattered. response:	It hurts. It hurts.
context: I gave you fair warning.\You made me\Made me kill you?\Made me kill you?\So sorry.\Its nothing.\A woman reporter bit off more than she could chew, and committed suicide after having her dreams shattered.\It hurts. It hurts. response:	I cant move.
context: You made me\Made me kill you?\Made me kill you?\So sorry.\Its nothing.\A woman reporter bit off more than she could chew, and committed suicide after having her dreams shattered.\It hurts. It hurts.\I cant move. response:	No! No, it cant be!
context: Made me kill you?\Made me kill you?\So sorry.\Its nothing.\A woman reporter bit off more than she could chew, and committed suicide after having her dreams shattered.\It hurts. It hurts.\I cant move.\No! No, it cant be! response:	No!
context: Made me kill you?\So sorry.\Its nothing.\A woman reporter bit off more than she could chew, and committed suicide after having her dreams shattered.\It hurts. It hurts.\I cant move.\No! No, it cant be!\No! response:	Please, notice me!
context: So sorry.\Its nothing.\A woman reporter bit off more than she could chew, and committed suicide after having her dreams shattered.\It hurts. It hurts.\I cant move.\No! No, it cant be!\No!\Please, notice me! response:	Dont hit me! You have to notice me!
context: Its nothing.\A woman reporter bit off more than she could chew, and committed suicide after having her dreams shattered.\It hurts. It hurts.\I cant move.\No! No, it cant be!\No!\Please, notice me!\Dont hit me! You have to notice me! response:	Ill never forgive you.
context: A woman reporter bit off more than she could chew, and committed suicide after having her dreams shattered.\It hurts. It hurts.\I cant move.\No! No, it cant be!\No!\Please, notice me!\Dont hit me! You have to notice me!\Ill never forgive you. response:	Ill never forgive you.
context: It hurts. It hurts.\I cant move.\No! No, it cant be!\No!\Please, notice me!\Dont hit me! You have to notice me!\Ill never forgive you.\Ill never forgive you. response:	No!
context: I cant move.\No! No, it cant be!\No!\Please, notice me!\Dont hit me! You have to notice me!\Ill never forgive you.\Ill never forgive you.\No! response:	Shes not even good enough for the back page.
context: No! No, it cant be!\No!\Please, notice me!\Dont hit me! You have to notice me!\Ill never forgive you.\Ill never forgive you.\No!\Shes not even good enough for the back page. response:	I want to be an actress.
context: No!\Please, notice me!\Dont hit me! You have to notice me!\Ill never forgive you.\Ill never forgive you.\No!\Shes not even good enough for the back page.\I want to be an actress. response:	Heres your payment.
context: Please, notice me!\Dont hit me! You have to notice me!\Ill never forgive you.\Ill never forgive you.\No!\Shes not even good enough for the back page.\I want to be an actress.\Heres your payment. response:	Yeah, this is a suicide. A suicide, Im sure.
context: Dont hit me! You have to notice me!\Ill never forgive you.\Ill never forgive you.\No!\Shes not even good enough for the back page.\I want to be an actress.\Heres your payment.\Yeah, this is a suicide. A suicide, Im sure. response:	Shut up!
context: Ill never forgive you.\Ill never forgive you.\No!\Shes not even good enough for the back page.\I want to be an actress.\Heres your payment.\Yeah, this is a suicide. A suicide, Im sure.\Shut up! response:	Ill never forgive you.
context: Ill never forgive you.\No!\Shes not even good enough for the back page.\I want to be an actress.\Heres your payment.\Yeah, this is a suicide. A suicide, Im sure.\Shut up!\Ill never forgive you. response:	Ill never forgive you.
context: No!\Shes not even good enough for the back page.\I want to be an actress.\Heres your payment.\Yeah, this is a suicide. A suicide, Im sure.\Shut up!\Ill never forgive you.\Ill never forgive you. response:	Ayakashi reside in a host,
context: Shes not even good enough for the back page.\I want to be an actress.\Heres your payment.\Yeah, this is a suicide. A suicide, Im sure.\Shut up!\Ill never forgive you.\Ill never forgive you.\Ayakashi reside in a host, response:	and humans reside in the physical plane.
context: I want to be an actress.\Heres your payment.\Yeah, this is a suicide. A suicide, Im sure.\Shut up!\Ill never forgive you.\Ill never forgive you.\Ayakashi reside in a host,\and humans reside in the physical plane. response:	A Mononoke is formed with an Ayakashi as its host,
context: Heres your payment.\Yeah, this is a suicide. A suicide, Im sure.\Shut up!\Ill never forgive you.\Ill never forgive you.\Ayakashi reside in a host,\and humans reside in the physical plane.\A Mononoke is formed with an Ayakashi as its host, response:	and fed by the fates of men.
context: Yeah, this is a suicide. A suicide, Im sure.\Shut up!\Ill never forgive you.\Ill never forgive you.\Ayakashi reside in a host,\and humans reside in the physical plane.\A Mononoke is formed with an Ayakashi as its host,\and fed by the fates of men. response:	However, when a Mononoke comes into the human plane,
context: Shut up!\Ill never forgive you.\Ill never forgive you.\Ayakashi reside in a host,\and humans reside in the physical plane.\A Mononoke is formed with an Ayakashi as its host,\and fed by the fates of men.\However, when a Mononoke comes into the human plane, response:	it must be killed.
context: Ill never forgive you.\Ill never forgive you.\Ayakashi reside in a host,\and humans reside in the physical plane.\A Mononoke is formed with an Ayakashi as its host,\and fed by the fates of men.\However, when a Mononoke comes into the human plane,\it must be killed. response:	it must be killed.
context: Ill never forgive you.\Ayakashi reside in a host,\and humans reside in the physical plane.\A Mononoke is formed with an Ayakashi as its host,\and fed by the fates of men.\However, when a Mononoke comes into the human plane,\it must be killed.\it must be killed. response:	This is
context: Ayakashi reside in a host,\and humans reside in the physical plane.\A Mononoke is formed with an Ayakashi as its host,\and fed by the fates of men.\However, when a Mononoke comes into the human plane,\it must be killed.\it must be killed.\This is response:	a Ghost Cat.
context: and humans reside in the physical plane.\A Mononoke is formed with an Ayakashi as its host,\and fed by the fates of men.\However, when a Mononoke comes into the human plane,\it must be killed.\it must be killed.\This is\a Ghost Cat. response:	I will cleanse this world.
context: A Mononoke is formed with an Ayakashi as its host,\and fed by the fates of men.\However, when a Mononoke comes into the human plane,\it must be killed.\it must be killed.\This is\a Ghost Cat.\I will cleanse this world. response:	I will cleanse this world.
context: and fed by the fates of men.\However, when a Mononoke comes into the human plane,\it must be killed.\it must be killed.\This is\a Ghost Cat.\I will cleanse this world.\I will cleanse this world. response:	I will cleanse this world.
context: However, when a Mononoke comes into the human plane,\it must be killed.\it must be killed.\This is\a Ghost Cat.\I will cleanse this world.\I will cleanse this world.\I will cleanse this world. response:	The Mononoke must be killed.
context: it must be killed.\it must be killed.\This is\a Ghost Cat.\I will cleanse this world.\I will cleanse this world.\I will cleanse this world.\The Mononoke must be killed. response:	Release.
context: it must be killed.\This is\a Ghost Cat.\I will cleanse this world.\I will cleanse this world.\I will cleanse this world.\The Mononoke must be killed.\Release. response:	A dream?
context: This is\a Ghost Cat.\I will cleanse this world.\I will cleanse this world.\I will cleanse this world.\The Mononoke must be killed.\Release.\A dream? response:	Id like to embark on the second stage as soon as possible.
context: a Ghost Cat.\I will cleanse this world.\I will cleanse this world.\I will cleanse this world.\The Mononoke must be killed.\Release.\A dream?\Id like to embark on the second stage as soon as possible. response:	Were safe?
context: I will cleanse this world.\I will cleanse this world.\I will cleanse this world.\The Mononoke must be killed.\Release.\A dream?\Id like to embark on the second stage as soon as possible.\Were safe? response:	Are we safe?
context: I will cleanse this world.\I will cleanse this world.\The Mononoke must be killed.\Release.\A dream?\Id like to embark on the second stage as soon as possible.\Were safe?\Are we safe? response:	It was just a nightmare.
context: I will cleanse this world.\The Mononoke must be killed.\Release.\A dream?\Id like to embark on the second stage as soon as possible.\Were safe?\Are we safe?\It was just a nightmare. response:	Thats unlike me.
context: The Mononoke must be killed.\Release.\A dream?\Id like to embark on the second stage as soon as possible.\Were safe?\Are we safe?\It was just a nightmare.\Thats unlike me. response:	Im sorry, Ichikawa.
context: Release.\A dream?\Id like to embark on the second stage as soon as possible.\Were safe?\Are we safe?\It was just a nightmare.\Thats unlike me.\Im sorry, Ichikawa. response:	I had no choice.
context: A dream?\Id like to embark on the second stage as soon as possible.\Were safe?\Are we safe?\It was just a nightmare.\Thats unlike me.\Im sorry, Ichikawa.\I had no choice. response:	Ill never forgive you.
context: Id like to embark on the second stage as soon as possible.\Were safe?\Are we safe?\It was just a nightmare.\Thats unlike me.\Im sorry, Ichikawa.\I had no choice.\Ill never forgive you. response:	Men are born into this world,
context: Were safe?\Are we safe?\It was just a nightmare.\Thats unlike me.\Im sorry, Ichikawa.\I had no choice.\Ill never forgive you.\Men are born into this world, response:	Ayakashi simply come into being.
context: Are we safe?\It was just a nightmare.\Thats unlike me.\Im sorry, Ichikawa.\I had no choice.\Ill never forgive you.\Men are born into this world,\Ayakashi simply come into being. response:	If birth and being are accompanied by Truth and Regret,
context: It was just a nightmare.\Thats unlike me.\Im sorry, Ichikawa.\I had no choice.\Ill never forgive you.\Men are born into this world,\Ayakashi simply come into being.\If birth and being are accompanied by Truth and Regret, response:	they gain a Form.
context: Thats unlike me.\Im sorry, Ichikawa.\I had no choice.\Ill never forgive you.\Men are born into this world,\Ayakashi simply come into being.\If birth and being are accompanied by Truth and Regret,\they gain a Form. response:	If they gain a Form, they become a Mononoke, which should not exist.
context: Im sorry, Ichikawa.\I had no choice.\Ill never forgive you.\Men are born into this world,\Ayakashi simply come into being.\If birth and being are accompanied by Truth and Regret,\they gain a Form.\If they gain a Form, they become a Mononoke, which should not exist. response:	We cannot eradicate the Mononoke.
context: I had no choice.\Ill never forgive you.\Men are born into this world,\Ayakashi simply come into being.\If birth and being are accompanied by Truth and Regret,\they gain a Form.\If they gain a Form, they become a Mononoke, which should not exist.\We cannot eradicate the Mononoke. response:	However, we can purify them, and put them to rest.
context: Ill never forgive you.\Men are born into this world,\Ayakashi simply come into being.\If birth and being are accompanied by Truth and Regret,\they gain a Form.\If they gain a Form, they become a Mononoke, which should not exist.\We cannot eradicate the Mononoke.\However, we can purify them, and put them to rest. response:	And so, there must be a sword, and hands in which it might rest.
context: Men are born into this world,\Ayakashi simply come into being.\If birth and being are accompanied by Truth and Regret,\they gain a Form.\If they gain a Form, they become a Mononoke, which should not exist.\We cannot eradicate the Mononoke.\However, we can purify them, and put them to rest.\And so, there must be a sword, and hands in which it might rest. response:	My friends, let me ask you of your Truth and Regret.
context: Ayakashi simply come into being.\If birth and being are accompanied by Truth and Regret,\they gain a Form.\If they gain a Form, they become a Mononoke, which should not exist.\We cannot eradicate the Mononoke.\However, we can purify them, and put them to rest.\And so, there must be a sword, and hands in which it might rest.\My friends, let me ask you of your Truth and Regret. response:	So long as Mononoke roam this world
context: If birth and being are accompanied by Truth and Regret,\they gain a Form.\If they gain a Form, they become a Mononoke, which should not exist.\We cannot eradicate the Mononoke.\However, we can purify them, and put them to rest.\And so, there must be a sword, and hands in which it might rest.\My friends, let me ask you of your Truth and Regret.\So long as Mononoke roam this world response:	So long as Mononoke roam this world
context: they gain a Form.\If they gain a Form, they become a Mononoke, which should not exist.\We cannot eradicate the Mononoke.\However, we can purify them, and put them to rest.\And so, there must be a sword, and hands in which it might rest.\My friends, let me ask you of your Truth and Regret.\So long as Mononoke roam this world\So long as Mononoke roam this world response:	Miss?
context: If they gain a Form, they become a Mononoke, which should not exist.\We cannot eradicate the Mononoke.\However, we can purify them, and put them to rest.\And so, there must be a sword, and hands in which it might rest.\My friends, let me ask you of your Truth and Regret.\So long as Mononoke roam this world\So long as Mononoke roam this world\Miss? response:	Im coming!