context: The Third Plate response:	Nine
context: The Third Plate\Nine response:	The dining hall side needs reinforcements!
context: The Third Plate\Nine\The dining hall side needs reinforcements! response:	We won't let you lay a finger on this dorm until Yukihira's Shokugeki is over!
context: The Third Plate\Nine\The dining hall side needs reinforcements!\We won't let you lay a finger on this dorm until Yukihira's Shokugeki is over! response:	They got through our barricades?!
context: The Third Plate\Nine\The dining hall side needs reinforcements!\We won't let you lay a finger on this dorm until Yukihira's Shokugeki is over!\They got through our barricades?! response:	Shit! We're done for if they get inside!
context: The Third Plate\Nine\The dining hall side needs reinforcements!\We won't let you lay a finger on this dorm until Yukihira's Shokugeki is over!\They got through our barricades?!\Shit! We're done for if they get inside! response:	Wait.
context: The Third Plate\Nine\The dining hall side needs reinforcements!\We won't let you lay a finger on this dorm until Yukihira's Shokugeki is over!\They got through our barricades?!\Shit! We're done for if they get inside!\Wait. response:	Something's off.
context: The Third Plate\Nine\The dining hall side needs reinforcements!\We won't let you lay a finger on this dorm until Yukihira's Shokugeki is over!\They got through our barricades?!\Shit! We're done for if they get inside!\Wait.\Something's off. response:	They're not rushing in?
context: Nine\The dining hall side needs reinforcements!\We won't let you lay a finger on this dorm until Yukihira's Shokugeki is over!\They got through our barricades?!\Shit! We're done for if they get inside!\Wait.\Something's off.\They're not rushing in? response:	I can't believe my glasses broke now of all times!
context: The dining hall side needs reinforcements!\We won't let you lay a finger on this dorm until Yukihira's Shokugeki is over!\They got through our barricades?!\Shit! We're done for if they get inside!\Wait.\Something's off.\They're not rushing in?\I can't believe my glasses broke now of all times! response:	What's wrong, Marui?!
context: We won't let you lay a finger on this dorm until Yukihira's Shokugeki is over!\They got through our barricades?!\Shit! We're done for if they get inside!\Wait.\Something's off.\They're not rushing in?\I can't believe my glasses broke now of all times!\What's wrong, Marui?! response:	Wh-What's going on?!
context: They got through our barricades?!\Shit! We're done for if they get inside!\Wait.\Something's off.\They're not rushing in?\I can't believe my glasses broke now of all times!\What's wrong, Marui?!\Wh-What's going on?! response:	Yukihira Soma
context: Shit! We're done for if they get inside!\Wait.\Something's off.\They're not rushing in?\I can't believe my glasses broke now of all times!\What's wrong, Marui?!\Wh-What's going on?!\Yukihira Soma response:	Eizan Etsuya
context: Wait.\Something's off.\They're not rushing in?\I can't believe my glasses broke now of all times!\What's wrong, Marui?!\Wh-What's going on?!\Yukihira Soma\Eizan Etsuya response:	In the Shokugeki between Yukihira Soma and Eizan Etsuya,
context: Something's off.\They're not rushing in?\I can't believe my glasses broke now of all times!\What's wrong, Marui?!\Wh-What's going on?!\Yukihira Soma\Eizan Etsuya\In the Shokugeki between Yukihira Soma and Eizan Etsuya, response:	Yukihira Soma won with a score of 3 to 0.
context: They're not rushing in?\I can't believe my glasses broke now of all times!\What's wrong, Marui?!\Wh-What's going on?!\Yukihira Soma\Eizan Etsuya\In the Shokugeki between Yukihira Soma and Eizan Etsuya,\Yukihira Soma won with a score of 3 to 0. response:	Eizan Etsuya
context: I can't believe my glasses broke now of all times!\What's wrong, Marui?!\Wh-What's going on?!\Yukihira Soma\Eizan Etsuya\In the Shokugeki between Yukihira Soma and Eizan Etsuya,\Yukihira Soma won with a score of 3 to 0.\Eizan Etsuya response:	Soma-kun won...
context: What's wrong, Marui?!\Wh-What's going on?!\Yukihira Soma\Eizan Etsuya\In the Shokugeki between Yukihira Soma and Eizan Etsuya,\Yukihira Soma won with a score of 3 to 0.\Eizan Etsuya\Soma-kun won... response:	I repeat, in the Shokugeki between Yukihira Soma and Eizan Etsuya...
context: Wh-What's going on?!\Yukihira Soma\Eizan Etsuya\In the Shokugeki between Yukihira Soma and Eizan Etsuya,\Yukihira Soma won with a score of 3 to 0.\Eizan Etsuya\Soma-kun won...\I repeat, in the Shokugeki between Yukihira Soma and Eizan Etsuya... response:	But how?!
context: Yukihira Soma\Eizan Etsuya\In the Shokugeki between Yukihira Soma and Eizan Etsuya,\Yukihira Soma won with a score of 3 to 0.\Eizan Etsuya\Soma-kun won...\I repeat, in the Shokugeki between Yukihira Soma and Eizan Etsuya...\But how?! response:	Yukihira!
context: Eizan Etsuya\In the Shokugeki between Yukihira Soma and Eizan Etsuya,\Yukihira Soma won with a score of 3 to 0.\Eizan Etsuya\Soma-kun won...\I repeat, in the Shokugeki between Yukihira Soma and Eizan Etsuya...\But how?!\Yukihira! response:	He really beat the Ninth Seat of the Elite Ten...
context: In the Shokugeki between Yukihira Soma and Eizan Etsuya,\Yukihira Soma won with a score of 3 to 0.\Eizan Etsuya\Soma-kun won...\I repeat, in the Shokugeki between Yukihira Soma and Eizan Etsuya...\But how?!\Yukihira!\He really beat the Ninth Seat of the Elite Ten... response:	Eizan might've taken the Shokugeki more seriously
context: Yukihira Soma won with a score of 3 to 0.\Eizan Etsuya\Soma-kun won...\I repeat, in the Shokugeki between Yukihira Soma and Eizan Etsuya...\But how?!\Yukihira!\He really beat the Ninth Seat of the Elite Ten...\Eizan might've taken the Shokugeki more seriously response:	if he'd wagered his seat, but...
context: Eizan Etsuya\Soma-kun won...\I repeat, in the Shokugeki between Yukihira Soma and Eizan Etsuya...\But how?!\Yukihira!\He really beat the Ninth Seat of the Elite Ten...\Eizan might've taken the Shokugeki more seriously\if he'd wagered his seat, but... response:	Yukihira Soma...
context: Soma-kun won...\I repeat, in the Shokugeki between Yukihira Soma and Eizan Etsuya...\But how?!\Yukihira!\He really beat the Ninth Seat of the Elite Ten...\Eizan might've taken the Shokugeki more seriously\if he'd wagered his seat, but...\Yukihira Soma... response:	Hey, Isshiki. Hard at work on the paperwork, huh?
context: I repeat, in the Shokugeki between Yukihira Soma and Eizan Etsuya...\But how?!\Yukihira!\He really beat the Ninth Seat of the Elite Ten...\Eizan might've taken the Shokugeki more seriously\if he'd wagered his seat, but...\Yukihira Soma...\Hey, Isshiki. Hard at work on the paperwork, huh? response:	Are you cool with all of this, though?
context: But how?!\Yukihira!\He really beat the Ninth Seat of the Elite Ten...\Eizan might've taken the Shokugeki more seriously\if he'd wagered his seat, but...\Yukihira Soma...\Hey, Isshiki. Hard at work on the paperwork, huh?\Are you cool with all of this, though? response:	Your dorm's about to get shut down.
context: Yukihira!\He really beat the Ninth Seat of the Elite Ten...\Eizan might've taken the Shokugeki more seriously\if he'd wagered his seat, but...\Yukihira Soma...\Hey, Isshiki. Hard at work on the paperwork, huh?\Are you cool with all of this, though?\Your dorm's about to get shut down. response:	How can you just watch that happen from over there?
context: He really beat the Ninth Seat of the Elite Ten...\Eizan might've taken the Shokugeki more seriously\if he'd wagered his seat, but...\Yukihira Soma...\Hey, Isshiki. Hard at work on the paperwork, huh?\Are you cool with all of this, though?\Your dorm's about to get shut down.\How can you just watch that happen from over there? response:	Polar Star Dormitory won't get shut down.
context: Eizan might've taken the Shokugeki more seriously\if he'd wagered his seat, but...\Yukihira Soma...\Hey, Isshiki. Hard at work on the paperwork, huh?\Are you cool with all of this, though?\Your dorm's about to get shut down.\How can you just watch that happen from over there?\Polar Star Dormitory won't get shut down. response:	Soma-kun knows that the true worth of a chef
context: if he'd wagered his seat, but...\Yukihira Soma...\Hey, Isshiki. Hard at work on the paperwork, huh?\Are you cool with all of this, though?\Your dorm's about to get shut down.\How can you just watch that happen from over there?\Polar Star Dormitory won't get shut down.\Soma-kun knows that the true worth of a chef response:	can only be gauged through their creations.
context: Yukihira Soma...\Hey, Isshiki. Hard at work on the paperwork, huh?\Are you cool with all of this, though?\Your dorm's about to get shut down.\How can you just watch that happen from over there?\Polar Star Dormitory won't get shut down.\Soma-kun knows that the true worth of a chef\can only be gauged through their creations. response:	I know what he's capable of.
context: Hey, Isshiki. Hard at work on the paperwork, huh?\Are you cool with all of this, though?\Your dorm's about to get shut down.\How can you just watch that happen from over there?\Polar Star Dormitory won't get shut down.\Soma-kun knows that the true worth of a chef\can only be gauged through their creations.\I know what he's capable of. response:	He will easily overcome Eizan-kun's rigged match.
context: Are you cool with all of this, though?\Your dorm's about to get shut down.\How can you just watch that happen from over there?\Polar Star Dormitory won't get shut down.\Soma-kun knows that the true worth of a chef\can only be gauged through their creations.\I know what he's capable of.\He will easily overcome Eizan-kun's rigged match. response:	Rather, what will be critical is what follows that match.
context: Your dorm's about to get shut down.\How can you just watch that happen from over there?\Polar Star Dormitory won't get shut down.\Soma-kun knows that the true worth of a chef\can only be gauged through their creations.\I know what he's capable of.\He will easily overcome Eizan-kun's rigged match.\Rather, what will be critical is what follows that match. response:	That is when the true battle begins.
context: How can you just watch that happen from over there?\Polar Star Dormitory won't get shut down.\Soma-kun knows that the true worth of a chef\can only be gauged through their creations.\I know what he's capable of.\He will easily overcome Eizan-kun's rigged match.\Rather, what will be critical is what follows that match.\That is when the true battle begins. response:	I must make the necessary preparations for that, no matter what happens.
context: Polar Star Dormitory won't get shut down.\Soma-kun knows that the true worth of a chef\can only be gauged through their creations.\I know what he's capable of.\He will easily overcome Eizan-kun's rigged match.\Rather, what will be critical is what follows that match.\That is when the true battle begins.\I must make the necessary preparations for that, no matter what happens. response:	Looks like things are playing out exactly as Isshiki had imagined.
context: Soma-kun knows that the true worth of a chef\can only be gauged through their creations.\I know what he's capable of.\He will easily overcome Eizan-kun's rigged match.\Rather, what will be critical is what follows that match.\That is when the true battle begins.\I must make the necessary preparations for that, no matter what happens.\Looks like things are playing out exactly as Isshiki had imagined. response:	Yukihira Soma
context: can only be gauged through their creations.\I know what he's capable of.\He will easily overcome Eizan-kun's rigged match.\Rather, what will be critical is what follows that match.\That is when the true battle begins.\I must make the necessary preparations for that, no matter what happens.\Looks like things are playing out exactly as Isshiki had imagined.\Yukihira Soma response:	Eizan Etsuya
context: I know what he's capable of.\He will easily overcome Eizan-kun's rigged match.\Rather, what will be critical is what follows that match.\That is when the true battle begins.\I must make the necessary preparations for that, no matter what happens.\Looks like things are playing out exactly as Isshiki had imagined.\Yukihira Soma\Eizan Etsuya response:	So the eviction's been canceled.
context: He will easily overcome Eizan-kun's rigged match.\Rather, what will be critical is what follows that match.\That is when the true battle begins.\I must make the necessary preparations for that, no matter what happens.\Looks like things are playing out exactly as Isshiki had imagined.\Yukihira Soma\Eizan Etsuya\So the eviction's been canceled. response:	Yay!
context: Rather, what will be critical is what follows that match.\That is when the true battle begins.\I must make the necessary preparations for that, no matter what happens.\Looks like things are playing out exactly as Isshiki had imagined.\Yukihira Soma\Eizan Etsuya\So the eviction's been canceled.\Yay! response:	Nice! They're leaving!
context: That is when the true battle begins.\I must make the necessary preparations for that, no matter what happens.\Looks like things are playing out exactly as Isshiki had imagined.\Yukihira Soma\Eizan Etsuya\So the eviction's been canceled.\Yay!\Nice! They're leaving! response:	Shove it!
context: I must make the necessary preparations for that, no matter what happens.\Looks like things are playing out exactly as Isshiki had imagined.\Yukihira Soma\Eizan Etsuya\So the eviction's been canceled.\Yay!\Nice! They're leaving!\Shove it! response:	So Polar Star Dormitory's safe!
context: Looks like things are playing out exactly as Isshiki had imagined.\Yukihira Soma\Eizan Etsuya\So the eviction's been canceled.\Yay!\Nice! They're leaving!\Shove it!\So Polar Star Dormitory's safe! response:	I'm back.
context: Yukihira Soma\Eizan Etsuya\So the eviction's been canceled.\Yay!\Nice! They're leaving!\Shove it!\So Polar Star Dormitory's safe!\I'm back. response:	You idiot!
context: Eizan Etsuya\So the eviction's been canceled.\Yay!\Nice! They're leaving!\Shove it!\So Polar Star Dormitory's safe!\I'm back.\You idiot! response:	You up and did a Shokugeki all by yourself!
context: So the eviction's been canceled.\Yay!\Nice! They're leaving!\Shove it!\So Polar Star Dormitory's safe!\I'm back.\You idiot!\You up and did a Shokugeki all by yourself! response:	You didn't even talk to us!
context: Yay!\Nice! They're leaving!\Shove it!\So Polar Star Dormitory's safe!\I'm back.\You idiot!\You up and did a Shokugeki all by yourself!\You didn't even talk to us! response:	You're so reckless!
context: Nice! They're leaving!\Shove it!\So Polar Star Dormitory's safe!\I'm back.\You idiot!\You up and did a Shokugeki all by yourself!\You didn't even talk to us!\You're so reckless! response:	You idiot! Fool! Nincompoop!
context: Shove it!\So Polar Star Dormitory's safe!\I'm back.\You idiot!\You up and did a Shokugeki all by yourself!\You didn't even talk to us!\You're so reckless!\You idiot! Fool! Nincompoop! response:	We were all worried about you.
context: So Polar Star Dormitory's safe!\I'm back.\You idiot!\You up and did a Shokugeki all by yourself!\You didn't even talk to us!\You're so reckless!\You idiot! Fool! Nincompoop!\We were all worried about you. response:	But I'm so relieved now! Seriously.
context: I'm back.\You idiot!\You up and did a Shokugeki all by yourself!\You didn't even talk to us!\You're so reckless!\You idiot! Fool! Nincompoop!\We were all worried about you.\But I'm so relieved now! Seriously. response:	Thanks so much, Yukihira!
context: You idiot!\You up and did a Shokugeki all by yourself!\You didn't even talk to us!\You're so reckless!\You idiot! Fool! Nincompoop!\We were all worried about you.\But I'm so relieved now! Seriously.\Thanks so much, Yukihira! response:	Soma-kun...
context: You up and did a Shokugeki all by yourself!\You didn't even talk to us!\You're so reckless!\You idiot! Fool! Nincompoop!\We were all worried about you.\But I'm so relieved now! Seriously.\Thanks so much, Yukihira!\Soma-kun... response:	Yeah!
context: You didn't even talk to us!\You're so reckless!\You idiot! Fool! Nincompoop!\We were all worried about you.\But I'm so relieved now! Seriously.\Thanks so much, Yukihira!\Soma-kun...\Yeah! response:	But how'd you beat Eizan Etsuya?
context: You're so reckless!\You idiot! Fool! Nincompoop!\We were all worried about you.\But I'm so relieved now! Seriously.\Thanks so much, Yukihira!\Soma-kun...\Yeah!\But how'd you beat Eizan Etsuya? response:	Oh, well a lot of things happened.
context: You idiot! Fool! Nincompoop!\We were all worried about you.\But I'm so relieved now! Seriously.\Thanks so much, Yukihira!\Soma-kun...\Yeah!\But how'd you beat Eizan Etsuya?\Oh, well a lot of things happened. response:	I still can't believe it.
context: We were all worried about you.\But I'm so relieved now! Seriously.\Thanks so much, Yukihira!\Soma-kun...\Yeah!\But how'd you beat Eizan Etsuya?\Oh, well a lot of things happened.\I still can't believe it. response:	So what's with the helmets?
context: But I'm so relieved now! Seriously.\Thanks so much, Yukihira!\Soma-kun...\Yeah!\But how'd you beat Eizan Etsuya?\Oh, well a lot of things happened.\I still can't believe it.\So what's with the helmets? response:	Oh, um, they're from back in the golden age...
context: Thanks so much, Yukihira!\Soma-kun...\Yeah!\But how'd you beat Eizan Etsuya?\Oh, well a lot of things happened.\I still can't believe it.\So what's with the helmets?\Oh, um, they're from back in the golden age... response:	Let's leave the talk for later
context: Soma-kun...\Yeah!\But how'd you beat Eizan Etsuya?\Oh, well a lot of things happened.\I still can't believe it.\So what's with the helmets?\Oh, um, they're from back in the golden age...\Let's leave the talk for later response:	and get back inside the dorm for now.
context: Yeah!\But how'd you beat Eizan Etsuya?\Oh, well a lot of things happened.\I still can't believe it.\So what's with the helmets?\Oh, um, they're from back in the golden age...\Let's leave the talk for later\and get back inside the dorm for now. response:	Yeah!
context: But how'd you beat Eizan Etsuya?\Oh, well a lot of things happened.\I still can't believe it.\So what's with the helmets?\Oh, um, they're from back in the golden age...\Let's leave the talk for later\and get back inside the dorm for now.\Yeah! response:	We need to celebrate how we managed to save our dorm!
context: Oh, well a lot of things happened.\I still can't believe it.\So what's with the helmets?\Oh, um, they're from back in the golden age...\Let's leave the talk for later\and get back inside the dorm for now.\Yeah!\We need to celebrate how we managed to save our dorm! response:	Food Wars
context: I still can't believe it.\So what's with the helmets?\Oh, um, they're from back in the golden age...\Let's leave the talk for later\and get back inside the dorm for now.\Yeah!\We need to celebrate how we managed to save our dorm!\Food Wars response:	The Third Plate
context: So what's with the helmets?\Oh, um, they're from back in the golden age...\Let's leave the talk for later\and get back inside the dorm for now.\Yeah!\We need to celebrate how we managed to save our dorm!\Food Wars\The Third Plate response:	May the Polar Star Shine Eternal Celebration Party
context: Oh, um, they're from back in the golden age...\Let's leave the talk for later\and get back inside the dorm for now.\Yeah!\We need to celebrate how we managed to save our dorm!\Food Wars\The Third Plate\May the Polar Star Shine Eternal Celebration Party response:	Cheers!
context: Let's leave the talk for later\and get back inside the dorm for now.\Yeah!\We need to celebrate how we managed to save our dorm!\Food Wars\The Third Plate\May the Polar Star Shine Eternal Celebration Party\Cheers! response:	Hunting the Survivors
context: and get back inside the dorm for now.\Yeah!\We need to celebrate how we managed to save our dorm!\Food Wars\The Third Plate\May the Polar Star Shine Eternal Celebration Party\Cheers!\Hunting the Survivors response:	Well done, Yukihira.
context: Yeah!\We need to celebrate how we managed to save our dorm!\Food Wars\The Third Plate\May the Polar Star Shine Eternal Celebration Party\Cheers!\Hunting the Survivors\Well done, Yukihira. response:	You too, Arato!
context: We need to celebrate how we managed to save our dorm!\Food Wars\The Third Plate\May the Polar Star Shine Eternal Celebration Party\Cheers!\Hunting the Survivors\Well done, Yukihira.\You too, Arato! response:	Yukihira!
context: Food Wars\The Third Plate\May the Polar Star Shine Eternal Celebration Party\Cheers!\Hunting the Survivors\Well done, Yukihira.\You too, Arato!\Yukihira! response:	I was watching your Shokugeki!
context: The Third Plate\May the Polar Star Shine Eternal Celebration Party\Cheers!\Hunting the Survivors\Well done, Yukihira.\You too, Arato!\Yukihira!\I was watching your Shokugeki! response:	Takumi-cchi, Isami-cchi.
context: May the Polar Star Shine Eternal Celebration Party\Cheers!\Hunting the Survivors\Well done, Yukihira.\You too, Arato!\Yukihira!\I was watching your Shokugeki!\Takumi-cchi, Isami-cchi. response:	Takumi-kun's in his usual lecture mode.
context: Cheers!\Hunting the Survivors\Well done, Yukihira.\You too, Arato!\Yukihira!\I was watching your Shokugeki!\Takumi-cchi, Isami-cchi.\Takumi-kun's in his usual lecture mode. response:	Nag, nag, nag, nag, nag...
context: Hunting the Survivors\Well done, Yukihira.\You too, Arato!\Yukihira!\I was watching your Shokugeki!\Takumi-cchi, Isami-cchi.\Takumi-kun's in his usual lecture mode.\Nag, nag, nag, nag, nag... response:	Oh?
context: Well done, Yukihira.\You too, Arato!\Yukihira!\I was watching your Shokugeki!\Takumi-cchi, Isami-cchi.\Takumi-kun's in his usual lecture mode.\Nag, nag, nag, nag, nag...\Oh? response:	You're not mad at him?
context: You too, Arato!\Yukihira!\I was watching your Shokugeki!\Takumi-cchi, Isami-cchi.\Takumi-kun's in his usual lecture mode.\Nag, nag, nag, nag, nag...\Oh?\You're not mad at him? response:	No lectures?
context: Yukihira!\I was watching your Shokugeki!\Takumi-cchi, Isami-cchi.\Takumi-kun's in his usual lecture mode.\Nag, nag, nag, nag, nag...\Oh?\You're not mad at him?\No lectures? response:	He had no choice.
context: I was watching your Shokugeki!\Takumi-cchi, Isami-cchi.\Takumi-kun's in his usual lecture mode.\Nag, nag, nag, nag, nag...\Oh?\You're not mad at him?\No lectures?\He had no choice. response:	Your home was under threat.
context: Takumi-cchi, Isami-cchi.\Takumi-kun's in his usual lecture mode.\Nag, nag, nag, nag, nag...\Oh?\You're not mad at him?\No lectures?\He had no choice.\Your home was under threat. response:	Even I would've done the same.
context: Takumi-kun's in his usual lecture mode.\Nag, nag, nag, nag, nag...\Oh?\You're not mad at him?\No lectures?\He had no choice.\Your home was under threat.\Even I would've done the same. response:	Takumi-kun...
context: Nag, nag, nag, nag, nag...\Oh?\You're not mad at him?\No lectures?\He had no choice.\Your home was under threat.\Even I would've done the same.\Takumi-kun... response:	Nakiri-san, hello.
context: Oh?\You're not mad at him?\No lectures?\He had no choice.\Your home was under threat.\Even I would've done the same.\Takumi-kun...\Nakiri-san, hello. response:	Wow!
context: You're not mad at him?\No lectures?\He had no choice.\Your home was under threat.\Even I would've done the same.\Takumi-kun...\Nakiri-san, hello.\Wow! response:	You were really at Polar Star Dormitory.
context: No lectures?\He had no choice.\Your home was under threat.\Even I would've done the same.\Takumi-kun...\Nakiri-san, hello.\Wow!\You were really at Polar Star Dormitory. response:	H-Hello, Aldini brothers.
context: He had no choice.\Your home was under threat.\Even I would've done the same.\Takumi-kun...\Nakiri-san, hello.\Wow!\You were really at Polar Star Dormitory.\H-Hello, Aldini brothers. response:	In any case, this is a night to celebrate!
context: Your home was under threat.\Even I would've done the same.\Takumi-kun...\Nakiri-san, hello.\Wow!\You were really at Polar Star Dormitory.\H-Hello, Aldini brothers.\In any case, this is a night to celebrate! response:	You guys should eat before you go!
context: Even I would've done the same.\Takumi-kun...\Nakiri-san, hello.\Wow!\You were really at Polar Star Dormitory.\H-Hello, Aldini brothers.\In any case, this is a night to celebrate!\You guys should eat before you go! response:	I guess he did just wrap up a really challenging match.
context: Takumi-kun...\Nakiri-san, hello.\Wow!\You were really at Polar Star Dormitory.\H-Hello, Aldini brothers.\In any case, this is a night to celebrate!\You guys should eat before you go!\I guess he did just wrap up a really challenging match. response:	All the tension's left him.
context: Nakiri-san, hello.\Wow!\You were really at Polar Star Dormitory.\H-Hello, Aldini brothers.\In any case, this is a night to celebrate!\You guys should eat before you go!\I guess he did just wrap up a really challenging match.\All the tension's left him. response:	But man, you're amazing, Yukihira.
context: Wow!\You were really at Polar Star Dormitory.\H-Hello, Aldini brothers.\In any case, this is a night to celebrate!\You guys should eat before you go!\I guess he did just wrap up a really challenging match.\All the tension's left him.\But man, you're amazing, Yukihira. response:	You crushed the Ninth Seat in a Shokugeki.
context: You were really at Polar Star Dormitory.\H-Hello, Aldini brothers.\In any case, this is a night to celebrate!\You guys should eat before you go!\I guess he did just wrap up a really challenging match.\All the tension's left him.\But man, you're amazing, Yukihira.\You crushed the Ninth Seat in a Shokugeki. response:	That means you might even win against the Tenth Seat, Nakiri-chan.
context: H-Hello, Aldini brothers.\In any case, this is a night to celebrate!\You guys should eat before you go!\I guess he did just wrap up a really challenging match.\All the tension's left him.\But man, you're amazing, Yukihira.\You crushed the Ninth Seat in a Shokugeki.\That means you might even win against the Tenth Seat, Nakiri-chan. response:	What?!
context: In any case, this is a night to celebrate!\You guys should eat before you go!\I guess he did just wrap up a really challenging match.\All the tension's left him.\But man, you're amazing, Yukihira.\You crushed the Ninth Seat in a Shokugeki.\That means you might even win against the Tenth Seat, Nakiri-chan.\What?! response:	Don't be ridiculous! How rude!
context: You guys should eat before you go!\I guess he did just wrap up a really challenging match.\All the tension's left him.\But man, you're amazing, Yukihira.\You crushed the Ninth Seat in a Shokugeki.\That means you might even win against the Tenth Seat, Nakiri-chan.\What?!\Don't be ridiculous! How rude! response:	And who are you calling Nakiri-chan?
context: I guess he did just wrap up a really challenging match.\All the tension's left him.\But man, you're amazing, Yukihira.\You crushed the Ninth Seat in a Shokugeki.\That means you might even win against the Tenth Seat, Nakiri-chan.\What?!\Don't be ridiculous! How rude!\And who are you calling Nakiri-chan? response:	What?
context: All the tension's left him.\But man, you're amazing, Yukihira.\You crushed the Ninth Seat in a Shokugeki.\That means you might even win against the Tenth Seat, Nakiri-chan.\What?!\Don't be ridiculous! How rude!\And who are you calling Nakiri-chan?\What? response:	Erina-cchi...
context: But man, you're amazing, Yukihira.\You crushed the Ninth Seat in a Shokugeki.\That means you might even win against the Tenth Seat, Nakiri-chan.\What?!\Don't be ridiculous! How rude!\And who are you calling Nakiri-chan?\What?\Erina-cchi... response:	Chan = No Good
context: You crushed the Ninth Seat in a Shokugeki.\That means you might even win against the Tenth Seat, Nakiri-chan.\What?!\Don't be ridiculous! How rude!\And who are you calling Nakiri-chan?\What?\Erina-cchi...\Chan = No Good response:	But you let Yoshino call you Erina-cchi.
context: That means you might even win against the Tenth Seat, Nakiri-chan.\What?!\Don't be ridiculous! How rude!\And who are you calling Nakiri-chan?\What?\Erina-cchi...\Chan = No Good\But you let Yoshino call you Erina-cchi. response:	You can't use chan with me!
context: What?!\Don't be ridiculous! How rude!\And who are you calling Nakiri-chan?\What?\Erina-cchi...\Chan = No Good\But you let Yoshino call you Erina-cchi.\You can't use chan with me! response:	It's too undignified!
context: Don't be ridiculous! How rude!\And who are you calling Nakiri-chan?\What?\Erina-cchi...\Chan = No Good\But you let Yoshino call you Erina-cchi.\You can't use chan with me!\It's too undignified! response:	Yes! That's right!
context: And who are you calling Nakiri-chan?\What?\Erina-cchi...\Chan = No Good\But you let Yoshino call you Erina-cchi.\You can't use chan with me!\It's too undignified!\Yes! That's right! response:	Besides, Erina-sama is only the Tenth Seat due to her restraint.
context: What?\Erina-cchi...\Chan = No Good\But you let Yoshino call you Erina-cchi.\You can't use chan with me!\It's too undignified!\Yes! That's right!\Besides, Erina-sama is only the Tenth Seat due to her restraint. response:	Her true abilities would place her at a higher
context: Erina-cchi...\Chan = No Good\But you let Yoshino call you Erina-cchi.\You can't use chan with me!\It's too undignified!\Yes! That's right!\Besides, Erina-sama is only the Tenth Seat due to her restraint.\Her true abilities would place her at a higher response:	Oh, well. I was the one who suggested the topic for that Shokugeki.
context: Chan = No Good\But you let Yoshino call you Erina-cchi.\You can't use chan with me!\It's too undignified!\Yes! That's right!\Besides, Erina-sama is only the Tenth Seat due to her restraint.\Her true abilities would place her at a higher\Oh, well. I was the one who suggested the topic for that Shokugeki. response:	Even though Eizan-senpai came up with his dish halfway through the thing,
context: But you let Yoshino call you Erina-cchi.\You can't use chan with me!\It's too undignified!\Yes! That's right!\Besides, Erina-sama is only the Tenth Seat due to her restraint.\Her true abilities would place her at a higher\Oh, well. I was the one who suggested the topic for that Shokugeki.\Even though Eizan-senpai came up with his dish halfway through the thing, response:	he still managed to create something impressive.
context: You can't use chan with me!\It's too undignified!\Yes! That's right!\Besides, Erina-sama is only the Tenth Seat due to her restraint.\Her true abilities would place her at a higher\Oh, well. I was the one who suggested the topic for that Shokugeki.\Even though Eizan-senpai came up with his dish halfway through the thing,\he still managed to create something impressive. response:	I want to face him soon on equal terms.
context: It's too undignified!\Yes! That's right!\Besides, Erina-sama is only the Tenth Seat due to her restraint.\Her true abilities would place her at a higher\Oh, well. I was the one who suggested the topic for that Shokugeki.\Even though Eizan-senpai came up with his dish halfway through the thing,\he still managed to create something impressive.\I want to face him soon on equal terms. response:	So it wasn't a satisfactory victory.
context: Yes! That's right!\Besides, Erina-sama is only the Tenth Seat due to her restraint.\Her true abilities would place her at a higher\Oh, well. I was the one who suggested the topic for that Shokugeki.\Even though Eizan-senpai came up with his dish halfway through the thing,\he still managed to create something impressive.\I want to face him soon on equal terms.\So it wasn't a satisfactory victory. response:	I get you, Yukihira!
context: Besides, Erina-sama is only the Tenth Seat due to her restraint.\Her true abilities would place her at a higher\Oh, well. I was the one who suggested the topic for that Shokugeki.\Even though Eizan-senpai came up with his dish halfway through the thing,\he still managed to create something impressive.\I want to face him soon on equal terms.\So it wasn't a satisfactory victory.\I get you, Yukihira! response:	Now that I think about it,
context: Her true abilities would place her at a higher\Oh, well. I was the one who suggested the topic for that Shokugeki.\Even though Eizan-senpai came up with his dish halfway through the thing,\he still managed to create something impressive.\I want to face him soon on equal terms.\So it wasn't a satisfactory victory.\I get you, Yukihira!\Now that I think about it, response:	what's going on with the other groups who are facing shutdowns?
context: Oh, well. I was the one who suggested the topic for that Shokugeki.\Even though Eizan-senpai came up with his dish halfway through the thing,\he still managed to create something impressive.\I want to face him soon on equal terms.\So it wasn't a satisfactory victory.\I get you, Yukihira!\Now that I think about it,\what's going on with the other groups who are facing shutdowns? response:	They're still between a rock and a hard place.
context: Even though Eizan-senpai came up with his dish halfway through the thing,\he still managed to create something impressive.\I want to face him soon on equal terms.\So it wasn't a satisfactory victory.\I get you, Yukihira!\Now that I think about it,\what's going on with the other groups who are facing shutdowns?\They're still between a rock and a hard place. response:	Oh?
context: he still managed to create something impressive.\I want to face him soon on equal terms.\So it wasn't a satisfactory victory.\I get you, Yukihira!\Now that I think about it,\what's going on with the other groups who are facing shutdowns?\They're still between a rock and a hard place.\Oh? response:	But thanks to you, Soma-kun, the situation has slightly improved.
context: I want to face him soon on equal terms.\So it wasn't a satisfactory victory.\I get you, Yukihira!\Now that I think about it,\what's going on with the other groups who are facing shutdowns?\They're still between a rock and a hard place.\Oh?\But thanks to you, Soma-kun, the situation has slightly improved. response:	I-Isshiki-senpai!
context: So it wasn't a satisfactory victory.\I get you, Yukihira!\Now that I think about it,\what's going on with the other groups who are facing shutdowns?\They're still between a rock and a hard place.\Oh?\But thanks to you, Soma-kun, the situation has slightly improved.\I-Isshiki-senpai! response:	Where have you been?!
context: I get you, Yukihira!\Now that I think about it,\what's going on with the other groups who are facing shutdowns?\They're still between a rock and a hard place.\Oh?\But thanks to you, Soma-kun, the situation has slightly improved.\I-Isshiki-senpai!\Where have you been?! response:	Sorry, all.
context: Now that I think about it,\what's going on with the other groups who are facing shutdowns?\They're still between a rock and a hard place.\Oh?\But thanks to you, Soma-kun, the situation has slightly improved.\I-Isshiki-senpai!\Where have you been?!\Sorry, all. response:	I am an Elite Ten member, after all.
context: what's going on with the other groups who are facing shutdowns?\They're still between a rock and a hard place.\Oh?\But thanks to you, Soma-kun, the situation has slightly improved.\I-Isshiki-senpai!\Where have you been?!\Sorry, all.\I am an Elite Ten member, after all. response:	I was concerned that if I did anything rash to help the dorm,
context: They're still between a rock and a hard place.\Oh?\But thanks to you, Soma-kun, the situation has slightly improved.\I-Isshiki-senpai!\Where have you been?!\Sorry, all.\I am an Elite Ten member, after all.\I was concerned that if I did anything rash to help the dorm, response:	the Azami administration would up the ante on us.
context: Oh?\But thanks to you, Soma-kun, the situation has slightly improved.\I-Isshiki-senpai!\Where have you been?!\Sorry, all.\I am an Elite Ten member, after all.\I was concerned that if I did anything rash to help the dorm,\the Azami administration would up the ante on us. response:	I mean, I was wondering if you'd turned on us, Isshiki-senpai.
context: But thanks to you, Soma-kun, the situation has slightly improved.\I-Isshiki-senpai!\Where have you been?!\Sorry, all.\I am an Elite Ten member, after all.\I was concerned that if I did anything rash to help the dorm,\the Azami administration would up the ante on us.\I mean, I was wondering if you'd turned on us, Isshiki-senpai. response:	Yeah, it wouldn't have surprised me.
context: I-Isshiki-senpai!\Where have you been?!\Sorry, all.\I am an Elite Ten member, after all.\I was concerned that if I did anything rash to help the dorm,\the Azami administration would up the ante on us.\I mean, I was wondering if you'd turned on us, Isshiki-senpai.\Yeah, it wouldn't have surprised me. response:	What?!
context: Where have you been?!\Sorry, all.\I am an Elite Ten member, after all.\I was concerned that if I did anything rash to help the dorm,\the Azami administration would up the ante on us.\I mean, I was wondering if you'd turned on us, Isshiki-senpai.\Yeah, it wouldn't have surprised me.\What?! response:	How could I ever do that?
context: Sorry, all.\I am an Elite Ten member, after all.\I was concerned that if I did anything rash to help the dorm,\the Azami administration would up the ante on us.\I mean, I was wondering if you'd turned on us, Isshiki-senpai.\Yeah, it wouldn't have surprised me.\What?!\How could I ever do that? response:	Don't you understand how much I love Polar Star Dormitory?!
context: I am an Elite Ten member, after all.\I was concerned that if I did anything rash to help the dorm,\the Azami administration would up the ante on us.\I mean, I was wondering if you'd turned on us, Isshiki-senpai.\Yeah, it wouldn't have surprised me.\What?!\How could I ever do that?\Don't you understand how much I love Polar Star Dormitory?! response:	Um, Isshiki-san...
context: I was concerned that if I did anything rash to help the dorm,\the Azami administration would up the ante on us.\I mean, I was wondering if you'd turned on us, Isshiki-senpai.\Yeah, it wouldn't have surprised me.\What?!\How could I ever do that?\Don't you understand how much I love Polar Star Dormitory?!\Um, Isshiki-san... response:	What's improved?
context: the Azami administration would up the ante on us.\I mean, I was wondering if you'd turned on us, Isshiki-senpai.\Yeah, it wouldn't have surprised me.\What?!\How could I ever do that?\Don't you understand how much I love Polar Star Dormitory?!\Um, Isshiki-san...\What's improved? response:	Right.
context: I mean, I was wondering if you'd turned on us, Isshiki-senpai.\Yeah, it wouldn't have surprised me.\What?!\How could I ever do that?\Don't you understand how much I love Polar Star Dormitory?!\Um, Isshiki-san...\What's improved?\Right. response:	Upon learning of the Shokugeki's results,
context: Yeah, it wouldn't have surprised me.\What?!\How could I ever do that?\Don't you understand how much I love Polar Star Dormitory?!\Um, Isshiki-san...\What's improved?\Right.\Upon learning of the Shokugeki's results, response:	the Azami administration has made a new announcement.
context: What?!\How could I ever do that?\Don't you understand how much I love Polar Star Dormitory?!\Um, Isshiki-san...\What's improved?\Right.\Upon learning of the Shokugeki's results,\the Azami administration has made a new announcement. response:	Central has agreed to accept any Shokugeki challenge from an organization
context: How could I ever do that?\Don't you understand how much I love Polar Star Dormitory?!\Um, Isshiki-san...\What's improved?\Right.\Upon learning of the Shokugeki's results,\the Azami administration has made a new announcement.\Central has agreed to accept any Shokugeki challenge from an organization response:	that is trying to overturn being shut down.
context: Don't you understand how much I love Polar Star Dormitory?!\Um, Isshiki-san...\What's improved?\Right.\Upon learning of the Shokugeki's results,\the Azami administration has made a new announcement.\Central has agreed to accept any Shokugeki challenge from an organization\that is trying to overturn being shut down. response:	Of course, the Shokugeki will be official and judged by neutral judges!
context: Um, Isshiki-san...\What's improved?\Right.\Upon learning of the Shokugeki's results,\the Azami administration has made a new announcement.\Central has agreed to accept any Shokugeki challenge from an organization\that is trying to overturn being shut down.\Of course, the Shokugeki will be official and judged by neutral judges! response:	It doesn't change the fact that the academy remains under Central's control,
context: What's improved?\Right.\Upon learning of the Shokugeki's results,\the Azami administration has made a new announcement.\Central has agreed to accept any Shokugeki challenge from an organization\that is trying to overturn being shut down.\Of course, the Shokugeki will be official and judged by neutral judges!\It doesn't change the fact that the academy remains under Central's control, response:	but Eizan-kun's rigged match method has been shut down.
context: Right.\Upon learning of the Shokugeki's results,\the Azami administration has made a new announcement.\Central has agreed to accept any Shokugeki challenge from an organization\that is trying to overturn being shut down.\Of course, the Shokugeki will be official and judged by neutral judges!\It doesn't change the fact that the academy remains under Central's control,\but Eizan-kun's rigged match method has been shut down. response:	You made this happen, Soma-kun!
context: Upon learning of the Shokugeki's results,\the Azami administration has made a new announcement.\Central has agreed to accept any Shokugeki challenge from an organization\that is trying to overturn being shut down.\Of course, the Shokugeki will be official and judged by neutral judges!\It doesn't change the fact that the academy remains under Central's control,\but Eizan-kun's rigged match method has been shut down.\You made this happen, Soma-kun! response:	You have brought the Shokugeki back to life!
context: the Azami administration has made a new announcement.\Central has agreed to accept any Shokugeki challenge from an organization\that is trying to overturn being shut down.\Of course, the Shokugeki will be official and judged by neutral judges!\It doesn't change the fact that the academy remains under Central's control,\but Eizan-kun's rigged match method has been shut down.\You made this happen, Soma-kun!\You have brought the Shokugeki back to life! response:	Thank you, Soma-kun, for saving our home.
context: Central has agreed to accept any Shokugeki challenge from an organization\that is trying to overturn being shut down.\Of course, the Shokugeki will be official and judged by neutral judges!\It doesn't change the fact that the academy remains under Central's control,\but Eizan-kun's rigged match method has been shut down.\You made this happen, Soma-kun!\You have brought the Shokugeki back to life!\Thank you, Soma-kun, for saving our home. response:	Oh, there's no need to thank me.
context: that is trying to overturn being shut down.\Of course, the Shokugeki will be official and judged by neutral judges!\It doesn't change the fact that the academy remains under Central's control,\but Eizan-kun's rigged match method has been shut down.\You made this happen, Soma-kun!\You have brought the Shokugeki back to life!\Thank you, Soma-kun, for saving our home.\Oh, there's no need to thank me. response:	This place is important to me, too.
context: Of course, the Shokugeki will be official and judged by neutral judges!\It doesn't change the fact that the academy remains under Central's control,\but Eizan-kun's rigged match method has been shut down.\You made this happen, Soma-kun!\You have brought the Shokugeki back to life!\Thank you, Soma-kun, for saving our home.\Oh, there's no need to thank me.\This place is important to me, too. response:	Thanks to all of you for protecting the dorm, too.
context: It doesn't change the fact that the academy remains under Central's control,\but Eizan-kun's rigged match method has been shut down.\You made this happen, Soma-kun!\You have brought the Shokugeki back to life!\Thank you, Soma-kun, for saving our home.\Oh, there's no need to thank me.\This place is important to me, too.\Thanks to all of you for protecting the dorm, too. response:	Well, enough serious talk.
context: but Eizan-kun's rigged match method has been shut down.\You made this happen, Soma-kun!\You have brought the Shokugeki back to life!\Thank you, Soma-kun, for saving our home.\Oh, there's no need to thank me.\This place is important to me, too.\Thanks to all of you for protecting the dorm, too.\Well, enough serious talk. response:	Let's just enjoy the rest of the evening!
context: You made this happen, Soma-kun!\You have brought the Shokugeki back to life!\Thank you, Soma-kun, for saving our home.\Oh, there's no need to thank me.\This place is important to me, too.\Thanks to all of you for protecting the dorm, too.\Well, enough serious talk.\Let's just enjoy the rest of the evening! response:	Yeah!
context: You have brought the Shokugeki back to life!\Thank you, Soma-kun, for saving our home.\Oh, there's no need to thank me.\This place is important to me, too.\Thanks to all of you for protecting the dorm, too.\Well, enough serious talk.\Let's just enjoy the rest of the evening!\Yeah! response:	Wh-What?!
context: Thank you, Soma-kun, for saving our home.\Oh, there's no need to thank me.\This place is important to me, too.\Thanks to all of you for protecting the dorm, too.\Well, enough serious talk.\Let's just enjoy the rest of the evening!\Yeah!\Wh-What?! response:	He's naked, save for an apron?!
context: Oh, there's no need to thank me.\This place is important to me, too.\Thanks to all of you for protecting the dorm, too.\Well, enough serious talk.\Let's just enjoy the rest of the evening!\Yeah!\Wh-What?!\He's naked, save for an apron?! response:	Naked?!
context: This place is important to me, too.\Thanks to all of you for protecting the dorm, too.\Well, enough serious talk.\Let's just enjoy the rest of the evening!\Yeah!\Wh-What?!\He's naked, save for an apron?!\Naked?! response:	But with an apron?!
context: Thanks to all of you for protecting the dorm, too.\Well, enough serious talk.\Let's just enjoy the rest of the evening!\Yeah!\Wh-What?!\He's naked, save for an apron?!\Naked?!\But with an apron?! response:	How vulgar!
context: Well, enough serious talk.\Let's just enjoy the rest of the evening!\Yeah!\Wh-What?!\He's naked, save for an apron?!\Naked?!\But with an apron?!\How vulgar! response:	Look away!
context: Let's just enjoy the rest of the evening!\Yeah!\Wh-What?!\He's naked, save for an apron?!\Naked?!\But with an apron?!\How vulgar!\Look away! response:	Look away, Erina-sama!
context: Yeah!\Wh-What?!\He's naked, save for an apron?!\Naked?!\But with an apron?!\How vulgar!\Look away!\Look away, Erina-sama! response:	It's not my first time seeing this, but he still leaves quite an impression.
context: Wh-What?!\He's naked, save for an apron?!\Naked?!\But with an apron?!\How vulgar!\Look away!\Look away, Erina-sama!\It's not my first time seeing this, but he still leaves quite an impression. response:	It wouldn't be Polar Star Dormitory without it, I guess.
context: He's naked, save for an apron?!\Naked?!\But with an apron?!\How vulgar!\Look away!\Look away, Erina-sama!\It's not my first time seeing this, but he still leaves quite an impression.\It wouldn't be Polar Star Dormitory without it, I guess. response:	Wiggle
context: Naked?!\But with an apron?!\How vulgar!\Look away!\Look away, Erina-sama!\It's not my first time seeing this, but he still leaves quite an impression.\It wouldn't be Polar Star Dormitory without it, I guess.\Wiggle response:	Hup! Hup!
context: But with an apron?!\How vulgar!\Look away!\Look away, Erina-sama!\It's not my first time seeing this, but he still leaves quite an impression.\It wouldn't be Polar Star Dormitory without it, I guess.\Wiggle\Hup! Hup! response:	Wh-What is going on with the people at this dorm?
context: How vulgar!\Look away!\Look away, Erina-sama!\It's not my first time seeing this, but he still leaves quite an impression.\It wouldn't be Polar Star Dormitory without it, I guess.\Wiggle\Hup! Hup!\Wh-What is going on with the people at this dorm? response:	Wiggle
context: Look away!\Look away, Erina-sama!\It's not my first time seeing this, but he still leaves quite an impression.\It wouldn't be Polar Star Dormitory without it, I guess.\Wiggle\Hup! Hup!\Wh-What is going on with the people at this dorm?\Wiggle response:	Wiggle
context: Look away, Erina-sama!\It's not my first time seeing this, but he still leaves quite an impression.\It wouldn't be Polar Star Dormitory without it, I guess.\Wiggle\Hup! Hup!\Wh-What is going on with the people at this dorm?\Wiggle\Wiggle response:	Wiggle
context: It's not my first time seeing this, but he still leaves quite an impression.\It wouldn't be Polar Star Dormitory without it, I guess.\Wiggle\Hup! Hup!\Wh-What is going on with the people at this dorm?\Wiggle\Wiggle\Wiggle response:	Wiggle
context: It wouldn't be Polar Star Dormitory without it, I guess.\Wiggle\Hup! Hup!\Wh-What is going on with the people at this dorm?\Wiggle\Wiggle\Wiggle\Wiggle response:	Wiggle
context: Wiggle\Hup! Hup!\Wh-What is going on with the people at this dorm?\Wiggle\Wiggle\Wiggle\Wiggle\Wiggle response:	Th-They're totally fine with him wearing nothing but an apron!
context: Hup! Hup!\Wh-What is going on with the people at this dorm?\Wiggle\Wiggle\Wiggle\Wiggle\Wiggle\Th-They're totally fine with him wearing nothing but an apron! response:	This dorm really is quite strange.
context: Wh-What is going on with the people at this dorm?\Wiggle\Wiggle\Wiggle\Wiggle\Wiggle\Th-They're totally fine with him wearing nothing but an apron!\This dorm really is quite strange. response:	It is!
context: Wiggle\Wiggle\Wiggle\Wiggle\Wiggle\Th-They're totally fine with him wearing nothing but an apron!\This dorm really is quite strange.\It is! response:	No, it's bizarre!
context: Wiggle\Wiggle\Wiggle\Wiggle\Th-They're totally fine with him wearing nothing but an apron!\This dorm really is quite strange.\It is!\No, it's bizarre! response:	Bizarre!
context: Wiggle\Wiggle\Wiggle\Th-They're totally fine with him wearing nothing but an apron!\This dorm really is quite strange.\It is!\No, it's bizarre!\Bizarre! response:	Bizarre! Bizarre! Bizarre!
context: Wiggle\Wiggle\Th-They're totally fine with him wearing nothing but an apron!\This dorm really is quite strange.\It is!\No, it's bizarre!\Bizarre!\Bizarre! Bizarre! Bizarre! response:	Erina-sama?
context: Wiggle\Th-They're totally fine with him wearing nothing but an apron!\This dorm really is quite strange.\It is!\No, it's bizarre!\Bizarre!\Bizarre! Bizarre! Bizarre!\Erina-sama? response:	Hisako, do you know how to use a washing machine?
context: Th-They're totally fine with him wearing nothing but an apron!\This dorm really is quite strange.\It is!\No, it's bizarre!\Bizarre!\Bizarre! Bizarre! Bizarre!\Erina-sama?\Hisako, do you know how to use a washing machine? response:	Er, a washing machine?
context: This dorm really is quite strange.\It is!\No, it's bizarre!\Bizarre!\Bizarre! Bizarre! Bizarre!\Erina-sama?\Hisako, do you know how to use a washing machine?\Er, a washing machine? response:	Well, yes.
context: It is!\No, it's bizarre!\Bizarre!\Bizarre! Bizarre! Bizarre!\Erina-sama?\Hisako, do you know how to use a washing machine?\Er, a washing machine?\Well, yes. response:	I see.
context: No, it's bizarre!\Bizarre!\Bizarre! Bizarre! Bizarre!\Erina-sama?\Hisako, do you know how to use a washing machine?\Er, a washing machine?\Well, yes.\I see. response:	It's impressive that you can use a device with so many buttons.
context: Bizarre!\Bizarre! Bizarre! Bizarre!\Erina-sama?\Hisako, do you know how to use a washing machine?\Er, a washing machine?\Well, yes.\I see.\It's impressive that you can use a device with so many buttons. response:	Um, Erina-sama?
context: Bizarre! Bizarre! Bizarre!\Erina-sama?\Hisako, do you know how to use a washing machine?\Er, a washing machine?\Well, yes.\I see.\It's impressive that you can use a device with so many buttons.\Um, Erina-sama? response:	A-Anyway, forget washing machines!
context: Erina-sama?\Hisako, do you know how to use a washing machine?\Er, a washing machine?\Well, yes.\I see.\It's impressive that you can use a device with so many buttons.\Um, Erina-sama?\A-Anyway, forget washing machines! response:	I'm just trying to say that there were a lot of things and oddities
context: Hisako, do you know how to use a washing machine?\Er, a washing machine?\Well, yes.\I see.\It's impressive that you can use a device with so many buttons.\Um, Erina-sama?\A-Anyway, forget washing machines!\I'm just trying to say that there were a lot of things and oddities response:	I had no idea about before I came to this dorm!
context: Er, a washing machine?\Well, yes.\I see.\It's impressive that you can use a device with so many buttons.\Um, Erina-sama?\A-Anyway, forget washing machines!\I'm just trying to say that there were a lot of things and oddities\I had no idea about before I came to this dorm! response:	R-Right.
context: Well, yes.\I see.\It's impressive that you can use a device with so many buttons.\Um, Erina-sama?\A-Anyway, forget washing machines!\I'm just trying to say that there were a lot of things and oddities\I had no idea about before I came to this dorm!\R-Right. response:	They really are very strange people.
context: I see.\It's impressive that you can use a device with so many buttons.\Um, Erina-sama?\A-Anyway, forget washing machines!\I'm just trying to say that there were a lot of things and oddities\I had no idea about before I came to this dorm!\R-Right.\They really are very strange people. response:	And Yukihira-kun is right in their center.
context: It's impressive that you can use a device with so many buttons.\Um, Erina-sama?\A-Anyway, forget washing machines!\I'm just trying to say that there were a lot of things and oddities\I had no idea about before I came to this dorm!\R-Right.\They really are very strange people.\And Yukihira-kun is right in their center. response:	When Polar Star Dormitory was under siege,
context: Um, Erina-sama?\A-Anyway, forget washing machines!\I'm just trying to say that there were a lot of things and oddities\I had no idea about before I came to this dorm!\R-Right.\They really are very strange people.\And Yukihira-kun is right in their center.\When Polar Star Dormitory was under siege, response:	they seemed to feel that Yukihira-kun would be able to pull off a miracle.
context: A-Anyway, forget washing machines!\I'm just trying to say that there were a lot of things and oddities\I had no idea about before I came to this dorm!\R-Right.\They really are very strange people.\And Yukihira-kun is right in their center.\When Polar Star Dormitory was under siege,\they seemed to feel that Yukihira-kun would be able to pull off a miracle. response:	You did, too, Hisako.
context: I'm just trying to say that there were a lot of things and oddities\I had no idea about before I came to this dorm!\R-Right.\They really are very strange people.\And Yukihira-kun is right in their center.\When Polar Star Dormitory was under siege,\they seemed to feel that Yukihira-kun would be able to pull off a miracle.\You did, too, Hisako. response:	What?
context: I had no idea about before I came to this dorm!\R-Right.\They really are very strange people.\And Yukihira-kun is right in their center.\When Polar Star Dormitory was under siege,\they seemed to feel that Yukihira-kun would be able to pull off a miracle.\You did, too, Hisako.\What? response:	Me, too?
context: R-Right.\They really are very strange people.\And Yukihira-kun is right in their center.\When Polar Star Dormitory was under siege,\they seemed to feel that Yukihira-kun would be able to pull off a miracle.\You did, too, Hisako.\What?\Me, too? response:	You seemed to know that Yukihira-kun would manage to do something.
context: They really are very strange people.\And Yukihira-kun is right in their center.\When Polar Star Dormitory was under siege,\they seemed to feel that Yukihira-kun would be able to pull off a miracle.\You did, too, Hisako.\What?\Me, too?\You seemed to know that Yukihira-kun would manage to do something. response:	Why'd you look that way?
context: And Yukihira-kun is right in their center.\When Polar Star Dormitory was under siege,\they seemed to feel that Yukihira-kun would be able to pull off a miracle.\You did, too, Hisako.\What?\Me, too?\You seemed to know that Yukihira-kun would manage to do something.\Why'd you look that way? response:	U-Um, well...
context: When Polar Star Dormitory was under siege,\they seemed to feel that Yukihira-kun would be able to pull off a miracle.\You did, too, Hisako.\What?\Me, too?\You seemed to know that Yukihira-kun would manage to do something.\Why'd you look that way?\U-Um, well... response:	What can I say?
context: they seemed to feel that Yukihira-kun would be able to pull off a miracle.\You did, too, Hisako.\What?\Me, too?\You seemed to know that Yukihira-kun would manage to do something.\Why'd you look that way?\U-Um, well...\What can I say? response:	It's not like I had any reason to feel that way.
context: You did, too, Hisako.\What?\Me, too?\You seemed to know that Yukihira-kun would manage to do something.\Why'd you look that way?\U-Um, well...\What can I say?\It's not like I had any reason to feel that way. response:	I did have a premonition...
context: What?\Me, too?\You seemed to know that Yukihira-kun would manage to do something.\Why'd you look that way?\U-Um, well...\What can I say?\It's not like I had any reason to feel that way.\I did have a premonition... response:	That perhaps the one who'll save Totsuki from Azami-dono
context: Me, too?\You seemed to know that Yukihira-kun would manage to do something.\Why'd you look that way?\U-Um, well...\What can I say?\It's not like I had any reason to feel that way.\I did have a premonition...\That perhaps the one who'll save Totsuki from Azami-dono response:	is that man.
context: You seemed to know that Yukihira-kun would manage to do something.\Why'd you look that way?\U-Um, well...\What can I say?\It's not like I had any reason to feel that way.\I did have a premonition...\That perhaps the one who'll save Totsuki from Azami-dono\is that man. response:	Nakiri-kun, Arato-kun...
context: Why'd you look that way?\U-Um, well...\What can I say?\It's not like I had any reason to feel that way.\I did have a premonition...\That perhaps the one who'll save Totsuki from Azami-dono\is that man.\Nakiri-kun, Arato-kun... response:	You should come join us!
context: U-Um, well...\What can I say?\It's not like I had any reason to feel that way.\I did have a premonition...\That perhaps the one who'll save Totsuki from Azami-dono\is that man.\Nakiri-kun, Arato-kun...\You should come join us! response:	Please put on some clothes!
context: What can I say?\It's not like I had any reason to feel that way.\I did have a premonition...\That perhaps the one who'll save Totsuki from Azami-dono\is that man.\Nakiri-kun, Arato-kun...\You should come join us!\Please put on some clothes! response:	It's fine.
context: It's not like I had any reason to feel that way.\I did have a premonition...\That perhaps the one who'll save Totsuki from Azami-dono\is that man.\Nakiri-kun, Arato-kun...\You should come join us!\Please put on some clothes!\It's fine. response:	It's comfortable once you get used to it!
context: I did have a premonition...\That perhaps the one who'll save Totsuki from Azami-dono\is that man.\Nakiri-kun, Arato-kun...\You should come join us!\Please put on some clothes!\It's fine.\It's comfortable once you get used to it! response:	I don't even understand that!
context: That perhaps the one who'll save Totsuki from Azami-dono\is that man.\Nakiri-kun, Arato-kun...\You should come join us!\Please put on some clothes!\It's fine.\It's comfortable once you get used to it!\I don't even understand that! response:	Hup!
context: is that man.\Nakiri-kun, Arato-kun...\You should come join us!\Please put on some clothes!\It's fine.\It's comfortable once you get used to it!\I don't even understand that!\Hup! response:	Several Days Later
context: Nakiri-kun, Arato-kun...\You should come join us!\Please put on some clothes!\It's fine.\It's comfortable once you get used to it!\I don't even understand that!\Hup!\Several Days Later response:	Isshiki Satoshi, Seventh Seat of the Elite Ten.
context: You should come join us!\Please put on some clothes!\It's fine.\It's comfortable once you get used to it!\I don't even understand that!\Hup!\Several Days Later\Isshiki Satoshi, Seventh Seat of the Elite Ten. response:	Today, you will step down from the Totsuki Elite Ten Council,
context: Please put on some clothes!\It's fine.\It's comfortable once you get used to it!\I don't even understand that!\Hup!\Several Days Later\Isshiki Satoshi, Seventh Seat of the Elite Ten.\Today, you will step down from the Totsuki Elite Ten Council, response:	Totsuki Elite Ten, Eighth Seat Kuga Terunori
context: It's fine.\It's comfortable once you get used to it!\I don't even understand that!\Hup!\Several Days Later\Isshiki Satoshi, Seventh Seat of the Elite Ten.\Today, you will step down from the Totsuki Elite Ten Council,\Totsuki Elite Ten, Eighth Seat Kuga Terunori response:	Totsuki Elite Ten, Third Seat Megishima Tosuke
context: It's comfortable once you get used to it!\I don't even understand that!\Hup!\Several Days Later\Isshiki Satoshi, Seventh Seat of the Elite Ten.\Today, you will step down from the Totsuki Elite Ten Council,\Totsuki Elite Ten, Eighth Seat Kuga Terunori\Totsuki Elite Ten, Third Seat Megishima Tosuke response:	along with the Third Seat, Megishima Tosuke,
context: I don't even understand that!\Hup!\Several Days Later\Isshiki Satoshi, Seventh Seat of the Elite Ten.\Today, you will step down from the Totsuki Elite Ten Council,\Totsuki Elite Ten, Eighth Seat Kuga Terunori\Totsuki Elite Ten, Third Seat Megishima Tosuke\along with the Third Seat, Megishima Tosuke, response:	and the Eighth Seat, Kuga Terunori.
context: Hup!\Several Days Later\Isshiki Satoshi, Seventh Seat of the Elite Ten.\Today, you will step down from the Totsuki Elite Ten Council,\Totsuki Elite Ten, Eighth Seat Kuga Terunori\Totsuki Elite Ten, Third Seat Megishima Tosuke\along with the Third Seat, Megishima Tosuke,\and the Eighth Seat, Kuga Terunori. response:	This happened faster than I thought it would.
context: Several Days Later\Isshiki Satoshi, Seventh Seat of the Elite Ten.\Today, you will step down from the Totsuki Elite Ten Council,\Totsuki Elite Ten, Eighth Seat Kuga Terunori\Totsuki Elite Ten, Third Seat Megishima Tosuke\along with the Third Seat, Megishima Tosuke,\and the Eighth Seat, Kuga Terunori.\This happened faster than I thought it would. response:	You are calmer than I thought you'd be.
context: Isshiki Satoshi, Seventh Seat of the Elite Ten.\Today, you will step down from the Totsuki Elite Ten Council,\Totsuki Elite Ten, Eighth Seat Kuga Terunori\Totsuki Elite Ten, Third Seat Megishima Tosuke\along with the Third Seat, Megishima Tosuke,\and the Eighth Seat, Kuga Terunori.\This happened faster than I thought it would.\You are calmer than I thought you'd be. response:	I was more than expecting it.
context: Today, you will step down from the Totsuki Elite Ten Council,\Totsuki Elite Ten, Eighth Seat Kuga Terunori\Totsuki Elite Ten, Third Seat Megishima Tosuke\along with the Third Seat, Megishima Tosuke,\and the Eighth Seat, Kuga Terunori.\This happened faster than I thought it would.\You are calmer than I thought you'd be.\I was more than expecting it. response:	Someone who does not ascribe to Central's teachings, like me,
context: Totsuki Elite Ten, Eighth Seat Kuga Terunori\Totsuki Elite Ten, Third Seat Megishima Tosuke\along with the Third Seat, Megishima Tosuke,\and the Eighth Seat, Kuga Terunori.\This happened faster than I thought it would.\You are calmer than I thought you'd be.\I was more than expecting it.\Someone who does not ascribe to Central's teachings, like me, response:	in the Elite Ten would only be a hindrance, wouldn't it?
context: Totsuki Elite Ten, Third Seat Megishima Tosuke\along with the Third Seat, Megishima Tosuke,\and the Eighth Seat, Kuga Terunori.\This happened faster than I thought it would.\You are calmer than I thought you'd be.\I was more than expecting it.\Someone who does not ascribe to Central's teachings, like me,\in the Elite Ten would only be a hindrance, wouldn't it? response:	It's helpful that you require little explanation.
context: along with the Third Seat, Megishima Tosuke,\and the Eighth Seat, Kuga Terunori.\This happened faster than I thought it would.\You are calmer than I thought you'd be.\I was more than expecting it.\Someone who does not ascribe to Central's teachings, like me,\in the Elite Ten would only be a hindrance, wouldn't it?\It's helpful that you require little explanation. response:	The other Elite Ten members are in agreement, as well.
context: and the Eighth Seat, Kuga Terunori.\This happened faster than I thought it would.\You are calmer than I thought you'd be.\I was more than expecting it.\Someone who does not ascribe to Central's teachings, like me,\in the Elite Ten would only be a hindrance, wouldn't it?\It's helpful that you require little explanation.\The other Elite Ten members are in agreement, as well. response:	But why, why?
context: This happened faster than I thought it would.\You are calmer than I thought you'd be.\I was more than expecting it.\Someone who does not ascribe to Central's teachings, like me,\in the Elite Ten would only be a hindrance, wouldn't it?\It's helpful that you require little explanation.\The other Elite Ten members are in agreement, as well.\But why, why? response:	I don't think we need to kick them out of the Elite Ten! Why?
context: You are calmer than I thought you'd be.\I was more than expecting it.\Someone who does not ascribe to Central's teachings, like me,\in the Elite Ten would only be a hindrance, wouldn't it?\It's helpful that you require little explanation.\The other Elite Ten members are in agreement, as well.\But why, why?\I don't think we need to kick them out of the Elite Ten! Why? response:	Well, Kobayashi Rindo was the lone protest.
context: I was more than expecting it.\Someone who does not ascribe to Central's teachings, like me,\in the Elite Ten would only be a hindrance, wouldn't it?\It's helpful that you require little explanation.\The other Elite Ten members are in agreement, as well.\But why, why?\I don't think we need to kick them out of the Elite Ten! Why?\Well, Kobayashi Rindo was the lone protest. response:	You aren't forcing Nakiri Erina, your daughter, to step down?
context: Someone who does not ascribe to Central's teachings, like me,\in the Elite Ten would only be a hindrance, wouldn't it?\It's helpful that you require little explanation.\The other Elite Ten members are in agreement, as well.\But why, why?\I don't think we need to kick them out of the Elite Ten! Why?\Well, Kobayashi Rindo was the lone protest.\You aren't forcing Nakiri Erina, your daughter, to step down? response:	She will eventually return to my side.
context: in the Elite Ten would only be a hindrance, wouldn't it?\It's helpful that you require little explanation.\The other Elite Ten members are in agreement, as well.\But why, why?\I don't think we need to kick them out of the Elite Ten! Why?\Well, Kobayashi Rindo was the lone protest.\You aren't forcing Nakiri Erina, your daughter, to step down?\She will eventually return to my side. response:	I am certain that she will join me in my cause.
context: It's helpful that you require little explanation.\The other Elite Ten members are in agreement, as well.\But why, why?\I don't think we need to kick them out of the Elite Ten! Why?\Well, Kobayashi Rindo was the lone protest.\You aren't forcing Nakiri Erina, your daughter, to step down?\She will eventually return to my side.\I am certain that she will join me in my cause. response:	Well, thanks to you, we're going to be very busy.
context: The other Elite Ten members are in agreement, as well.\But why, why?\I don't think we need to kick them out of the Elite Ten! Why?\Well, Kobayashi Rindo was the lone protest.\You aren't forcing Nakiri Erina, your daughter, to step down?\She will eventually return to my side.\I am certain that she will join me in my cause.\Well, thanks to you, we're going to be very busy. response:	With Shokugeki?
context: But why, why?\I don't think we need to kick them out of the Elite Ten! Why?\Well, Kobayashi Rindo was the lone protest.\You aren't forcing Nakiri Erina, your daughter, to step down?\She will eventually return to my side.\I am certain that she will join me in my cause.\Well, thanks to you, we're going to be very busy.\With Shokugeki? response:	That's right.
context: I don't think we need to kick them out of the Elite Ten! Why?\Well, Kobayashi Rindo was the lone protest.\You aren't forcing Nakiri Erina, your daughter, to step down?\She will eventually return to my side.\I am certain that she will join me in my cause.\Well, thanks to you, we're going to be very busy.\With Shokugeki?\That's right. response:	You worked behind the scenes, reaching out to relevant parties
context: Well, Kobayashi Rindo was the lone protest.\You aren't forcing Nakiri Erina, your daughter, to step down?\She will eventually return to my side.\I am certain that she will join me in my cause.\Well, thanks to you, we're going to be very busy.\With Shokugeki?\That's right.\You worked behind the scenes, reaching out to relevant parties response:	to lay the groundwork for these new rules we must now follow.
context: You aren't forcing Nakiri Erina, your daughter, to step down?\She will eventually return to my side.\I am certain that she will join me in my cause.\Well, thanks to you, we're going to be very busy.\With Shokugeki?\That's right.\You worked behind the scenes, reaching out to relevant parties\to lay the groundwork for these new rules we must now follow. response:	We must allow organizations who wish to overturn our closure directive
context: She will eventually return to my side.\I am certain that she will join me in my cause.\Well, thanks to you, we're going to be very busy.\With Shokugeki?\That's right.\You worked behind the scenes, reaching out to relevant parties\to lay the groundwork for these new rules we must now follow.\We must allow organizations who wish to overturn our closure directive response:	to face my pride and joy, the soldiers of Central.
context: I am certain that she will join me in my cause.\Well, thanks to you, we're going to be very busy.\With Shokugeki?\That's right.\You worked behind the scenes, reaching out to relevant parties\to lay the groundwork for these new rules we must now follow.\We must allow organizations who wish to overturn our closure directive\to face my pride and joy, the soldiers of Central. response:	Rules Concerning Shokugeki involving Organizations Opposing the Azami Organization,
context: Well, thanks to you, we're going to be very busy.\With Shokugeki?\That's right.\You worked behind the scenes, reaching out to relevant parties\to lay the groundwork for these new rules we must now follow.\We must allow organizations who wish to overturn our closure directive\to face my pride and joy, the soldiers of Central.\Rules Concerning Shokugeki involving Organizations Opposing the Azami Organization, response:	also known as the Isshiki Rules.
context: With Shokugeki?\That's right.\You worked behind the scenes, reaching out to relevant parties\to lay the groundwork for these new rules we must now follow.\We must allow organizations who wish to overturn our closure directive\to face my pride and joy, the soldiers of Central.\Rules Concerning Shokugeki involving Organizations Opposing the Azami Organization,\also known as the Isshiki Rules. response:	Who names stuff after himself?
context: That's right.\You worked behind the scenes, reaching out to relevant parties\to lay the groundwork for these new rules we must now follow.\We must allow organizations who wish to overturn our closure directive\to face my pride and joy, the soldiers of Central.\Rules Concerning Shokugeki involving Organizations Opposing the Azami Organization,\also known as the Isshiki Rules.\Who names stuff after himself? response:	That's kind of annoying.
context: You worked behind the scenes, reaching out to relevant parties\to lay the groundwork for these new rules we must now follow.\We must allow organizations who wish to overturn our closure directive\to face my pride and joy, the soldiers of Central.\Rules Concerning Shokugeki involving Organizations Opposing the Azami Organization,\also known as the Isshiki Rules.\Who names stuff after himself?\That's kind of annoying. response:	Still, because Isshiki clarified that Central cannot contact judges,
context: to lay the groundwork for these new rules we must now follow.\We must allow organizations who wish to overturn our closure directive\to face my pride and joy, the soldiers of Central.\Rules Concerning Shokugeki involving Organizations Opposing the Azami Organization,\also known as the Isshiki Rules.\Who names stuff after himself?\That's kind of annoying.\Still, because Isshiki clarified that Central cannot contact judges, response:	the legitimacy of their ruling has been established.
context: We must allow organizations who wish to overturn our closure directive\to face my pride and joy, the soldiers of Central.\Rules Concerning Shokugeki involving Organizations Opposing the Azami Organization,\also known as the Isshiki Rules.\Who names stuff after himself?\That's kind of annoying.\Still, because Isshiki clarified that Central cannot contact judges,\the legitimacy of their ruling has been established. response:	Of course, I was against rigged matches in the first place.
context: to face my pride and joy, the soldiers of Central.\Rules Concerning Shokugeki involving Organizations Opposing the Azami Organization,\also known as the Isshiki Rules.\Who names stuff after himself?\That's kind of annoying.\Still, because Isshiki clarified that Central cannot contact judges,\the legitimacy of their ruling has been established.\Of course, I was against rigged matches in the first place. response:	There's a clause requiring Central to accept any Shokugeki challenge
context: Rules Concerning Shokugeki involving Organizations Opposing the Azami Organization,\also known as the Isshiki Rules.\Who names stuff after himself?\That's kind of annoying.\Still, because Isshiki clarified that Central cannot contact judges,\the legitimacy of their ruling has been established.\Of course, I was against rigged matches in the first place.\There's a clause requiring Central to accept any Shokugeki challenge response:	that involves overturning the organization's closure, too.
context: also known as the Isshiki Rules.\Who names stuff after himself?\That's kind of annoying.\Still, because Isshiki clarified that Central cannot contact judges,\the legitimacy of their ruling has been established.\Of course, I was against rigged matches in the first place.\There's a clause requiring Central to accept any Shokugeki challenge\that involves overturning the organization's closure, too. response:	Isshiki's pretty thorough.
context: Who names stuff after himself?\That's kind of annoying.\Still, because Isshiki clarified that Central cannot contact judges,\the legitimacy of their ruling has been established.\Of course, I was against rigged matches in the first place.\There's a clause requiring Central to accept any Shokugeki challenge\that involves overturning the organization's closure, too.\Isshiki's pretty thorough. response:	It's also annoying that this forces us to face subpar opponents.
context: That's kind of annoying.\Still, because Isshiki clarified that Central cannot contact judges,\the legitimacy of their ruling has been established.\Of course, I was against rigged matches in the first place.\There's a clause requiring Central to accept any Shokugeki challenge\that involves overturning the organization's closure, too.\Isshiki's pretty thorough.\It's also annoying that this forces us to face subpar opponents. response:	I was first place in overall sales at the Moon Festival.
context: Still, because Isshiki clarified that Central cannot contact judges,\the legitimacy of their ruling has been established.\Of course, I was against rigged matches in the first place.\There's a clause requiring Central to accept any Shokugeki challenge\that involves overturning the organization's closure, too.\Isshiki's pretty thorough.\It's also annoying that this forces us to face subpar opponents.\I was first place in overall sales at the Moon Festival. response:	They should just have Central win by default every time.
context: the legitimacy of their ruling has been established.\Of course, I was against rigged matches in the first place.\There's a clause requiring Central to accept any Shokugeki challenge\that involves overturning the organization's closure, too.\Isshiki's pretty thorough.\It's also annoying that this forces us to face subpar opponents.\I was first place in overall sales at the Moon Festival.\They should just have Central win by default every time. response:	You'll just have to accept this, Momo-senpai.
context: Of course, I was against rigged matches in the first place.\There's a clause requiring Central to accept any Shokugeki challenge\that involves overturning the organization's closure, too.\Isshiki's pretty thorough.\It's also annoying that this forces us to face subpar opponents.\I was first place in overall sales at the Moon Festival.\They should just have Central win by default every time.\You'll just have to accept this, Momo-senpai. response:	And Rindo-senpai, please wear the Central badge.
context: There's a clause requiring Central to accept any Shokugeki challenge\that involves overturning the organization's closure, too.\Isshiki's pretty thorough.\It's also annoying that this forces us to face subpar opponents.\I was first place in overall sales at the Moon Festival.\They should just have Central win by default every time.\You'll just have to accept this, Momo-senpai.\And Rindo-senpai, please wear the Central badge. response:	Really?
context: that involves overturning the organization's closure, too.\Isshiki's pretty thorough.\It's also annoying that this forces us to face subpar opponents.\I was first place in overall sales at the Moon Festival.\They should just have Central win by default every time.\You'll just have to accept this, Momo-senpai.\And Rindo-senpai, please wear the Central badge.\Really? response:	But that looks like it'll always get in the way.
context: Isshiki's pretty thorough.\It's also annoying that this forces us to face subpar opponents.\I was first place in overall sales at the Moon Festival.\They should just have Central win by default every time.\You'll just have to accept this, Momo-senpai.\And Rindo-senpai, please wear the Central badge.\Really?\But that looks like it'll always get in the way. response:	Don't really me, please.
context: It's also annoying that this forces us to face subpar opponents.\I was first place in overall sales at the Moon Festival.\They should just have Central win by default every time.\You'll just have to accept this, Momo-senpai.\And Rindo-senpai, please wear the Central badge.\Really?\But that looks like it'll always get in the way.\Don't really me, please. response:	But, but...
context: I was first place in overall sales at the Moon Festival.\They should just have Central win by default every time.\You'll just have to accept this, Momo-senpai.\And Rindo-senpai, please wear the Central badge.\Really?\But that looks like it'll always get in the way.\Don't really me, please.\But, but... response:	Don't but, but me, please.
context: They should just have Central win by default every time.\You'll just have to accept this, Momo-senpai.\And Rindo-senpai, please wear the Central badge.\Really?\But that looks like it'll always get in the way.\Don't really me, please.\But, but...\Don't but, but me, please. response:	Okay.
context: You'll just have to accept this, Momo-senpai.\And Rindo-senpai, please wear the Central badge.\Really?\But that looks like it'll always get in the way.\Don't really me, please.\But, but...\Don't but, but me, please.\Okay. response:	The rest of you should put your badges on, too, before Nene gets mad at you.
context: And Rindo-senpai, please wear the Central badge.\Really?\But that looks like it'll always get in the way.\Don't really me, please.\But, but...\Don't but, but me, please.\Okay.\The rest of you should put your badges on, too, before Nene gets mad at you. response:	No need to tell me twice.
context: Really?\But that looks like it'll always get in the way.\Don't really me, please.\But, but...\Don't but, but me, please.\Okay.\The rest of you should put your badges on, too, before Nene gets mad at you.\No need to tell me twice. response:	Well, let's get going, then.
context: But that looks like it'll always get in the way.\Don't really me, please.\But, but...\Don't but, but me, please.\Okay.\The rest of you should put your badges on, too, before Nene gets mad at you.\No need to tell me twice.\Well, let's get going, then. response:	It's time to start hunting the survivors.
context: Don't really me, please.\But, but...\Don't but, but me, please.\Okay.\The rest of you should put your badges on, too, before Nene gets mad at you.\No need to tell me twice.\Well, let's get going, then.\It's time to start hunting the survivors. response:	Hunting the survivors?
context: But, but...\Don't but, but me, please.\Okay.\The rest of you should put your badges on, too, before Nene gets mad at you.\No need to tell me twice.\Well, let's get going, then.\It's time to start hunting the survivors.\Hunting the survivors? response:	That's what Central's calling Shokugeki matches with
context: Don't but, but me, please.\Okay.\The rest of you should put your badges on, too, before Nene gets mad at you.\No need to tell me twice.\Well, let's get going, then.\It's time to start hunting the survivors.\Hunting the survivors?\That's what Central's calling Shokugeki matches with response:	organizations that want to survive.
context: Okay.\The rest of you should put your badges on, too, before Nene gets mad at you.\No need to tell me twice.\Well, let's get going, then.\It's time to start hunting the survivors.\Hunting the survivors?\That's what Central's calling Shokugeki matches with\organizations that want to survive. response:	The first set's happening today.
context: The rest of you should put your badges on, too, before Nene gets mad at you.\No need to tell me twice.\Well, let's get going, then.\It's time to start hunting the survivors.\Hunting the survivors?\That's what Central's calling Shokugeki matches with\organizations that want to survive.\The first set's happening today. response:	They're not trying to sugarcoat it, huh.
context: No need to tell me twice.\Well, let's get going, then.\It's time to start hunting the survivors.\Hunting the survivors?\That's what Central's calling Shokugeki matches with\organizations that want to survive.\The first set's happening today.\They're not trying to sugarcoat it, huh. response:	Students from Central will be participating in the matches.
context: Well, let's get going, then.\It's time to start hunting the survivors.\Hunting the survivors?\That's what Central's calling Shokugeki matches with\organizations that want to survive.\The first set's happening today.\They're not trying to sugarcoat it, huh.\Students from Central will be participating in the matches. response:	Yeah.
context: It's time to start hunting the survivors.\Hunting the survivors?\That's what Central's calling Shokugeki matches with\organizations that want to survive.\The first set's happening today.\They're not trying to sugarcoat it, huh.\Students from Central will be participating in the matches.\Yeah. response:	The pro-Azami Elite Ten will be a given,
context: Hunting the survivors?\That's what Central's calling Shokugeki matches with\organizations that want to survive.\The first set's happening today.\They're not trying to sugarcoat it, huh.\Students from Central will be participating in the matches.\Yeah.\The pro-Azami Elite Ten will be a given, response:	Academy Director Elite Ten General Student Population (Pro-Azami Administration) (Anti-Azami Administration)
context: That's what Central's calling Shokugeki matches with\organizations that want to survive.\The first set's happening today.\They're not trying to sugarcoat it, huh.\Students from Central will be participating in the matches.\Yeah.\The pro-Azami Elite Ten will be a given,\Academy Director Elite Ten General Student Population (Pro-Azami Administration) (Anti-Azami Administration) response:	and the rest are high performers who could
context: organizations that want to survive.\The first set's happening today.\They're not trying to sugarcoat it, huh.\Students from Central will be participating in the matches.\Yeah.\The pro-Azami Elite Ten will be a given,\Academy Director Elite Ten General Student Population (Pro-Azami Administration) (Anti-Azami Administration)\and the rest are high performers who could response:	be called the Elite Ten's reserves.
context: The first set's happening today.\They're not trying to sugarcoat it, huh.\Students from Central will be participating in the matches.\Yeah.\The pro-Azami Elite Ten will be a given,\Academy Director Elite Ten General Student Population (Pro-Azami Administration) (Anti-Azami Administration)\and the rest are high performers who could\be called the Elite Ten's reserves. response:	The Elite Ten's reserve troops, huh?
context: They're not trying to sugarcoat it, huh.\Students from Central will be participating in the matches.\Yeah.\The pro-Azami Elite Ten will be a given,\Academy Director Elite Ten General Student Population (Pro-Azami Administration) (Anti-Azami Administration)\and the rest are high performers who could\be called the Elite Ten's reserves.\The Elite Ten's reserve troops, huh? response:	I want to check them out.
context: Students from Central will be participating in the matches.\Yeah.\The pro-Azami Elite Ten will be a given,\Academy Director Elite Ten General Student Population (Pro-Azami Administration) (Anti-Azami Administration)\and the rest are high performers who could\be called the Elite Ten's reserves.\The Elite Ten's reserve troops, huh?\I want to check them out. response:	Huh?!
context: Yeah.\The pro-Azami Elite Ten will be a given,\Academy Director Elite Ten General Student Population (Pro-Azami Administration) (Anti-Azami Administration)\and the rest are high performers who could\be called the Elite Ten's reserves.\The Elite Ten's reserve troops, huh?\I want to check them out.\Huh?! response:	You'd better not be thinking of doing something again.
context: The pro-Azami Elite Ten will be a given,\Academy Director Elite Ten General Student Population (Pro-Azami Administration) (Anti-Azami Administration)\and the rest are high performers who could\be called the Elite Ten's reserves.\The Elite Ten's reserve troops, huh?\I want to check them out.\Huh?!\You'd better not be thinking of doing something again. response:	No more going off on your own!
context: Academy Director Elite Ten General Student Population (Pro-Azami Administration) (Anti-Azami Administration)\and the rest are high performers who could\be called the Elite Ten's reserves.\The Elite Ten's reserve troops, huh?\I want to check them out.\Huh?!\You'd better not be thinking of doing something again.\No more going off on your own! response:	If you're going to watch the Shokugeki, I'll go with you.
context: and the rest are high performers who could\be called the Elite Ten's reserves.\The Elite Ten's reserve troops, huh?\I want to check them out.\Huh?!\You'd better not be thinking of doing something again.\No more going off on your own!\If you're going to watch the Shokugeki, I'll go with you. response:	I'd be too worried if I let you go by yourself!
context: be called the Elite Ten's reserves.\The Elite Ten's reserve troops, huh?\I want to check them out.\Huh?!\You'd better not be thinking of doing something again.\No more going off on your own!\If you're going to watch the Shokugeki, I'll go with you.\I'd be too worried if I let you go by yourself! response:	I guess it'll be fine if Takumi-cchi goes with him.
context: The Elite Ten's reserve troops, huh?\I want to check them out.\Huh?!\You'd better not be thinking of doing something again.\No more going off on your own!\If you're going to watch the Shokugeki, I'll go with you.\I'd be too worried if I let you go by yourself!\I guess it'll be fine if Takumi-cchi goes with him. response:	I mean, he's basically always at the dorm.
context: I want to check them out.\Huh?!\You'd better not be thinking of doing something again.\No more going off on your own!\If you're going to watch the Shokugeki, I'll go with you.\I'd be too worried if I let you go by yourself!\I guess it'll be fine if Takumi-cchi goes with him.\I mean, he's basically always at the dorm. response:	Yeah, let's go.
context: Huh?!\You'd better not be thinking of doing something again.\No more going off on your own!\If you're going to watch the Shokugeki, I'll go with you.\I'd be too worried if I let you go by yourself!\I guess it'll be fine if Takumi-cchi goes with him.\I mean, he's basically always at the dorm.\Yeah, let's go. response:	It's just for scouting purposes, understand?
context: You'd better not be thinking of doing something again.\No more going off on your own!\If you're going to watch the Shokugeki, I'll go with you.\I'd be too worried if I let you go by yourself!\I guess it'll be fine if Takumi-cchi goes with him.\I mean, he's basically always at the dorm.\Yeah, let's go.\It's just for scouting purposes, understand? response:	I-I want to go, too!
context: No more going off on your own!\If you're going to watch the Shokugeki, I'll go with you.\I'd be too worried if I let you go by yourself!\I guess it'll be fine if Takumi-cchi goes with him.\I mean, he's basically always at the dorm.\Yeah, let's go.\It's just for scouting purposes, understand?\I-I want to go, too! response:	I'm sure Regional Cooking RS will also be having a Shokugeki.
context: If you're going to watch the Shokugeki, I'll go with you.\I'd be too worried if I let you go by yourself!\I guess it'll be fine if Takumi-cchi goes with him.\I mean, he's basically always at the dorm.\Yeah, let's go.\It's just for scouting purposes, understand?\I-I want to go, too!\I'm sure Regional Cooking RS will also be having a Shokugeki. response:	True. My Miyazato Research Group will be fighting the same foe.
context: I'd be too worried if I let you go by yourself!\I guess it'll be fine if Takumi-cchi goes with him.\I mean, he's basically always at the dorm.\Yeah, let's go.\It's just for scouting purposes, understand?\I-I want to go, too!\I'm sure Regional Cooking RS will also be having a Shokugeki.\True. My Miyazato Research Group will be fighting the same foe. response:	Watching the matches wouldn't be a waste of time.
context: I guess it'll be fine if Takumi-cchi goes with him.\I mean, he's basically always at the dorm.\Yeah, let's go.\It's just for scouting purposes, understand?\I-I want to go, too!\I'm sure Regional Cooking RS will also be having a Shokugeki.\True. My Miyazato Research Group will be fighting the same foe.\Watching the matches wouldn't be a waste of time. response:	There's supposed to be three separate arenas.
context: I mean, he's basically always at the dorm.\Yeah, let's go.\It's just for scouting purposes, understand?\I-I want to go, too!\I'm sure Regional Cooking RS will also be having a Shokugeki.\True. My Miyazato Research Group will be fighting the same foe.\Watching the matches wouldn't be a waste of time.\There's supposed to be three separate arenas. response:	Oh, then we can just all split up and cover them all.
context: Yeah, let's go.\It's just for scouting purposes, understand?\I-I want to go, too!\I'm sure Regional Cooking RS will also be having a Shokugeki.\True. My Miyazato Research Group will be fighting the same foe.\Watching the matches wouldn't be a waste of time.\There's supposed to be three separate arenas.\Oh, then we can just all split up and cover them all. response:	Yeah!
context: It's just for scouting purposes, understand?\I-I want to go, too!\I'm sure Regional Cooking RS will also be having a Shokugeki.\True. My Miyazato Research Group will be fighting the same foe.\Watching the matches wouldn't be a waste of time.\There's supposed to be three separate arenas.\Oh, then we can just all split up and cover them all.\Yeah! response:	Let's do that.
context: I-I want to go, too!\I'm sure Regional Cooking RS will also be having a Shokugeki.\True. My Miyazato Research Group will be fighting the same foe.\Watching the matches wouldn't be a waste of time.\There's supposed to be three separate arenas.\Oh, then we can just all split up and cover them all.\Yeah!\Let's do that. response:	Hall A Group
context: I'm sure Regional Cooking RS will also be having a Shokugeki.\True. My Miyazato Research Group will be fighting the same foe.\Watching the matches wouldn't be a waste of time.\There's supposed to be three separate arenas.\Oh, then we can just all split up and cover them all.\Yeah!\Let's do that.\Hall A Group response:	We'll be going to Hall A, then.
context: True. My Miyazato Research Group will be fighting the same foe.\Watching the matches wouldn't be a waste of time.\There's supposed to be three separate arenas.\Oh, then we can just all split up and cover them all.\Yeah!\Let's do that.\Hall A Group\We'll be going to Hall A, then. response:	Let's do our best!
context: Watching the matches wouldn't be a waste of time.\There's supposed to be three separate arenas.\Oh, then we can just all split up and cover them all.\Yeah!\Let's do that.\Hall A Group\We'll be going to Hall A, then.\Let's do our best! response:	Hall B Group
context: There's supposed to be three separate arenas.\Oh, then we can just all split up and cover them all.\Yeah!\Let's do that.\Hall A Group\We'll be going to Hall A, then.\Let's do our best!\Hall B Group response:	We'll be going to Hall B!
context: Oh, then we can just all split up and cover them all.\Yeah!\Let's do that.\Hall A Group\We'll be going to Hall A, then.\Let's do our best!\Hall B Group\We'll be going to Hall B! response:	I'll be worried about Erina-sama while we're all gone.
context: Yeah!\Let's do that.\Hall A Group\We'll be going to Hall A, then.\Let's do our best!\Hall B Group\We'll be going to Hall B!\I'll be worried about Erina-sama while we're all gone. response:	Nakiri-chan will be fine.
context: Let's do that.\Hall A Group\We'll be going to Hall A, then.\Let's do our best!\Hall B Group\We'll be going to Hall B!\I'll be worried about Erina-sama while we're all gone.\Nakiri-chan will be fine. response:	Fumio-san will still be here.
context: Hall A Group\We'll be going to Hall A, then.\Let's do our best!\Hall B Group\We'll be going to Hall B!\I'll be worried about Erina-sama while we're all gone.\Nakiri-chan will be fine.\Fumio-san will still be here. response:	Hey!
context: We'll be going to Hall A, then.\Let's do our best!\Hall B Group\We'll be going to Hall B!\I'll be worried about Erina-sama while we're all gone.\Nakiri-chan will be fine.\Fumio-san will still be here.\Hey! response:	Don't call her Nakiri-chan!
context: Let's do our best!\Hall B Group\We'll be going to Hall B!\I'll be worried about Erina-sama while we're all gone.\Nakiri-chan will be fine.\Fumio-san will still be here.\Hey!\Don't call her Nakiri-chan! response:	S-Sorry.
context: Hall B Group\We'll be going to Hall B!\I'll be worried about Erina-sama while we're all gone.\Nakiri-chan will be fine.\Fumio-san will still be here.\Hey!\Don't call her Nakiri-chan!\S-Sorry. response:	Hall C Group
context: We'll be going to Hall B!\I'll be worried about Erina-sama while we're all gone.\Nakiri-chan will be fine.\Fumio-san will still be here.\Hey!\Don't call her Nakiri-chan!\S-Sorry.\Hall C Group response:	All right!
context: I'll be worried about Erina-sama while we're all gone.\Nakiri-chan will be fine.\Fumio-san will still be here.\Hey!\Don't call her Nakiri-chan!\S-Sorry.\Hall C Group\All right! response:	We'll go to Hall C!
context: Nakiri-chan will be fine.\Fumio-san will still be here.\Hey!\Don't call her Nakiri-chan!\S-Sorry.\Hall C Group\All right!\We'll go to Hall C! response:	Yukihira, today is for scouting purposes only, understand?
context: Fumio-san will still be here.\Hey!\Don't call her Nakiri-chan!\S-Sorry.\Hall C Group\All right!\We'll go to Hall C!\Yukihira, today is for scouting purposes only, understand? response:	Don't take this too far.
context: Hey!\Don't call her Nakiri-chan!\S-Sorry.\Hall C Group\All right!\We'll go to Hall C!\Yukihira, today is for scouting purposes only, understand?\Don't take this too far. response:	I know, I know.
context: Don't call her Nakiri-chan!\S-Sorry.\Hall C Group\All right!\We'll go to Hall C!\Yukihira, today is for scouting purposes only, understand?\Don't take this too far.\I know, I know. response:	Hall C
context: S-Sorry.\Hall C Group\All right!\We'll go to Hall C!\Yukihira, today is for scouting purposes only, understand?\Don't take this too far.\I know, I know.\Hall C response:	Elite Ten, Fourth Seat, 3rd Year Akanegakubo Momo
context: Hall C Group\All right!\We'll go to Hall C!\Yukihira, today is for scouting purposes only, understand?\Don't take this too far.\I know, I know.\Hall C\Elite Ten, Fourth Seat, 3rd Year Akanegakubo Momo response:	Elite Ten, Ninth Seat, 2nd Year Eizan Etsuya
context: All right!\We'll go to Hall C!\Yukihira, today is for scouting purposes only, understand?\Don't take this too far.\I know, I know.\Hall C\Elite Ten, Fourth Seat, 3rd Year Akanegakubo Momo\Elite Ten, Ninth Seat, 2nd Year Eizan Etsuya response:	Hunting survivors or not,
context: We'll go to Hall C!\Yukihira, today is for scouting purposes only, understand?\Don't take this too far.\I know, I know.\Hall C\Elite Ten, Fourth Seat, 3rd Year Akanegakubo Momo\Elite Ten, Ninth Seat, 2nd Year Eizan Etsuya\Hunting survivors or not, response:	Japanese Food Industry Council President Oizumi Kakinoshin
context: Yukihira, today is for scouting purposes only, understand?\Don't take this too far.\I know, I know.\Hall C\Elite Ten, Fourth Seat, 3rd Year Akanegakubo Momo\Elite Ten, Ninth Seat, 2nd Year Eizan Etsuya\Hunting survivors or not,\Japanese Food Industry Council President Oizumi Kakinoshin response:	I won't let anything detract from the fairness of this match while I still live.
context: Don't take this too far.\I know, I know.\Hall C\Elite Ten, Fourth Seat, 3rd Year Akanegakubo Momo\Elite Ten, Ninth Seat, 2nd Year Eizan Etsuya\Hunting survivors or not,\Japanese Food Industry Council President Oizumi Kakinoshin\I won't let anything detract from the fairness of this match while I still live. response:	Japan Gourmet Society Director Saotome Seishu
context: I know, I know.\Hall C\Elite Ten, Fourth Seat, 3rd Year Akanegakubo Momo\Elite Ten, Ninth Seat, 2nd Year Eizan Etsuya\Hunting survivors or not,\Japanese Food Industry Council President Oizumi Kakinoshin\I won't let anything detract from the fairness of this match while I still live.\Japan Gourmet Society Director Saotome Seishu response:	Yes, it's our responsibility to provide fair judgment.
context: Hall C\Elite Ten, Fourth Seat, 3rd Year Akanegakubo Momo\Elite Ten, Ninth Seat, 2nd Year Eizan Etsuya\Hunting survivors or not,\Japanese Food Industry Council President Oizumi Kakinoshin\I won't let anything detract from the fairness of this match while I still live.\Japan Gourmet Society Director Saotome Seishu\Yes, it's our responsibility to provide fair judgment. response:	Wow, what a crowd!
context: Elite Ten, Fourth Seat, 3rd Year Akanegakubo Momo\Elite Ten, Ninth Seat, 2nd Year Eizan Etsuya\Hunting survivors or not,\Japanese Food Industry Council President Oizumi Kakinoshin\I won't let anything detract from the fairness of this match while I still live.\Japan Gourmet Society Director Saotome Seishu\Yes, it's our responsibility to provide fair judgment.\Wow, what a crowd! response:	Um, this match is the Fourth Seat, Akanegakubo-senpai,
context: Elite Ten, Ninth Seat, 2nd Year Eizan Etsuya\Hunting survivors or not,\Japanese Food Industry Council President Oizumi Kakinoshin\I won't let anything detract from the fairness of this match while I still live.\Japan Gourmet Society Director Saotome Seishu\Yes, it's our responsibility to provide fair judgment.\Wow, what a crowd!\Um, this match is the Fourth Seat, Akanegakubo-senpai, response:	Chocolate RS vs. Akanegakubo Momo
context: Hunting survivors or not,\Japanese Food Industry Council President Oizumi Kakinoshin\I won't let anything detract from the fairness of this match while I still live.\Japan Gourmet Society Director Saotome Seishu\Yes, it's our responsibility to provide fair judgment.\Wow, what a crowd!\Um, this match is the Fourth Seat, Akanegakubo-senpai,\Chocolate RS vs. Akanegakubo Momo response:	versus the Chocolate RS.
context: Japanese Food Industry Council President Oizumi Kakinoshin\I won't let anything detract from the fairness of this match while I still live.\Japan Gourmet Society Director Saotome Seishu\Yes, it's our responsibility to provide fair judgment.\Wow, what a crowd!\Um, this match is the Fourth Seat, Akanegakubo-senpai,\Chocolate RS vs. Akanegakubo Momo\versus the Chocolate RS. response:	Eizan Etsuya vs. Western Cuisine RS
context: I won't let anything detract from the fairness of this match while I still live.\Japan Gourmet Society Director Saotome Seishu\Yes, it's our responsibility to provide fair judgment.\Wow, what a crowd!\Um, this match is the Fourth Seat, Akanegakubo-senpai,\Chocolate RS vs. Akanegakubo Momo\versus the Chocolate RS.\Eizan Etsuya vs. Western Cuisine RS response:	There's also Eizan-senpai versus the Western Cuisine RS.
context: Japan Gourmet Society Director Saotome Seishu\Yes, it's our responsibility to provide fair judgment.\Wow, what a crowd!\Um, this match is the Fourth Seat, Akanegakubo-senpai,\Chocolate RS vs. Akanegakubo Momo\versus the Chocolate RS.\Eizan Etsuya vs. Western Cuisine RS\There's also Eizan-senpai versus the Western Cuisine RS. response:	Looks like there will be several Shokugeki happening in parallel at each arena.
context: Yes, it's our responsibility to provide fair judgment.\Wow, what a crowd!\Um, this match is the Fourth Seat, Akanegakubo-senpai,\Chocolate RS vs. Akanegakubo Momo\versus the Chocolate RS.\Eizan Etsuya vs. Western Cuisine RS\There's also Eizan-senpai versus the Western Cuisine RS.\Looks like there will be several Shokugeki happening in parallel at each arena. response:	The Don RS guys aren't here, huh?
context: Wow, what a crowd!\Um, this match is the Fourth Seat, Akanegakubo-senpai,\Chocolate RS vs. Akanegakubo Momo\versus the Chocolate RS.\Eizan Etsuya vs. Western Cuisine RS\There's also Eizan-senpai versus the Western Cuisine RS.\Looks like there will be several Shokugeki happening in parallel at each arena.\The Don RS guys aren't here, huh? response:	Shiomi Research Group's Hayama isn't here, either.
context: Um, this match is the Fourth Seat, Akanegakubo-senpai,\Chocolate RS vs. Akanegakubo Momo\versus the Chocolate RS.\Eizan Etsuya vs. Western Cuisine RS\There's also Eizan-senpai versus the Western Cuisine RS.\Looks like there will be several Shokugeki happening in parallel at each arena.\The Don RS guys aren't here, huh?\Shiomi Research Group's Hayama isn't here, either. response:	Let's go, Bucchi.
context: Chocolate RS vs. Akanegakubo Momo\versus the Chocolate RS.\Eizan Etsuya vs. Western Cuisine RS\There's also Eizan-senpai versus the Western Cuisine RS.\Looks like there will be several Shokugeki happening in parallel at each arena.\The Don RS guys aren't here, huh?\Shiomi Research Group's Hayama isn't here, either.\Let's go, Bucchi. response:	Help my cooking.
context: versus the Chocolate RS.\Eizan Etsuya vs. Western Cuisine RS\There's also Eizan-senpai versus the Western Cuisine RS.\Looks like there will be several Shokugeki happening in parallel at each arena.\The Don RS guys aren't here, huh?\Shiomi Research Group's Hayama isn't here, either.\Let's go, Bucchi.\Help my cooking. response:	All right.
context: Eizan Etsuya vs. Western Cuisine RS\There's also Eizan-senpai versus the Western Cuisine RS.\Looks like there will be several Shokugeki happening in parallel at each arena.\The Don RS guys aren't here, huh?\Shiomi Research Group's Hayama isn't here, either.\Let's go, Bucchi.\Help my cooking.\All right. response:	I hope it baked okay.
context: There's also Eizan-senpai versus the Western Cuisine RS.\Looks like there will be several Shokugeki happening in parallel at each arena.\The Don RS guys aren't here, huh?\Shiomi Research Group's Hayama isn't here, either.\Let's go, Bucchi.\Help my cooking.\All right.\I hope it baked okay. response:	She ripped off the teddy bear's hands to serve as oven mitts...
context: Looks like there will be several Shokugeki happening in parallel at each arena.\The Don RS guys aren't here, huh?\Shiomi Research Group's Hayama isn't here, either.\Let's go, Bucchi.\Help my cooking.\All right.\I hope it baked okay.\She ripped off the teddy bear's hands to serve as oven mitts... response:	Is there some meaning that I'm missing there?
context: The Don RS guys aren't here, huh?\Shiomi Research Group's Hayama isn't here, either.\Let's go, Bucchi.\Help my cooking.\All right.\I hope it baked okay.\She ripped off the teddy bear's hands to serve as oven mitts...\Is there some meaning that I'm missing there? response:	Rumor has it that she does it every time she cooks.
context: Shiomi Research Group's Hayama isn't here, either.\Let's go, Bucchi.\Help my cooking.\All right.\I hope it baked okay.\She ripped off the teddy bear's hands to serve as oven mitts...\Is there some meaning that I'm missing there?\Rumor has it that she does it every time she cooks. response:	She works fast, as expected.
context: Let's go, Bucchi.\Help my cooking.\All right.\I hope it baked okay.\She ripped off the teddy bear's hands to serve as oven mitts...\Is there some meaning that I'm missing there?\Rumor has it that she does it every time she cooks.\She works fast, as expected. response:	She is called the best patissier at Totsuki Academy, after all.
context: Help my cooking.\All right.\I hope it baked okay.\She ripped off the teddy bear's hands to serve as oven mitts...\Is there some meaning that I'm missing there?\Rumor has it that she does it every time she cooks.\She works fast, as expected.\She is called the best patissier at Totsuki Academy, after all. response:	The cake we ate at the Autumn Leaf Viewing was super tasty, too.
context: All right.\I hope it baked okay.\She ripped off the teddy bear's hands to serve as oven mitts...\Is there some meaning that I'm missing there?\Rumor has it that she does it every time she cooks.\She works fast, as expected.\She is called the best patissier at Totsuki Academy, after all.\The cake we ate at the Autumn Leaf Viewing was super tasty, too. response:	Done.
context: I hope it baked okay.\She ripped off the teddy bear's hands to serve as oven mitts...\Is there some meaning that I'm missing there?\Rumor has it that she does it every time she cooks.\She works fast, as expected.\She is called the best patissier at Totsuki Academy, after all.\The cake we ate at the Autumn Leaf Viewing was super tasty, too.\Done. response:	How beautiful.
context: She ripped off the teddy bear's hands to serve as oven mitts...\Is there some meaning that I'm missing there?\Rumor has it that she does it every time she cooks.\She works fast, as expected.\She is called the best patissier at Totsuki Academy, after all.\The cake we ate at the Autumn Leaf Viewing was super tasty, too.\Done.\How beautiful. response:	But what of the taste?
context: Is there some meaning that I'm missing there?\Rumor has it that she does it every time she cooks.\She works fast, as expected.\She is called the best patissier at Totsuki Academy, after all.\The cake we ate at the Autumn Leaf Viewing was super tasty, too.\Done.\How beautiful.\But what of the taste? response:	Western Cuisine RS
context: Rumor has it that she does it every time she cooks.\She works fast, as expected.\She is called the best patissier at Totsuki Academy, after all.\The cake we ate at the Autumn Leaf Viewing was super tasty, too.\Done.\How beautiful.\But what of the taste?\Western Cuisine RS response:	Chocolate RS
context: She works fast, as expected.\She is called the best patissier at Totsuki Academy, after all.\The cake we ate at the Autumn Leaf Viewing was super tasty, too.\Done.\How beautiful.\But what of the taste?\Western Cuisine RS\Chocolate RS response:	Akanegakubo Momo and Eizan Etsuya both won in a complete shut-out.
context: She is called the best patissier at Totsuki Academy, after all.\The cake we ate at the Autumn Leaf Viewing was super tasty, too.\Done.\How beautiful.\But what of the taste?\Western Cuisine RS\Chocolate RS\Akanegakubo Momo and Eizan Etsuya both won in a complete shut-out. response:	Wow...
context: The cake we ate at the Autumn Leaf Viewing was super tasty, too.\Done.\How beautiful.\But what of the taste?\Western Cuisine RS\Chocolate RS\Akanegakubo Momo and Eizan Etsuya both won in a complete shut-out.\Wow... response:	A sweeping victory by Central.
context: Done.\How beautiful.\But what of the taste?\Western Cuisine RS\Chocolate RS\Akanegakubo Momo and Eizan Etsuya both won in a complete shut-out.\Wow...\A sweeping victory by Central. response:	Huh...
context: How beautiful.\But what of the taste?\Western Cuisine RS\Chocolate RS\Akanegakubo Momo and Eizan Etsuya both won in a complete shut-out.\Wow...\A sweeping victory by Central.\Huh... response:	I want to fight them.
context: But what of the taste?\Western Cuisine RS\Chocolate RS\Akanegakubo Momo and Eizan Etsuya both won in a complete shut-out.\Wow...\A sweeping victory by Central.\Huh...\I want to fight them. response:	Soma-kun!
context: Western Cuisine RS\Chocolate RS\Akanegakubo Momo and Eizan Etsuya both won in a complete shut-out.\Wow...\A sweeping victory by Central.\Huh...\I want to fight them.\Soma-kun! response:	Yukihira, I know I sound like a broken record,
context: Chocolate RS\Akanegakubo Momo and Eizan Etsuya both won in a complete shut-out.\Wow...\A sweeping victory by Central.\Huh...\I want to fight them.\Soma-kun!\Yukihira, I know I sound like a broken record, response:	but today is for scouting purposes only.
context: Akanegakubo Momo and Eizan Etsuya both won in a complete shut-out.\Wow...\A sweeping victory by Central.\Huh...\I want to fight them.\Soma-kun!\Yukihira, I know I sound like a broken record,\but today is for scouting purposes only. response:	You can't challenge them
context: Wow...\A sweeping victory by Central.\Huh...\I want to fight them.\Soma-kun!\Yukihira, I know I sound like a broken record,\but today is for scouting purposes only.\You can't challenge them response:	I know, I know.
context: A sweeping victory by Central.\Huh...\I want to fight them.\Soma-kun!\Yukihira, I know I sound like a broken record,\but today is for scouting purposes only.\You can't challenge them\I know, I know. response:	Yukihira...
context: Huh...\I want to fight them.\Soma-kun!\Yukihira, I know I sound like a broken record,\but today is for scouting purposes only.\You can't challenge them\I know, I know.\Yukihira... response:	Come to think of it, I haven't seen Eizan-senpai's specialty dish yet.
context: I want to fight them.\Soma-kun!\Yukihira, I know I sound like a broken record,\but today is for scouting purposes only.\You can't challenge them\I know, I know.\Yukihira...\Come to think of it, I haven't seen Eizan-senpai's specialty dish yet. response:	Next time, let's give each other a lot of time to prep and do a Shokugeki!
context: Soma-kun!\Yukihira, I know I sound like a broken record,\but today is for scouting purposes only.\You can't challenge them\I know, I know.\Yukihira...\Come to think of it, I haven't seen Eizan-senpai's specialty dish yet.\Next time, let's give each other a lot of time to prep and do a Shokugeki! response:	Some day, for sure.
context: Yukihira, I know I sound like a broken record,\but today is for scouting purposes only.\You can't challenge them\I know, I know.\Yukihira...\Come to think of it, I haven't seen Eizan-senpai's specialty dish yet.\Next time, let's give each other a lot of time to prep and do a Shokugeki!\Some day, for sure. response:	Damn brat!
context: but today is for scouting purposes only.\You can't challenge them\I know, I know.\Yukihira...\Come to think of it, I haven't seen Eizan-senpai's specialty dish yet.\Next time, let's give each other a lot of time to prep and do a Shokugeki!\Some day, for sure.\Damn brat! response:	You're going to pay...
context: You can't challenge them\I know, I know.\Yukihira...\Come to think of it, I haven't seen Eizan-senpai's specialty dish yet.\Next time, let's give each other a lot of time to prep and do a Shokugeki!\Some day, for sure.\Damn brat!\You're going to pay... response:	I'll make you regret humiliating me.
context: I know, I know.\Yukihira...\Come to think of it, I haven't seen Eizan-senpai's specialty dish yet.\Next time, let's give each other a lot of time to prep and do a Shokugeki!\Some day, for sure.\Damn brat!\You're going to pay...\I'll make you regret humiliating me. response:	In quite a state, aren't we?
context: Yukihira...\Come to think of it, I haven't seen Eizan-senpai's specialty dish yet.\Next time, let's give each other a lot of time to prep and do a Shokugeki!\Some day, for sure.\Damn brat!\You're going to pay...\I'll make you regret humiliating me.\In quite a state, aren't we? response:	Weren't you supposed to be good enough to be an Elite Ten member?
context: Come to think of it, I haven't seen Eizan-senpai's specialty dish yet.\Next time, let's give each other a lot of time to prep and do a Shokugeki!\Some day, for sure.\Damn brat!\You're going to pay...\I'll make you regret humiliating me.\In quite a state, aren't we?\Weren't you supposed to be good enough to be an Elite Ten member? response:	Well, we'll take it from here.
context: Next time, let's give each other a lot of time to prep and do a Shokugeki!\Some day, for sure.\Damn brat!\You're going to pay...\I'll make you regret humiliating me.\In quite a state, aren't we?\Weren't you supposed to be good enough to be an Elite Ten member?\Well, we'll take it from here. response:	Let us handle the rest of the Shokugeki.
context: Some day, for sure.\Damn brat!\You're going to pay...\I'll make you regret humiliating me.\In quite a state, aren't we?\Weren't you supposed to be good enough to be an Elite Ten member?\Well, we'll take it from here.\Let us handle the rest of the Shokugeki. response:	You lost to a first-year, Eizan-kun.
context: Damn brat!\You're going to pay...\I'll make you regret humiliating me.\In quite a state, aren't we?\Weren't you supposed to be good enough to be an Elite Ten member?\Well, we'll take it from here.\Let us handle the rest of the Shokugeki.\You lost to a first-year, Eizan-kun. response:	Oh?
context: You're going to pay...\I'll make you regret humiliating me.\In quite a state, aren't we?\Weren't you supposed to be good enough to be an Elite Ten member?\Well, we'll take it from here.\Let us handle the rest of the Shokugeki.\You lost to a first-year, Eizan-kun.\Oh? response:	Central's soldiers, hand-picked by Nakiri Azami.
context: I'll make you regret humiliating me.\In quite a state, aren't we?\Weren't you supposed to be good enough to be an Elite Ten member?\Well, we'll take it from here.\Let us handle the rest of the Shokugeki.\You lost to a first-year, Eizan-kun.\Oh?\Central's soldiers, hand-picked by Nakiri Azami. response:	They're now part of the faction that rules Totsuki.
context: In quite a state, aren't we?\Weren't you supposed to be good enough to be an Elite Ten member?\Well, we'll take it from here.\Let us handle the rest of the Shokugeki.\You lost to a first-year, Eizan-kun.\Oh?\Central's soldiers, hand-picked by Nakiri Azami.\They're now part of the faction that rules Totsuki. response:	You really don't mind that we're selecting the topic?
context: Weren't you supposed to be good enough to be an Elite Ten member?\Well, we'll take it from here.\Let us handle the rest of the Shokugeki.\You lost to a first-year, Eizan-kun.\Oh?\Central's soldiers, hand-picked by Nakiri Azami.\They're now part of the faction that rules Totsuki.\You really don't mind that we're selecting the topic? response:	Yeah.
context: Well, we'll take it from here.\Let us handle the rest of the Shokugeki.\You lost to a first-year, Eizan-kun.\Oh?\Central's soldiers, hand-picked by Nakiri Azami.\They're now part of the faction that rules Totsuki.\You really don't mind that we're selecting the topic?\Yeah. response:	We'll compete against you with dishes that you specialize in.
context: Let us handle the rest of the Shokugeki.\You lost to a first-year, Eizan-kun.\Oh?\Central's soldiers, hand-picked by Nakiri Azami.\They're now part of the faction that rules Totsuki.\You really don't mind that we're selecting the topic?\Yeah.\We'll compete against you with dishes that you specialize in. response:	We'll crush you in the very genre you've been trying to perfect your skills in.
context: You lost to a first-year, Eizan-kun.\Oh?\Central's soldiers, hand-picked by Nakiri Azami.\They're now part of the faction that rules Totsuki.\You really don't mind that we're selecting the topic?\Yeah.\We'll compete against you with dishes that you specialize in.\We'll crush you in the very genre you've been trying to perfect your skills in. response:	That's in poor taste.
context: Oh?\Central's soldiers, hand-picked by Nakiri Azami.\They're now part of the faction that rules Totsuki.\You really don't mind that we're selecting the topic?\Yeah.\We'll compete against you with dishes that you specialize in.\We'll crush you in the very genre you've been trying to perfect your skills in.\That's in poor taste. response:	You're just trying to mess with them.
context: Central's soldiers, hand-picked by Nakiri Azami.\They're now part of the faction that rules Totsuki.\You really don't mind that we're selecting the topic?\Yeah.\We'll compete against you with dishes that you specialize in.\We'll crush you in the very genre you've been trying to perfect your skills in.\That's in poor taste.\You're just trying to mess with them. response:	But that makes victory even sweeter, Momo-senpai.
context: They're now part of the faction that rules Totsuki.\You really don't mind that we're selecting the topic?\Yeah.\We'll compete against you with dishes that you specialize in.\We'll crush you in the very genre you've been trying to perfect your skills in.\That's in poor taste.\You're just trying to mess with them.\But that makes victory even sweeter, Momo-senpai. response:	Spanish Cuisine RS
context: You really don't mind that we're selecting the topic?\Yeah.\We'll compete against you with dishes that you specialize in.\We'll crush you in the very genre you've been trying to perfect your skills in.\That's in poor taste.\You're just trying to mess with them.\But that makes victory even sweeter, Momo-senpai.\Spanish Cuisine RS response:	Underestimate us all you want.
context: Yeah.\We'll compete against you with dishes that you specialize in.\We'll crush you in the very genre you've been trying to perfect your skills in.\That's in poor taste.\You're just trying to mess with them.\But that makes victory even sweeter, Momo-senpai.\Spanish Cuisine RS\Underestimate us all you want. response:	But we've been honing our craft at Totsuki all this time.
context: We'll compete against you with dishes that you specialize in.\We'll crush you in the very genre you've been trying to perfect your skills in.\That's in poor taste.\You're just trying to mess with them.\But that makes victory even sweeter, Momo-senpai.\Spanish Cuisine RS\Underestimate us all you want.\But we've been honing our craft at Totsuki all this time. response:	It won't be that easy!
context: We'll crush you in the very genre you've been trying to perfect your skills in.\That's in poor taste.\You're just trying to mess with them.\But that makes victory even sweeter, Momo-senpai.\Spanish Cuisine RS\Underestimate us all you want.\But we've been honing our craft at Totsuki all this time.\It won't be that easy! response:	Grains RS
context: That's in poor taste.\You're just trying to mess with them.\But that makes victory even sweeter, Momo-senpai.\Spanish Cuisine RS\Underestimate us all you want.\But we've been honing our craft at Totsuki all this time.\It won't be that easy!\Grains RS response:	Moroccan Cuisine RS
context: You're just trying to mess with them.\But that makes victory even sweeter, Momo-senpai.\Spanish Cuisine RS\Underestimate us all you want.\But we've been honing our craft at Totsuki all this time.\It won't be that easy!\Grains RS\Moroccan Cuisine RS response:	Moroccan Cuisine RS
context: But that makes victory even sweeter, Momo-senpai.\Spanish Cuisine RS\Underestimate us all you want.\But we've been honing our craft at Totsuki all this time.\It won't be that easy!\Grains RS\Moroccan Cuisine RS\Moroccan Cuisine RS response:	Spanish Cuisine RS
context: Spanish Cuisine RS\Underestimate us all you want.\But we've been honing our craft at Totsuki all this time.\It won't be that easy!\Grains RS\Moroccan Cuisine RS\Moroccan Cuisine RS\Spanish Cuisine RS response:	Now, choose.
context: Underestimate us all you want.\But we've been honing our craft at Totsuki all this time.\It won't be that easy!\Grains RS\Moroccan Cuisine RS\Moroccan Cuisine RS\Spanish Cuisine RS\Now, choose. response:	Will you close down your research society,
context: But we've been honing our craft at Totsuki all this time.\It won't be that easy!\Grains RS\Moroccan Cuisine RS\Moroccan Cuisine RS\Spanish Cuisine RS\Now, choose.\Will you close down your research society, response:	or will you be expelled from Totsuki?
context: It won't be that easy!\Grains RS\Moroccan Cuisine RS\Moroccan Cuisine RS\Spanish Cuisine RS\Now, choose.\Will you close down your research society,\or will you be expelled from Totsuki? response:	We'll accept closure.
context: Grains RS\Moroccan Cuisine RS\Moroccan Cuisine RS\Spanish Cuisine RS\Now, choose.\Will you close down your research society,\or will you be expelled from Totsuki?\We'll accept closure. response:	Worthless, the whole lot of you.
context: Moroccan Cuisine RS\Moroccan Cuisine RS\Spanish Cuisine RS\Now, choose.\Will you close down your research society,\or will you be expelled from Totsuki?\We'll accept closure.\Worthless, the whole lot of you. response:	You get it now, right?
context: Moroccan Cuisine RS\Spanish Cuisine RS\Now, choose.\Will you close down your research society,\or will you be expelled from Totsuki?\We'll accept closure.\Worthless, the whole lot of you.\You get it now, right? response:	You weren't chosen.
context: Spanish Cuisine RS\Now, choose.\Will you close down your research society,\or will you be expelled from Totsuki?\We'll accept closure.\Worthless, the whole lot of you.\You get it now, right?\You weren't chosen. response:	So you should obey!
context: Now, choose.\Will you close down your research society,\or will you be expelled from Totsuki?\We'll accept closure.\Worthless, the whole lot of you.\You get it now, right?\You weren't chosen.\So you should obey! response:	That's the correct choice!
context: Will you close down your research society,\or will you be expelled from Totsuki?\We'll accept closure.\Worthless, the whole lot of you.\You get it now, right?\You weren't chosen.\So you should obey!\That's the correct choice! response:	Bowing down before us in Central
context: or will you be expelled from Totsuki?\We'll accept closure.\Worthless, the whole lot of you.\You get it now, right?\You weren't chosen.\So you should obey!\That's the correct choice!\Bowing down before us in Central response:	is your only remaining path!
context: We'll accept closure.\Worthless, the whole lot of you.\You get it now, right?\You weren't chosen.\So you should obey!\That's the correct choice!\Bowing down before us in Central\is your only remaining path! response:	I can't let that pass!
context: Worthless, the whole lot of you.\You get it now, right?\You weren't chosen.\So you should obey!\That's the correct choice!\Bowing down before us in Central\is your only remaining path!\I can't let that pass! response:	I can't let that pass.
context: You get it now, right?\You weren't chosen.\So you should obey!\That's the correct choice!\Bowing down before us in Central\is your only remaining path!\I can't let that pass!\I can't let that pass. response:	Huh?
context: You weren't chosen.\So you should obey!\That's the correct choice!\Bowing down before us in Central\is your only remaining path!\I can't let that pass!\I can't let that pass.\Huh? response:	What?
context: So you should obey!\That's the correct choice!\Bowing down before us in Central\is your only remaining path!\I can't let that pass!\I can't let that pass.\Huh?\What? response:	Huh?
context: That's the correct choice!\Bowing down before us in Central\is your only remaining path!\I can't let that pass!\I can't let that pass.\Huh?\What?\Huh? response:	Did you first-years say something?
context: Bowing down before us in Central\is your only remaining path!\I can't let that pass!\I can't let that pass.\Huh?\What?\Huh?\Did you first-years say something? response:	We said we can't just have you guys...
context: is your only remaining path!\I can't let that pass!\I can't let that pass.\Huh?\What?\Huh?\Did you first-years say something?\We said we can't just have you guys... response:	Not only Soma-kun, but even Takumi-kun couldn't hold back!
context: I can't let that pass!\I can't let that pass.\Huh?\What?\Huh?\Did you first-years say something?\We said we can't just have you guys...\Not only Soma-kun, but even Takumi-kun couldn't hold back! response:	You're the first-year who defeated Eizan,
context: I can't let that pass.\Huh?\What?\Huh?\Did you first-years say something?\We said we can't just have you guys...\Not only Soma-kun, but even Takumi-kun couldn't hold back!\You're the first-year who defeated Eizan, response:	and you're one of the students from the Autumn Elections.
context: Huh?\What?\Huh?\Did you first-years say something?\We said we can't just have you guys...\Not only Soma-kun, but even Takumi-kun couldn't hold back!\You're the first-year who defeated Eizan,\and you're one of the students from the Autumn Elections. response:	I wouldn't run your mouths to me if I were you.
context: What?\Huh?\Did you first-years say something?\We said we can't just have you guys...\Not only Soma-kun, but even Takumi-kun couldn't hold back!\You're the first-year who defeated Eizan,\and you're one of the students from the Autumn Elections.\I wouldn't run your mouths to me if I were you. response:	I'm an elite who will shoulder the next generation of chefs.
context: Huh?\Did you first-years say something?\We said we can't just have you guys...\Not only Soma-kun, but even Takumi-kun couldn't hold back!\You're the first-year who defeated Eizan,\and you're one of the students from the Autumn Elections.\I wouldn't run your mouths to me if I were you.\I'm an elite who will shoulder the next generation of chefs. response:	An elite?
context: Did you first-years say something?\We said we can't just have you guys...\Not only Soma-kun, but even Takumi-kun couldn't hold back!\You're the first-year who defeated Eizan,\and you're one of the students from the Autumn Elections.\I wouldn't run your mouths to me if I were you.\I'm an elite who will shoulder the next generation of chefs.\An elite? response:	That's right.
context: We said we can't just have you guys...\Not only Soma-kun, but even Takumi-kun couldn't hold back!\You're the first-year who defeated Eizan,\and you're one of the students from the Autumn Elections.\I wouldn't run your mouths to me if I were you.\I'm an elite who will shoulder the next generation of chefs.\An elite?\That's right. response:	I'm an elite hand-picked by the current academy director.
context: Not only Soma-kun, but even Takumi-kun couldn't hold back!\You're the first-year who defeated Eizan,\and you're one of the students from the Autumn Elections.\I wouldn't run your mouths to me if I were you.\I'm an elite who will shoulder the next generation of chefs.\An elite?\That's right.\I'm an elite hand-picked by the current academy director. response:	You shouldn't try to oppose me.
context: You're the first-year who defeated Eizan,\and you're one of the students from the Autumn Elections.\I wouldn't run your mouths to me if I were you.\I'm an elite who will shoulder the next generation of chefs.\An elite?\That's right.\I'm an elite hand-picked by the current academy director.\You shouldn't try to oppose me. response:	I feel no sense of identity from you.
context: and you're one of the students from the Autumn Elections.\I wouldn't run your mouths to me if I were you.\I'm an elite who will shoulder the next generation of chefs.\An elite?\That's right.\I'm an elite hand-picked by the current academy director.\You shouldn't try to oppose me.\I feel no sense of identity from you. response:	Your strong emphasis on being chosen
context: I wouldn't run your mouths to me if I were you.\I'm an elite who will shoulder the next generation of chefs.\An elite?\That's right.\I'm an elite hand-picked by the current academy director.\You shouldn't try to oppose me.\I feel no sense of identity from you.\Your strong emphasis on being chosen response:	comes across as a reflection of the low self-esteem you experienced beforehand.
context: I'm an elite who will shoulder the next generation of chefs.\An elite?\That's right.\I'm an elite hand-picked by the current academy director.\You shouldn't try to oppose me.\I feel no sense of identity from you.\Your strong emphasis on being chosen\comes across as a reflection of the low self-esteem you experienced beforehand. response:	Is your inability to avoid describing yourself as an elite
context: An elite?\That's right.\I'm an elite hand-picked by the current academy director.\You shouldn't try to oppose me.\I feel no sense of identity from you.\Your strong emphasis on being chosen\comes across as a reflection of the low self-esteem you experienced beforehand.\Is your inability to avoid describing yourself as an elite response:	due to a lack of confidence in your own cooking?
context: That's right.\I'm an elite hand-picked by the current academy director.\You shouldn't try to oppose me.\I feel no sense of identity from you.\Your strong emphasis on being chosen\comes across as a reflection of the low self-esteem you experienced beforehand.\Is your inability to avoid describing yourself as an elite\due to a lack of confidence in your own cooking? response:	You said some smart-sounding stuff there, Takumi.
context: I'm an elite hand-picked by the current academy director.\You shouldn't try to oppose me.\I feel no sense of identity from you.\Your strong emphasis on being chosen\comes across as a reflection of the low self-esteem you experienced beforehand.\Is your inability to avoid describing yourself as an elite\due to a lack of confidence in your own cooking?\You said some smart-sounding stuff there, Takumi. response:	So, was it true, senpai?
context: You shouldn't try to oppose me.\I feel no sense of identity from you.\Your strong emphasis on being chosen\comes across as a reflection of the low self-esteem you experienced beforehand.\Is your inability to avoid describing yourself as an elite\due to a lack of confidence in your own cooking?\You said some smart-sounding stuff there, Takumi.\So, was it true, senpai? response:	You assholes!
context: I feel no sense of identity from you.\Your strong emphasis on being chosen\comes across as a reflection of the low self-esteem you experienced beforehand.\Is your inability to avoid describing yourself as an elite\due to a lack of confidence in your own cooking?\You said some smart-sounding stuff there, Takumi.\So, was it true, senpai?\You assholes! response:	I'm gonna beat you up
context: Your strong emphasis on being chosen\comes across as a reflection of the low self-esteem you experienced beforehand.\Is your inability to avoid describing yourself as an elite\due to a lack of confidence in your own cooking?\You said some smart-sounding stuff there, Takumi.\So, was it true, senpai?\You assholes!\I'm gonna beat you up response:	Don't act out.
context: comes across as a reflection of the low self-esteem you experienced beforehand.\Is your inability to avoid describing yourself as an elite\due to a lack of confidence in your own cooking?\You said some smart-sounding stuff there, Takumi.\So, was it true, senpai?\You assholes!\I'm gonna beat you up\Don't act out. response:	High School Division, 2nd Year Kumai Shigemichi
context: Is your inability to avoid describing yourself as an elite\due to a lack of confidence in your own cooking?\You said some smart-sounding stuff there, Takumi.\So, was it true, senpai?\You assholes!\I'm gonna beat you up\Don't act out.\High School Division, 2nd Year Kumai Shigemichi response:	Shige!
context: due to a lack of confidence in your own cooking?\You said some smart-sounding stuff there, Takumi.\So, was it true, senpai?\You assholes!\I'm gonna beat you up\Don't act out.\High School Division, 2nd Year Kumai Shigemichi\Shige! response:	Let me down! Hey!
context: You said some smart-sounding stuff there, Takumi.\So, was it true, senpai?\You assholes!\I'm gonna beat you up\Don't act out.\High School Division, 2nd Year Kumai Shigemichi\Shige!\Let me down! Hey! response:	I'm not letting you down.
context: So, was it true, senpai?\You assholes!\I'm gonna beat you up\Don't act out.\High School Division, 2nd Year Kumai Shigemichi\Shige!\Let me down! Hey!\I'm not letting you down. response:	Fine, I'll do as you say!
context: You assholes!\I'm gonna beat you up\Don't act out.\High School Division, 2nd Year Kumai Shigemichi\Shige!\Let me down! Hey!\I'm not letting you down.\Fine, I'll do as you say! response:	I will! So let me down!
context: I'm gonna beat you up\Don't act out.\High School Division, 2nd Year Kumai Shigemichi\Shige!\Let me down! Hey!\I'm not letting you down.\Fine, I'll do as you say!\I will! So let me down! response:	Don't carry me around!
context: Don't act out.\High School Division, 2nd Year Kumai Shigemichi\Shige!\Let me down! Hey!\I'm not letting you down.\Fine, I'll do as you say!\I will! So let me down!\Don't carry me around! response:	You're so easily provoked, Ren-chan.
context: High School Division, 2nd Year Kumai Shigemichi\Shige!\Let me down! Hey!\I'm not letting you down.\Fine, I'll do as you say!\I will! So let me down!\Don't carry me around!\You're so easily provoked, Ren-chan. response:	Shut up, Mea!
context: Shige!\Let me down! Hey!\I'm not letting you down.\Fine, I'll do as you say!\I will! So let me down!\Don't carry me around!\You're so easily provoked, Ren-chan.\Shut up, Mea! response:	Listen up, first-years!
context: Let me down! Hey!\I'm not letting you down.\Fine, I'll do as you say!\I will! So let me down!\Don't carry me around!\You're so easily provoked, Ren-chan.\Shut up, Mea!\Listen up, first-years! response:	High School Division, 2nd Year Kusunoki Rentaro
context: I'm not letting you down.\Fine, I'll do as you say!\I will! So let me down!\Don't carry me around!\You're so easily provoked, Ren-chan.\Shut up, Mea!\Listen up, first-years!\High School Division, 2nd Year Kusunoki Rentaro response:	I'm gonna fight you in a match one day!
context: Fine, I'll do as you say!\I will! So let me down!\Don't carry me around!\You're so easily provoked, Ren-chan.\Shut up, Mea!\Listen up, first-years!\High School Division, 2nd Year Kusunoki Rentaro\I'm gonna fight you in a match one day! response:	Just go, okay?
context: I will! So let me down!\Don't carry me around!\You're so easily provoked, Ren-chan.\Shut up, Mea!\Listen up, first-years!\High School Division, 2nd Year Kusunoki Rentaro\I'm gonna fight you in a match one day!\Just go, okay? response:	High School Division, 2nd Year Yanai Mea
context: Don't carry me around!\You're so easily provoked, Ren-chan.\Shut up, Mea!\Listen up, first-years!\High School Division, 2nd Year Kusunoki Rentaro\I'm gonna fight you in a match one day!\Just go, okay?\High School Division, 2nd Year Yanai Mea response:	Make sure you nail the last match, too!
context: You're so easily provoked, Ren-chan.\Shut up, Mea!\Listen up, first-years!\High School Division, 2nd Year Kusunoki Rentaro\I'm gonna fight you in a match one day!\Just go, okay?\High School Division, 2nd Year Yanai Mea\Make sure you nail the last match, too! response:	High School Division, 2nd Year Kofuru Rui
context: Shut up, Mea!\Listen up, first-years!\High School Division, 2nd Year Kusunoki Rentaro\I'm gonna fight you in a match one day!\Just go, okay?\High School Division, 2nd Year Yanai Mea\Make sure you nail the last match, too!\High School Division, 2nd Year Kofuru Rui response:	He's going to do another match?
context: Listen up, first-years!\High School Division, 2nd Year Kusunoki Rentaro\I'm gonna fight you in a match one day!\Just go, okay?\High School Division, 2nd Year Yanai Mea\Make sure you nail the last match, too!\High School Division, 2nd Year Kofuru Rui\He's going to do another match? response:	Who is he going to face?
context: High School Division, 2nd Year Kusunoki Rentaro\I'm gonna fight you in a match one day!\Just go, okay?\High School Division, 2nd Year Yanai Mea\Make sure you nail the last match, too!\High School Division, 2nd Year Kofuru Rui\He's going to do another match?\Who is he going to face? response:	What?
context: I'm gonna fight you in a match one day!\Just go, okay?\High School Division, 2nd Year Yanai Mea\Make sure you nail the last match, too!\High School Division, 2nd Year Kofuru Rui\He's going to do another match?\Who is he going to face?\What? response:	Oh?
context: Just go, okay?\High School Division, 2nd Year Yanai Mea\Make sure you nail the last match, too!\High School Division, 2nd Year Kofuru Rui\He's going to do another match?\Who is he going to face?\What?\Oh? response:	Hm?
context: High School Division, 2nd Year Yanai Mea\Make sure you nail the last match, too!\High School Division, 2nd Year Kofuru Rui\He's going to do another match?\Who is he going to face?\What?\Oh?\Hm? response:	Nakiri Alice?!
context: Make sure you nail the last match, too!\High School Division, 2nd Year Kofuru Rui\He's going to do another match?\Who is he going to face?\What?\Oh?\Hm?\Nakiri Alice?! response:	Kurokiba!
context: High School Division, 2nd Year Kofuru Rui\He's going to do another match?\Who is he going to face?\What?\Oh?\Hm?\Nakiri Alice?!\Kurokiba! response:	Oh, you two. Hello!
context: He's going to do another match?\Who is he going to face?\What?\Oh?\Hm?\Nakiri Alice?!\Kurokiba!\Oh, you two. Hello! response:	Why are you here?
context: Who is he going to face?\What?\Oh?\Hm?\Nakiri Alice?!\Kurokiba!\Oh, you two. Hello!\Why are you here? response:	You joined a research society?
context: What?\Oh?\Hm?\Nakiri Alice?!\Kurokiba!\Oh, you two. Hello!\Why are you here?\You joined a research society? response:	I was shocked, too!
context: Oh?\Hm?\Nakiri Alice?!\Kurokiba!\Oh, you two. Hello!\Why are you here?\You joined a research society?\I was shocked, too! response:	When I was in junior high,
context: Hm?\Nakiri Alice?!\Kurokiba!\Oh, you two. Hello!\Why are you here?\You joined a research society?\I was shocked, too!\When I was in junior high, response:	I did a Shokugeki against the Cutting Edge Cuisine RS.
context: Nakiri Alice?!\Kurokiba!\Oh, you two. Hello!\Why are you here?\You joined a research society?\I was shocked, too!\When I was in junior high,\I did a Shokugeki against the Cutting Edge Cuisine RS. response:	Of course, I won.
context: Kurokiba!\Oh, you two. Hello!\Why are you here?\You joined a research society?\I was shocked, too!\When I was in junior high,\I did a Shokugeki against the Cutting Edge Cuisine RS.\Of course, I won. response:	I'd taken their space and equipment...
context: Oh, you two. Hello!\Why are you here?\You joined a research society?\I was shocked, too!\When I was in junior high,\I did a Shokugeki against the Cutting Edge Cuisine RS.\Of course, I won.\I'd taken their space and equipment... response:	Shokugeki Notice Cutting Edge Cuisine RS Chief: Nakiri Alice
context: Why are you here?\You joined a research society?\I was shocked, too!\When I was in junior high,\I did a Shokugeki against the Cutting Edge Cuisine RS.\Of course, I won.\I'd taken their space and equipment...\Shokugeki Notice Cutting Edge Cuisine RS Chief: Nakiri Alice response:	but I'd apparently become the RS's chief on paper!
context: You joined a research society?\I was shocked, too!\When I was in junior high,\I did a Shokugeki against the Cutting Edge Cuisine RS.\Of course, I won.\I'd taken their space and equipment...\Shokugeki Notice Cutting Edge Cuisine RS Chief: Nakiri Alice\but I'd apparently become the RS's chief on paper! response:	I was so shocked to learn about it!
context: I was shocked, too!\When I was in junior high,\I did a Shokugeki against the Cutting Edge Cuisine RS.\Of course, I won.\I'd taken their space and equipment...\Shokugeki Notice Cutting Edge Cuisine RS Chief: Nakiri Alice\but I'd apparently become the RS's chief on paper!\I was so shocked to learn about it! response:	That's horrible on so many different levels.
context: When I was in junior high,\I did a Shokugeki against the Cutting Edge Cuisine RS.\Of course, I won.\I'd taken their space and equipment...\Shokugeki Notice Cutting Edge Cuisine RS Chief: Nakiri Alice\but I'd apparently become the RS's chief on paper!\I was so shocked to learn about it!\That's horrible on so many different levels. response:	So that's why you got dragged into the hunt for survivors, huh.
context: I did a Shokugeki against the Cutting Edge Cuisine RS.\Of course, I won.\I'd taken their space and equipment...\Shokugeki Notice Cutting Edge Cuisine RS Chief: Nakiri Alice\but I'd apparently become the RS's chief on paper!\I was so shocked to learn about it!\That's horrible on so many different levels.\So that's why you got dragged into the hunt for survivors, huh. response:	You may call me Chief Alice.
context: Of course, I won.\I'd taken their space and equipment...\Shokugeki Notice Cutting Edge Cuisine RS Chief: Nakiri Alice\but I'd apparently become the RS's chief on paper!\I was so shocked to learn about it!\That's horrible on so many different levels.\So that's why you got dragged into the hunt for survivors, huh.\You may call me Chief Alice. response:	You didn't even know for all this time!
context: I'd taken their space and equipment...\Shokugeki Notice Cutting Edge Cuisine RS Chief: Nakiri Alice\but I'd apparently become the RS's chief on paper!\I was so shocked to learn about it!\That's horrible on so many different levels.\So that's why you got dragged into the hunt for survivors, huh.\You may call me Chief Alice.\You didn't even know for all this time! response:	Why do you care whether the research society gets shut down, then?
context: Shokugeki Notice Cutting Edge Cuisine RS Chief: Nakiri Alice\but I'd apparently become the RS's chief on paper!\I was so shocked to learn about it!\That's horrible on so many different levels.\So that's why you got dragged into the hunt for survivors, huh.\You may call me Chief Alice.\You didn't even know for all this time!\Why do you care whether the research society gets shut down, then? response:	Well, I suppose...
context: but I'd apparently become the RS's chief on paper!\I was so shocked to learn about it!\That's horrible on so many different levels.\So that's why you got dragged into the hunt for survivors, huh.\You may call me Chief Alice.\You didn't even know for all this time!\Why do you care whether the research society gets shut down, then?\Well, I suppose... response:	So Cutting Edge Cuisine RS will be disbanded.
context: I was so shocked to learn about it!\That's horrible on so many different levels.\So that's why you got dragged into the hunt for survivors, huh.\You may call me Chief Alice.\You didn't even know for all this time!\Why do you care whether the research society gets shut down, then?\Well, I suppose...\So Cutting Edge Cuisine RS will be disbanded. response:	Several Days Ago
context: That's horrible on so many different levels.\So that's why you got dragged into the hunt for survivors, huh.\You may call me Chief Alice.\You didn't even know for all this time!\Why do you care whether the research society gets shut down, then?\Well, I suppose...\So Cutting Edge Cuisine RS will be disbanded.\Several Days Ago response:	I can agree to a Shokugeki challenging that decision, though.
context: So that's why you got dragged into the hunt for survivors, huh.\You may call me Chief Alice.\You didn't even know for all this time!\Why do you care whether the research society gets shut down, then?\Well, I suppose...\So Cutting Edge Cuisine RS will be disbanded.\Several Days Ago\I can agree to a Shokugeki challenging that decision, though. response:	No, I'm fine with that.
context: You may call me Chief Alice.\You didn't even know for all this time!\Why do you care whether the research society gets shut down, then?\Well, I suppose...\So Cutting Edge Cuisine RS will be disbanded.\Several Days Ago\I can agree to a Shokugeki challenging that decision, though.\No, I'm fine with that. response:	Huh?
context: You didn't even know for all this time!\Why do you care whether the research society gets shut down, then?\Well, I suppose...\So Cutting Edge Cuisine RS will be disbanded.\Several Days Ago\I can agree to a Shokugeki challenging that decision, though.\No, I'm fine with that.\Huh? response:	Having chief as a title is rather refreshing, and a bit hard to let go of,
context: Why do you care whether the research society gets shut down, then?\Well, I suppose...\So Cutting Edge Cuisine RS will be disbanded.\Several Days Ago\I can agree to a Shokugeki challenging that decision, though.\No, I'm fine with that.\Huh?\Having chief as a title is rather refreshing, and a bit hard to let go of, response:	but I'm not interested in it at all.
context: Well, I suppose...\So Cutting Edge Cuisine RS will be disbanded.\Several Days Ago\I can agree to a Shokugeki challenging that decision, though.\No, I'm fine with that.\Huh?\Having chief as a title is rather refreshing, and a bit hard to let go of,\but I'm not interested in it at all. response:	So please leave us.
context: So Cutting Edge Cuisine RS will be disbanded.\Several Days Ago\I can agree to a Shokugeki challenging that decision, though.\No, I'm fine with that.\Huh?\Having chief as a title is rather refreshing, and a bit hard to let go of,\but I'm not interested in it at all.\So please leave us. response:	Smart choice.
context: Several Days Ago\I can agree to a Shokugeki challenging that decision, though.\No, I'm fine with that.\Huh?\Having chief as a title is rather refreshing, and a bit hard to let go of,\but I'm not interested in it at all.\So please leave us.\Smart choice. response:	You riffraff should just shut up and watch the Azami administration prosper!
context: I can agree to a Shokugeki challenging that decision, though.\No, I'm fine with that.\Huh?\Having chief as a title is rather refreshing, and a bit hard to let go of,\but I'm not interested in it at all.\So please leave us.\Smart choice.\You riffraff should just shut up and watch the Azami administration prosper! response:	Who'd you call riffraff?!
context: No, I'm fine with that.\Huh?\Having chief as a title is rather refreshing, and a bit hard to let go of,\but I'm not interested in it at all.\So please leave us.\Smart choice.\You riffraff should just shut up and watch the Azami administration prosper!\Who'd you call riffraff?! response:	What? What's this all of a sudden?
context: Huh?\Having chief as a title is rather refreshing, and a bit hard to let go of,\but I'm not interested in it at all.\So please leave us.\Smart choice.\You riffraff should just shut up and watch the Azami administration prosper!\Who'd you call riffraff?!\What? What's this all of a sudden? response:	I'll crush anyone who attacks me!
context: Having chief as a title is rather refreshing, and a bit hard to let go of,\but I'm not interested in it at all.\So please leave us.\Smart choice.\You riffraff should just shut up and watch the Azami administration prosper!\Who'd you call riffraff?!\What? What's this all of a sudden?\I'll crush anyone who attacks me! response:	I'll use my cooking to drag you down with me!
context: but I'm not interested in it at all.\So please leave us.\Smart choice.\You riffraff should just shut up and watch the Azami administration prosper!\Who'd you call riffraff?!\What? What's this all of a sudden?\I'll crush anyone who attacks me!\I'll use my cooking to drag you down with me! response:	Ryo-kun...
context: So please leave us.\Smart choice.\You riffraff should just shut up and watch the Azami administration prosper!\Who'd you call riffraff?!\What? What's this all of a sudden?\I'll crush anyone who attacks me!\I'll use my cooking to drag you down with me!\Ryo-kun... response:	Very well.
context: Smart choice.\You riffraff should just shut up and watch the Azami administration prosper!\Who'd you call riffraff?!\What? What's this all of a sudden?\I'll crush anyone who attacks me!\I'll use my cooking to drag you down with me!\Ryo-kun...\Very well. response:	I'll accept this challenge!
context: You riffraff should just shut up and watch the Azami administration prosper!\Who'd you call riffraff?!\What? What's this all of a sudden?\I'll crush anyone who attacks me!\I'll use my cooking to drag you down with me!\Ryo-kun...\Very well.\I'll accept this challenge! response:	So, Ryo-kun's the one who'll be in this match.
context: Who'd you call riffraff?!\What? What's this all of a sudden?\I'll crush anyone who attacks me!\I'll use my cooking to drag you down with me!\Ryo-kun...\Very well.\I'll accept this challenge!\So, Ryo-kun's the one who'll be in this match. response:	Go, Ryo-kun.
context: What? What's this all of a sudden?\I'll crush anyone who attacks me!\I'll use my cooking to drag you down with me!\Ryo-kun...\Very well.\I'll accept this challenge!\So, Ryo-kun's the one who'll be in this match.\Go, Ryo-kun. response:	Expose that self-proclaimed elite for what he truly is.
context: I'll crush anyone who attacks me!\I'll use my cooking to drag you down with me!\Ryo-kun...\Very well.\I'll accept this challenge!\So, Ryo-kun's the one who'll be in this match.\Go, Ryo-kun.\Expose that self-proclaimed elite for what he truly is. response:	'Kay.
context: I'll use my cooking to drag you down with me!\Ryo-kun...\Very well.\I'll accept this challenge!\So, Ryo-kun's the one who'll be in this match.\Go, Ryo-kun.\Expose that self-proclaimed elite for what he truly is.\'Kay. response:	The last Shokugeki to conclude the first day at Hall C...
context: Ryo-kun...\Very well.\I'll accept this challenge!\So, Ryo-kun's the one who'll be in this match.\Go, Ryo-kun.\Expose that self-proclaimed elite for what he truly is.\'Kay.\The last Shokugeki to conclude the first day at Hall C... response:	Kurokiba-kun!
context: Very well.\I'll accept this challenge!\So, Ryo-kun's the one who'll be in this match.\Go, Ryo-kun.\Expose that self-proclaimed elite for what he truly is.\'Kay.\The last Shokugeki to conclude the first day at Hall C...\Kurokiba-kun! response:	Central's rookie, Kusunoki Rentaro.
context: I'll accept this challenge!\So, Ryo-kun's the one who'll be in this match.\Go, Ryo-kun.\Expose that self-proclaimed elite for what he truly is.\'Kay.\The last Shokugeki to conclude the first day at Hall C...\Kurokiba-kun!\Central's rookie, Kusunoki Rentaro. response:	Ryo-kun, don't you dare lose!
context: So, Ryo-kun's the one who'll be in this match.\Go, Ryo-kun.\Expose that self-proclaimed elite for what he truly is.\'Kay.\The last Shokugeki to conclude the first day at Hall C...\Kurokiba-kun!\Central's rookie, Kusunoki Rentaro.\Ryo-kun, don't you dare lose! response:	I'm ordering you to win as the chief of Cutting Edge Cuisine RS!
context: Go, Ryo-kun.\Expose that self-proclaimed elite for what he truly is.\'Kay.\The last Shokugeki to conclude the first day at Hall C...\Kurokiba-kun!\Central's rookie, Kusunoki Rentaro.\Ryo-kun, don't you dare lose!\I'm ordering you to win as the chief of Cutting Edge Cuisine RS! response:	I'm not going to let Uncle Azami get his way anymore!
context: Expose that self-proclaimed elite for what he truly is.\'Kay.\The last Shokugeki to conclude the first day at Hall C...\Kurokiba-kun!\Central's rookie, Kusunoki Rentaro.\Ryo-kun, don't you dare lose!\I'm ordering you to win as the chief of Cutting Edge Cuisine RS!\I'm not going to let Uncle Azami get his way anymore! response:	Kurokiba Ryo...
context: 'Kay.\The last Shokugeki to conclude the first day at Hall C...\Kurokiba-kun!\Central's rookie, Kusunoki Rentaro.\Ryo-kun, don't you dare lose!\I'm ordering you to win as the chief of Cutting Edge Cuisine RS!\I'm not going to let Uncle Azami get his way anymore!\Kurokiba Ryo... response:	He made it through to the finals in the Autumn Elections.
context: The last Shokugeki to conclude the first day at Hall C...\Kurokiba-kun!\Central's rookie, Kusunoki Rentaro.\Ryo-kun, don't you dare lose!\I'm ordering you to win as the chief of Cutting Edge Cuisine RS!\I'm not going to let Uncle Azami get his way anymore!\Kurokiba Ryo...\He made it through to the finals in the Autumn Elections. response:	Something really pissed me off earlier.
context: Kurokiba-kun!\Central's rookie, Kusunoki Rentaro.\Ryo-kun, don't you dare lose!\I'm ordering you to win as the chief of Cutting Edge Cuisine RS!\I'm not going to let Uncle Azami get his way anymore!\Kurokiba Ryo...\He made it through to the finals in the Autumn Elections.\Something really pissed me off earlier. response:	I'm gonna take it all out on you.
context: Central's rookie, Kusunoki Rentaro.\Ryo-kun, don't you dare lose!\I'm ordering you to win as the chief of Cutting Edge Cuisine RS!\I'm not going to let Uncle Azami get his way anymore!\Kurokiba Ryo...\He made it through to the finals in the Autumn Elections.\Something really pissed me off earlier.\I'm gonna take it all out on you. response:	You're not a bad one to crush to wrap things up on the first day.
context: Ryo-kun, don't you dare lose!\I'm ordering you to win as the chief of Cutting Edge Cuisine RS!\I'm not going to let Uncle Azami get his way anymore!\Kurokiba Ryo...\He made it through to the finals in the Autumn Elections.\Something really pissed me off earlier.\I'm gonna take it all out on you.\You're not a bad one to crush to wrap things up on the first day. response:	If you're gonna try to crush me,
context: I'm ordering you to win as the chief of Cutting Edge Cuisine RS!\I'm not going to let Uncle Azami get his way anymore!\Kurokiba Ryo...\He made it through to the finals in the Autumn Elections.\Something really pissed me off earlier.\I'm gonna take it all out on you.\You're not a bad one to crush to wrap things up on the first day.\If you're gonna try to crush me, response:	I'm just gonna crush you right back!
context: I'm not going to let Uncle Azami get his way anymore!\Kurokiba Ryo...\He made it through to the finals in the Autumn Elections.\Something really pissed me off earlier.\I'm gonna take it all out on you.\You're not a bad one to crush to wrap things up on the first day.\If you're gonna try to crush me,\I'm just gonna crush you right back! response:	Go, Kurokiba!
context: Kurokiba Ryo...\He made it through to the finals in the Autumn Elections.\Something really pissed me off earlier.\I'm gonna take it all out on you.\You're not a bad one to crush to wrap things up on the first day.\If you're gonna try to crush me,\I'm just gonna crush you right back!\Go, Kurokiba! response:	I'm watching you from right here!
context: He made it through to the finals in the Autumn Elections.\Something really pissed me off earlier.\I'm gonna take it all out on you.\You're not a bad one to crush to wrap things up on the first day.\If you're gonna try to crush me,\I'm just gonna crush you right back!\Go, Kurokiba!\I'm watching you from right here! response:	Oh, thanks for letting us barge our way into such a good viewing spot.
context: Something really pissed me off earlier.\I'm gonna take it all out on you.\You're not a bad one to crush to wrap things up on the first day.\If you're gonna try to crush me,\I'm just gonna crush you right back!\Go, Kurokiba!\I'm watching you from right here!\Oh, thanks for letting us barge our way into such a good viewing spot. response:	Hmph!
context: I'm gonna take it all out on you.\You're not a bad one to crush to wrap things up on the first day.\If you're gonna try to crush me,\I'm just gonna crush you right back!\Go, Kurokiba!\I'm watching you from right here!\Oh, thanks for letting us barge our way into such a good viewing spot.\Hmph! response:	Huh?
context: You're not a bad one to crush to wrap things up on the first day.\If you're gonna try to crush me,\I'm just gonna crush you right back!\Go, Kurokiba!\I'm watching you from right here!\Oh, thanks for letting us barge our way into such a good viewing spot.\Hmph!\Huh? response:	Oh, Momo-senpai's always like that at first, so don't let it get to you.
context: If you're gonna try to crush me,\I'm just gonna crush you right back!\Go, Kurokiba!\I'm watching you from right here!\Oh, thanks for letting us barge our way into such a good viewing spot.\Hmph!\Huh?\Oh, Momo-senpai's always like that at first, so don't let it get to you. response:	You can easily take at least a month getting her to look at you
context: I'm just gonna crush you right back!\Go, Kurokiba!\I'm watching you from right here!\Oh, thanks for letting us barge our way into such a good viewing spot.\Hmph!\Huh?\Oh, Momo-senpai's always like that at first, so don't let it get to you.\You can easily take at least a month getting her to look at you response:	and have a decent conversation.
context: Go, Kurokiba!\I'm watching you from right here!\Oh, thanks for letting us barge our way into such a good viewing spot.\Hmph!\Huh?\Oh, Momo-senpai's always like that at first, so don't let it get to you.\You can easily take at least a month getting her to look at you\and have a decent conversation. response:	Huh?
context: I'm watching you from right here!\Oh, thanks for letting us barge our way into such a good viewing spot.\Hmph!\Huh?\Oh, Momo-senpai's always like that at first, so don't let it get to you.\You can easily take at least a month getting her to look at you\and have a decent conversation.\Huh? response:	How'd you manage to get through camp and Stagiaire and stuff like that?
context: Oh, thanks for letting us barge our way into such a good viewing spot.\Hmph!\Huh?\Oh, Momo-senpai's always like that at first, so don't let it get to you.\You can easily take at least a month getting her to look at you\and have a decent conversation.\Huh?\How'd you manage to get through camp and Stagiaire and stuff like that? response:	I have no obligation to explain that to you.
context: Hmph!\Huh?\Oh, Momo-senpai's always like that at first, so don't let it get to you.\You can easily take at least a month getting her to look at you\and have a decent conversation.\Huh?\How'd you manage to get through camp and Stagiaire and stuff like that?\I have no obligation to explain that to you. response:	You're annoying.
context: Huh?\Oh, Momo-senpai's always like that at first, so don't let it get to you.\You can easily take at least a month getting her to look at you\and have a decent conversation.\Huh?\How'd you manage to get through camp and Stagiaire and stuff like that?\I have no obligation to explain that to you.\You're annoying. response:	Huh? What was that?
context: Oh, Momo-senpai's always like that at first, so don't let it get to you.\You can easily take at least a month getting her to look at you\and have a decent conversation.\Huh?\How'd you manage to get through camp and Stagiaire and stuff like that?\I have no obligation to explain that to you.\You're annoying.\Huh? What was that? response:	What?
context: You can easily take at least a month getting her to look at you\and have a decent conversation.\Huh?\How'd you manage to get through camp and Stagiaire and stuff like that?\I have no obligation to explain that to you.\You're annoying.\Huh? What was that?\What? response:	Soma-kun, you're pushing her too far!
context: and have a decent conversation.\Huh?\How'd you manage to get through camp and Stagiaire and stuff like that?\I have no obligation to explain that to you.\You're annoying.\Huh? What was that?\What?\Soma-kun, you're pushing her too far! response:	The topic is salmon!
context: Huh?\How'd you manage to get through camp and Stagiaire and stuff like that?\I have no obligation to explain that to you.\You're annoying.\Huh? What was that?\What?\Soma-kun, you're pushing her too far!\The topic is salmon! response:	Oh, that's some nice salmon.
context: How'd you manage to get through camp and Stagiaire and stuff like that?\I have no obligation to explain that to you.\You're annoying.\Huh? What was that?\What?\Soma-kun, you're pushing her too far!\The topic is salmon!\Oh, that's some nice salmon. response:	Look at the color and shine of those gills.
context: I have no obligation to explain that to you.\You're annoying.\Huh? What was that?\What?\Soma-kun, you're pushing her too far!\The topic is salmon!\Oh, that's some nice salmon.\Look at the color and shine of those gills. response:	Seafood...
context: You're annoying.\Huh? What was that?\What?\Soma-kun, you're pushing her too far!\The topic is salmon!\Oh, that's some nice salmon.\Look at the color and shine of those gills.\Seafood... response:	Ryo-kun, focus!
context: Huh? What was that?\What?\Soma-kun, you're pushing her too far!\The topic is salmon!\Oh, that's some nice salmon.\Look at the color and shine of those gills.\Seafood...\Ryo-kun, focus! response:	Kusunoki Rentaro versus Kurokiba Ryo.
context: What?\Soma-kun, you're pushing her too far!\The topic is salmon!\Oh, that's some nice salmon.\Look at the color and shine of those gills.\Seafood...\Ryo-kun, focus!\Kusunoki Rentaro versus Kurokiba Ryo. response:	Let the Shokugeki begin!
context: Soma-kun, you're pushing her too far!\The topic is salmon!\Oh, that's some nice salmon.\Look at the color and shine of those gills.\Seafood...\Ryo-kun, focus!\Kusunoki Rentaro versus Kurokiba Ryo.\Let the Shokugeki begin! response:	Totsuki
context: The topic is salmon!\Oh, that's some nice salmon.\Look at the color and shine of those gills.\Seafood...\Ryo-kun, focus!\Kusunoki Rentaro versus Kurokiba Ryo.\Let the Shokugeki begin!\Totsuki response:	Food Wars
context: Oh, that's some nice salmon.\Look at the color and shine of those gills.\Seafood...\Ryo-kun, focus!\Kusunoki Rentaro versus Kurokiba Ryo.\Let the Shokugeki begin!\Totsuki\Food Wars response:	The Third Plate
context: Look at the color and shine of those gills.\Seafood...\Ryo-kun, focus!\Kusunoki Rentaro versus Kurokiba Ryo.\Let the Shokugeki begin!\Totsuki\Food Wars\The Third Plate response:	Next Episode: The Salmon Will Dance
context: Seafood...\Ryo-kun, focus!\Kusunoki Rentaro versus Kurokiba Ryo.\Let the Shokugeki begin!\Totsuki\Food Wars\The Third Plate\Next Episode: The Salmon Will Dance response:	I hope you savor the next episode!