context: Shinonome Institute response:	Nichijou ED
context: Shinonome Institute\Nichijou ED response:	Nichijou
context: Shinonome Institute\Nichijou ED\Nichijou response:	TL - NeWbY/Shoujo_Q
context: Shinonome Institute\Nichijou ED\Nichijou\TL - NeWbY/Shoujo_Q response:	TLC - Shoujo_Q/Nanakoto
context: Shinonome Institute\Nichijou ED\Nichijou\TL - NeWbY/Shoujo_Q\TLC - Shoujo_Q/Nanakoto response:	K-Timer - Pahndamonium
context: Shinonome Institute\Nichijou ED\Nichijou\TL - NeWbY/Shoujo_Q\TLC - Shoujo_Q/Nanakoto\K-Timer - Pahndamonium response:	Timer - DiabeticBee
context: Shinonome Institute\Nichijou ED\Nichijou\TL - NeWbY/Shoujo_Q\TLC - Shoujo_Q/Nanakoto\K-Timer - Pahndamonium\Timer - DiabeticBee response:	Editor - Akashic, Gyzome, Spiffy
context: Shinonome Institute\Nichijou ED\Nichijou\TL - NeWbY/Shoujo_Q\TLC - Shoujo_Q/Nanakoto\K-Timer - Pahndamonium\Timer - DiabeticBee\Editor - Akashic, Gyzome, Spiffy response:	TS - Zdm321
context: Nichijou ED\Nichijou\TL - NeWbY/Shoujo_Q\TLC - Shoujo_Q/Nanakoto\K-Timer - Pahndamonium\Timer - DiabeticBee\Editor - Akashic, Gyzome, Spiffy\TS - Zdm321 response:	encoder - kokus
context: Nichijou\TL - NeWbY/Shoujo_Q\TLC - Shoujo_Q/Nanakoto\K-Timer - Pahndamonium\Timer - DiabeticBee\Editor - Akashic, Gyzome, Spiffy\TS - Zdm321\encoder - kokus response:	QC - Spiffy
context: TL - NeWbY/Shoujo_Q\TLC - Shoujo_Q/Nanakoto\K-Timer - Pahndamonium\Timer - DiabeticBee\Editor - Akashic, Gyzome, Spiffy\TS - Zdm321\encoder - kokus\QC - Spiffy response:	Project Leader - Zdm321
context: TLC - Shoujo_Q/Nanakoto\K-Timer - Pahndamonium\Timer - DiabeticBee\Editor - Akashic, Gyzome, Spiffy\TS - Zdm321\encoder - kokus\QC - Spiffy\Project Leader - Zdm321 response:	Current: Spiffy QC
context: K-Timer - Pahndamonium\Timer - DiabeticBee\Editor - Akashic, Gyzome, Spiffy\TS - Zdm321\encoder - kokus\QC - Spiffy\Project Leader - Zdm321\Current: Spiffy QC response:	em-dash: -
context: Timer - DiabeticBee\Editor - Akashic, Gyzome, Spiffy\TS - Zdm321\encoder - kokus\QC - Spiffy\Project Leader - Zdm321\Current: Spiffy QC\em-dash: - response:	italics: word
context: Editor - Akashic, Gyzome, Spiffy\TS - Zdm321\encoder - kokus\QC - Spiffy\Project Leader - Zdm321\Current: Spiffy QC\em-dash: -\italics: word response:	Section Titles: Nichijou
context: TS - Zdm321\encoder - kokus\QC - Spiffy\Project Leader - Zdm321\Current: Spiffy QC\em-dash: -\italics: word\Section Titles: Nichijou response:	Characters
context: encoder - kokus\QC - Spiffy\Project Leader - Zdm321\Current: Spiffy QC\em-dash: -\italics: word\Section Titles: Nichijou\Characters response:	Naganohara Mio - Schoolgirl, Blue hair twin tails.
context: QC - Spiffy\Project Leader - Zdm321\Current: Spiffy QC\em-dash: -\italics: word\Section Titles: Nichijou\Characters\Naganohara Mio - Schoolgirl, Blue hair twin tails. response:	Aioi Yuuko - Schoolgirl, Chin length light brown hair. (Nickname = Yukko)
context: Project Leader - Zdm321\Current: Spiffy QC\em-dash: -\italics: word\Section Titles: Nichijou\Characters\Naganohara Mio - Schoolgirl, Blue hair twin tails.\Aioi Yuuko - Schoolgirl, Chin length light brown hair. (Nickname = Yukko) response:	Minakami Mai - Schoolgirl, Long dark hair, glasses.
context: Current: Spiffy QC\em-dash: -\italics: word\Section Titles: Nichijou\Characters\Naganohara Mio - Schoolgirl, Blue hair twin tails.\Aioi Yuuko - Schoolgirl, Chin length light brown hair. (Nickname = Yukko)\Minakami Mai - Schoolgirl, Long dark hair, glasses. response:	Shinonome Nano - Schoolgirl, Robot
context: em-dash: -\italics: word\Section Titles: Nichijou\Characters\Naganohara Mio - Schoolgirl, Blue hair twin tails.\Aioi Yuuko - Schoolgirl, Chin length light brown hair. (Nickname = Yukko)\Minakami Mai - Schoolgirl, Long dark hair, glasses.\Shinonome Nano - Schoolgirl, Robot response:	Professor - Nano's Inventor. No formal name (yet...)
context: italics: word\Section Titles: Nichijou\Characters\Naganohara Mio - Schoolgirl, Blue hair twin tails.\Aioi Yuuko - Schoolgirl, Chin length light brown hair. (Nickname = Yukko)\Minakami Mai - Schoolgirl, Long dark hair, glasses.\Shinonome Nano - Schoolgirl, Robot\Professor - Nano's Inventor. No formal name (yet...) response:	Sakamoto - Their cat. (Nano uses the -san honorific, the doctor doesn't).
context: Section Titles: Nichijou\Characters\Naganohara Mio - Schoolgirl, Blue hair twin tails.\Aioi Yuuko - Schoolgirl, Chin length light brown hair. (Nickname = Yukko)\Minakami Mai - Schoolgirl, Long dark hair, glasses.\Shinonome Nano - Schoolgirl, Robot\Professor - Nano's Inventor. No formal name (yet...)\Sakamoto - Their cat. (Nano uses the -san honorific, the doctor doesn't). response:	Nano/Professor/Sakamoto's House: Shinonome Institute
context: Characters\Naganohara Mio - Schoolgirl, Blue hair twin tails.\Aioi Yuuko - Schoolgirl, Chin length light brown hair. (Nickname = Yukko)\Minakami Mai - Schoolgirl, Long dark hair, glasses.\Shinonome Nano - Schoolgirl, Robot\Professor - Nano's Inventor. No formal name (yet...)\Sakamoto - Their cat. (Nano uses the -san honorific, the doctor doesn't).\Nano/Professor/Sakamoto's House: Shinonome Institute response:	Notes
context: Naganohara Mio - Schoolgirl, Blue hair twin tails.\Aioi Yuuko - Schoolgirl, Chin length light brown hair. (Nickname = Yukko)\Minakami Mai - Schoolgirl, Long dark hair, glasses.\Shinonome Nano - Schoolgirl, Robot\Professor - Nano's Inventor. No formal name (yet...)\Sakamoto - Their cat. (Nano uses the -san honorific, the doctor doesn't).\Nano/Professor/Sakamoto's House: Shinonome Institute\Notes response:	Always use OK and all right, nyan
context: Aioi Yuuko - Schoolgirl, Chin length light brown hair. (Nickname = Yukko)\Minakami Mai - Schoolgirl, Long dark hair, glasses.\Shinonome Nano - Schoolgirl, Robot\Professor - Nano's Inventor. No formal name (yet...)\Sakamoto - Their cat. (Nano uses the -san honorific, the doctor doesn't).\Nano/Professor/Sakamoto's House: Shinonome Institute\Notes\Always use OK and all right, nyan response:	Shinonome Institute
context: Minakami Mai - Schoolgirl, Long dark hair, glasses.\Shinonome Nano - Schoolgirl, Robot\Professor - Nano's Inventor. No formal name (yet...)\Sakamoto - Their cat. (Nano uses the -san honorific, the doctor doesn't).\Nano/Professor/Sakamoto's House: Shinonome Institute\Notes\Always use OK and all right, nyan\Shinonome Institute response:	> A humble request to all TLs... When you TL a sign, can you please leave a timecode with it, so we can find it without having to search through the entire vid. Cheers! :) <
context: Shinonome Nano - Schoolgirl, Robot\Professor - Nano's Inventor. No formal name (yet...)\Sakamoto - Their cat. (Nano uses the -san honorific, the doctor doesn't).\Nano/Professor/Sakamoto's House: Shinonome Institute\Notes\Always use OK and all right, nyan\Shinonome Institute\> A humble request to all TLs... When you TL a sign, can you please leave a timecode with it, so we can find it without having to search through the entire vid. Cheers! :) < response:	ep05
context: Professor - Nano's Inventor. No formal name (yet...)\Sakamoto - Their cat. (Nano uses the -san honorific, the doctor doesn't).\Nano/Professor/Sakamoto's House: Shinonome Institute\Notes\Always use OK and all right, nyan\Shinonome Institute\> A humble request to all TLs... When you TL a sign, can you please leave a timecode with it, so we can find it without having to search through the entire vid. Cheers! :) <\ep05 response:	START OP
context: Sakamoto - Their cat. (Nano uses the -san honorific, the doctor doesn't).\Nano/Professor/Sakamoto's House: Shinonome Institute\Notes\Always use OK and all right, nyan\Shinonome Institute\> A humble request to all TLs... When you TL a sign, can you please leave a timecode with it, so we can find it without having to search through the entire vid. Cheers! :) <\ep05\START OP response:	END OP
context: Nano/Professor/Sakamoto's House: Shinonome Institute\Notes\Always use OK and all right, nyan\Shinonome Institute\> A humble request to all TLs... When you TL a sign, can you please leave a timecode with it, so we can find it without having to search through the entire vid. Cheers! :) <\ep05\START OP\END OP response:	Sign 15 Nichijou 22
context: Notes\Always use OK and all right, nyan\Shinonome Institute\> A humble request to all TLs... When you TL a sign, can you please leave a timecode with it, so we can find it without having to search through the entire vid. Cheers! :) <\ep05\START OP\END OP\Sign 15 Nichijou 22 response:	Sign 15 Mini-test English
context: Always use OK and all right, nyan\Shinonome Institute\> A humble request to all TLs... When you TL a sign, can you please leave a timecode with it, so we can find it without having to search through the entire vid. Cheers! :) <\ep05\START OP\END OP\Sign 15 Nichijou 22\Sign 15 Mini-test English response:	Sign 20 15:40 In front of the 1-Q lectern Naganohara Mio: Sunk
context: Shinonome Institute\> A humble request to all TLs... When you TL a sign, can you please leave a timecode with it, so we can find it without having to search through the entire vid. Cheers! :) <\ep05\START OP\END OP\Sign 15 Nichijou 22\Sign 15 Mini-test English\Sign 20 15:40 In front of the 1-Q lectern Naganohara Mio: Sunk response:	Sign 20 Word of the Day
context: > A humble request to all TLs... When you TL a sign, can you please leave a timecode with it, so we can find it without having to search through the entire vid. Cheers! :) <\ep05\START OP\END OP\Sign 15 Nichijou 22\Sign 15 Mini-test English\Sign 20 15:40 In front of the 1-Q lectern Naganohara Mio: Sunk\Sign 20 Word of the Day response:	Sign 20 The next day
context: ep05\START OP\END OP\Sign 15 Nichijou 22\Sign 15 Mini-test English\Sign 20 15:40 In front of the 1-Q lectern Naganohara Mio: Sunk\Sign 20 Word of the Day\Sign 20 The next day response:	sign 21 Mini-test English
context: START OP\END OP\Sign 15 Nichijou 22\Sign 15 Mini-test English\Sign 20 15:40 In front of the 1-Q lectern Naganohara Mio: Sunk\Sign 20 Word of the Day\Sign 20 The next day\sign 21 Mini-test English response:	Start ED
context: END OP\Sign 15 Nichijou 22\Sign 15 Mini-test English\Sign 20 15:40 In front of the 1-Q lectern Naganohara Mio: Sunk\Sign 20 Word of the Day\Sign 20 The next day\sign 21 Mini-test English\Start ED response:	End ED
context: Sign 15 Nichijou 22\Sign 15 Mini-test English\Sign 20 15:40 In front of the 1-Q lectern Naganohara Mio: Sunk\Sign 20 Word of the Day\Sign 20 The next day\sign 21 Mini-test English\Start ED\End ED response:	Sign 23 Narration Koyama Rikiya
context: Sign 15 Mini-test English\Sign 20 15:40 In front of the 1-Q lectern Naganohara Mio: Sunk\Sign 20 Word of the Day\Sign 20 The next day\sign 21 Mini-test English\Start ED\End ED\Sign 23 Narration Koyama Rikiya response:	Shinonome Institute
context: Sign 20 15:40 In front of the 1-Q lectern Naganohara Mio: Sunk\Sign 20 Word of the Day\Sign 20 The next day\sign 21 Mini-test English\Start ED\End ED\Sign 23 Narration Koyama Rikiya\Shinonome Institute response:	It's Nyan
context: Sign 20 Word of the Day\Sign 20 The next day\sign 21 Mini-test English\Start ED\End ED\Sign 23 Narration Koyama Rikiya\Shinonome Institute\It's Nyan response:	Grave
context: Sign 20 The next day\sign 21 Mini-test English\Start ED\End ED\Sign 23 Narration Koyama Rikiya\Shinonome Institute\It's Nyan\Grave response:	Grave
context: sign 21 Mini-test English\Start ED\End ED\Sign 23 Narration Koyama Rikiya\Shinonome Institute\It's Nyan\Grave\Grave response:	Mt. Osore
context: Start ED\End ED\Sign 23 Narration Koyama Rikiya\Shinonome Institute\It's Nyan\Grave\Grave\Mt. Osore response:	Nichijou 19
context: End ED\Sign 23 Narration Koyama Rikiya\Shinonome Institute\It's Nyan\Grave\Grave\Mt. Osore\Nichijou 19 response:	Nichijou 19
context: Sign 23 Narration Koyama Rikiya\Shinonome Institute\It's Nyan\Grave\Grave\Mt. Osore\Nichijou 19\Nichijou 19 response:	Spiritualist
context: Shinonome Institute\It's Nyan\Grave\Grave\Mt. Osore\Nichijou 19\Nichijou 19\Spiritualist response:	Daruma Otoshi
context: It's Nyan\Grave\Grave\Mt. Osore\Nichijou 19\Nichijou 19\Spiritualist\Daruma Otoshi response:	100 Points
context: Grave\Grave\Mt. Osore\Nichijou 19\Nichijou 19\Spiritualist\Daruma Otoshi\100 Points response:	Nichijou 20
context: Grave\Mt. Osore\Nichijou 19\Nichijou 19\Spiritualist\Daruma Otoshi\100 Points\Nichijou 20 response:	2nd Period Self Study
context: Mt. Osore\Nichijou 19\Nichijou 19\Spiritualist\Daruma Otoshi\100 Points\Nichijou 20\2nd Period Self Study response:	Shinonome Institute
context: Nichijou 19\Nichijou 19\Spiritualist\Daruma Otoshi\100 Points\Nichijou 20\2nd Period Self Study\Shinonome Institute response:	Nichijou 21
context: Nichijou 19\Spiritualist\Daruma Otoshi\100 Points\Nichijou 20\2nd Period Self Study\Shinonome Institute\Nichijou 21 response:	You can't have too much ice cream and juice!
context: Spiritualist\Daruma Otoshi\100 Points\Nichijou 20\2nd Period Self Study\Shinonome Institute\Nichijou 21\You can't have too much ice cream and juice! response:	Kokkuri-san
context: Daruma Otoshi\100 Points\Nichijou 20\2nd Period Self Study\Shinonome Institute\Nichijou 21\You can't have too much ice cream and juice!\Kokkuri-san response:	Nichijou 22
context: 100 Points\Nichijou 20\2nd Period Self Study\Shinonome Institute\Nichijou 21\You can't have too much ice cream and juice!\Kokkuri-san\Nichijou 22 response:	Mini-test English
context: Nichijou 20\2nd Period Self Study\Shinonome Institute\Nichijou 21\You can't have too much ice cream and juice!\Kokkuri-san\Nichijou 22\Mini-test English response:	Piss off!
context: 2nd Period Self Study\Shinonome Institute\Nichijou 21\You can't have too much ice cream and juice!\Kokkuri-san\Nichijou 22\Mini-test English\Piss off! response:	In front of the 1-Q lectern
context: Shinonome Institute\Nichijou 21\You can't have too much ice cream and juice!\Kokkuri-san\Nichijou 22\Mini-test English\Piss off!\In front of the 1-Q lectern response:	Naganohara Mio: Sunk
context: Nichijou 21\You can't have too much ice cream and juice!\Kokkuri-san\Nichijou 22\Mini-test English\Piss off!\In front of the 1-Q lectern\Naganohara Mio: Sunk response:	Word Of The Day
context: You can't have too much ice cream and juice!\Kokkuri-san\Nichijou 22\Mini-test English\Piss off!\In front of the 1-Q lectern\Naganohara Mio: Sunk\Word Of The Day response:	The Next Day
context: Kokkuri-san\Nichijou 22\Mini-test English\Piss off!\In front of the 1-Q lectern\Naganohara Mio: Sunk\Word Of The Day\The Next Day response:	English
context: Nichijou 22\Mini-test English\Piss off!\In front of the 1-Q lectern\Naganohara Mio: Sunk\Word Of The Day\The Next Day\English response:	Narration Koyama Rikiya
context: Mini-test English\Piss off!\In front of the 1-Q lectern\Naganohara Mio: Sunk\Word Of The Day\The Next Day\English\Narration Koyama Rikiya response:	shi kou kai wa gu cha gu cha ko n ran shaa ba dee bee doo bee, yeah!
context: Piss off!\In front of the 1-Q lectern\Naganohara Mio: Sunk\Word Of The Day\The Next Day\English\Narration Koyama Rikiya\shi kou kai wa gu cha gu cha ko n ran shaa ba dee bee doo bee, yeah! response:	ko nna... ko to... ha ji me te da yo
context: In front of the 1-Q lectern\Naganohara Mio: Sunk\Word Of The Day\The Next Day\English\Narration Koyama Rikiya\shi kou kai wa gu cha gu cha ko n ran shaa ba dee bee doo bee, yeah!\ko nna... ko to... ha ji me te da yo response:	I just realized for the first time that I had fallen in love
context: Naganohara Mio: Sunk\Word Of The Day\The Next Day\English\Narration Koyama Rikiya\shi kou kai wa gu cha gu cha ko n ran shaa ba dee bee doo bee, yeah!\ko nna... ko to... ha ji me te da yo\I just realized for the first time that I had fallen in love response:	All day long, it's only you, you, you; I just couldn't avoid it
context: Word Of The Day\The Next Day\English\Narration Koyama Rikiya\shi kou kai wa gu cha gu cha ko n ran shaa ba dee bee doo bee, yeah!\ko nna... ko to... ha ji me te da yo\I just realized for the first time that I had fallen in love\All day long, it's only you, you, you; I just couldn't avoid it response:	Somehow, somehow I'm different from usual when I'm with you
context: The Next Day\English\Narration Koyama Rikiya\shi kou kai wa gu cha gu cha ko n ran shaa ba dee bee doo bee, yeah!\ko nna... ko to... ha ji me te da yo\I just realized for the first time that I had fallen in love\All day long, it's only you, you, you; I just couldn't avoid it\Somehow, somehow I'm different from usual when I'm with you response:	Do we converse awkwardly? mutual love?
context: English\Narration Koyama Rikiya\shi kou kai wa gu cha gu cha ko n ran shaa ba dee bee doo bee, yeah!\ko nna... ko to... ha ji me te da yo\I just realized for the first time that I had fallen in love\All day long, it's only you, you, you; I just couldn't avoid it\Somehow, somehow I'm different from usual when I'm with you\Do we converse awkwardly? mutual love? response:	Nope, it's an unrequited love, whoops, we made eye contact
context: Narration Koyama Rikiya\shi kou kai wa gu cha gu cha ko n ran shaa ba dee bee doo bee, yeah!\ko nna... ko to... ha ji me te da yo\I just realized for the first time that I had fallen in love\All day long, it's only you, you, you; I just couldn't avoid it\Somehow, somehow I'm different from usual when I'm with you\Do we converse awkwardly? mutual love?\Nope, it's an unrequited love, whoops, we made eye contact response:	Something's making my heart beat faster sha ba da ba de bee doo wa ba dee ay
context: shi kou kai wa gu cha gu cha ko n ran shaa ba dee bee doo bee, yeah!\ko nna... ko to... ha ji me te da yo\I just realized for the first time that I had fallen in love\All day long, it's only you, you, you; I just couldn't avoid it\Somehow, somehow I'm different from usual when I'm with you\Do we converse awkwardly? mutual love?\Nope, it's an unrequited love, whoops, we made eye contact\Something's making my heart beat faster sha ba da ba de bee doo wa ba dee ay response:	My train of thought derails with a *splat* *splat* shaaba deebee doobee, yeah!
context: ko nna... ko to... ha ji me te da yo\I just realized for the first time that I had fallen in love\All day long, it's only you, you, you; I just couldn't avoid it\Somehow, somehow I'm different from usual when I'm with you\Do we converse awkwardly? mutual love?\Nope, it's an unrequited love, whoops, we made eye contact\Something's making my heart beat faster sha ba da ba de bee doo wa ba dee ay\My train of thought derails with a *splat* *splat* shaaba deebee doobee, yeah! response:	This... is the... very first time for me
context: I just realized for the first time that I had fallen in love\All day long, it's only you, you, you; I just couldn't avoid it\Somehow, somehow I'm different from usual when I'm with you\Do we converse awkwardly? mutual love?\Nope, it's an unrequited love, whoops, we made eye contact\Something's making my heart beat faster sha ba da ba de bee doo wa ba dee ay\My train of thought derails with a *splat* *splat* shaaba deebee doobee, yeah!\This... is the... very first time for me response:	Do I have a fever, I wonder?
context: All day long, it's only you, you, you; I just couldn't avoid it\Somehow, somehow I'm different from usual when I'm with you\Do we converse awkwardly? mutual love?\Nope, it's an unrequited love, whoops, we made eye contact\Something's making my heart beat faster sha ba da ba de bee doo wa ba dee ay\My train of thought derails with a *splat* *splat* shaaba deebee doobee, yeah!\This... is the... very first time for me\Do I have a fever, I wonder? response:	The awakening of love that you induced it was without pride
context: Somehow, somehow I'm different from usual when I'm with you\Do we converse awkwardly? mutual love?\Nope, it's an unrequited love, whoops, we made eye contact\Something's making my heart beat faster sha ba da ba de bee doo wa ba dee ay\My train of thought derails with a *splat* *splat* shaaba deebee doobee, yeah!\This... is the... very first time for me\Do I have a fever, I wonder?\The awakening of love that you induced it was without pride response:	T-T-These stupid hands are shaking and from here, we'll proceed
context: Do we converse awkwardly? mutual love?\Nope, it's an unrequited love, whoops, we made eye contact\Something's making my heart beat faster sha ba da ba de bee doo wa ba dee ay\My train of thought derails with a *splat* *splat* shaaba deebee doobee, yeah!\This... is the... very first time for me\Do I have a fever, I wonder?\The awakening of love that you induced it was without pride\T-T-These stupid hands are shaking and from here, we'll proceed response:	No no no, I've messed up my words a bit and so there's an awkward silence
context: Nope, it's an unrequited love, whoops, we made eye contact\Something's making my heart beat faster sha ba da ba de bee doo wa ba dee ay\My train of thought derails with a *splat* *splat* shaaba deebee doobee, yeah!\This... is the... very first time for me\Do I have a fever, I wonder?\The awakening of love that you induced it was without pride\T-T-These stupid hands are shaking and from here, we'll proceed\No no no, I've messed up my words a bit and so there's an awkward silence response:	About your about your feelings I really want to know, it's an u-u-un-unrequited love
context: Something's making my heart beat faster sha ba da ba de bee doo wa ba dee ay\My train of thought derails with a *splat* *splat* shaaba deebee doobee, yeah!\This... is the... very first time for me\Do I have a fever, I wonder?\The awakening of love that you induced it was without pride\T-T-These stupid hands are shaking and from here, we'll proceed\No no no, I've messed up my words a bit and so there's an awkward silence\About your about your feelings I really want to know, it's an u-u-un-unrequited love response:	First love always in the school zone
context: My train of thought derails with a *splat* *splat* shaaba deebee doobee, yeah!\This... is the... very first time for me\Do I have a fever, I wonder?\The awakening of love that you induced it was without pride\T-T-These stupid hands are shaking and from here, we'll proceed\No no no, I've messed up my words a bit and so there's an awkward silence\About your about your feelings I really want to know, it's an u-u-un-unrequited love\First love always in the school zone response:	A glittering light I will fall in love
context: This... is the... very first time for me\Do I have a fever, I wonder?\The awakening of love that you induced it was without pride\T-T-These stupid hands are shaking and from here, we'll proceed\No no no, I've messed up my words a bit and so there's an awkward silence\About your about your feelings I really want to know, it's an u-u-un-unrequited love\First love always in the school zone\A glittering light I will fall in love response:	I'm flying through the sky
context: Do I have a fever, I wonder?\The awakening of love that you induced it was without pride\T-T-These stupid hands are shaking and from here, we'll proceed\No no no, I've messed up my words a bit and so there's an awkward silence\About your about your feelings I really want to know, it's an u-u-un-unrequited love\First love always in the school zone\A glittering light I will fall in love\I'm flying through the sky response:	U-U-U-U-Unrequited love!
context: The awakening of love that you induced it was without pride\T-T-These stupid hands are shaking and from here, we'll proceed\No no no, I've messed up my words a bit and so there's an awkward silence\About your about your feelings I really want to know, it's an u-u-un-unrequited love\First love always in the school zone\A glittering light I will fall in love\I'm flying through the sky\U-U-U-U-Unrequited love! response:	DREAMS COME TRUE
context: T-T-These stupid hands are shaking and from here, we'll proceed\No no no, I've messed up my words a bit and so there's an awkward silence\About your about your feelings I really want to know, it's an u-u-un-unrequited love\First love always in the school zone\A glittering light I will fall in love\I'm flying through the sky\U-U-U-U-Unrequited love!\DREAMS COME TRUE response:	Wake up in the morning, brush my teeth and in the blink of an eye, it's 10pm.
context: No no no, I've messed up my words a bit and so there's an awkward silence\About your about your feelings I really want to know, it's an u-u-un-unrequited love\First love always in the school zone\A glittering light I will fall in love\I'm flying through the sky\U-U-U-U-Unrequited love!\DREAMS COME TRUE\Wake up in the morning, brush my teeth and in the blink of an eye, it's 10pm. response:	Today also, we laughed a whole lot; we had a great time.
context: About your about your feelings I really want to know, it's an u-u-un-unrequited love\First love always in the school zone\A glittering light I will fall in love\I'm flying through the sky\U-U-U-U-Unrequited love!\DREAMS COME TRUE\Wake up in the morning, brush my teeth and in the blink of an eye, it's 10pm.\Today also, we laughed a whole lot; we had a great time. response:	With my friends, I played the fool, and we all played around.
context: First love always in the school zone\A glittering light I will fall in love\I'm flying through the sky\U-U-U-U-Unrequited love!\DREAMS COME TRUE\Wake up in the morning, brush my teeth and in the blink of an eye, it's 10pm.\Today also, we laughed a whole lot; we had a great time.\With my friends, I played the fool, and we all played around. response:	And when the blood began to run, we wished it was a coincidence.
context: A glittering light I will fall in love\I'm flying through the sky\U-U-U-U-Unrequited love!\DREAMS COME TRUE\Wake up in the morning, brush my teeth and in the blink of an eye, it's 10pm.\Today also, we laughed a whole lot; we had a great time.\With my friends, I played the fool, and we all played around.\And when the blood began to run, we wished it was a coincidence. response:	I can't talk about the first time, it wouldn't be in-character.
context: I'm flying through the sky\U-U-U-U-Unrequited love!\DREAMS COME TRUE\Wake up in the morning, brush my teeth and in the blink of an eye, it's 10pm.\Today also, we laughed a whole lot; we had a great time.\With my friends, I played the fool, and we all played around.\And when the blood began to run, we wished it was a coincidence.\I can't talk about the first time, it wouldn't be in-character. response:	Hey, we can meet again tomorrow, right?
context: U-U-U-U-Unrequited love!\DREAMS COME TRUE\Wake up in the morning, brush my teeth and in the blink of an eye, it's 10pm.\Today also, we laughed a whole lot; we had a great time.\With my friends, I played the fool, and we all played around.\And when the blood began to run, we wished it was a coincidence.\I can't talk about the first time, it wouldn't be in-character.\Hey, we can meet again tomorrow, right? response:	As my eyelids close, I see you glittering.
context: DREAMS COME TRUE\Wake up in the morning, brush my teeth and in the blink of an eye, it's 10pm.\Today also, we laughed a whole lot; we had a great time.\With my friends, I played the fool, and we all played around.\And when the blood began to run, we wished it was a coincidence.\I can't talk about the first time, it wouldn't be in-character.\Hey, we can meet again tomorrow, right?\As my eyelids close, I see you glittering. response:	Today was fun too, wasn't it? Silly me.
context: Wake up in the morning, brush my teeth and in the blink of an eye, it's 10pm.\Today also, we laughed a whole lot; we had a great time.\With my friends, I played the fool, and we all played around.\And when the blood began to run, we wished it was a coincidence.\I can't talk about the first time, it wouldn't be in-character.\Hey, we can meet again tomorrow, right?\As my eyelids close, I see you glittering.\Today was fun too, wasn't it? Silly me. response:	DREAMS COME TRUE
context: Today also, we laughed a whole lot; we had a great time.\With my friends, I played the fool, and we all played around.\And when the blood began to run, we wished it was a coincidence.\I can't talk about the first time, it wouldn't be in-character.\Hey, we can meet again tomorrow, right?\As my eyelids close, I see you glittering.\Today was fun too, wasn't it? Silly me.\DREAMS COME TRUE response:	So happy, so happy, how do you do? It's an unrequited love.
context: With my friends, I played the fool, and we all played around.\And when the blood began to run, we wished it was a coincidence.\I can't talk about the first time, it wouldn't be in-character.\Hey, we can meet again tomorrow, right?\As my eyelids close, I see you glittering.\Today was fun too, wasn't it? Silly me.\DREAMS COME TRUE\So happy, so happy, how do you do? It's an unrequited love. response:	We'll meet again tomorrow, goodnight!
context: And when the blood began to run, we wished it was a coincidence.\I can't talk about the first time, it wouldn't be in-character.\Hey, we can meet again tomorrow, right?\As my eyelids close, I see you glittering.\Today was fun too, wasn't it? Silly me.\DREAMS COME TRUE\So happy, so happy, how do you do? It's an unrequited love.\We'll meet again tomorrow, goodnight! response:	I'll soon be dreaming, goodnight!
context: I can't talk about the first time, it wouldn't be in-character.\Hey, we can meet again tomorrow, right?\As my eyelids close, I see you glittering.\Today was fun too, wasn't it? Silly me.\DREAMS COME TRUE\So happy, so happy, how do you do? It's an unrequited love.\We'll meet again tomorrow, goodnight!\I'll soon be dreaming, goodnight! response:	Nano!
context: Hey, we can meet again tomorrow, right?\As my eyelids close, I see you glittering.\Today was fun too, wasn't it? Silly me.\DREAMS COME TRUE\So happy, so happy, how do you do? It's an unrequited love.\We'll meet again tomorrow, goodnight!\I'll soon be dreaming, goodnight!\Nano! response:	Nano?
context: As my eyelids close, I see you glittering.\Today was fun too, wasn't it? Silly me.\DREAMS COME TRUE\So happy, so happy, how do you do? It's an unrequited love.\We'll meet again tomorrow, goodnight!\I'll soon be dreaming, goodnight!\Nano!\Nano? response:	Naaano!
context: Today was fun too, wasn't it? Silly me.\DREAMS COME TRUE\So happy, so happy, how do you do? It's an unrequited love.\We'll meet again tomorrow, goodnight!\I'll soon be dreaming, goodnight!\Nano!\Nano?\Naaano! response:	Nano!
context: DREAMS COME TRUE\So happy, so happy, how do you do? It's an unrequited love.\We'll meet again tomorrow, goodnight!\I'll soon be dreaming, goodnight!\Nano!\Nano?\Naaano!\Nano! response:	Yes?
context: So happy, so happy, how do you do? It's an unrequited love.\We'll meet again tomorrow, goodnight!\I'll soon be dreaming, goodnight!\Nano!\Nano?\Naaano!\Nano!\Yes? response:	Nano, Nano!
context: We'll meet again tomorrow, goodnight!\I'll soon be dreaming, goodnight!\Nano!\Nano?\Naaano!\Nano!\Yes?\Nano, Nano! response:	Yes?
context: I'll soon be dreaming, goodnight!\Nano!\Nano?\Naaano!\Nano!\Yes?\Nano, Nano!\Yes? response:	Nano!
context: Nano!\Nano?\Naaano!\Nano!\Yes?\Nano, Nano!\Yes?\Nano! response:	Yes, yes.
context: Nano?\Naaano!\Nano!\Yes?\Nano, Nano!\Yes?\Nano!\Yes, yes. response:	Nano!
context: Naaano!\Nano!\Yes?\Nano, Nano!\Yes?\Nano!\Yes, yes.\Nano! response:	Look, look!
context: Nano!\Yes?\Nano, Nano!\Yes?\Nano!\Yes, yes.\Nano!\Look, look! response:	It's Professor nyan!
context: Yes?\Nano, Nano!\Yes?\Nano!\Yes, yes.\Nano!\Look, look!\It's Professor nyan! response:	Nyan.
context: Nano, Nano!\Yes?\Nano!\Yes, yes.\Nano!\Look, look!\It's Professor nyan!\Nyan. response:	You too, Sakamoto... Look, look!
context: Yes?\Nano!\Yes, yes.\Nano!\Look, look!\It's Professor nyan!\Nyan.\You too, Sakamoto... Look, look! response:	It's Professor nyan!
context: Nano!\Yes, yes.\Nano!\Look, look!\It's Professor nyan!\Nyan.\You too, Sakamoto... Look, look!\It's Professor nyan! response:	It's Professor nyan!
context: Yes, yes.\Nano!\Look, look!\It's Professor nyan!\Nyan.\You too, Sakamoto... Look, look!\It's Professor nyan!\It's Professor nyan! response:	Professor.
context: Nano!\Look, look!\It's Professor nyan!\Nyan.\You too, Sakamoto... Look, look!\It's Professor nyan!\It's Professor nyan!\Professor. response:	That's probably... moe!
context: Look, look!\It's Professor nyan!\Nyan.\You too, Sakamoto... Look, look!\It's Professor nyan!\It's Professor nyan!\Professor.\That's probably... moe! response:	Nyan?
context: It's Professor nyan!\Nyan.\You too, Sakamoto... Look, look!\It's Professor nyan!\It's Professor nyan!\Professor.\That's probably... moe!\Nyan? response:	Nyan!
context: Nyan.\You too, Sakamoto... Look, look!\It's Professor nyan!\It's Professor nyan!\Professor.\That's probably... moe!\Nyan?\Nyan! response:	It's Professor nyan!
context: You too, Sakamoto... Look, look!\It's Professor nyan!\It's Professor nyan!\Professor.\That's probably... moe!\Nyan?\Nyan!\It's Professor nyan! response:	It's moe!
context: It's Professor nyan!\It's Professor nyan!\Professor.\That's probably... moe!\Nyan?\Nyan!\It's Professor nyan!\It's moe! response:	It's Professor nyan!
context: It's Professor nyan!\Professor.\That's probably... moe!\Nyan?\Nyan!\It's Professor nyan!\It's moe!\It's Professor nyan! response:	It's moe!
context: Professor.\That's probably... moe!\Nyan?\Nyan!\It's Professor nyan!\It's moe!\It's Professor nyan!\It's moe! response:	It's Professor nyan!
context: That's probably... moe!\Nyan?\Nyan!\It's Professor nyan!\It's moe!\It's Professor nyan!\It's moe!\It's Professor nyan! response:	It's moe!
context: Nyan?\Nyan!\It's Professor nyan!\It's moe!\It's Professor nyan!\It's moe!\It's Professor nyan!\It's moe! response:	It's Professor nyan nyan!
context: Nyan!\It's Professor nyan!\It's moe!\It's Professor nyan!\It's moe!\It's Professor nyan!\It's moe!\It's Professor nyan nyan! response:	It's moe!
context: It's Professor nyan!\It's moe!\It's Professor nyan!\It's moe!\It's Professor nyan!\It's moe!\It's Professor nyan nyan!\It's moe! response:	It's Professor nyan!
context: It's moe!\It's Professor nyan!\It's moe!\It's Professor nyan!\It's moe!\It's Professor nyan nyan!\It's moe!\It's Professor nyan! response:	It's moe!
context: It's Professor nyan!\It's moe!\It's Professor nyan!\It's moe!\It's Professor nyan nyan!\It's moe!\It's Professor nyan!\It's moe! response:	It's Professor nyan nyan!
context: It's moe!\It's Professor nyan!\It's moe!\It's Professor nyan nyan!\It's moe!\It's Professor nyan!\It's moe!\It's Professor nyan nyan! response:	The Shinonome household was at peace again today.
context: It's Professor nyan!\It's moe!\It's Professor nyan nyan!\It's moe!\It's Professor nyan!\It's moe!\It's Professor nyan nyan!\The Shinonome household was at peace again today. response:	Why is the Earth round?
context: It's moe!\It's Professor nyan nyan!\It's moe!\It's Professor nyan!\It's moe!\It's Professor nyan nyan!\The Shinonome household was at peace again today.\Why is the Earth round? response:	Why do rockets fly?
context: It's Professor nyan nyan!\It's moe!\It's Professor nyan!\It's moe!\It's Professor nyan nyan!\The Shinonome household was at peace again today.\Why is the Earth round?\Why do rockets fly? response:	Why do magnets pull against each other?
context: It's moe!\It's Professor nyan!\It's moe!\It's Professor nyan nyan!\The Shinonome household was at peace again today.\Why is the Earth round?\Why do rockets fly?\Why do magnets pull against each other? response:	Everything in this world can be proven by science.
context: It's Professor nyan!\It's moe!\It's Professor nyan nyan!\The Shinonome household was at peace again today.\Why is the Earth round?\Why do rockets fly?\Why do magnets pull against each other?\Everything in this world can be proven by science. response:	There are things that may be eliminated...
context: It's moe!\It's Professor nyan nyan!\The Shinonome household was at peace again today.\Why is the Earth round?\Why do rockets fly?\Why do magnets pull against each other?\Everything in this world can be proven by science.\There are things that may be eliminated... response:	Spiritual phenomena such as a world after death, ghosts and ghost stories.
context: It's Professor nyan nyan!\The Shinonome household was at peace again today.\Why is the Earth round?\Why do rockets fly?\Why do magnets pull against each other?\Everything in this world can be proven by science.\There are things that may be eliminated...\Spiritual phenomena such as a world after death, ghosts and ghost stories. response:	There's no way those kinds of sleep-inducing things could be real!
context: The Shinonome household was at peace again today.\Why is the Earth round?\Why do rockets fly?\Why do magnets pull against each other?\Everything in this world can be proven by science.\There are things that may be eliminated...\Spiritual phenomena such as a world after death, ghosts and ghost stories.\There's no way those kinds of sleep-inducing things could be real! response:	Because... they can't be.
context: Why is the Earth round?\Why do rockets fly?\Why do magnets pull against each other?\Everything in this world can be proven by science.\There are things that may be eliminated...\Spiritual phenomena such as a world after death, ghosts and ghost stories.\There's no way those kinds of sleep-inducing things could be real!\Because... they can't be. response:	In other words...
context: Why do rockets fly?\Why do magnets pull against each other?\Everything in this world can be proven by science.\There are things that may be eliminated...\Spiritual phenomena such as a world after death, ghosts and ghost stories.\There's no way those kinds of sleep-inducing things could be real!\Because... they can't be.\In other words... response:	I don't believe in spiritualists!
context: Why do magnets pull against each other?\Everything in this world can be proven by science.\There are things that may be eliminated...\Spiritual phenomena such as a world after death, ghosts and ghost stories.\There's no way those kinds of sleep-inducing things could be real!\Because... they can't be.\In other words...\I don't believe in spiritualists! response:	Using my day off, I spent 8 hours going one-way to Mt. Osore.
context: Everything in this world can be proven by science.\There are things that may be eliminated...\Spiritual phenomena such as a world after death, ghosts and ghost stories.\There's no way those kinds of sleep-inducing things could be real!\Because... they can't be.\In other words...\I don't believe in spiritualists!\Using my day off, I spent 8 hours going one-way to Mt. Osore. response:	Getting closer to the summit, the beating of my heart increases.
context: There are things that may be eliminated...\Spiritual phenomena such as a world after death, ghosts and ghost stories.\There's no way those kinds of sleep-inducing things could be real!\Because... they can't be.\In other words...\I don't believe in spiritualists!\Using my day off, I spent 8 hours going one-way to Mt. Osore.\Getting closer to the summit, the beating of my heart increases. response:	I wonder if a spiritualist really exists here.
context: Spiritual phenomena such as a world after death, ghosts and ghost stories.\There's no way those kinds of sleep-inducing things could be real!\Because... they can't be.\In other words...\I don't believe in spiritualists!\Using my day off, I spent 8 hours going one-way to Mt. Osore.\Getting closer to the summit, the beating of my heart increases.\I wonder if a spiritualist really exists here. response:	If so, where?
context: There's no way those kinds of sleep-inducing things could be real!\Because... they can't be.\In other words...\I don't believe in spiritualists!\Using my day off, I spent 8 hours going one-way to Mt. Osore.\Getting closer to the summit, the beating of my heart increases.\I wonder if a spiritualist really exists here.\If so, where? response:	I wonder if she would live alone here.
context: Because... they can't be.\In other words...\I don't believe in spiritualists!\Using my day off, I spent 8 hours going one-way to Mt. Osore.\Getting closer to the summit, the beating of my heart increases.\I wonder if a spiritualist really exists here.\If so, where?\I wonder if she would live alone here. response:	Or...
context: In other words...\I don't believe in spiritualists!\Using my day off, I spent 8 hours going one-way to Mt. Osore.\Getting closer to the summit, the beating of my heart increases.\I wonder if a spiritualist really exists here.\If so, where?\I wonder if she would live alone here.\Or... response:	There she is!
context: I don't believe in spiritualists!\Using my day off, I spent 8 hours going one-way to Mt. Osore.\Getting closer to the summit, the beating of my heart increases.\I wonder if a spiritualist really exists here.\If so, where?\I wonder if she would live alone here.\Or...\There she is! response:	A-All right!
context: Using my day off, I spent 8 hours going one-way to Mt. Osore.\Getting closer to the summit, the beating of my heart increases.\I wonder if a spiritualist really exists here.\If so, where?\I wonder if she would live alone here.\Or...\There she is!\A-All right! response:	Let's have her summon something already.
context: Getting closer to the summit, the beating of my heart increases.\I wonder if a spiritualist really exists here.\If so, where?\I wonder if she would live alone here.\Or...\There she is!\A-All right!\Let's have her summon something already. response:	Excuse me.
context: I wonder if a spiritualist really exists here.\If so, where?\I wonder if she would live alone here.\Or...\There she is!\A-All right!\Let's have her summon something already.\Excuse me. response:	Yes.
context: If so, where?\I wonder if she would live alone here.\Or...\There she is!\A-All right!\Let's have her summon something already.\Excuse me.\Yes. response:	Um... Please summon some soap!
context: I wonder if she would live alone here.\Or...\There she is!\A-All right!\Let's have her summon something already.\Excuse me.\Yes.\Um... Please summon some soap! response:	Ah, OK.
context: Or...\There she is!\A-All right!\Let's have her summon something already.\Excuse me.\Yes.\Um... Please summon some soap!\Ah, OK. response:	Bubble, it's Soap!
context: There she is!\A-All right!\Let's have her summon something already.\Excuse me.\Yes.\Um... Please summon some soap!\Ah, OK.\Bubble, it's Soap! response:	What's this sensation of helplessness?
context: A-All right!\Let's have her summon something already.\Excuse me.\Yes.\Um... Please summon some soap!\Ah, OK.\Bubble, it's Soap!\What's this sensation of helplessness? response:	Could it be there's someone called Soap...?
context: Let's have her summon something already.\Excuse me.\Yes.\Um... Please summon some soap!\Ah, OK.\Bubble, it's Soap!\What's this sensation of helplessness?\Could it be there's someone called Soap...? response:	I-It's S-S-Soap.
context: Excuse me.\Yes.\Um... Please summon some soap!\Ah, OK.\Bubble, it's Soap!\What's this sensation of helplessness?\Could it be there's someone called Soap...?\I-It's S-S-Soap. response:	No, there can't be.
context: Yes.\Um... Please summon some soap!\Ah, OK.\Bubble, it's Soap!\What's this sensation of helplessness?\Could it be there's someone called Soap...?\I-It's S-S-Soap.\No, there can't be. response:	What... if I keep asking, then eventually a contradiction point will appear.
context: Um... Please summon some soap!\Ah, OK.\Bubble, it's Soap!\What's this sensation of helplessness?\Could it be there's someone called Soap...?\I-It's S-S-Soap.\No, there can't be.\What... if I keep asking, then eventually a contradiction point will appear. response:	I have a question.
context: Ah, OK.\Bubble, it's Soap!\What's this sensation of helplessness?\Could it be there's someone called Soap...?\I-It's S-S-Soap.\No, there can't be.\What... if I keep asking, then eventually a contradiction point will appear.\I have a question. response:	What's the blood type of Soap?
context: Bubble, it's Soap!\What's this sensation of helplessness?\Could it be there's someone called Soap...?\I-It's S-S-Soap.\No, there can't be.\What... if I keep asking, then eventually a contradiction point will appear.\I have a question.\What's the blood type of Soap? response:	Who knows?
context: What's this sensation of helplessness?\Could it be there's someone called Soap...?\I-It's S-S-Soap.\No, there can't be.\What... if I keep asking, then eventually a contradiction point will appear.\I have a question.\What's the blood type of Soap?\Who knows? response:	Let's try a simpler person.
context: Could it be there's someone called Soap...?\I-It's S-S-Soap.\No, there can't be.\What... if I keep asking, then eventually a contradiction point will appear.\I have a question.\What's the blood type of Soap?\Who knows?\Let's try a simpler person. response:	Excuse me.
context: I-It's S-S-Soap.\No, there can't be.\What... if I keep asking, then eventually a contradiction point will appear.\I have a question.\What's the blood type of Soap?\Who knows?\Let's try a simpler person.\Excuse me. response:	Nobunaga... please summon Oda Nobunaga!
context: No, there can't be.\What... if I keep asking, then eventually a contradiction point will appear.\I have a question.\What's the blood type of Soap?\Who knows?\Let's try a simpler person.\Excuse me.\Nobunaga... please summon Oda Nobunaga! response:	Please give me a break.
context: What... if I keep asking, then eventually a contradiction point will appear.\I have a question.\What's the blood type of Soap?\Who knows?\Let's try a simpler person.\Excuse me.\Nobunaga... please summon Oda Nobunaga!\Please give me a break. response:	Rejecting me before even trying to summon him?
context: I have a question.\What's the blood type of Soap?\Who knows?\Let's try a simpler person.\Excuse me.\Nobunaga... please summon Oda Nobunaga!\Please give me a break.\Rejecting me before even trying to summon him? response:	No, she's old after all.
context: What's the blood type of Soap?\Who knows?\Let's try a simpler person.\Excuse me.\Nobunaga... please summon Oda Nobunaga!\Please give me a break.\Rejecting me before even trying to summon him?\No, she's old after all. response:	She has to look after her health.
context: Who knows?\Let's try a simpler person.\Excuse me.\Nobunaga... please summon Oda Nobunaga!\Please give me a break.\Rejecting me before even trying to summon him?\No, she's old after all.\She has to look after her health. response:	I shouldn't scold her here.
context: Let's try a simpler person.\Excuse me.\Nobunaga... please summon Oda Nobunaga!\Please give me a break.\Rejecting me before even trying to summon him?\No, she's old after all.\She has to look after her health.\I shouldn't scold her here. response:	Excuse me.
context: Excuse me.\Nobunaga... please summon Oda Nobunaga!\Please give me a break.\Rejecting me before even trying to summon him?\No, she's old after all.\She has to look after her health.\I shouldn't scold her here.\Excuse me. response:	Let's go home.
context: Nobunaga... please summon Oda Nobunaga!\Please give me a break.\Rejecting me before even trying to summon him?\No, she's old after all.\She has to look after her health.\I shouldn't scold her here.\Excuse me.\Let's go home. response:	Scolding people is not for me.
context: Please give me a break.\Rejecting me before even trying to summon him?\No, she's old after all.\She has to look after her health.\I shouldn't scold her here.\Excuse me.\Let's go home.\Scolding people is not for me. response:	Just by knowing that, I should reap what I've sown.
context: Rejecting me before even trying to summon him?\No, she's old after all.\She has to look after her health.\I shouldn't scold her here.\Excuse me.\Let's go home.\Scolding people is not for me.\Just by knowing that, I should reap what I've sown. response:	Oh, Onii-san?
context: No, she's old after all.\She has to look after her health.\I shouldn't scold her here.\Excuse me.\Let's go home.\Scolding people is not for me.\Just by knowing that, I should reap what I've sown.\Oh, Onii-san? response:	That'll be 5000 yen.
context: She has to look after her health.\I shouldn't scold her here.\Excuse me.\Let's go home.\Scolding people is not for me.\Just by knowing that, I should reap what I've sown.\Oh, Onii-san?\That'll be 5000 yen. response:	Ok here goes.
context: I shouldn't scold her here.\Excuse me.\Let's go home.\Scolding people is not for me.\Just by knowing that, I should reap what I've sown.\Oh, Onii-san?\That'll be 5000 yen.\Ok here goes. response:	Rock Paper Scissors.
context: Excuse me.\Let's go home.\Scolding people is not for me.\Just by knowing that, I should reap what I've sown.\Oh, Onii-san?\That'll be 5000 yen.\Ok here goes.\Rock Paper Scissors. response:	W-W-Whoa!
context: Let's go home.\Scolding people is not for me.\Just by knowing that, I should reap what I've sown.\Oh, Onii-san?\That'll be 5000 yen.\Ok here goes.\Rock Paper Scissors.\W-W-Whoa! response:	That's not how you do it Mai-chan, didn't I just explain it?
context: Scolding people is not for me.\Just by knowing that, I should reap what I've sown.\Oh, Onii-san?\That'll be 5000 yen.\Ok here goes.\Rock Paper Scissors.\W-W-Whoa!\That's not how you do it Mai-chan, didn't I just explain it? response:	You have to hit me if you win!
context: Just by knowing that, I should reap what I've sown.\Oh, Onii-san?\That'll be 5000 yen.\Ok here goes.\Rock Paper Scissors.\W-W-Whoa!\That's not how you do it Mai-chan, didn't I just explain it?\You have to hit me if you win! response:	It's amazing, you've got incredible concentration. In a way, it's even more cruel than hitting me.
context: Oh, Onii-san?\That'll be 5000 yen.\Ok here goes.\Rock Paper Scissors.\W-W-Whoa!\That's not how you do it Mai-chan, didn't I just explain it?\You have to hit me if you win!\It's amazing, you've got incredible concentration. In a way, it's even more cruel than hitting me. response:	Listen. As I've just explained, when you lose you defend, when you win you hit, OK?
context: That'll be 5000 yen.\Ok here goes.\Rock Paper Scissors.\W-W-Whoa!\That's not how you do it Mai-chan, didn't I just explain it?\You have to hit me if you win!\It's amazing, you've got incredible concentration. In a way, it's even more cruel than hitting me.\Listen. As I've just explained, when you lose you defend, when you win you hit, OK? response:	Not now! Why did you hit me now!
context: Ok here goes.\Rock Paper Scissors.\W-W-Whoa!\That's not how you do it Mai-chan, didn't I just explain it?\You have to hit me if you win!\It's amazing, you've got incredible concentration. In a way, it's even more cruel than hitting me.\Listen. As I've just explained, when you lose you defend, when you win you hit, OK?\Not now! Why did you hit me now! response:	No, it's because I won just then.
context: Rock Paper Scissors.\W-W-Whoa!\That's not how you do it Mai-chan, didn't I just explain it?\You have to hit me if you win!\It's amazing, you've got incredible concentration. In a way, it's even more cruel than hitting me.\Listen. As I've just explained, when you lose you defend, when you win you hit, OK?\Not now! Why did you hit me now!\No, it's because I won just then. response:	It wasn't now was it, it was just then!
context: W-W-Whoa!\That's not how you do it Mai-chan, didn't I just explain it?\You have to hit me if you win!\It's amazing, you've got incredible concentration. In a way, it's even more cruel than hitting me.\Listen. As I've just explained, when you lose you defend, when you win you hit, OK?\Not now! Why did you hit me now!\No, it's because I won just then.\It wasn't now was it, it was just then! response:	It's the moment! Live for the moment! We're that kind of living thing you know!
context: That's not how you do it Mai-chan, didn't I just explain it?\You have to hit me if you win!\It's amazing, you've got incredible concentration. In a way, it's even more cruel than hitting me.\Listen. As I've just explained, when you lose you defend, when you win you hit, OK?\Not now! Why did you hit me now!\No, it's because I won just then.\It wasn't now was it, it was just then!\It's the moment! Live for the moment! We're that kind of living thing you know! response:	OK then, let's do it again.
context: You have to hit me if you win!\It's amazing, you've got incredible concentration. In a way, it's even more cruel than hitting me.\Listen. As I've just explained, when you lose you defend, when you win you hit, OK?\Not now! Why did you hit me now!\No, it's because I won just then.\It wasn't now was it, it was just then!\It's the moment! Live for the moment! We're that kind of living thing you know!\OK then, let's do it again. response:	Rock paper scissors.
context: It's amazing, you've got incredible concentration. In a way, it's even more cruel than hitting me.\Listen. As I've just explained, when you lose you defend, when you win you hit, OK?\Not now! Why did you hit me now!\No, it's because I won just then.\It wasn't now was it, it was just then!\It's the moment! Live for the moment! We're that kind of living thing you know!\OK then, let's do it again.\Rock paper scissors. response:	You have zero motivation to play!?
context: Listen. As I've just explained, when you lose you defend, when you win you hit, OK?\Not now! Why did you hit me now!\No, it's because I won just then.\It wasn't now was it, it was just then!\It's the moment! Live for the moment! We're that kind of living thing you know!\OK then, let's do it again.\Rock paper scissors.\You have zero motivation to play!? response:	You are a clown!
context: Not now! Why did you hit me now!\No, it's because I won just then.\It wasn't now was it, it was just then!\It's the moment! Live for the moment! We're that kind of living thing you know!\OK then, let's do it again.\Rock paper scissors.\You have zero motivation to play!?\You are a clown! response:	How much of a clown can you be?!
context: No, it's because I won just then.\It wasn't now was it, it was just then!\It's the moment! Live for the moment! We're that kind of living thing you know!\OK then, let's do it again.\Rock paper scissors.\You have zero motivation to play!?\You are a clown!\How much of a clown can you be?! response:	In my mind... something is coming.
context: It wasn't now was it, it was just then!\It's the moment! Live for the moment! We're that kind of living thing you know!\OK then, let's do it again.\Rock paper scissors.\You have zero motivation to play!?\You are a clown!\How much of a clown can you be?!\In my mind... something is coming. response:	Ah, hold on Mai-chan.
context: It's the moment! Live for the moment! We're that kind of living thing you know!\OK then, let's do it again.\Rock paper scissors.\You have zero motivation to play!?\You are a clown!\How much of a clown can you be?!\In my mind... something is coming.\Ah, hold on Mai-chan. response:	There it is.
context: OK then, let's do it again.\Rock paper scissors.\You have zero motivation to play!?\You are a clown!\How much of a clown can you be?!\In my mind... something is coming.\Ah, hold on Mai-chan.\There it is. response:	Mai-chan, w-what's with that?
context: Rock paper scissors.\You have zero motivation to play!?\You are a clown!\How much of a clown can you be?!\In my mind... something is coming.\Ah, hold on Mai-chan.\There it is.\Mai-chan, w-what's with that? response:	I carved it.
context: You have zero motivation to play!?\You are a clown!\How much of a clown can you be?!\In my mind... something is coming.\Ah, hold on Mai-chan.\There it is.\Mai-chan, w-what's with that?\I carved it. response:	Thank god! I thought it had been reincarnated!
context: You are a clown!\How much of a clown can you be?!\In my mind... something is coming.\Ah, hold on Mai-chan.\There it is.\Mai-chan, w-what's with that?\I carved it.\Thank god! I thought it had been reincarnated! response:	I will put this here.
context: How much of a clown can you be?!\In my mind... something is coming.\Ah, hold on Mai-chan.\There it is.\Mai-chan, w-what's with that?\I carved it.\Thank god! I thought it had been reincarnated!\I will put this here. response:	Somehow, she looks really happy.
context: In my mind... something is coming.\Ah, hold on Mai-chan.\There it is.\Mai-chan, w-what's with that?\I carved it.\Thank god! I thought it had been reincarnated!\I will put this here.\Somehow, she looks really happy. response:	Ah well that doesn't matter, let's start.
context: Ah, hold on Mai-chan.\There it is.\Mai-chan, w-what's with that?\I carved it.\Thank god! I thought it had been reincarnated!\I will put this here.\Somehow, she looks really happy.\Ah well that doesn't matter, let's start. response:	OK, rock paper scissors.
context: There it is.\Mai-chan, w-what's with that?\I carved it.\Thank god! I thought it had been reincarnated!\I will put this here.\Somehow, she looks really happy.\Ah well that doesn't matter, let's start.\OK, rock paper scissors. response:	Ma-Mai-chan. That's...
context: Mai-chan, w-what's with that?\I carved it.\Thank god! I thought it had been reincarnated!\I will put this here.\Somehow, she looks really happy.\Ah well that doesn't matter, let's start.\OK, rock paper scissors.\Ma-Mai-chan. That's... response:	No way, such a brutal...
context: I carved it.\Thank god! I thought it had been reincarnated!\I will put this here.\Somehow, she looks really happy.\Ah well that doesn't matter, let's start.\OK, rock paper scissors.\Ma-Mai-chan. That's...\No way, such a brutal... response:	Seriously, Mai-chan, that doesn't count, that doesn't count. Rockscispaper doesn't count.
context: Thank god! I thought it had been reincarnated!\I will put this here.\Somehow, she looks really happy.\Ah well that doesn't matter, let's start.\OK, rock paper scissors.\Ma-Mai-chan. That's...\No way, such a brutal...\Seriously, Mai-chan, that doesn't count, that doesn't count. Rockscispaper doesn't count. response:	Also, hitting with the Buddha doesn't count either.
context: I will put this here.\Somehow, she looks really happy.\Ah well that doesn't matter, let's start.\OK, rock paper scissors.\Ma-Mai-chan. That's...\No way, such a brutal...\Seriously, Mai-chan, that doesn't count, that doesn't count. Rockscispaper doesn't count.\Also, hitting with the Buddha doesn't count either. response:	OK, let's do it again.
context: Somehow, she looks really happy.\Ah well that doesn't matter, let's start.\OK, rock paper scissors.\Ma-Mai-chan. That's...\No way, such a brutal...\Seriously, Mai-chan, that doesn't count, that doesn't count. Rockscispaper doesn't count.\Also, hitting with the Buddha doesn't count either.\OK, let's do it again. response:	First comes rock -
context: Ah well that doesn't matter, let's start.\OK, rock paper scissors.\Ma-Mai-chan. That's...\No way, such a brutal...\Seriously, Mai-chan, that doesn't count, that doesn't count. Rockscispaper doesn't count.\Also, hitting with the Buddha doesn't count either.\OK, let's do it again.\First comes rock - response:	Rock paper scissors.
context: OK, rock paper scissors.\Ma-Mai-chan. That's...\No way, such a brutal...\Seriously, Mai-chan, that doesn't count, that doesn't count. Rockscispaper doesn't count.\Also, hitting with the Buddha doesn't count either.\OK, let's do it again.\First comes rock -\Rock paper scissors. response:	Mai-chan...
context: Ma-Mai-chan. That's...\No way, such a brutal...\Seriously, Mai-chan, that doesn't count, that doesn't count. Rockscispaper doesn't count.\Also, hitting with the Buddha doesn't count either.\OK, let's do it again.\First comes rock -\Rock paper scissors.\Mai-chan... response:	That, that! That's it Mai-chan.
context: No way, such a brutal...\Seriously, Mai-chan, that doesn't count, that doesn't count. Rockscispaper doesn't count.\Also, hitting with the Buddha doesn't count either.\OK, let's do it again.\First comes rock -\Rock paper scissors.\Mai-chan...\That, that! That's it Mai-chan. response:	See, you can do it if you try!
context: Seriously, Mai-chan, that doesn't count, that doesn't count. Rockscispaper doesn't count.\Also, hitting with the Buddha doesn't count either.\OK, let's do it again.\First comes rock -\Rock paper scissors.\Mai-chan...\That, that! That's it Mai-chan.\See, you can do it if you try! response:	Ok, let's do the next one.
context: Also, hitting with the Buddha doesn't count either.\OK, let's do it again.\First comes rock -\Rock paper scissors.\Mai-chan...\That, that! That's it Mai-chan.\See, you can do it if you try!\Ok, let's do the next one. response:	First comes rock -
context: OK, let's do it again.\First comes rock -\Rock paper scissors.\Mai-chan...\That, that! That's it Mai-chan.\See, you can do it if you try!\Ok, let's do the next one.\First comes rock - response:	God is dead!
context: First comes rock -\Rock paper scissors.\Mai-chan...\That, that! That's it Mai-chan.\See, you can do it if you try!\Ok, let's do the next one.\First comes rock -\God is dead! response:	God has died.
context: Rock paper scissors.\Mai-chan...\That, that! That's it Mai-chan.\See, you can do it if you try!\Ok, let's do the next one.\First comes rock -\God is dead!\God has died. response:	Hey, why did you hit me?! You did it properly just now!
context: Mai-chan...\That, that! That's it Mai-chan.\See, you can do it if you try!\Ok, let's do the next one.\First comes rock -\God is dead!\God has died.\Hey, why did you hit me?! You did it properly just now! response:	How do I say it, because I don't want to play.
context: That, that! That's it Mai-chan.\See, you can do it if you try!\Ok, let's do the next one.\First comes rock -\God is dead!\God has died.\Hey, why did you hit me?! You did it properly just now!\How do I say it, because I don't want to play. response:	Can I take a look at your Maitreya?
context: See, you can do it if you try!\Ok, let's do the next one.\First comes rock -\God is dead!\God has died.\Hey, why did you hit me?! You did it properly just now!\How do I say it, because I don't want to play.\Can I take a look at your Maitreya? response:	Sure.
context: Ok, let's do the next one.\First comes rock -\God is dead!\God has died.\Hey, why did you hit me?! You did it properly just now!\How do I say it, because I don't want to play.\Can I take a look at your Maitreya?\Sure. response:	Then, I'll be going to the library to return the books!
context: First comes rock -\God is dead!\God has died.\Hey, why did you hit me?! You did it properly just now!\How do I say it, because I don't want to play.\Can I take a look at your Maitreya?\Sure.\Then, I'll be going to the library to return the books! response:	Make sure you look after the house, OK?
context: God is dead!\God has died.\Hey, why did you hit me?! You did it properly just now!\How do I say it, because I don't want to play.\Can I take a look at your Maitreya?\Sure.\Then, I'll be going to the library to return the books!\Make sure you look after the house, OK? response:	Yes!
context: God has died.\Hey, why did you hit me?! You did it properly just now!\How do I say it, because I don't want to play.\Can I take a look at your Maitreya?\Sure.\Then, I'll be going to the library to return the books!\Make sure you look after the house, OK?\Yes! response:	I wonder why Nano's daruma only has one eye...
context: Hey, why did you hit me?! You did it properly just now!\How do I say it, because I don't want to play.\Can I take a look at your Maitreya?\Sure.\Then, I'll be going to the library to return the books!\Make sure you look after the house, OK?\Yes!\I wonder why Nano's daruma only has one eye... response:	That's it! If I give it another eye I might get praised!
context: How do I say it, because I don't want to play.\Can I take a look at your Maitreya?\Sure.\Then, I'll be going to the library to return the books!\Make sure you look after the house, OK?\Yes!\I wonder why Nano's daruma only has one eye...\That's it! If I give it another eye I might get praised! response:	She might say'it's OK to eat as many snacks as you like'!
context: Can I take a look at your Maitreya?\Sure.\Then, I'll be going to the library to return the books!\Make sure you look after the house, OK?\Yes!\I wonder why Nano's daruma only has one eye...\That's it! If I give it another eye I might get praised!\She might say'it's OK to eat as many snacks as you like'! response:	I might've made a mistake...
context: Sure.\Then, I'll be going to the library to return the books!\Make sure you look after the house, OK?\Yes!\I wonder why Nano's daruma only has one eye...\That's it! If I give it another eye I might get praised!\She might say'it's OK to eat as many snacks as you like'!\I might've made a mistake... response:	It's Nano's, so what do I do...
context: Then, I'll be going to the library to return the books!\Make sure you look after the house, OK?\Yes!\I wonder why Nano's daruma only has one eye...\That's it! If I give it another eye I might get praised!\She might say'it's OK to eat as many snacks as you like'!\I might've made a mistake...\It's Nano's, so what do I do... response:	Oh! She might get mad at me!
context: Make sure you look after the house, OK?\Yes!\I wonder why Nano's daruma only has one eye...\That's it! If I give it another eye I might get praised!\She might say'it's OK to eat as many snacks as you like'!\I might've made a mistake...\It's Nano's, so what do I do...\Oh! She might get mad at me! response:	You won't get any snacks for a long time!
context: Yes!\I wonder why Nano's daruma only has one eye...\That's it! If I give it another eye I might get praised!\She might say'it's OK to eat as many snacks as you like'!\I might've made a mistake...\It's Nano's, so what do I do...\Oh! She might get mad at me!\You won't get any snacks for a long time! response:	Um... here... and here...
context: I wonder why Nano's daruma only has one eye...\That's it! If I give it another eye I might get praised!\She might say'it's OK to eat as many snacks as you like'!\I might've made a mistake...\It's Nano's, so what do I do...\Oh! She might get mad at me!\You won't get any snacks for a long time!\Um... here... and here... response:	What are you doing?
context: That's it! If I give it another eye I might get praised!\She might say'it's OK to eat as many snacks as you like'!\I might've made a mistake...\It's Nano's, so what do I do...\Oh! She might get mad at me!\You won't get any snacks for a long time!\Um... here... and here...\What are you doing? response:	S-Sakamoto, what should I do? This...
context: She might say'it's OK to eat as many snacks as you like'!\I might've made a mistake...\It's Nano's, so what do I do...\Oh! She might get mad at me!\You won't get any snacks for a long time!\Um... here... and here...\What are you doing?\S-Sakamoto, what should I do? This... response:	What's this? What were you doing!?
context: I might've made a mistake...\It's Nano's, so what do I do...\Oh! She might get mad at me!\You won't get any snacks for a long time!\Um... here... and here...\What are you doing?\S-Sakamoto, what should I do? This...\What's this? What were you doing!? response:	This is hers, right?
context: It's Nano's, so what do I do...\Oh! She might get mad at me!\You won't get any snacks for a long time!\Um... here... and here...\What are you doing?\S-Sakamoto, what should I do? This...\What's this? What were you doing!?\This is hers, right? response:	You see, it didn't have an eye...
context: Oh! She might get mad at me!\You won't get any snacks for a long time!\Um... here... and here...\What are you doing?\S-Sakamoto, what should I do? This...\What's this? What were you doing!?\This is hers, right?\You see, it didn't have an eye... response:	It can't be helped, try doing what I say.
context: You won't get any snacks for a long time!\Um... here... and here...\What are you doing?\S-Sakamoto, what should I do? This...\What's this? What were you doing!?\This is hers, right?\You see, it didn't have an eye...\It can't be helped, try doing what I say. response:	I'm home!
context: Um... here... and here...\What are you doing?\S-Sakamoto, what should I do? This...\What's this? What were you doing!?\This is hers, right?\You see, it didn't have an eye...\It can't be helped, try doing what I say.\I'm home! response:	Stay in good health.
context: What are you doing?\S-Sakamoto, what should I do? This...\What's this? What were you doing!?\This is hers, right?\You see, it didn't have an eye...\It can't be helped, try doing what I say.\I'm home!\Stay in good health. response:	Ah, Sakamoto!
context: S-Sakamoto, what should I do? This...\What's this? What were you doing!?\This is hers, right?\You see, it didn't have an eye...\It can't be helped, try doing what I say.\I'm home!\Stay in good health.\Ah, Sakamoto! response:	Ah, Sakamoto-san, you're going out?
context: What's this? What were you doing!?\This is hers, right?\You see, it didn't have an eye...\It can't be helped, try doing what I say.\I'm home!\Stay in good health.\Ah, Sakamoto!\Ah, Sakamoto-san, you're going out? response:	Professor, I'm home.
context: This is hers, right?\You see, it didn't have an eye...\It can't be helped, try doing what I say.\I'm home!\Stay in good health.\Ah, Sakamoto!\Ah, Sakamoto-san, you're going out?\Professor, I'm home. response:	I'm late because it took me some time to choose some new books to borrow.
context: You see, it didn't have an eye...\It can't be helped, try doing what I say.\I'm home!\Stay in good health.\Ah, Sakamoto!\Ah, Sakamoto-san, you're going out?\Professor, I'm home.\I'm late because it took me some time to choose some new books to borrow. response:	What are you doing?
context: It can't be helped, try doing what I say.\I'm home!\Stay in good health.\Ah, Sakamoto!\Ah, Sakamoto-san, you're going out?\Professor, I'm home.\I'm late because it took me some time to choose some new books to borrow.\What are you doing? response:	Eh, what's with that stomach of yours?
context: I'm home!\Stay in good health.\Ah, Sakamoto!\Ah, Sakamoto-san, you're going out?\Professor, I'm home.\I'm late because it took me some time to choose some new books to borrow.\What are you doing?\Eh, what's with that stomach of yours? response:	It's not'ehehe'!
context: Stay in good health.\Ah, Sakamoto!\Ah, Sakamoto-san, you're going out?\Professor, I'm home.\I'm late because it took me some time to choose some new books to borrow.\What are you doing?\Eh, what's with that stomach of yours?\It's not'ehehe'! response:	I-It'll be born!
context: Ah, Sakamoto!\Ah, Sakamoto-san, you're going out?\Professor, I'm home.\I'm late because it took me some time to choose some new books to borrow.\What are you doing?\Eh, what's with that stomach of yours?\It's not'ehehe'!\I-It'll be born! response:	No no no, that's not possible.
context: Ah, Sakamoto-san, you're going out?\Professor, I'm home.\I'm late because it took me some time to choose some new books to borrow.\What are you doing?\Eh, what's with that stomach of yours?\It's not'ehehe'!\I-It'll be born!\No no no, that's not possible. response:	It'll be born! It'll be born! It'll be born!
context: Professor, I'm home.\I'm late because it took me some time to choose some new books to borrow.\What are you doing?\Eh, what's with that stomach of yours?\It's not'ehehe'!\I-It'll be born!\No no no, that's not possible.\It'll be born! It'll be born! It'll be born! response:	Um, is this some kind of game?
context: I'm late because it took me some time to choose some new books to borrow.\What are you doing?\Eh, what's with that stomach of yours?\It's not'ehehe'!\I-It'll be born!\No no no, that's not possible.\It'll be born! It'll be born! It'll be born!\Um, is this some kind of game? response:	No it's not! Your little brother is about to be born!
context: What are you doing?\Eh, what's with that stomach of yours?\It's not'ehehe'!\I-It'll be born!\No no no, that's not possible.\It'll be born! It'll be born! It'll be born!\Um, is this some kind of game?\No it's not! Your little brother is about to be born! response:	It's your little brother.
context: Eh, what's with that stomach of yours?\It's not'ehehe'!\I-It'll be born!\No no no, that's not possible.\It'll be born! It'll be born! It'll be born!\Um, is this some kind of game?\No it's not! Your little brother is about to be born!\It's your little brother. response:	T-This isn't good.
context: It's not'ehehe'!\I-It'll be born!\No no no, that's not possible.\It'll be born! It'll be born! It'll be born!\Um, is this some kind of game?\No it's not! Your little brother is about to be born!\It's your little brother.\T-This isn't good. response:	Mio-chan, Mio-chan!
context: I-It'll be born!\No no no, that's not possible.\It'll be born! It'll be born! It'll be born!\Um, is this some kind of game?\No it's not! Your little brother is about to be born!\It's your little brother.\T-This isn't good.\Mio-chan, Mio-chan! response:	What is it?
context: No no no, that's not possible.\It'll be born! It'll be born! It'll be born!\Um, is this some kind of game?\No it's not! Your little brother is about to be born!\It's your little brother.\T-This isn't good.\Mio-chan, Mio-chan!\What is it? response:	Let's play Kokkuri-san!
context: It'll be born! It'll be born! It'll be born!\Um, is this some kind of game?\No it's not! Your little brother is about to be born!\It's your little brother.\T-This isn't good.\Mio-chan, Mio-chan!\What is it?\Let's play Kokkuri-san! response:	Hm? What's that?
context: Um, is this some kind of game?\No it's not! Your little brother is about to be born!\It's your little brother.\T-This isn't good.\Mio-chan, Mio-chan!\What is it?\Let's play Kokkuri-san!\Hm? What's that? response:	Oh, you don't know it?
context: No it's not! Your little brother is about to be born!\It's your little brother.\T-This isn't good.\Mio-chan, Mio-chan!\What is it?\Let's play Kokkuri-san!\Hm? What's that?\Oh, you don't know it? response:	I don't.
context: It's your little brother.\T-This isn't good.\Mio-chan, Mio-chan!\What is it?\Let's play Kokkuri-san!\Hm? What's that?\Oh, you don't know it?\I don't. response:	OK, I'll briefly explain it then.
context: T-This isn't good.\Mio-chan, Mio-chan!\What is it?\Let's play Kokkuri-san!\Hm? What's that?\Oh, you don't know it?\I don't.\OK, I'll briefly explain it then. response:	First you need to prepare a piece of paper by drawing a gate in the middle like this,
context: Mio-chan, Mio-chan!\What is it?\Let's play Kokkuri-san!\Hm? What's that?\Oh, you don't know it?\I don't.\OK, I'll briefly explain it then.\First you need to prepare a piece of paper by drawing a gate in the middle like this, response:	then you write'yes','no' and the 50 Japanese syllabary on the page.
context: What is it?\Let's play Kokkuri-san!\Hm? What's that?\Oh, you don't know it?\I don't.\OK, I'll briefly explain it then.\First you need to prepare a piece of paper by drawing a gate in the middle like this,\then you write'yes','no' and the 50 Japanese syllabary on the page. response:	Mmm.
context: Let's play Kokkuri-san!\Hm? What's that?\Oh, you don't know it?\I don't.\OK, I'll briefly explain it then.\First you need to prepare a piece of paper by drawing a gate in the middle like this,\then you write'yes','no' and the 50 Japanese syllabary on the page.\Mmm. response:	Although in some regions, you're supposed to draw a fried tofu on the paper instead...
context: Hm? What's that?\Oh, you don't know it?\I don't.\OK, I'll briefly explain it then.\First you need to prepare a piece of paper by drawing a gate in the middle like this,\then you write'yes','no' and the 50 Japanese syllabary on the page.\Mmm.\Although in some regions, you're supposed to draw a fried tofu on the paper instead... response:	For now, let's just keep it simple.
context: Oh, you don't know it?\I don't.\OK, I'll briefly explain it then.\First you need to prepare a piece of paper by drawing a gate in the middle like this,\then you write'yes','no' and the 50 Japanese syllabary on the page.\Mmm.\Although in some regions, you're supposed to draw a fried tofu on the paper instead...\For now, let's just keep it simple. response:	Mmm.
context: I don't.\OK, I'll briefly explain it then.\First you need to prepare a piece of paper by drawing a gate in the middle like this,\then you write'yes','no' and the 50 Japanese syllabary on the page.\Mmm.\Although in some regions, you're supposed to draw a fried tofu on the paper instead...\For now, let's just keep it simple.\Mmm. response:	Then, for Kokkuri-san to be able to come in, you open the north-facing window.
context: OK, I'll briefly explain it then.\First you need to prepare a piece of paper by drawing a gate in the middle like this,\then you write'yes','no' and the 50 Japanese syllabary on the page.\Mmm.\Although in some regions, you're supposed to draw a fried tofu on the paper instead...\For now, let's just keep it simple.\Mmm.\Then, for Kokkuri-san to be able to come in, you open the north-facing window. response:	Mmm.
context: First you need to prepare a piece of paper by drawing a gate in the middle like this,\then you write'yes','no' and the 50 Japanese syllabary on the page.\Mmm.\Although in some regions, you're supposed to draw a fried tofu on the paper instead...\For now, let's just keep it simple.\Mmm.\Then, for Kokkuri-san to be able to come in, you open the north-facing window.\Mmm. response:	Then you set this 10-yen coin on the gate.
context: then you write'yes','no' and the 50 Japanese syllabary on the page.\Mmm.\Although in some regions, you're supposed to draw a fried tofu on the paper instead...\For now, let's just keep it simple.\Mmm.\Then, for Kokkuri-san to be able to come in, you open the north-facing window.\Mmm.\Then you set this 10-yen coin on the gate. response:	We put both of our fingers on it and ask a question that you want to know about,
context: Mmm.\Although in some regions, you're supposed to draw a fried tofu on the paper instead...\For now, let's just keep it simple.\Mmm.\Then, for Kokkuri-san to be able to come in, you open the north-facing window.\Mmm.\Then you set this 10-yen coin on the gate.\We put both of our fingers on it and ask a question that you want to know about, response:	such as a person's secret, or who someone likes, or something that's bothering you.
context: Although in some regions, you're supposed to draw a fried tofu on the paper instead...\For now, let's just keep it simple.\Mmm.\Then, for Kokkuri-san to be able to come in, you open the north-facing window.\Mmm.\Then you set this 10-yen coin on the gate.\We put both of our fingers on it and ask a question that you want to know about,\such as a person's secret, or who someone likes, or something that's bothering you. response:	Mmm.
context: For now, let's just keep it simple.\Mmm.\Then, for Kokkuri-san to be able to come in, you open the north-facing window.\Mmm.\Then you set this 10-yen coin on the gate.\We put both of our fingers on it and ask a question that you want to know about,\such as a person's secret, or who someone likes, or something that's bothering you.\Mmm. response:	If you do that, all by itself, the 10-yen coin will move and Kokkuri-san will answer your question.
context: Mmm.\Then, for Kokkuri-san to be able to come in, you open the north-facing window.\Mmm.\Then you set this 10-yen coin on the gate.\We put both of our fingers on it and ask a question that you want to know about,\such as a person's secret, or who someone likes, or something that's bothering you.\Mmm.\If you do that, all by itself, the 10-yen coin will move and Kokkuri-san will answer your question. response:	Isn't it amazing?
context: Then, for Kokkuri-san to be able to come in, you open the north-facing window.\Mmm.\Then you set this 10-yen coin on the gate.\We put both of our fingers on it and ask a question that you want to know about,\such as a person's secret, or who someone likes, or something that's bothering you.\Mmm.\If you do that, all by itself, the 10-yen coin will move and Kokkuri-san will answer your question.\Isn't it amazing? response:	There are some taboos though...
context: Mmm.\Then you set this 10-yen coin on the gate.\We put both of our fingers on it and ask a question that you want to know about,\such as a person's secret, or who someone likes, or something that's bothering you.\Mmm.\If you do that, all by itself, the 10-yen coin will move and Kokkuri-san will answer your question.\Isn't it amazing?\There are some taboos though... response:	First, don't do it by yourself... second, don't mess around when doing it...
context: Then you set this 10-yen coin on the gate.\We put both of our fingers on it and ask a question that you want to know about,\such as a person's secret, or who someone likes, or something that's bothering you.\Mmm.\If you do that, all by itself, the 10-yen coin will move and Kokkuri-san will answer your question.\Isn't it amazing?\There are some taboos though...\First, don't do it by yourself... second, don't mess around when doing it... response:	or else you will be haunted by spirits...
context: We put both of our fingers on it and ask a question that you want to know about,\such as a person's secret, or who someone likes, or something that's bothering you.\Mmm.\If you do that, all by itself, the 10-yen coin will move and Kokkuri-san will answer your question.\Isn't it amazing?\There are some taboos though...\First, don't do it by yourself... second, don't mess around when doing it...\or else you will be haunted by spirits... response:	Also, if you stop halfway through, you will be haunted, so be wary.
context: such as a person's secret, or who someone likes, or something that's bothering you.\Mmm.\If you do that, all by itself, the 10-yen coin will move and Kokkuri-san will answer your question.\Isn't it amazing?\There are some taboos though...\First, don't do it by yourself... second, don't mess around when doing it...\or else you will be haunted by spirits...\Also, if you stop halfway through, you will be haunted, so be wary. response:	I see.
context: Mmm.\If you do that, all by itself, the 10-yen coin will move and Kokkuri-san will answer your question.\Isn't it amazing?\There are some taboos though...\First, don't do it by yourself... second, don't mess around when doing it...\or else you will be haunted by spirits...\Also, if you stop halfway through, you will be haunted, so be wary.\I see. response:	It's something like that.
context: If you do that, all by itself, the 10-yen coin will move and Kokkuri-san will answer your question.\Isn't it amazing?\There are some taboos though...\First, don't do it by yourself... second, don't mess around when doing it...\or else you will be haunted by spirits...\Also, if you stop halfway through, you will be haunted, so be wary.\I see.\It's something like that. response:	It's a pretty dangerous game, don't you think?
context: Isn't it amazing?\There are some taboos though...\First, don't do it by yourself... second, don't mess around when doing it...\or else you will be haunted by spirits...\Also, if you stop halfway through, you will be haunted, so be wary.\I see.\It's something like that.\It's a pretty dangerous game, don't you think? response:	Anyway, why don't you give it a try?
context: There are some taboos though...\First, don't do it by yourself... second, don't mess around when doing it...\or else you will be haunted by spirits...\Also, if you stop halfway through, you will be haunted, so be wary.\I see.\It's something like that.\It's a pretty dangerous game, don't you think?\Anyway, why don't you give it a try? response:	It's OK.
context: First, don't do it by yourself... second, don't mess around when doing it...\or else you will be haunted by spirits...\Also, if you stop halfway through, you will be haunted, so be wary.\I see.\It's something like that.\It's a pretty dangerous game, don't you think?\Anyway, why don't you give it a try?\It's OK. response:	Whaaat?
context: or else you will be haunted by spirits...\Also, if you stop halfway through, you will be haunted, so be wary.\I see.\It's something like that.\It's a pretty dangerous game, don't you think?\Anyway, why don't you give it a try?\It's OK.\Whaaat? response:	Um... well that's all for today.
context: Also, if you stop halfway through, you will be haunted, so be wary.\I see.\It's something like that.\It's a pretty dangerous game, don't you think?\Anyway, why don't you give it a try?\It's OK.\Whaaat?\Um... well that's all for today. response:	Tomorrow we have a mini-test, so everyone please study for it.
context: I see.\It's something like that.\It's a pretty dangerous game, don't you think?\Anyway, why don't you give it a try?\It's OK.\Whaaat?\Um... well that's all for today.\Tomorrow we have a mini-test, so everyone please study for it. response:	Eh? Postpone it, postpone it!
context: It's something like that.\It's a pretty dangerous game, don't you think?\Anyway, why don't you give it a try?\It's OK.\Whaaat?\Um... well that's all for today.\Tomorrow we have a mini-test, so everyone please study for it.\Eh? Postpone it, postpone it! response:	Wouldn't the outcome be exactly the same for you no matter how long it's postponed?
context: It's a pretty dangerous game, don't you think?\Anyway, why don't you give it a try?\It's OK.\Whaaat?\Um... well that's all for today.\Tomorrow we have a mini-test, so everyone please study for it.\Eh? Postpone it, postpone it!\Wouldn't the outcome be exactly the same for you no matter how long it's postponed? response:	Probably.
context: Anyway, why don't you give it a try?\It's OK.\Whaaat?\Um... well that's all for today.\Tomorrow we have a mini-test, so everyone please study for it.\Eh? Postpone it, postpone it!\Wouldn't the outcome be exactly the same for you no matter how long it's postponed?\Probably. response:	Sakurai-sensei.
context: It's OK.\Whaaat?\Um... well that's all for today.\Tomorrow we have a mini-test, so everyone please study for it.\Eh? Postpone it, postpone it!\Wouldn't the outcome be exactly the same for you no matter how long it's postponed?\Probably.\Sakurai-sensei. response:	What is it, Aioi-san?
context: Whaaat?\Um... well that's all for today.\Tomorrow we have a mini-test, so everyone please study for it.\Eh? Postpone it, postpone it!\Wouldn't the outcome be exactly the same for you no matter how long it's postponed?\Probably.\Sakurai-sensei.\What is it, Aioi-san? response:	There's something I want to ask you.
context: Um... well that's all for today.\Tomorrow we have a mini-test, so everyone please study for it.\Eh? Postpone it, postpone it!\Wouldn't the outcome be exactly the same for you no matter how long it's postponed?\Probably.\Sakurai-sensei.\What is it, Aioi-san?\There's something I want to ask you. response:	Yes?
context: Tomorrow we have a mini-test, so everyone please study for it.\Eh? Postpone it, postpone it!\Wouldn't the outcome be exactly the same for you no matter how long it's postponed?\Probably.\Sakurai-sensei.\What is it, Aioi-san?\There's something I want to ask you.\Yes? response:	Um... about the test we had before.
context: Eh? Postpone it, postpone it!\Wouldn't the outcome be exactly the same for you no matter how long it's postponed?\Probably.\Sakurai-sensei.\What is it, Aioi-san?\There's something I want to ask you.\Yes?\Um... about the test we had before. response:	What is this?
context: Wouldn't the outcome be exactly the same for you no matter how long it's postponed?\Probably.\Sakurai-sensei.\What is it, Aioi-san?\There's something I want to ask you.\Yes?\Um... about the test we had before.\What is this? response:	Um... That's a fly.
context: Probably.\Sakurai-sensei.\What is it, Aioi-san?\There's something I want to ask you.\Yes?\Um... about the test we had before.\What is this?\Um... That's a fly. response:	No, not the answer. I'm talking about this thing that looks like it'd vanish pretty easily... did you draw it, Sensei?
context: Sakurai-sensei.\What is it, Aioi-san?\There's something I want to ask you.\Yes?\Um... about the test we had before.\What is this?\Um... That's a fly.\No, not the answer. I'm talking about this thing that looks like it'd vanish pretty easily... did you draw it, Sensei? response:	Yes. I thought that if I included some pictures, the test might be a little easier...
context: What is it, Aioi-san?\There's something I want to ask you.\Yes?\Um... about the test we had before.\What is this?\Um... That's a fly.\No, not the answer. I'm talking about this thing that looks like it'd vanish pretty easily... did you draw it, Sensei?\Yes. I thought that if I included some pictures, the test might be a little easier... response:	You draw very interesting pictures, Sensei.
context: There's something I want to ask you.\Yes?\Um... about the test we had before.\What is this?\Um... That's a fly.\No, not the answer. I'm talking about this thing that looks like it'd vanish pretty easily... did you draw it, Sensei?\Yes. I thought that if I included some pictures, the test might be a little easier...\You draw very interesting pictures, Sensei. response:	I'm sorry. I'm bad at drawing pictures, so it was hard to understand wasn't it?
context: Yes?\Um... about the test we had before.\What is this?\Um... That's a fly.\No, not the answer. I'm talking about this thing that looks like it'd vanish pretty easily... did you draw it, Sensei?\Yes. I thought that if I included some pictures, the test might be a little easier...\You draw very interesting pictures, Sensei.\I'm sorry. I'm bad at drawing pictures, so it was hard to understand wasn't it? response:	Ah! That's right.
context: Um... about the test we had before.\What is this?\Um... That's a fly.\No, not the answer. I'm talking about this thing that looks like it'd vanish pretty easily... did you draw it, Sensei?\Yes. I thought that if I included some pictures, the test might be a little easier...\You draw very interesting pictures, Sensei.\I'm sorry. I'm bad at drawing pictures, so it was hard to understand wasn't it?\Ah! That's right. response:	Could you include a picture that I've drawn next time?
context: What is this?\Um... That's a fly.\No, not the answer. I'm talking about this thing that looks like it'd vanish pretty easily... did you draw it, Sensei?\Yes. I thought that if I included some pictures, the test might be a little easier...\You draw very interesting pictures, Sensei.\I'm sorry. I'm bad at drawing pictures, so it was hard to understand wasn't it?\Ah! That's right.\Could you include a picture that I've drawn next time? response:	I'll draw something really cool!
context: Um... That's a fly.\No, not the answer. I'm talking about this thing that looks like it'd vanish pretty easily... did you draw it, Sensei?\Yes. I thought that if I included some pictures, the test might be a little easier...\You draw very interesting pictures, Sensei.\I'm sorry. I'm bad at drawing pictures, so it was hard to understand wasn't it?\Ah! That's right.\Could you include a picture that I've drawn next time?\I'll draw something really cool! response:	OK.
context: No, not the answer. I'm talking about this thing that looks like it'd vanish pretty easily... did you draw it, Sensei?\Yes. I thought that if I included some pictures, the test might be a little easier...\You draw very interesting pictures, Sensei.\I'm sorry. I'm bad at drawing pictures, so it was hard to understand wasn't it?\Ah! That's right.\Could you include a picture that I've drawn next time?\I'll draw something really cool!\OK. response:	Ah, Mio-chan!
context: Yes. I thought that if I included some pictures, the test might be a little easier...\You draw very interesting pictures, Sensei.\I'm sorry. I'm bad at drawing pictures, so it was hard to understand wasn't it?\Ah! That's right.\Could you include a picture that I've drawn next time?\I'll draw something really cool!\OK.\Ah, Mio-chan! response:	Listen, listen. My picture's going to be in the test.
context: You draw very interesting pictures, Sensei.\I'm sorry. I'm bad at drawing pictures, so it was hard to understand wasn't it?\Ah! That's right.\Could you include a picture that I've drawn next time?\I'll draw something really cool!\OK.\Ah, Mio-chan!\Listen, listen. My picture's going to be in the test. response:	Eh? Why?
context: I'm sorry. I'm bad at drawing pictures, so it was hard to understand wasn't it?\Ah! That's right.\Could you include a picture that I've drawn next time?\I'll draw something really cool!\OK.\Ah, Mio-chan!\Listen, listen. My picture's going to be in the test.\Eh? Why? response:	Sensei said she'll put them in.
context: Ah! That's right.\Could you include a picture that I've drawn next time?\I'll draw something really cool!\OK.\Ah, Mio-chan!\Listen, listen. My picture's going to be in the test.\Eh? Why?\Sensei said she'll put them in. response:	If you draw something right now, she'll definitely put yours in, maybe.
context: Could you include a picture that I've drawn next time?\I'll draw something really cool!\OK.\Ah, Mio-chan!\Listen, listen. My picture's going to be in the test.\Eh? Why?\Sensei said she'll put them in.\If you draw something right now, she'll definitely put yours in, maybe. response:	It's'definitely', but it's still'maybe'?
context: I'll draw something really cool!\OK.\Ah, Mio-chan!\Listen, listen. My picture's going to be in the test.\Eh? Why?\Sensei said she'll put them in.\If you draw something right now, she'll definitely put yours in, maybe.\It's'definitely', but it's still'maybe'? response:	Uh... you're not going to draw something?
context: OK.\Ah, Mio-chan!\Listen, listen. My picture's going to be in the test.\Eh? Why?\Sensei said she'll put them in.\If you draw something right now, she'll definitely put yours in, maybe.\It's'definitely', but it's still'maybe'?\Uh... you're not going to draw something? response:	No, I'm fine. I'll pass on that.
context: Ah, Mio-chan!\Listen, listen. My picture's going to be in the test.\Eh? Why?\Sensei said she'll put them in.\If you draw something right now, she'll definitely put yours in, maybe.\It's'definitely', but it's still'maybe'?\Uh... you're not going to draw something?\No, I'm fine. I'll pass on that. response:	Besides, I have to return this.
context: Listen, listen. My picture's going to be in the test.\Eh? Why?\Sensei said she'll put them in.\If you draw something right now, she'll definitely put yours in, maybe.\It's'definitely', but it's still'maybe'?\Uh... you're not going to draw something?\No, I'm fine. I'll pass on that.\Besides, I have to return this. response:	Oh, really?
context: Eh? Why?\Sensei said she'll put them in.\If you draw something right now, she'll definitely put yours in, maybe.\It's'definitely', but it's still'maybe'?\Uh... you're not going to draw something?\No, I'm fine. I'll pass on that.\Besides, I have to return this.\Oh, really? response:	All right! One cool guy -
context: Sensei said she'll put them in.\If you draw something right now, she'll definitely put yours in, maybe.\It's'definitely', but it's still'maybe'?\Uh... you're not going to draw something?\No, I'm fine. I'll pass on that.\Besides, I have to return this.\Oh, really?\All right! One cool guy - response:	Something like this?
context: If you draw something right now, she'll definitely put yours in, maybe.\It's'definitely', but it's still'maybe'?\Uh... you're not going to draw something?\No, I'm fine. I'll pass on that.\Besides, I have to return this.\Oh, really?\All right! One cool guy -\Something like this? response:	Uwah! He's so cool!
context: It's'definitely', but it's still'maybe'?\Uh... you're not going to draw something?\No, I'm fine. I'll pass on that.\Besides, I have to return this.\Oh, really?\All right! One cool guy -\Something like this?\Uwah! He's so cool! response:	Aioi-san, you're so good at drawing. You have my respect.
context: Uh... you're not going to draw something?\No, I'm fine. I'll pass on that.\Besides, I have to return this.\Oh, really?\All right! One cool guy -\Something like this?\Uwah! He's so cool!\Aioi-san, you're so good at drawing. You have my respect. response:	No, I'm not that good... I'm awesome at it!
context: No, I'm fine. I'll pass on that.\Besides, I have to return this.\Oh, really?\All right! One cool guy -\Something like this?\Uwah! He's so cool!\Aioi-san, you're so good at drawing. You have my respect.\No, I'm not that good... I'm awesome at it! response:	Just kidding.
context: Besides, I have to return this.\Oh, really?\All right! One cool guy -\Something like this?\Uwah! He's so cool!\Aioi-san, you're so good at drawing. You have my respect.\No, I'm not that good... I'm awesome at it!\Just kidding. response:	Incidentally, his name is Samidare George.
context: Oh, really?\All right! One cool guy -\Something like this?\Uwah! He's so cool!\Aioi-san, you're so good at drawing. You have my respect.\No, I'm not that good... I'm awesome at it!\Just kidding.\Incidentally, his name is Samidare George. response:	That's even cooler.
context: All right! One cool guy -\Something like this?\Uwah! He's so cool!\Aioi-san, you're so good at drawing. You have my respect.\No, I'm not that good... I'm awesome at it!\Just kidding.\Incidentally, his name is Samidare George.\That's even cooler. response:	Cool?!
context: Something like this?\Uwah! He's so cool!\Aioi-san, you're so good at drawing. You have my respect.\No, I'm not that good... I'm awesome at it!\Just kidding.\Incidentally, his name is Samidare George.\That's even cooler.\Cool?! response:	Hold on a second you two.
context: Uwah! He's so cool!\Aioi-san, you're so good at drawing. You have my respect.\No, I'm not that good... I'm awesome at it!\Just kidding.\Incidentally, his name is Samidare George.\That's even cooler.\Cool?!\Hold on a second you two. response:	Normally, what you'd call cool is...
context: Aioi-san, you're so good at drawing. You have my respect.\No, I'm not that good... I'm awesome at it!\Just kidding.\Incidentally, his name is Samidare George.\That's even cooler.\Cool?!\Hold on a second you two.\Normally, what you'd call cool is... response:	something like this, right?
context: No, I'm not that good... I'm awesome at it!\Just kidding.\Incidentally, his name is Samidare George.\That's even cooler.\Cool?!\Hold on a second you two.\Normally, what you'd call cool is...\something like this, right? response:	Piss off!
context: Just kidding.\Incidentally, his name is Samidare George.\That's even cooler.\Cool?!\Hold on a second you two.\Normally, what you'd call cool is...\something like this, right?\Piss off! response:	Uwah! Amazing! It's just like a manga.
context: Incidentally, his name is Samidare George.\That's even cooler.\Cool?!\Hold on a second you two.\Normally, what you'd call cool is...\something like this, right?\Piss off!\Uwah! Amazing! It's just like a manga. response:	Naganohara-san, do you draw manga or something?
context: That's even cooler.\Cool?!\Hold on a second you two.\Normally, what you'd call cool is...\something like this, right?\Piss off!\Uwah! Amazing! It's just like a manga.\Naganohara-san, do you draw manga or something? response:	No, well, only a little.
context: Cool?!\Hold on a second you two.\Normally, what you'd call cool is...\something like this, right?\Piss off!\Uwah! Amazing! It's just like a manga.\Naganohara-san, do you draw manga or something?\No, well, only a little. response:	Amazing! Please show me next time.
context: Hold on a second you two.\Normally, what you'd call cool is...\something like this, right?\Piss off!\Uwah! Amazing! It's just like a manga.\Naganohara-san, do you draw manga or something?\No, well, only a little.\Amazing! Please show me next time. response:	That is, well...
context: Normally, what you'd call cool is...\something like this, right?\Piss off!\Uwah! Amazing! It's just like a manga.\Naganohara-san, do you draw manga or something?\No, well, only a little.\Amazing! Please show me next time.\That is, well... response:	Eh? You can't?
context: something like this, right?\Piss off!\Uwah! Amazing! It's just like a manga.\Naganohara-san, do you draw manga or something?\No, well, only a little.\Amazing! Please show me next time.\That is, well...\Eh? You can't? response:	I want to see it. Please show it to me.
context: Piss off!\Uwah! Amazing! It's just like a manga.\Naganohara-san, do you draw manga or something?\No, well, only a little.\Amazing! Please show me next time.\That is, well...\Eh? You can't?\I want to see it. Please show it to me. response:	Eh... ah... but...
context: Uwah! Amazing! It's just like a manga.\Naganohara-san, do you draw manga or something?\No, well, only a little.\Amazing! Please show me next time.\That is, well...\Eh? You can't?\I want to see it. Please show it to me.\Eh... ah... but... response:	Give that back to me!
context: Naganohara-san, do you draw manga or something?\No, well, only a little.\Amazing! Please show me next time.\That is, well...\Eh? You can't?\I want to see it. Please show it to me.\Eh... ah... but...\Give that back to me! response:	Mine are much cooler.
context: No, well, only a little.\Amazing! Please show me next time.\That is, well...\Eh? You can't?\I want to see it. Please show it to me.\Eh... ah... but...\Give that back to me!\Mine are much cooler. response:	You just ripped off mine!
context: Amazing! Please show me next time.\That is, well...\Eh? You can't?\I want to see it. Please show it to me.\Eh... ah... but...\Give that back to me!\Mine are much cooler.\You just ripped off mine! response:	I didn't rip it off.
context: That is, well...\Eh? You can't?\I want to see it. Please show it to me.\Eh... ah... but...\Give that back to me!\Mine are much cooler.\You just ripped off mine!\I didn't rip it off. response:	Yes, you did.
context: Eh? You can't?\I want to see it. Please show it to me.\Eh... ah... but...\Give that back to me!\Mine are much cooler.\You just ripped off mine!\I didn't rip it off.\Yes, you did. response:	This kind of rip-off is known as homage.
context: I want to see it. Please show it to me.\Eh... ah... but...\Give that back to me!\Mine are much cooler.\You just ripped off mine!\I didn't rip it off.\Yes, you did.\This kind of rip-off is known as homage. response:	You just admitted it!
context: Eh... ah... but...\Give that back to me!\Mine are much cooler.\You just ripped off mine!\I didn't rip it off.\Yes, you did.\This kind of rip-off is known as homage.\You just admitted it! response:	Uwah! So cool!
context: Give that back to me!\Mine are much cooler.\You just ripped off mine!\I didn't rip it off.\Yes, you did.\This kind of rip-off is known as homage.\You just admitted it!\Uwah! So cool! response:	Anything works for you?!
context: Mine are much cooler.\You just ripped off mine!\I didn't rip it off.\Yes, you did.\This kind of rip-off is known as homage.\You just admitted it!\Uwah! So cool!\Anything works for you?! response:	Well, how about this?
context: You just ripped off mine!\I didn't rip it off.\Yes, you did.\This kind of rip-off is known as homage.\You just admitted it!\Uwah! So cool!\Anything works for you?!\Well, how about this? response:	Glasses!
context: I didn't rip it off.\Yes, you did.\This kind of rip-off is known as homage.\You just admitted it!\Uwah! So cool!\Anything works for you?!\Well, how about this?\Glasses! response:	An intelligent and cool look that appeals to all women of any era!
context: Yes, you did.\This kind of rip-off is known as homage.\You just admitted it!\Uwah! So cool!\Anything works for you?!\Well, how about this?\Glasses!\An intelligent and cool look that appeals to all women of any era! response:	Glasses, huh?
context: This kind of rip-off is known as homage.\You just admitted it!\Uwah! So cool!\Anything works for you?!\Well, how about this?\Glasses!\An intelligent and cool look that appeals to all women of any era!\Glasses, huh? response:	Is his eyesight bad?
context: You just admitted it!\Uwah! So cool!\Anything works for you?!\Well, how about this?\Glasses!\An intelligent and cool look that appeals to all women of any era!\Glasses, huh?\Is his eyesight bad? response:	He should just wear contacts.
context: Uwah! So cool!\Anything works for you?!\Well, how about this?\Glasses!\An intelligent and cool look that appeals to all women of any era!\Glasses, huh?\Is his eyesight bad?\He should just wear contacts. response:	These two just don't get it!!
context: Anything works for you?!\Well, how about this?\Glasses!\An intelligent and cool look that appeals to all women of any era!\Glasses, huh?\Is his eyesight bad?\He should just wear contacts.\These two just don't get it!! response:	Then I'll do... this!
context: Well, how about this?\Glasses!\An intelligent and cool look that appeals to all women of any era!\Glasses, huh?\Is his eyesight bad?\He should just wear contacts.\These two just don't get it!!\Then I'll do... this! response:	They're underneath his ears!
context: Glasses!\An intelligent and cool look that appeals to all women of any era!\Glasses, huh?\Is his eyesight bad?\He should just wear contacts.\These two just don't get it!!\Then I'll do... this!\They're underneath his ears! response:	Anyhow, this is a rip-off too!
context: An intelligent and cool look that appeals to all women of any era!\Glasses, huh?\Is his eyesight bad?\He should just wear contacts.\These two just don't get it!!\Then I'll do... this!\They're underneath his ears!\Anyhow, this is a rip-off too! response:	Tsk, tsk, tsk... they're sunglasses.
context: Glasses, huh?\Is his eyesight bad?\He should just wear contacts.\These two just don't get it!!\Then I'll do... this!\They're underneath his ears!\Anyhow, this is a rip-off too!\Tsk, tsk, tsk... they're sunglasses. response:	Uwah! So cool.
context: Is his eyesight bad?\He should just wear contacts.\These two just don't get it!!\Then I'll do... this!\They're underneath his ears!\Anyhow, this is a rip-off too!\Tsk, tsk, tsk... they're sunglasses.\Uwah! So cool. response:	You're OK with it?!
context: He should just wear contacts.\These two just don't get it!!\Then I'll do... this!\They're underneath his ears!\Anyhow, this is a rip-off too!\Tsk, tsk, tsk... they're sunglasses.\Uwah! So cool.\You're OK with it?! response:	Then... how about this? A butler!
context: These two just don't get it!!\Then I'll do... this!\They're underneath his ears!\Anyhow, this is a rip-off too!\Tsk, tsk, tsk... they're sunglasses.\Uwah! So cool.\You're OK with it?!\Then... how about this? A butler! response:	From picking you up to serving you tea... you'll feel like a real lady.
context: Then I'll do... this!\They're underneath his ears!\Anyhow, this is a rip-off too!\Tsk, tsk, tsk... they're sunglasses.\Uwah! So cool.\You're OK with it?!\Then... how about this? A butler!\From picking you up to serving you tea... you'll feel like a real lady. response:	Feel the magic of Darjeeling!
context: They're underneath his ears!\Anyhow, this is a rip-off too!\Tsk, tsk, tsk... they're sunglasses.\Uwah! So cool.\You're OK with it?!\Then... how about this? A butler!\From picking you up to serving you tea... you'll feel like a real lady.\Feel the magic of Darjeeling! response:	Glasses again? I'm sorry, I don't really get it.
context: Anyhow, this is a rip-off too!\Tsk, tsk, tsk... they're sunglasses.\Uwah! So cool.\You're OK with it?!\Then... how about this? A butler!\From picking you up to serving you tea... you'll feel like a real lady.\Feel the magic of Darjeeling!\Glasses again? I'm sorry, I don't really get it. response:	She didn't listen to my advice about contacts...
context: Tsk, tsk, tsk... they're sunglasses.\Uwah! So cool.\You're OK with it?!\Then... how about this? A butler!\From picking you up to serving you tea... you'll feel like a real lady.\Feel the magic of Darjeeling!\Glasses again? I'm sorry, I don't really get it.\She didn't listen to my advice about contacts... response:	Mio-chan, you don't get it, do you?
context: Uwah! So cool.\You're OK with it?!\Then... how about this? A butler!\From picking you up to serving you tea... you'll feel like a real lady.\Feel the magic of Darjeeling!\Glasses again? I'm sorry, I don't really get it.\She didn't listen to my advice about contacts...\Mio-chan, you don't get it, do you? response:	You see, what's really cool is...
context: You're OK with it?!\Then... how about this? A butler!\From picking you up to serving you tea... you'll feel like a real lady.\Feel the magic of Darjeeling!\Glasses again? I'm sorry, I don't really get it.\She didn't listen to my advice about contacts...\Mio-chan, you don't get it, do you?\You see, what's really cool is... response:	It's floating!
context: Then... how about this? A butler!\From picking you up to serving you tea... you'll feel like a real lady.\Feel the magic of Darjeeling!\Glasses again? I'm sorry, I don't really get it.\She didn't listen to my advice about contacts...\Mio-chan, you don't get it, do you?\You see, what's really cool is...\It's floating! response:	No, hold on... this... it's running?!
context: From picking you up to serving you tea... you'll feel like a real lady.\Feel the magic of Darjeeling!\Glasses again? I'm sorry, I don't really get it.\She didn't listen to my advice about contacts...\Mio-chan, you don't get it, do you?\You see, what's really cool is...\It's floating!\No, hold on... this... it's running?! response:	Uwah! It looks so fast and cool!
context: Feel the magic of Darjeeling!\Glasses again? I'm sorry, I don't really get it.\She didn't listen to my advice about contacts...\Mio-chan, you don't get it, do you?\You see, what's really cool is...\It's floating!\No, hold on... this... it's running?!\Uwah! It looks so fast and cool! response:	I can't believe this!!!
context: Glasses again? I'm sorry, I don't really get it.\She didn't listen to my advice about contacts...\Mio-chan, you don't get it, do you?\You see, what's really cool is...\It's floating!\No, hold on... this... it's running?!\Uwah! It looks so fast and cool!\I can't believe this!!! response:	What cool is...
context: She didn't listen to my advice about contacts...\Mio-chan, you don't get it, do you?\You see, what's really cool is...\It's floating!\No, hold on... this... it's running?!\Uwah! It looks so fast and cool!\I can't believe this!!!\What cool is... response:	What cool is...
context: Mio-chan, you don't get it, do you?\You see, what's really cool is...\It's floating!\No, hold on... this... it's running?!\Uwah! It looks so fast and cool!\I can't believe this!!!\What cool is...\What cool is... response:	What cool is...
context: You see, what's really cool is...\It's floating!\No, hold on... this... it's running?!\Uwah! It looks so fast and cool!\I can't believe this!!!\What cool is...\What cool is...\What cool is... response:	Normally...
context: It's floating!\No, hold on... this... it's running?!\Uwah! It looks so fast and cool!\I can't believe this!!!\What cool is...\What cool is...\What cool is...\Normally... response:	If you think about it in a normal way...
context: No, hold on... this... it's running?!\Uwah! It looks so fast and cool!\I can't believe this!!!\What cool is...\What cool is...\What cool is...\Normally...\If you think about it in a normal way... response:	What cool is...
context: Uwah! It looks so fast and cool!\I can't believe this!!!\What cool is...\What cool is...\What cool is...\Normally...\If you think about it in a normal way...\What cool is... response:	this, right?
context: I can't believe this!!!\What cool is...\What cool is...\What cool is...\Normally...\If you think about it in a normal way...\What cool is...\this, right? response:	Oh no...
context: What cool is...\What cool is...\What cool is...\Normally...\If you think about it in a normal way...\What cool is...\this, right?\Oh no... response:	Just kidding!
context: What cool is...\What cool is...\Normally...\If you think about it in a normal way...\What cool is...\this, right?\Oh no...\Just kidding! response:	I drew this while I was listening to jazz music.
context: What cool is...\Normally...\If you think about it in a normal way...\What cool is...\this, right?\Oh no...\Just kidding!\I drew this while I was listening to jazz music. response:	Morning!
context: Normally...\If you think about it in a normal way...\What cool is...\this, right?\Oh no...\Just kidding!\I drew this while I was listening to jazz music.\Morning! response:	Ah! Sensei, good morning!
context: If you think about it in a normal way...\What cool is...\this, right?\Oh no...\Just kidding!\I drew this while I was listening to jazz music.\Morning!\Ah! Sensei, good morning! response:	Who are you calling Sensei?!
context: What cool is...\this, right?\Oh no...\Just kidding!\I drew this while I was listening to jazz music.\Morning!\Ah! Sensei, good morning!\Who are you calling Sensei?! response:	Well then, I'll hand out this morning's mini-test, so please pass them around.
context: this, right?\Oh no...\Just kidding!\I drew this while I was listening to jazz music.\Morning!\Ah! Sensei, good morning!\Who are you calling Sensei?!\Well then, I'll hand out this morning's mini-test, so please pass them around. response:	I'm done for...
context: Oh no...\Just kidding!\I drew this while I was listening to jazz music.\Morning!\Ah! Sensei, good morning!\Who are you calling Sensei?!\Well then, I'll hand out this morning's mini-test, so please pass them around.\I'm done for... response:	I wanted to keep secret the fact that I draw.
context: Just kidding!\I drew this while I was listening to jazz music.\Morning!\Ah! Sensei, good morning!\Who are you calling Sensei?!\Well then, I'll hand out this morning's mini-test, so please pass them around.\I'm done for...\I wanted to keep secret the fact that I draw. response:	I can't believe I drew a picture like that...
context: I drew this while I was listening to jazz music.\Morning!\Ah! Sensei, good morning!\Who are you calling Sensei?!\Well then, I'll hand out this morning's mini-test, so please pass them around.\I'm done for...\I wanted to keep secret the fact that I draw.\I can't believe I drew a picture like that... response:	Anyway, even though I lost control, only going to that level was a blessing amongst all the misfortune.
context: Morning!\Ah! Sensei, good morning!\Who are you calling Sensei?!\Well then, I'll hand out this morning's mini-test, so please pass them around.\I'm done for...\I wanted to keep secret the fact that I draw.\I can't believe I drew a picture like that...\Anyway, even though I lost control, only going to that level was a blessing amongst all the misfortune. response:	It was pretty close.
context: Ah! Sensei, good morning!\Who are you calling Sensei?!\Well then, I'll hand out this morning's mini-test, so please pass them around.\I'm done for...\I wanted to keep secret the fact that I draw.\I can't believe I drew a picture like that...\Anyway, even though I lost control, only going to that level was a blessing amongst all the misfortune.\It was pretty close. response:	Yukko's going to tease me for two or three days though...
context: Who are you calling Sensei?!\Well then, I'll hand out this morning's mini-test, so please pass them around.\I'm done for...\I wanted to keep secret the fact that I draw.\I can't believe I drew a picture like that...\Anyway, even though I lost control, only going to that level was a blessing amongst all the misfortune.\It was pretty close.\Yukko's going to tease me for two or three days though... response:	No, no! I have to keep my chin up and move forward.
context: Well then, I'll hand out this morning's mini-test, so please pass them around.\I'm done for...\I wanted to keep secret the fact that I draw.\I can't believe I drew a picture like that...\Anyway, even though I lost control, only going to that level was a blessing amongst all the misfortune.\It was pretty close.\Yukko's going to tease me for two or three days though...\No, no! I have to keep my chin up and move forward. response:	Mio-sensei, hurry up.
context: I'm done for...\I wanted to keep secret the fact that I draw.\I can't believe I drew a picture like that...\Anyway, even though I lost control, only going to that level was a blessing amongst all the misfortune.\It was pretty close.\Yukko's going to tease me for two or three days though...\No, no! I have to keep my chin up and move forward.\Mio-sensei, hurry up. response:	Um... begin!
context: I wanted to keep secret the fact that I draw.\I can't believe I drew a picture like that...\Anyway, even though I lost control, only going to that level was a blessing amongst all the misfortune.\It was pretty close.\Yukko's going to tease me for two or three days though...\No, no! I have to keep my chin up and move forward.\Mio-sensei, hurry up.\Um... begin! response:	Mio-sensei!
context: I can't believe I drew a picture like that...\Anyway, even though I lost control, only going to that level was a blessing amongst all the misfortune.\It was pretty close.\Yukko's going to tease me for two or three days though...\No, no! I have to keep my chin up and move forward.\Mio-sensei, hurry up.\Um... begin!\Mio-sensei! response:	Pleased to meet you, I'm onomatopoeia!
context: Anyway, even though I lost control, only going to that level was a blessing amongst all the misfortune.\It was pretty close.\Yukko's going to tease me for two or three days though...\No, no! I have to keep my chin up and move forward.\Mio-sensei, hurry up.\Um... begin!\Mio-sensei!\Pleased to meet you, I'm onomatopoeia! response:	You can't help but say'Cock-a-doodle-do' in Japanese even though it's not Japanese.
context: It was pretty close.\Yukko's going to tease me for two or three days though...\No, no! I have to keep my chin up and move forward.\Mio-sensei, hurry up.\Um... begin!\Mio-sensei!\Pleased to meet you, I'm onomatopoeia!\You can't help but say'Cock-a-doodle-do' in Japanese even though it's not Japanese. response:	The next Nichijou is the sixth. Look forward to it.