context: It appeared as though humanity would be destroyed by the demons. response:	But a single mage saved them all.
context: It appeared as though humanity would be destroyed by the demons.\But a single mage saved them all. response:	He was called the Wizard King, and he became a legend.
context: It appeared as though humanity would be destroyed by the demons.\But a single mage saved them all.\He was called the Wizard King, and he became a legend. response:	Yuno, we're family, right?
context: It appeared as though humanity would be destroyed by the demons.\But a single mage saved them all.\He was called the Wizard King, and he became a legend.\Yuno, we're family, right? response:	Yeah.
context: It appeared as though humanity would be destroyed by the demons.\But a single mage saved them all.\He was called the Wizard King, and he became a legend.\Yuno, we're family, right?\Yeah. response:	But we don't share the same blood.
context: It appeared as though humanity would be destroyed by the demons.\But a single mage saved them all.\He was called the Wizard King, and he became a legend.\Yuno, we're family, right?\Yeah.\But we don't share the same blood. response:	Yeah.
context: It appeared as though humanity would be destroyed by the demons.\But a single mage saved them all.\He was called the Wizard King, and he became a legend.\Yuno, we're family, right?\Yeah.\But we don't share the same blood.\Yeah. response:	But we're more connected than people who share the same blood.
context: It appeared as though humanity would be destroyed by the demons.\But a single mage saved them all.\He was called the Wizard King, and he became a legend.\Yuno, we're family, right?\Yeah.\But we don't share the same blood.\Yeah.\But we're more connected than people who share the same blood. response:	What brought this on?
context: But a single mage saved them all.\He was called the Wizard King, and he became a legend.\Yuno, we're family, right?\Yeah.\But we don't share the same blood.\Yeah.\But we're more connected than people who share the same blood.\What brought this on? response:	I'm saying...
context: He was called the Wizard King, and he became a legend.\Yuno, we're family, right?\Yeah.\But we don't share the same blood.\Yeah.\But we're more connected than people who share the same blood.\What brought this on?\I'm saying... response:	We don't have any blood relatives,
context: Yuno, we're family, right?\Yeah.\But we don't share the same blood.\Yeah.\But we're more connected than people who share the same blood.\What brought this on?\I'm saying...\We don't have any blood relatives, response:	but all of the friends we've made...
context: Yeah.\But we don't share the same blood.\Yeah.\But we're more connected than people who share the same blood.\What brought this on?\I'm saying...\We don't have any blood relatives,\but all of the friends we've made... response:	And all the friends we're going to make...
context: But we don't share the same blood.\Yeah.\But we're more connected than people who share the same blood.\What brought this on?\I'm saying...\We don't have any blood relatives,\but all of the friends we've made...\And all the friends we're going to make... response:	Let's treat them just like they're family.
context: Yeah.\But we're more connected than people who share the same blood.\What brought this on?\I'm saying...\We don't have any blood relatives,\but all of the friends we've made...\And all the friends we're going to make...\Let's treat them just like they're family. response:	Yeah.
context: But we're more connected than people who share the same blood.\What brought this on?\I'm saying...\We don't have any blood relatives,\but all of the friends we've made...\And all the friends we're going to make...\Let's treat them just like they're family.\Yeah. response:	We're almost there. Once we get through this tunnel...
context: What brought this on?\I'm saying...\We don't have any blood relatives,\but all of the friends we've made...\And all the friends we're going to make...\Let's treat them just like they're family.\Yeah.\We're almost there. Once we get through this tunnel... response:	How amazing!
context: I'm saying...\We don't have any blood relatives,\but all of the friends we've made...\And all the friends we're going to make...\Let's treat them just like they're family.\Yeah.\We're almost there. Once we get through this tunnel...\How amazing! response:	That's all there is to dungeons?
context: We don't have any blood relatives,\but all of the friends we've made...\And all the friends we're going to make...\Let's treat them just like they're family.\Yeah.\We're almost there. Once we get through this tunnel...\How amazing!\That's all there is to dungeons? response:	I wonder how you get in.
context: but all of the friends we've made...\And all the friends we're going to make...\Let's treat them just like they're family.\Yeah.\We're almost there. Once we get through this tunnel...\How amazing!\That's all there is to dungeons?\I wonder how you get in. response:	It appears the Black Bulls aren't here yet.
context: And all the friends we're going to make...\Let's treat them just like they're family.\Yeah.\We're almost there. Once we get through this tunnel...\How amazing!\That's all there is to dungeons?\I wonder how you get in.\It appears the Black Bulls aren't here yet. response:	Of course not. There's no way they'd beat us.
context: Let's treat them just like they're family.\Yeah.\We're almost there. Once we get through this tunnel...\How amazing!\That's all there is to dungeons?\I wonder how you get in.\It appears the Black Bulls aren't here yet.\Of course not. There's no way they'd beat us. response:	Indeed.
context: Yeah.\We're almost there. Once we get through this tunnel...\How amazing!\That's all there is to dungeons?\I wonder how you get in.\It appears the Black Bulls aren't here yet.\Of course not. There's no way they'd beat us.\Indeed. response:	Mimosa!
context: We're almost there. Once we get through this tunnel...\How amazing!\That's all there is to dungeons?\I wonder how you get in.\It appears the Black Bulls aren't here yet.\Of course not. There's no way they'd beat us.\Indeed.\Mimosa! response:	She's an expert at sensing mana, but she didn't notice?
context: How amazing!\That's all there is to dungeons?\I wonder how you get in.\It appears the Black Bulls aren't here yet.\Of course not. There's no way they'd beat us.\Indeed.\Mimosa!\She's an expert at sensing mana, but she didn't notice? response:	That wasn't a trap spell... What is this magic?
context: That's all there is to dungeons?\I wonder how you get in.\It appears the Black Bulls aren't here yet.\Of course not. There's no way they'd beat us.\Indeed.\Mimosa!\She's an expert at sensing mana, but she didn't notice?\That wasn't a trap spell... What is this magic? response:	Who are you?!
context: I wonder how you get in.\It appears the Black Bulls aren't here yet.\Of course not. There's no way they'd beat us.\Indeed.\Mimosa!\She's an expert at sensing mana, but she didn't notice?\That wasn't a trap spell... What is this magic?\Who are you?! response:	Who stands in my way?
context: It appears the Black Bulls aren't here yet.\Of course not. There's no way they'd beat us.\Indeed.\Mimosa!\She's an expert at sensing mana, but she didn't notice?\That wasn't a trap spell... What is this magic?\Who are you?!\Who stands in my way? response:	Move.
context: Of course not. There's no way they'd beat us.\Indeed.\Mimosa!\She's an expert at sensing mana, but she didn't notice?\That wasn't a trap spell... What is this magic?\Who are you?!\Who stands in my way?\Move. response:	Friends you can trust are worth their weight in gold.
context: Indeed.\Mimosa!\She's an expert at sensing mana, but she didn't notice?\That wasn't a trap spell... What is this magic?\Who are you?!\Who stands in my way?\Move.\Friends you can trust are worth their weight in gold. response:	Sorry, but stay there a while and get weaker.
context: Mimosa!\She's an expert at sensing mana, but she didn't notice?\That wasn't a trap spell... What is this magic?\Who are you?!\Who stands in my way?\Move.\Friends you can trust are worth their weight in gold.\Sorry, but stay there a while and get weaker. response:	Win...
context: She's an expert at sensing mana, but she didn't notice?\That wasn't a trap spell... What is this magic?\Who are you?!\Who stands in my way?\Move.\Friends you can trust are worth their weight in gold.\Sorry, but stay there a while and get weaker.\Win... response:	Win...
context: That wasn't a trap spell... What is this magic?\Who are you?!\Who stands in my way?\Move.\Friends you can trust are worth their weight in gold.\Sorry, but stay there a while and get weaker.\Win...\Win... response:	Keep winning, Luck!
context: Who are you?!\Who stands in my way?\Move.\Friends you can trust are worth their weight in gold.\Sorry, but stay there a while and get weaker.\Win...\Win...\Keep winning, Luck! response:	Wait.
context: Who stands in my way?\Move.\Friends you can trust are worth their weight in gold.\Sorry, but stay there a while and get weaker.\Win...\Win...\Keep winning, Luck!\Wait. response:	It's been a while
context: Move.\Friends you can trust are worth their weight in gold.\Sorry, but stay there a while and get weaker.\Win...\Win...\Keep winning, Luck!\Wait.\It's been a while response:	since things actually got interesting.
context: Friends you can trust are worth their weight in gold.\Sorry, but stay there a while and get weaker.\Win...\Win...\Keep winning, Luck!\Wait.\It's been a while\since things actually got interesting. response:	More... More!
context: Sorry, but stay there a while and get weaker.\Win...\Win...\Keep winning, Luck!\Wait.\It's been a while\since things actually got interesting.\More... More! response:	Let's fight some more!
context: Win...\Win...\Keep winning, Luck!\Wait.\It's been a while\since things actually got interesting.\More... More!\Let's fight some more! response:	I'd rather not pluck a bud that's still so young...
context: Win...\Keep winning, Luck!\Wait.\It's been a while\since things actually got interesting.\More... More!\Let's fight some more!\I'd rather not pluck a bud that's still so young... response:	I would always close my eyes
context: Keep winning, Luck!\Wait.\It's been a while\since things actually got interesting.\More... More!\Let's fight some more!\I'd rather not pluck a bud that's still so young...\I would always close my eyes response:	And cower at reality
context: Wait.\It's been a while\since things actually got interesting.\More... More!\Let's fight some more!\I'd rather not pluck a bud that's still so young...\I would always close my eyes\And cower at reality response:	I can't stand the idea
context: It's been a while\since things actually got interesting.\More... More!\Let's fight some more!\I'd rather not pluck a bud that's still so young...\I would always close my eyes\And cower at reality\I can't stand the idea response:	Of just making excuses to give up
context: since things actually got interesting.\More... More!\Let's fight some more!\I'd rather not pluck a bud that's still so young...\I would always close my eyes\And cower at reality\I can't stand the idea\Of just making excuses to give up response:	Stand right there
context: More... More!\Let's fight some more!\I'd rather not pluck a bud that's still so young...\I would always close my eyes\And cower at reality\I can't stand the idea\Of just making excuses to give up\Stand right there response:	I don't want to be near you
context: Let's fight some more!\I'd rather not pluck a bud that's still so young...\I would always close my eyes\And cower at reality\I can't stand the idea\Of just making excuses to give up\Stand right there\I don't want to be near you response:	Any minute now
context: I'd rather not pluck a bud that's still so young...\I would always close my eyes\And cower at reality\I can't stand the idea\Of just making excuses to give up\Stand right there\I don't want to be near you\Any minute now response:	Just wait right there
context: I would always close my eyes\And cower at reality\I can't stand the idea\Of just making excuses to give up\Stand right there\I don't want to be near you\Any minute now\Just wait right there response:	(The decisive battle is still a long way off)
context: And cower at reality\I can't stand the idea\Of just making excuses to give up\Stand right there\I don't want to be near you\Any minute now\Just wait right there\(The decisive battle is still a long way off) response:	Black and blue
context: I can't stand the idea\Of just making excuses to give up\Stand right there\I don't want to be near you\Any minute now\Just wait right there\(The decisive battle is still a long way off)\Black and blue response:	I'll give up on giving up
context: Of just making excuses to give up\Stand right there\I don't want to be near you\Any minute now\Just wait right there\(The decisive battle is still a long way off)\Black and blue\I'll give up on giving up response:	And get the world on my side
context: Stand right there\I don't want to be near you\Any minute now\Just wait right there\(The decisive battle is still a long way off)\Black and blue\I'll give up on giving up\And get the world on my side response:	I'm looking for the reason I'm alive
context: I don't want to be near you\Any minute now\Just wait right there\(The decisive battle is still a long way off)\Black and blue\I'll give up on giving up\And get the world on my side\I'm looking for the reason I'm alive response:	Every time somewhere under this sky
context: Any minute now\Just wait right there\(The decisive battle is still a long way off)\Black and blue\I'll give up on giving up\And get the world on my side\I'm looking for the reason I'm alive\Every time somewhere under this sky response:	Break through the tearful nights
context: Just wait right there\(The decisive battle is still a long way off)\Black and blue\I'll give up on giving up\And get the world on my side\I'm looking for the reason I'm alive\Every time somewhere under this sky\Break through the tearful nights response:	And head where the light shines
context: (The decisive battle is still a long way off)\Black and blue\I'll give up on giving up\And get the world on my side\I'm looking for the reason I'm alive\Every time somewhere under this sky\Break through the tearful nights\And head where the light shines response:	I want to keep my promise
context: Black and blue\I'll give up on giving up\And get the world on my side\I'm looking for the reason I'm alive\Every time somewhere under this sky\Break through the tearful nights\And head where the light shines\I want to keep my promise response:	I'll deliver it to you
context: I'll give up on giving up\And get the world on my side\I'm looking for the reason I'm alive\Every time somewhere under this sky\Break through the tearful nights\And head where the light shines\I want to keep my promise\I'll deliver it to you response:	shape of love
context: And get the world on my side\I'm looking for the reason I'm alive\Every time somewhere under this sky\Break through the tearful nights\And head where the light shines\I want to keep my promise\I'll deliver it to you\shape of love response:	Friends
context: I'm looking for the reason I'm alive\Every time somewhere under this sky\Break through the tearful nights\And head where the light shines\I want to keep my promise\I'll deliver it to you\shape of love\Friends response:	Luck!
context: Every time somewhere under this sky\Break through the tearful nights\And head where the light shines\I want to keep my promise\I'll deliver it to you\shape of love\Friends\Luck! response:	Why can't you do something so simple?
context: Break through the tearful nights\And head where the light shines\I want to keep my promise\I'll deliver it to you\shape of love\Friends\Luck!\Why can't you do something so simple? response:	How many times must I tell you?
context: And head where the light shines\I want to keep my promise\I'll deliver it to you\shape of love\Friends\Luck!\Why can't you do something so simple?\How many times must I tell you? response:	Why are you smiling like that?
context: I want to keep my promise\I'll deliver it to you\shape of love\Friends\Luck!\Why can't you do something so simple?\How many times must I tell you?\Why are you smiling like that? response:	Why can't you cry or get angry?
context: I'll deliver it to you\shape of love\Friends\Luck!\Why can't you do something so simple?\How many times must I tell you?\Why are you smiling like that?\Why can't you cry or get angry? response:	Why were you born that way?!
context: shape of love\Friends\Luck!\Why can't you do something so simple?\How many times must I tell you?\Why are you smiling like that?\Why can't you cry or get angry?\Why were you born that way?! response:	H-Hey...
context: Friends\Luck!\Why can't you do something so simple?\How many times must I tell you?\Why are you smiling like that?\Why can't you cry or get angry?\Why were you born that way?!\H-Hey... response:	You're kidding, right?
context: Luck!\Why can't you do something so simple?\How many times must I tell you?\Why are you smiling like that?\Why can't you cry or get angry?\Why were you born that way?!\H-Hey...\You're kidding, right? response:	One of the common students defeated a noble...
context: Why can't you do something so simple?\How many times must I tell you?\Why are you smiling like that?\Why can't you cry or get angry?\Why were you born that way?!\H-Hey...\You're kidding, right?\One of the common students defeated a noble... response:	That's never happened before in our school's magic exchange competition.
context: How many times must I tell you?\Why are you smiling like that?\Why can't you cry or get angry?\Why were you born that way?!\H-Hey...\You're kidding, right?\One of the common students defeated a noble...\That's never happened before in our school's magic exchange competition. response:	It's not normal for a commoner to beat a noble.
context: Why are you smiling like that?\Why can't you cry or get angry?\Why were you born that way?!\H-Hey...\You're kidding, right?\One of the common students defeated a noble...\That's never happened before in our school's magic exchange competition.\It's not normal for a commoner to beat a noble. response:	Crap, I was picking on him. He might try to get me back.
context: Why can't you cry or get angry?\Why were you born that way?!\H-Hey...\You're kidding, right?\One of the common students defeated a noble...\That's never happened before in our school's magic exchange competition.\It's not normal for a commoner to beat a noble.\Crap, I was picking on him. He might try to get me back. response:	He's always smiling... He's super creepy.
context: Why were you born that way?!\H-Hey...\You're kidding, right?\One of the common students defeated a noble...\That's never happened before in our school's magic exchange competition.\It's not normal for a commoner to beat a noble.\Crap, I was picking on him. He might try to get me back.\He's always smiling... He's super creepy. response:	Don't get involved with him. He'll beat you to a pulp.
context: H-Hey...\You're kidding, right?\One of the common students defeated a noble...\That's never happened before in our school's magic exchange competition.\It's not normal for a commoner to beat a noble.\Crap, I was picking on him. He might try to get me back.\He's always smiling... He's super creepy.\Don't get involved with him. He'll beat you to a pulp. response:	You won against a noble using magic?
context: You're kidding, right?\One of the common students defeated a noble...\That's never happened before in our school's magic exchange competition.\It's not normal for a commoner to beat a noble.\Crap, I was picking on him. He might try to get me back.\He's always smiling... He's super creepy.\Don't get involved with him. He'll beat you to a pulp.\You won against a noble using magic? response:	That's amazing, Luck!
context: One of the common students defeated a noble...\That's never happened before in our school's magic exchange competition.\It's not normal for a commoner to beat a noble.\Crap, I was picking on him. He might try to get me back.\He's always smiling... He's super creepy.\Don't get involved with him. He'll beat you to a pulp.\You won against a noble using magic?\That's amazing, Luck! response:	I had no idea you had such powers!
context: That's never happened before in our school's magic exchange competition.\It's not normal for a commoner to beat a noble.\Crap, I was picking on him. He might try to get me back.\He's always smiling... He's super creepy.\Don't get involved with him. He'll beat you to a pulp.\You won against a noble using magic?\That's amazing, Luck!\I had no idea you had such powers! response:	Normally, no one can beat a noble.
context: It's not normal for a commoner to beat a noble.\Crap, I was picking on him. He might try to get me back.\He's always smiling... He's super creepy.\Don't get involved with him. He'll beat you to a pulp.\You won against a noble using magic?\That's amazing, Luck!\I had no idea you had such powers!\Normally, no one can beat a noble. response:	You must be special!
context: Crap, I was picking on him. He might try to get me back.\He's always smiling... He's super creepy.\Don't get involved with him. He'll beat you to a pulp.\You won against a noble using magic?\That's amazing, Luck!\I had no idea you had such powers!\Normally, no one can beat a noble.\You must be special! response:	Keep winning.
context: He's always smiling... He's super creepy.\Don't get involved with him. He'll beat you to a pulp.\You won against a noble using magic?\That's amazing, Luck!\I had no idea you had such powers!\Normally, no one can beat a noble.\You must be special!\Keep winning. response:	Win, win, and keep on winning with your powers.
context: Don't get involved with him. He'll beat you to a pulp.\You won against a noble using magic?\That's amazing, Luck!\I had no idea you had such powers!\Normally, no one can beat a noble.\You must be special!\Keep winning.\Win, win, and keep on winning with your powers. response:	No one will help you in this world.
context: You won against a noble using magic?\That's amazing, Luck!\I had no idea you had such powers!\Normally, no one can beat a noble.\You must be special!\Keep winning.\Win, win, and keep on winning with your powers.\No one will help you in this world. response:	You must use your own powers.
context: That's amazing, Luck!\I had no idea you had such powers!\Normally, no one can beat a noble.\You must be special!\Keep winning.\Win, win, and keep on winning with your powers.\No one will help you in this world.\You must use your own powers. response:	If that will make you happy, Mother.
context: I had no idea you had such powers!\Normally, no one can beat a noble.\You must be special!\Keep winning.\Win, win, and keep on winning with your powers.\No one will help you in this world.\You must use your own powers.\If that will make you happy, Mother. response:	Win...
context: Normally, no one can beat a noble.\You must be special!\Keep winning.\Win, win, and keep on winning with your powers.\No one will help you in this world.\You must use your own powers.\If that will make you happy, Mother.\Win... response:	So dangerous.
context: You must be special!\Keep winning.\Win, win, and keep on winning with your powers.\No one will help you in this world.\You must use your own powers.\If that will make you happy, Mother.\Win...\So dangerous. response:	You've become faster and sharper.
context: Keep winning.\Win, win, and keep on winning with your powers.\No one will help you in this world.\You must use your own powers.\If that will make you happy, Mother.\Win...\So dangerous.\You've become faster and sharper. response:	Win...
context: Win, win, and keep on winning with your powers.\No one will help you in this world.\You must use your own powers.\If that will make you happy, Mother.\Win...\So dangerous.\You've become faster and sharper.\Win... response:	I'll keep winning!
context: No one will help you in this world.\You must use your own powers.\If that will make you happy, Mother.\Win...\So dangerous.\You've become faster and sharper.\Win...\I'll keep winning! response:	With my powers!
context: You must use your own powers.\If that will make you happy, Mother.\Win...\So dangerous.\You've become faster and sharper.\Win...\I'll keep winning!\With my powers! response:	Sorry, but I can't afford to lose, either.
context: If that will make you happy, Mother.\Win...\So dangerous.\You've become faster and sharper.\Win...\I'll keep winning!\With my powers!\Sorry, but I can't afford to lose, either. response:	Smoke Creation Magic: Binding Cross Prison.
context: Win...\So dangerous.\You've become faster and sharper.\Win...\I'll keep winning!\With my powers!\Sorry, but I can't afford to lose, either.\Smoke Creation Magic: Binding Cross Prison. response:	Solid smoke? I can't move.
context: So dangerous.\You've become faster and sharper.\Win...\I'll keep winning!\With my powers!\Sorry, but I can't afford to lose, either.\Smoke Creation Magic: Binding Cross Prison.\Solid smoke? I can't move. response:	This uses up a lot of magic, so I really didn't want to use it.
context: You've become faster and sharper.\Win...\I'll keep winning!\With my powers!\Sorry, but I can't afford to lose, either.\Smoke Creation Magic: Binding Cross Prison.\Solid smoke? I can't move.\This uses up a lot of magic, so I really didn't want to use it. response:	I'm out of gas.
context: Win...\I'll keep winning!\With my powers!\Sorry, but I can't afford to lose, either.\Smoke Creation Magic: Binding Cross Prison.\Solid smoke? I can't move.\This uses up a lot of magic, so I really didn't want to use it.\I'm out of gas. response:	You won't be able to zip around anymore, kid.
context: I'll keep winning!\With my powers!\Sorry, but I can't afford to lose, either.\Smoke Creation Magic: Binding Cross Prison.\Solid smoke? I can't move.\This uses up a lot of magic, so I really didn't want to use it.\I'm out of gas.\You won't be able to zip around anymore, kid. response:	Now, then... I wonder how our kid is doing.
context: With my powers!\Sorry, but I can't afford to lose, either.\Smoke Creation Magic: Binding Cross Prison.\Solid smoke? I can't move.\This uses up a lot of magic, so I really didn't want to use it.\I'm out of gas.\You won't be able to zip around anymore, kid.\Now, then... I wonder how our kid is doing. response:	Ouchie!
context: Sorry, but I can't afford to lose, either.\Smoke Creation Magic: Binding Cross Prison.\Solid smoke? I can't move.\This uses up a lot of magic, so I really didn't want to use it.\I'm out of gas.\You won't be able to zip around anymore, kid.\Now, then... I wonder how our kid is doing.\Ouchie! response:	He's not very good at communicating...
context: Smoke Creation Magic: Binding Cross Prison.\Solid smoke? I can't move.\This uses up a lot of magic, so I really didn't want to use it.\I'm out of gas.\You won't be able to zip around anymore, kid.\Now, then... I wonder how our kid is doing.\Ouchie!\He's not very good at communicating... response:	Maybe it's the generation gap?
context: Solid smoke? I can't move.\This uses up a lot of magic, so I really didn't want to use it.\I'm out of gas.\You won't be able to zip around anymore, kid.\Now, then... I wonder how our kid is doing.\Ouchie!\He's not very good at communicating...\Maybe it's the generation gap? response:	Dream-Healing Flower Cradle.
context: This uses up a lot of magic, so I really didn't want to use it.\I'm out of gas.\You won't be able to zip around anymore, kid.\Now, then... I wonder how our kid is doing.\Ouchie!\He's not very good at communicating...\Maybe it's the generation gap?\Dream-Healing Flower Cradle. response:	I'm so sorry... I'm supposed to be the healer, and I went down first.
context: I'm out of gas.\You won't be able to zip around anymore, kid.\Now, then... I wonder how our kid is doing.\Ouchie!\He's not very good at communicating...\Maybe it's the generation gap?\Dream-Healing Flower Cradle.\I'm so sorry... I'm supposed to be the healer, and I went down first. response:	Don't think about unnecessary things. Right now, concentrate on healing yourself.
context: You won't be able to zip around anymore, kid.\Now, then... I wonder how our kid is doing.\Ouchie!\He's not very good at communicating...\Maybe it's the generation gap?\Dream-Healing Flower Cradle.\I'm so sorry... I'm supposed to be the healer, and I went down first.\Don't think about unnecessary things. Right now, concentrate on healing yourself. response:	That crest... Is he one of the invading mages from the Diamond Kingdom?
context: Now, then... I wonder how our kid is doing.\Ouchie!\He's not very good at communicating...\Maybe it's the generation gap?\Dream-Healing Flower Cradle.\I'm so sorry... I'm supposed to be the healer, and I went down first.\Don't think about unnecessary things. Right now, concentrate on healing yourself.\That crest... Is he one of the invading mages from the Diamond Kingdom? response:	You scoundrel!
context: Ouchie!\He's not very good at communicating...\Maybe it's the generation gap?\Dream-Healing Flower Cradle.\I'm so sorry... I'm supposed to be the healer, and I went down first.\Don't think about unnecessary things. Right now, concentrate on healing yourself.\That crest... Is he one of the invading mages from the Diamond Kingdom?\You scoundrel! response:	You dare attack someone from behind? Is that something a warrior should do?
context: He's not very good at communicating...\Maybe it's the generation gap?\Dream-Healing Flower Cradle.\I'm so sorry... I'm supposed to be the healer, and I went down first.\Don't think about unnecessary things. Right now, concentrate on healing yourself.\That crest... Is he one of the invading mages from the Diamond Kingdom?\You scoundrel!\You dare attack someone from behind? Is that something a warrior should do? response:	I don't know what you're talking about.
context: Maybe it's the generation gap?\Dream-Healing Flower Cradle.\I'm so sorry... I'm supposed to be the healer, and I went down first.\Don't think about unnecessary things. Right now, concentrate on healing yourself.\That crest... Is he one of the invading mages from the Diamond Kingdom?\You scoundrel!\You dare attack someone from behind? Is that something a warrior should do?\I don't know what you're talking about. response:	What?
context: Dream-Healing Flower Cradle.\I'm so sorry... I'm supposed to be the healer, and I went down first.\Don't think about unnecessary things. Right now, concentrate on healing yourself.\That crest... Is he one of the invading mages from the Diamond Kingdom?\You scoundrel!\You dare attack someone from behind? Is that something a warrior should do?\I don't know what you're talking about.\What? response:	You're all the same. Just pebbles by the wayside.
context: I'm so sorry... I'm supposed to be the healer, and I went down first.\Don't think about unnecessary things. Right now, concentrate on healing yourself.\That crest... Is he one of the invading mages from the Diamond Kingdom?\You scoundrel!\You dare attack someone from behind? Is that something a warrior should do?\I don't know what you're talking about.\What?\You're all the same. Just pebbles by the wayside. response:	Back me up, Yuno!
context: Don't think about unnecessary things. Right now, concentrate on healing yourself.\That crest... Is he one of the invading mages from the Diamond Kingdom?\You scoundrel!\You dare attack someone from behind? Is that something a warrior should do?\I don't know what you're talking about.\What?\You're all the same. Just pebbles by the wayside.\Back me up, Yuno! response:	Right.
context: That crest... Is he one of the invading mages from the Diamond Kingdom?\You scoundrel!\You dare attack someone from behind? Is that something a warrior should do?\I don't know what you're talking about.\What?\You're all the same. Just pebbles by the wayside.\Back me up, Yuno!\Right. response:	You Diamond scum! I'll show you the true power of Clover's Golden Dawn!
context: You scoundrel!\You dare attack someone from behind? Is that something a warrior should do?\I don't know what you're talking about.\What?\You're all the same. Just pebbles by the wayside.\Back me up, Yuno!\Right.\You Diamond scum! I'll show you the true power of Clover's Golden Dawn! response:	All right! This path is a cinch to go down!
context: You dare attack someone from behind? Is that something a warrior should do?\I don't know what you're talking about.\What?\You're all the same. Just pebbles by the wayside.\Back me up, Yuno!\Right.\You Diamond scum! I'll show you the true power of Clover's Golden Dawn!\All right! This path is a cinch to go down! response:	The mana is getting denser.
context: I don't know what you're talking about.\What?\You're all the same. Just pebbles by the wayside.\Back me up, Yuno!\Right.\You Diamond scum! I'll show you the true power of Clover's Golden Dawn!\All right! This path is a cinch to go down!\The mana is getting denser. response:	Is the treasure chamber really this way?
context: What?\You're all the same. Just pebbles by the wayside.\Back me up, Yuno!\Right.\You Diamond scum! I'll show you the true power of Clover's Golden Dawn!\All right! This path is a cinch to go down!\The mana is getting denser.\Is the treasure chamber really this way? response:	Whoa... What's wrong?
context: You're all the same. Just pebbles by the wayside.\Back me up, Yuno!\Right.\You Diamond scum! I'll show you the true power of Clover's Golden Dawn!\All right! This path is a cinch to go down!\The mana is getting denser.\Is the treasure chamber really this way?\Whoa... What's wrong? response:	This magic is probably Luck's. I think he's fighting.
context: Back me up, Yuno!\Right.\You Diamond scum! I'll show you the true power of Clover's Golden Dawn!\All right! This path is a cinch to go down!\The mana is getting denser.\Is the treasure chamber really this way?\Whoa... What's wrong?\This magic is probably Luck's. I think he's fighting. response:	Seriously?
context: Right.\You Diamond scum! I'll show you the true power of Clover's Golden Dawn!\All right! This path is a cinch to go down!\The mana is getting denser.\Is the treasure chamber really this way?\Whoa... What's wrong?\This magic is probably Luck's. I think he's fighting.\Seriously? response:	I wonder if that means the enemy really did invade.
context: You Diamond scum! I'll show you the true power of Clover's Golden Dawn!\All right! This path is a cinch to go down!\The mana is getting denser.\Is the treasure chamber really this way?\Whoa... What's wrong?\This magic is probably Luck's. I think he's fighting.\Seriously?\I wonder if that means the enemy really did invade. response:	The enemy? We have to go help him out!
context: All right! This path is a cinch to go down!\The mana is getting denser.\Is the treasure chamber really this way?\Whoa... What's wrong?\This magic is probably Luck's. I think he's fighting.\Seriously?\I wonder if that means the enemy really did invade.\The enemy? We have to go help him out! response:	But...
context: The mana is getting denser.\Is the treasure chamber really this way?\Whoa... What's wrong?\This magic is probably Luck's. I think he's fighting.\Seriously?\I wonder if that means the enemy really did invade.\The enemy? We have to go help him out!\But... response:	Maybe it's better to just leave the fighting to Luck.
context: Is the treasure chamber really this way?\Whoa... What's wrong?\This magic is probably Luck's. I think he's fighting.\Seriously?\I wonder if that means the enemy really did invade.\The enemy? We have to go help him out!\But...\Maybe it's better to just leave the fighting to Luck. response:	If the enemy really got in, I'm sure they're after the treasure chamber.
context: Whoa... What's wrong?\This magic is probably Luck's. I think he's fighting.\Seriously?\I wonder if that means the enemy really did invade.\The enemy? We have to go help him out!\But...\Maybe it's better to just leave the fighting to Luck.\If the enemy really got in, I'm sure they're after the treasure chamber. response:	It might be better to head over there first.
context: This magic is probably Luck's. I think he's fighting.\Seriously?\I wonder if that means the enemy really did invade.\The enemy? We have to go help him out!\But...\Maybe it's better to just leave the fighting to Luck.\If the enemy really got in, I'm sure they're after the treasure chamber.\It might be better to head over there first. response:	We need to take care of this mission fast so Diamond's people won't steal anything.
context: Seriously?\I wonder if that means the enemy really did invade.\The enemy? We have to go help him out!\But...\Maybe it's better to just leave the fighting to Luck.\If the enemy really got in, I'm sure they're after the treasure chamber.\It might be better to head over there first.\We need to take care of this mission fast so Diamond's people won't steal anything. response:	At this rate, the Golden Dawn will get ahead of us, too.
context: I wonder if that means the enemy really did invade.\The enemy? We have to go help him out!\But...\Maybe it's better to just leave the fighting to Luck.\If the enemy really got in, I'm sure they're after the treasure chamber.\It might be better to head over there first.\We need to take care of this mission fast so Diamond's people won't steal anything.\At this rate, the Golden Dawn will get ahead of us, too. response:	Win... I have to keep winning with my powers...
context: The enemy? We have to go help him out!\But...\Maybe it's better to just leave the fighting to Luck.\If the enemy really got in, I'm sure they're after the treasure chamber.\It might be better to head over there first.\We need to take care of this mission fast so Diamond's people won't steal anything.\At this rate, the Golden Dawn will get ahead of us, too.\Win... I have to keep winning with my powers... response:	Looks like there's something tying you down.
context: But...\Maybe it's better to just leave the fighting to Luck.\If the enemy really got in, I'm sure they're after the treasure chamber.\It might be better to head over there first.\We need to take care of this mission fast so Diamond's people won't steal anything.\At this rate, the Golden Dawn will get ahead of us, too.\Win... I have to keep winning with my powers...\Looks like there's something tying you down. response:	What I want... is going away...
context: Maybe it's better to just leave the fighting to Luck.\If the enemy really got in, I'm sure they're after the treasure chamber.\It might be better to head over there first.\We need to take care of this mission fast so Diamond's people won't steal anything.\At this rate, the Golden Dawn will get ahead of us, too.\Win... I have to keep winning with my powers...\Looks like there's something tying you down.\What I want... is going away... response:	Huh? What was the thing I wanted?
context: If the enemy really got in, I'm sure they're after the treasure chamber.\It might be better to head over there first.\We need to take care of this mission fast so Diamond's people won't steal anything.\At this rate, the Golden Dawn will get ahead of us, too.\Win... I have to keep winning with my powers...\Looks like there's something tying you down.\What I want... is going away...\Huh? What was the thing I wanted? response:	He's using such powerful attacks without a grimoire.
context: It might be better to head over there first.\We need to take care of this mission fast so Diamond's people won't steal anything.\At this rate, the Golden Dawn will get ahead of us, too.\Win... I have to keep winning with my powers...\Looks like there's something tying you down.\What I want... is going away...\Huh? What was the thing I wanted?\He's using such powerful attacks without a grimoire. response:	Not only that, it doesn't appear that he's losing any magic.
context: We need to take care of this mission fast so Diamond's people won't steal anything.\At this rate, the Golden Dawn will get ahead of us, too.\Win... I have to keep winning with my powers...\Looks like there's something tying you down.\What I want... is going away...\Huh? What was the thing I wanted?\He's using such powerful attacks without a grimoire.\Not only that, it doesn't appear that he's losing any magic. response:	If this goes on...
context: At this rate, the Golden Dawn will get ahead of us, too.\Win... I have to keep winning with my powers...\Looks like there's something tying you down.\What I want... is going away...\Huh? What was the thing I wanted?\He's using such powerful attacks without a grimoire.\Not only that, it doesn't appear that he's losing any magic.\If this goes on... response:	Yuno! You head to the treasure chamber while I'm fighting him!
context: Win... I have to keep winning with my powers...\Looks like there's something tying you down.\What I want... is going away...\Huh? What was the thing I wanted?\He's using such powerful attacks without a grimoire.\Not only that, it doesn't appear that he's losing any magic.\If this goes on...\Yuno! You head to the treasure chamber while I'm fighting him! response:	He's strong. If you fight him without support, even you won't...
context: Looks like there's something tying you down.\What I want... is going away...\Huh? What was the thing I wanted?\He's using such powerful attacks without a grimoire.\Not only that, it doesn't appear that he's losing any magic.\If this goes on...\Yuno! You head to the treasure chamber while I'm fighting him!\He's strong. If you fight him without support, even you won't... response:	Just hurry up and go!
context: What I want... is going away...\Huh? What was the thing I wanted?\He's using such powerful attacks without a grimoire.\Not only that, it doesn't appear that he's losing any magic.\If this goes on...\Yuno! You head to the treasure chamber while I'm fighting him!\He's strong. If you fight him without support, even you won't...\Just hurry up and go! response:	Frankly, I'd rather not leave this to a peasant like you!
context: Huh? What was the thing I wanted?\He's using such powerful attacks without a grimoire.\Not only that, it doesn't appear that he's losing any magic.\If this goes on...\Yuno! You head to the treasure chamber while I'm fighting him!\He's strong. If you fight him without support, even you won't...\Just hurry up and go!\Frankly, I'd rather not leave this to a peasant like you! response:	But it's for our kingdom! Fulfill our duty!
context: He's using such powerful attacks without a grimoire.\Not only that, it doesn't appear that he's losing any magic.\If this goes on...\Yuno! You head to the treasure chamber while I'm fighting him!\He's strong. If you fight him without support, even you won't...\Just hurry up and go!\Frankly, I'd rather not leave this to a peasant like you!\But it's for our kingdom! Fulfill our duty! response:	That's right, you fool.
context: Not only that, it doesn't appear that he's losing any magic.\If this goes on...\Yuno! You head to the treasure chamber while I'm fighting him!\He's strong. If you fight him without support, even you won't...\Just hurry up and go!\Frankly, I'd rather not leave this to a peasant like you!\But it's for our kingdom! Fulfill our duty!\That's right, you fool. response:	Curses!
context: If this goes on...\Yuno! You head to the treasure chamber while I'm fighting him!\He's strong. If you fight him without support, even you won't...\Just hurry up and go!\Frankly, I'd rather not leave this to a peasant like you!\But it's for our kingdom! Fulfill our duty!\That's right, you fool.\Curses! response:	I'll set you free...
context: Yuno! You head to the treasure chamber while I'm fighting him!\He's strong. If you fight him without support, even you won't...\Just hurry up and go!\Frankly, I'd rather not leave this to a peasant like you!\But it's for our kingdom! Fulfill our duty!\That's right, you fool.\Curses!\I'll set you free... response:	Yuno, we're family, right?
context: He's strong. If you fight him without support, even you won't...\Just hurry up and go!\Frankly, I'd rather not leave this to a peasant like you!\But it's for our kingdom! Fulfill our duty!\That's right, you fool.\Curses!\I'll set you free...\Yuno, we're family, right? response:	But we're more connected than people who share the same blood.
context: Just hurry up and go!\Frankly, I'd rather not leave this to a peasant like you!\But it's for our kingdom! Fulfill our duty!\That's right, you fool.\Curses!\I'll set you free...\Yuno, we're family, right?\But we're more connected than people who share the same blood. response:	Looks like we've got another lively one.
context: Frankly, I'd rather not leave this to a peasant like you!\But it's for our kingdom! Fulfill our duty!\That's right, you fool.\Curses!\I'll set you free...\Yuno, we're family, right?\But we're more connected than people who share the same blood.\Looks like we've got another lively one. response:	What brought this on?
context: But it's for our kingdom! Fulfill our duty!\That's right, you fool.\Curses!\I'll set you free...\Yuno, we're family, right?\But we're more connected than people who share the same blood.\Looks like we've got another lively one.\What brought this on? response:	Why did you come back?!
context: That's right, you fool.\Curses!\I'll set you free...\Yuno, we're family, right?\But we're more connected than people who share the same blood.\Looks like we've got another lively one.\What brought this on?\Why did you come back?! response:	I'm saying...
context: Curses!\I'll set you free...\Yuno, we're family, right?\But we're more connected than people who share the same blood.\Looks like we've got another lively one.\What brought this on?\Why did you come back?!\I'm saying... response:	And who might you be?
context: I'll set you free...\Yuno, we're family, right?\But we're more connected than people who share the same blood.\Looks like we've got another lively one.\What brought this on?\Why did you come back?!\I'm saying...\And who might you be? response:	I'm...
context: Yuno, we're family, right?\But we're more connected than people who share the same blood.\Looks like we've got another lively one.\What brought this on?\Why did you come back?!\I'm saying...\And who might you be?\I'm... response:	We don't have any blood relatives,
context: But we're more connected than people who share the same blood.\Looks like we've got another lively one.\What brought this on?\Why did you come back?!\I'm saying...\And who might you be?\I'm...\We don't have any blood relatives, response:	but all of the friends we've made...
context: Looks like we've got another lively one.\What brought this on?\Why did you come back?!\I'm saying...\And who might you be?\I'm...\We don't have any blood relatives,\but all of the friends we've made... response:	You should be concentrating on the mission!
context: What brought this on?\Why did you come back?!\I'm saying...\And who might you be?\I'm...\We don't have any blood relatives,\but all of the friends we've made...\You should be concentrating on the mission! response:	And all the friends we're going to make...
context: Why did you come back?!\I'm saying...\And who might you be?\I'm...\We don't have any blood relatives,\but all of the friends we've made...\You should be concentrating on the mission!\And all the friends we're going to make... response:	Let's treat them just like they're family.
context: I'm saying...\And who might you be?\I'm...\We don't have any blood relatives,\but all of the friends we've made...\You should be concentrating on the mission!\And all the friends we're going to make...\Let's treat them just like they're family. response:	No...
context: And who might you be?\I'm...\We don't have any blood relatives,\but all of the friends we've made...\You should be concentrating on the mission!\And all the friends we're going to make...\Let's treat them just like they're family.\No... response:	We're friends!
context: I'm...\We don't have any blood relatives,\but all of the friends we've made...\You should be concentrating on the mission!\And all the friends we're going to make...\Let's treat them just like they're family.\No...\We're friends! response:	Yuno! You head to the treasure chamber while I'm fighting him!
context: We don't have any blood relatives,\but all of the friends we've made...\You should be concentrating on the mission!\And all the friends we're going to make...\Let's treat them just like they're family.\No...\We're friends!\Yuno! You head to the treasure chamber while I'm fighting him! response:	That's right, you fool.
context: but all of the friends we've made...\You should be concentrating on the mission!\And all the friends we're going to make...\Let's treat them just like they're family.\No...\We're friends!\Yuno! You head to the treasure chamber while I'm fighting him!\That's right, you fool. response:	Curses!
context: You should be concentrating on the mission!\And all the friends we're going to make...\Let's treat them just like they're family.\No...\We're friends!\Yuno! You head to the treasure chamber while I'm fighting him!\That's right, you fool.\Curses! response:	I'll set you free...
context: And all the friends we're going to make...\Let's treat them just like they're family.\No...\We're friends!\Yuno! You head to the treasure chamber while I'm fighting him!\That's right, you fool.\Curses!\I'll set you free... response:	Why did you come back, you fool?!
context: Let's treat them just like they're family.\No...\We're friends!\Yuno! You head to the treasure chamber while I'm fighting him!\That's right, you fool.\Curses!\I'll set you free...\Why did you come back, you fool?! response:	You need to hurry up and get to the treasure chamber,
context: No...\We're friends!\Yuno! You head to the treasure chamber while I'm fighting him!\That's right, you fool.\Curses!\I'll set you free...\Why did you come back, you fool?!\You need to hurry up and get to the treasure chamber, response:	for the sake of the Clover Kingdom!
context: We're friends!\Yuno! You head to the treasure chamber while I'm fighting him!\That's right, you fool.\Curses!\I'll set you free...\Why did you come back, you fool?!\You need to hurry up and get to the treasure chamber,\for the sake of the Clover Kingdom! response:	Let's defeat him and go together.
context: Yuno! You head to the treasure chamber while I'm fighting him!\That's right, you fool.\Curses!\I'll set you free...\Why did you come back, you fool?!\You need to hurry up and get to the treasure chamber,\for the sake of the Clover Kingdom!\Let's defeat him and go together. response:	All three of us!
context: That's right, you fool.\Curses!\I'll set you free...\Why did you come back, you fool?!\You need to hurry up and get to the treasure chamber,\for the sake of the Clover Kingdom!\Let's defeat him and go together.\All three of us! response:	Now you're gonna have to face us, old man!
context: Curses!\I'll set you free...\Why did you come back, you fool?!\You need to hurry up and get to the treasure chamber,\for the sake of the Clover Kingdom!\Let's defeat him and go together.\All three of us!\Now you're gonna have to face us, old man! response:	Oh, dear... Having your friends show up is definitely not in my favor.
context: I'll set you free...\Why did you come back, you fool?!\You need to hurry up and get to the treasure chamber,\for the sake of the Clover Kingdom!\Let's defeat him and go together.\All three of us!\Now you're gonna have to face us, old man!\Oh, dear... Having your friends show up is definitely not in my favor. response:	Apparently, she just suddenly dropped dead.
context: Why did you come back, you fool?!\You need to hurry up and get to the treasure chamber,\for the sake of the Clover Kingdom!\Let's defeat him and go together.\All three of us!\Now you're gonna have to face us, old man!\Oh, dear... Having your friends show up is definitely not in my favor.\Apparently, she just suddenly dropped dead. response:	She always seemed to be under a lot of stress.
context: You need to hurry up and get to the treasure chamber,\for the sake of the Clover Kingdom!\Let's defeat him and go together.\All three of us!\Now you're gonna have to face us, old man!\Oh, dear... Having your friends show up is definitely not in my favor.\Apparently, she just suddenly dropped dead.\She always seemed to be under a lot of stress. response:	And now her kid's all alone... How awful.
context: for the sake of the Clover Kingdom!\Let's defeat him and go together.\All three of us!\Now you're gonna have to face us, old man!\Oh, dear... Having your friends show up is definitely not in my favor.\Apparently, she just suddenly dropped dead.\She always seemed to be under a lot of stress.\And now her kid's all alone... How awful. response:	Well, I'm not so sure. Her kid's sort of weird.
context: Let's defeat him and go together.\All three of us!\Now you're gonna have to face us, old man!\Oh, dear... Having your friends show up is definitely not in my favor.\Apparently, she just suddenly dropped dead.\She always seemed to be under a lot of stress.\And now her kid's all alone... How awful.\Well, I'm not so sure. Her kid's sort of weird. response:	Despite the fact that his mother just died...
context: All three of us!\Now you're gonna have to face us, old man!\Oh, dear... Having your friends show up is definitely not in my favor.\Apparently, she just suddenly dropped dead.\She always seemed to be under a lot of stress.\And now her kid's all alone... How awful.\Well, I'm not so sure. Her kid's sort of weird.\Despite the fact that his mother just died... response:	He's...
context: Now you're gonna have to face us, old man!\Oh, dear... Having your friends show up is definitely not in my favor.\Apparently, she just suddenly dropped dead.\She always seemed to be under a lot of stress.\And now her kid's all alone... How awful.\Well, I'm not so sure. Her kid's sort of weird.\Despite the fact that his mother just died...\He's... response:	Luck?
context: Oh, dear... Having your friends show up is definitely not in my favor.\Apparently, she just suddenly dropped dead.\She always seemed to be under a lot of stress.\And now her kid's all alone... How awful.\Well, I'm not so sure. Her kid's sort of weird.\Despite the fact that his mother just died...\He's...\Luck? response:	He's my prey.
context: Apparently, she just suddenly dropped dead.\She always seemed to be under a lot of stress.\And now her kid's all alone... How awful.\Well, I'm not so sure. Her kid's sort of weird.\Despite the fact that his mother just died...\He's...\Luck?\He's my prey. response:	Win...
context: She always seemed to be under a lot of stress.\And now her kid's all alone... How awful.\Well, I'm not so sure. Her kid's sort of weird.\Despite the fact that his mother just died...\He's...\Luck?\He's my prey.\Win... response:	I'm going to win and keep offering those victories to my mom.
context: And now her kid's all alone... How awful.\Well, I'm not so sure. Her kid's sort of weird.\Despite the fact that his mother just died...\He's...\Luck?\He's my prey.\Win...\I'm going to win and keep offering those victories to my mom. response:	I'll take care of him myself.
context: Well, I'm not so sure. Her kid's sort of weird.\Despite the fact that his mother just died...\He's...\Luck?\He's my prey.\Win...\I'm going to win and keep offering those victories to my mom.\I'll take care of him myself. response:	I don't need any friends. Just my powers...
context: Despite the fact that his mother just died...\He's...\Luck?\He's my prey.\Win...\I'm going to win and keep offering those victories to my mom.\I'll take care of him myself.\I don't need any friends. Just my powers... response:	Hey, what are you
context: He's...\Luck?\He's my prey.\Win...\I'm going to win and keep offering those victories to my mom.\I'll take care of him myself.\I don't need any friends. Just my powers...\Hey, what are you response:	Otherwise, Mom won't accept me.
context: Luck?\He's my prey.\Win...\I'm going to win and keep offering those victories to my mom.\I'll take care of him myself.\I don't need any friends. Just my powers...\Hey, what are you\Otherwise, Mom won't accept me. response:	Have it your way.
context: He's my prey.\Win...\I'm going to win and keep offering those victories to my mom.\I'll take care of him myself.\I don't need any friends. Just my powers...\Hey, what are you\Otherwise, Mom won't accept me.\Have it your way. response:	Hey!
context: Win...\I'm going to win and keep offering those victories to my mom.\I'll take care of him myself.\I don't need any friends. Just my powers...\Hey, what are you\Otherwise, Mom won't accept me.\Have it your way.\Hey! response:	Guess I shouldn't be holding back anymore.
context: I'm going to win and keep offering those victories to my mom.\I'll take care of him myself.\I don't need any friends. Just my powers...\Hey, what are you\Otherwise, Mom won't accept me.\Have it your way.\Hey!\Guess I shouldn't be holding back anymore. response:	make Mom accept me...
context: I'll take care of him myself.\I don't need any friends. Just my powers...\Hey, what are you\Otherwise, Mom won't accept me.\Have it your way.\Hey!\Guess I shouldn't be holding back anymore.\make Mom accept me... response:	or I'll be all alone!
context: I don't need any friends. Just my powers...\Hey, what are you\Otherwise, Mom won't accept me.\Have it your way.\Hey!\Guess I shouldn't be holding back anymore.\make Mom accept me...\or I'll be all alone! response:	Do whatever you want! And I'll do what I want!
context: Hey, what are you\Otherwise, Mom won't accept me.\Have it your way.\Hey!\Guess I shouldn't be holding back anymore.\make Mom accept me...\or I'll be all alone!\Do whatever you want! And I'll do what I want! response:	I'll do this alone...
context: Otherwise, Mom won't accept me.\Have it your way.\Hey!\Guess I shouldn't be holding back anymore.\make Mom accept me...\or I'll be all alone!\Do whatever you want! And I'll do what I want!\I'll do this alone... response:	I won't leave you alone!
context: Have it your way.\Hey!\Guess I shouldn't be holding back anymore.\make Mom accept me...\or I'll be all alone!\Do whatever you want! And I'll do what I want!\I'll do this alone...\I won't leave you alone! response:	Not yet!
context: Hey!\Guess I shouldn't be holding back anymore.\make Mom accept me...\or I'll be all alone!\Do whatever you want! And I'll do what I want!\I'll do this alone...\I won't leave you alone!\Not yet! response:	Some part of me...
context: Guess I shouldn't be holding back anymore.\make Mom accept me...\or I'll be all alone!\Do whatever you want! And I'll do what I want!\I'll do this alone...\I won't leave you alone!\Not yet!\Some part of me... response:	I don't care what you think about me!
context: make Mom accept me...\or I'll be all alone!\Do whatever you want! And I'll do what I want!\I'll do this alone...\I won't leave you alone!\Not yet!\Some part of me...\I don't care what you think about me! response:	Do whatever you want!
context: or I'll be all alone!\Do whatever you want! And I'll do what I want!\I'll do this alone...\I won't leave you alone!\Not yet!\Some part of me...\I don't care what you think about me!\Do whatever you want! response:	I've already acknowledged you as my... as our friend!
context: Do whatever you want! And I'll do what I want!\I'll do this alone...\I won't leave you alone!\Not yet!\Some part of me...\I don't care what you think about me!\Do whatever you want!\I've already acknowledged you as my... as our friend! response:	I'm sorry, Mom. I...
context: I'll do this alone...\I won't leave you alone!\Not yet!\Some part of me...\I don't care what you think about me!\Do whatever you want!\I've already acknowledged you as my... as our friend!\I'm sorry, Mom. I... response:	wasn't alone.
context: I won't leave you alone!\Not yet!\Some part of me...\I don't care what you think about me!\Do whatever you want!\I've already acknowledged you as my... as our friend!\I'm sorry, Mom. I...\wasn't alone. response:	True, it seems like it'd be more fun if we all fought together.
context: Not yet!\Some part of me...\I don't care what you think about me!\Do whatever you want!\I've already acknowledged you as my... as our friend!\I'm sorry, Mom. I...\wasn't alone.\True, it seems like it'd be more fun if we all fought together. response:	Yeah!
context: Some part of me...\I don't care what you think about me!\Do whatever you want!\I've already acknowledged you as my... as our friend!\I'm sorry, Mom. I...\wasn't alone.\True, it seems like it'd be more fun if we all fought together.\Yeah! response:	Well, this isn't good at all.
context: I don't care what you think about me!\Do whatever you want!\I've already acknowledged you as my... as our friend!\I'm sorry, Mom. I...\wasn't alone.\True, it seems like it'd be more fun if we all fought together.\Yeah!\Well, this isn't good at all. response:	You're going to make an old man get serious.
context: Do whatever you want!\I've already acknowledged you as my... as our friend!\I'm sorry, Mom. I...\wasn't alone.\True, it seems like it'd be more fun if we all fought together.\Yeah!\Well, this isn't good at all.\You're going to make an old man get serious. response:	Smoke Creation Magic: Prison of the Fallen King.
context: I've already acknowledged you as my... as our friend!\I'm sorry, Mom. I...\wasn't alone.\True, it seems like it'd be more fun if we all fought together.\Yeah!\Well, this isn't good at all.\You're going to make an old man get serious.\Smoke Creation Magic: Prison of the Fallen King. response:	You won't be able to get away anymore, kids.
context: I'm sorry, Mom. I...\wasn't alone.\True, it seems like it'd be more fun if we all fought together.\Yeah!\Well, this isn't good at all.\You're going to make an old man get serious.\Smoke Creation Magic: Prison of the Fallen King.\You won't be able to get away anymore, kids. response:	No matter who we're facing,
context: wasn't alone.\True, it seems like it'd be more fun if we all fought together.\Yeah!\Well, this isn't good at all.\You're going to make an old man get serious.\Smoke Creation Magic: Prison of the Fallen King.\You won't be able to get away anymore, kids.\No matter who we're facing, response:	we, the Black Bulls, will win!
context: True, it seems like it'd be more fun if we all fought together.\Yeah!\Well, this isn't good at all.\You're going to make an old man get serious.\Smoke Creation Magic: Prison of the Fallen King.\You won't be able to get away anymore, kids.\No matter who we're facing,\we, the Black Bulls, will win! response:	I'm going to get serious now.
context: Yeah!\Well, this isn't good at all.\You're going to make an old man get serious.\Smoke Creation Magic: Prison of the Fallen King.\You won't be able to get away anymore, kids.\No matter who we're facing,\we, the Black Bulls, will win!\I'm going to get serious now. response:	What are you...
context: Well, this isn't good at all.\You're going to make an old man get serious.\Smoke Creation Magic: Prison of the Fallen King.\You won't be able to get away anymore, kids.\No matter who we're facing,\we, the Black Bulls, will win!\I'm going to get serious now.\What are you... response:	Wind Creation Magic: Swift White Hawk and Wind Blade Shower.
context: You're going to make an old man get serious.\Smoke Creation Magic: Prison of the Fallen King.\You won't be able to get away anymore, kids.\No matter who we're facing,\we, the Black Bulls, will win!\I'm going to get serious now.\What are you...\Wind Creation Magic: Swift White Hawk and Wind Blade Shower. response:	Simultaneous spell activation?!
context: Smoke Creation Magic: Prison of the Fallen King.\You won't be able to get away anymore, kids.\No matter who we're facing,\we, the Black Bulls, will win!\I'm going to get serious now.\What are you...\Wind Creation Magic: Swift White Hawk and Wind Blade Shower.\Simultaneous spell activation?! response:	And this power... H-He's...
context: You won't be able to get away anymore, kids.\No matter who we're facing,\we, the Black Bulls, will win!\I'm going to get serious now.\What are you...\Wind Creation Magic: Swift White Hawk and Wind Blade Shower.\Simultaneous spell activation?!\And this power... H-He's... response:	It will be the Golden Dawn that reaches the treasure chamber first!
context: No matter who we're facing,\we, the Black Bulls, will win!\I'm going to get serious now.\What are you...\Wind Creation Magic: Swift White Hawk and Wind Blade Shower.\Simultaneous spell activation?!\And this power... H-He's...\It will be the Golden Dawn that reaches the treasure chamber first! response:	Take that!
context: we, the Black Bulls, will win!\I'm going to get serious now.\What are you...\Wind Creation Magic: Swift White Hawk and Wind Blade Shower.\Simultaneous spell activation?!\And this power... H-He's...\It will be the Golden Dawn that reaches the treasure chamber first!\Take that! response:	I cut and cut, but there's no end! It keeps coming back!
context: I'm going to get serious now.\What are you...\Wind Creation Magic: Swift White Hawk and Wind Blade Shower.\Simultaneous spell activation?!\And this power... H-He's...\It will be the Golden Dawn that reaches the treasure chamber first!\Take that!\I cut and cut, but there's no end! It keeps coming back! response:	I'm getting dizzy...
context: What are you...\Wind Creation Magic: Swift White Hawk and Wind Blade Shower.\Simultaneous spell activation?!\And this power... H-He's...\It will be the Golden Dawn that reaches the treasure chamber first!\Take that!\I cut and cut, but there's no end! It keeps coming back!\I'm getting dizzy... response:	The smoke just keeps getting thicker.
context: Wind Creation Magic: Swift White Hawk and Wind Blade Shower.\Simultaneous spell activation?!\And this power... H-He's...\It will be the Golden Dawn that reaches the treasure chamber first!\Take that!\I cut and cut, but there's no end! It keeps coming back!\I'm getting dizzy...\The smoke just keeps getting thicker. response:	At this rate, we're going to suffocate.
context: Simultaneous spell activation?!\And this power... H-He's...\It will be the Golden Dawn that reaches the treasure chamber first!\Take that!\I cut and cut, but there's no end! It keeps coming back!\I'm getting dizzy...\The smoke just keeps getting thicker.\At this rate, we're going to suffocate. response:	This isn't good. We have to hurry up and defeat that mage.
context: And this power... H-He's...\It will be the Golden Dawn that reaches the treasure chamber first!\Take that!\I cut and cut, but there's no end! It keeps coming back!\I'm getting dizzy...\The smoke just keeps getting thicker.\At this rate, we're going to suffocate.\This isn't good. We have to hurry up and defeat that mage. response:	I can pretty much tell where he is with my magic,
context: It will be the Golden Dawn that reaches the treasure chamber first!\Take that!\I cut and cut, but there's no end! It keeps coming back!\I'm getting dizzy...\The smoke just keeps getting thicker.\At this rate, we're going to suffocate.\This isn't good. We have to hurry up and defeat that mage.\I can pretty much tell where he is with my magic, response:	but he'll probably dodge, even if I attack.
context: Take that!\I cut and cut, but there's no end! It keeps coming back!\I'm getting dizzy...\The smoke just keeps getting thicker.\At this rate, we're going to suffocate.\This isn't good. We have to hurry up and defeat that mage.\I can pretty much tell where he is with my magic,\but he'll probably dodge, even if I attack. response:	Thinking back on our battle so far,
context: I cut and cut, but there's no end! It keeps coming back!\I'm getting dizzy...\The smoke just keeps getting thicker.\At this rate, we're going to suffocate.\This isn't good. We have to hurry up and defeat that mage.\I can pretty much tell where he is with my magic,\but he'll probably dodge, even if I attack.\Thinking back on our battle so far, response:	he's able to travel at high speed within the smoke.
context: I'm getting dizzy...\The smoke just keeps getting thicker.\At this rate, we're going to suffocate.\This isn't good. We have to hurry up and defeat that mage.\I can pretty much tell where he is with my magic,\but he'll probably dodge, even if I attack.\Thinking back on our battle so far,\he's able to travel at high speed within the smoke. response:	And his ability to sense magic is high.
context: The smoke just keeps getting thicker.\At this rate, we're going to suffocate.\This isn't good. We have to hurry up and defeat that mage.\I can pretty much tell where he is with my magic,\but he'll probably dodge, even if I attack.\Thinking back on our battle so far,\he's able to travel at high speed within the smoke.\And his ability to sense magic is high. response:	If we're to land a hit on him, we'll have to surprise him.
context: At this rate, we're going to suffocate.\This isn't good. We have to hurry up and defeat that mage.\I can pretty much tell where he is with my magic,\but he'll probably dodge, even if I attack.\Thinking back on our battle so far,\he's able to travel at high speed within the smoke.\And his ability to sense magic is high.\If we're to land a hit on him, we'll have to surprise him. response:	But how do we do that without him noticing our magic?
context: This isn't good. We have to hurry up and defeat that mage.\I can pretty much tell where he is with my magic,\but he'll probably dodge, even if I attack.\Thinking back on our battle so far,\he's able to travel at high speed within the smoke.\And his ability to sense magic is high.\If we're to land a hit on him, we'll have to surprise him.\But how do we do that without him noticing our magic? response:	The downside of this magic is that it drains my powers a lot.
context: I can pretty much tell where he is with my magic,\but he'll probably dodge, even if I attack.\Thinking back on our battle so far,\he's able to travel at high speed within the smoke.\And his ability to sense magic is high.\If we're to land a hit on him, we'll have to surprise him.\But how do we do that without him noticing our magic?\The downside of this magic is that it drains my powers a lot. response:	My magic level is still fine, though.
context: but he'll probably dodge, even if I attack.\Thinking back on our battle so far,\he's able to travel at high speed within the smoke.\And his ability to sense magic is high.\If we're to land a hit on him, we'll have to surprise him.\But how do we do that without him noticing our magic?\The downside of this magic is that it drains my powers a lot.\My magic level is still fine, though. response:	Well, that and the fact that I can't see the enemy.
context: Thinking back on our battle so far,\he's able to travel at high speed within the smoke.\And his ability to sense magic is high.\If we're to land a hit on him, we'll have to surprise him.\But how do we do that without him noticing our magic?\The downside of this magic is that it drains my powers a lot.\My magic level is still fine, though.\Well, that and the fact that I can't see the enemy. response:	But that's no problem.
context: he's able to travel at high speed within the smoke.\And his ability to sense magic is high.\If we're to land a hit on him, we'll have to surprise him.\But how do we do that without him noticing our magic?\The downside of this magic is that it drains my powers a lot.\My magic level is still fine, though.\Well, that and the fact that I can't see the enemy.\But that's no problem. response:	Because I can sense your magic just fine.
context: And his ability to sense magic is high.\If we're to land a hit on him, we'll have to surprise him.\But how do we do that without him noticing our magic?\The downside of this magic is that it drains my powers a lot.\My magic level is still fine, though.\Well, that and the fact that I can't see the enemy.\But that's no problem.\Because I can sense your magic just fine. response:	Whoa, there!
context: If we're to land a hit on him, we'll have to surprise him.\But how do we do that without him noticing our magic?\The downside of this magic is that it drains my powers a lot.\My magic level is still fine, though.\Well, that and the fact that I can't see the enemy.\But that's no problem.\Because I can sense your magic just fine.\Whoa, there! response:	Wow, a barrage. Are you getting desperate?
context: But how do we do that without him noticing our magic?\The downside of this magic is that it drains my powers a lot.\My magic level is still fine, though.\Well, that and the fact that I can't see the enemy.\But that's no problem.\Because I can sense your magic just fine.\Whoa, there!\Wow, a barrage. Are you getting desperate? response:	That's not going to hit me or get rid of the smoke.
context: The downside of this magic is that it drains my powers a lot.\My magic level is still fine, though.\Well, that and the fact that I can't see the enemy.\But that's no problem.\Because I can sense your magic just fine.\Whoa, there!\Wow, a barrage. Are you getting desperate?\That's not going to hit me or get rid of the smoke. response:	You're just wasting magic.
context: My magic level is still fine, though.\Well, that and the fact that I can't see the enemy.\But that's no problem.\Because I can sense your magic just fine.\Whoa, there!\Wow, a barrage. Are you getting desperate?\That's not going to hit me or get rid of the smoke.\You're just wasting magic. response:	I think the difference in our experience levels is starting to show.
context: Well, that and the fact that I can't see the enemy.\But that's no problem.\Because I can sense your magic just fine.\Whoa, there!\Wow, a barrage. Are you getting desperate?\That's not going to hit me or get rid of the smoke.\You're just wasting magic.\I think the difference in our experience levels is starting to show. response:	After all, I've fought far more mages than you have.
context: But that's no problem.\Because I can sense your magic just fine.\Whoa, there!\Wow, a barrage. Are you getting desperate?\That's not going to hit me or get rid of the smoke.\You're just wasting magic.\I think the difference in our experience levels is starting to show.\After all, I've fought far more mages than you have. response:	Huh?
context: Because I can sense your magic just fine.\Whoa, there!\Wow, a barrage. Are you getting desperate?\That's not going to hit me or get rid of the smoke.\You're just wasting magic.\I think the difference in our experience levels is starting to show.\After all, I've fought far more mages than you have.\Huh? response:	I chased him over.
context: Whoa, there!\Wow, a barrage. Are you getting desperate?\That's not going to hit me or get rid of the smoke.\You're just wasting magic.\I think the difference in our experience levels is starting to show.\After all, I've fought far more mages than you have.\Huh?\I chased him over. response:	And I suppressed my magic so he wouldn't notice, and then...
context: Wow, a barrage. Are you getting desperate?\That's not going to hit me or get rid of the smoke.\You're just wasting magic.\I think the difference in our experience levels is starting to show.\After all, I've fought far more mages than you have.\Huh?\I chased him over.\And I suppressed my magic so he wouldn't notice, and then... response:	Go!
context: That's not going to hit me or get rid of the smoke.\You're just wasting magic.\I think the difference in our experience levels is starting to show.\After all, I've fought far more mages than you have.\Huh?\I chased him over.\And I suppressed my magic so he wouldn't notice, and then...\Go! response:	He can't sense Asta, so Asta attacked.
context: You're just wasting magic.\I think the difference in our experience levels is starting to show.\After all, I've fought far more mages than you have.\Huh?\I chased him over.\And I suppressed my magic so he wouldn't notice, and then...\Go!\He can't sense Asta, so Asta attacked. response:	It went well.
context: I think the difference in our experience levels is starting to show.\After all, I've fought far more mages than you have.\Huh?\I chased him over.\And I suppressed my magic so he wouldn't notice, and then...\Go!\He can't sense Asta, so Asta attacked.\It went well. response:	I guess teamwork really is important.
context: After all, I've fought far more mages than you have.\Huh?\I chased him over.\And I suppressed my magic so he wouldn't notice, and then...\Go!\He can't sense Asta, so Asta attacked.\It went well.\I guess teamwork really is important. response:	H-How can this be?
context: Huh?\I chased him over.\And I suppressed my magic so he wouldn't notice, and then...\Go!\He can't sense Asta, so Asta attacked.\It went well.\I guess teamwork really is important.\H-How can this be? response:	Begone.
context: I chased him over.\And I suppressed my magic so he wouldn't notice, and then...\Go!\He can't sense Asta, so Asta attacked.\It went well.\I guess teamwork really is important.\H-How can this be?\Begone. response:	My dry emotions gaze at the me from that day
context: And I suppressed my magic so he wouldn't notice, and then...\Go!\He can't sense Asta, so Asta attacked.\It went well.\I guess teamwork really is important.\H-How can this be?\Begone.\My dry emotions gaze at the me from that day response:	And push me forward
context: Go!\He can't sense Asta, so Asta attacked.\It went well.\I guess teamwork really is important.\H-How can this be?\Begone.\My dry emotions gaze at the me from that day\And push me forward response:	(I can't find a place to go)
context: He can't sense Asta, so Asta attacked.\It went well.\I guess teamwork really is important.\H-How can this be?\Begone.\My dry emotions gaze at the me from that day\And push me forward\(I can't find a place to go) response:	Even the faintest light can still break through the darkness
context: It went well.\I guess teamwork really is important.\H-How can this be?\Begone.\My dry emotions gaze at the me from that day\And push me forward\(I can't find a place to go)\Even the faintest light can still break through the darkness response:	And change the flow of time
context: I guess teamwork really is important.\H-How can this be?\Begone.\My dry emotions gaze at the me from that day\And push me forward\(I can't find a place to go)\Even the faintest light can still break through the darkness\And change the flow of time response:	(I will keep believing in you)
context: H-How can this be?\Begone.\My dry emotions gaze at the me from that day\And push me forward\(I can't find a place to go)\Even the faintest light can still break through the darkness\And change the flow of time\(I will keep believing in you) response:	In this ever-vivid place
context: Begone.\My dry emotions gaze at the me from that day\And push me forward\(I can't find a place to go)\Even the faintest light can still break through the darkness\And change the flow of time\(I will keep believing in you)\In this ever-vivid place response:	(Break free yourself)
context: My dry emotions gaze at the me from that day\And push me forward\(I can't find a place to go)\Even the faintest light can still break through the darkness\And change the flow of time\(I will keep believing in you)\In this ever-vivid place\(Break free yourself) response:	In order to grasp my endless dream
context: And push me forward\(I can't find a place to go)\Even the faintest light can still break through the darkness\And change the flow of time\(I will keep believing in you)\In this ever-vivid place\(Break free yourself)\In order to grasp my endless dream response:	If there is a path that I should choose
context: (I can't find a place to go)\Even the faintest light can still break through the darkness\And change the flow of time\(I will keep believing in you)\In this ever-vivid place\(Break free yourself)\In order to grasp my endless dream\If there is a path that I should choose response:	(Do you wanna try? Do you wanna try?)
context: Even the faintest light can still break through the darkness\And change the flow of time\(I will keep believing in you)\In this ever-vivid place\(Break free yourself)\In order to grasp my endless dream\If there is a path that I should choose\(Do you wanna try? Do you wanna try?) response:	Wherever it may lead us
context: And change the flow of time\(I will keep believing in you)\In this ever-vivid place\(Break free yourself)\In order to grasp my endless dream\If there is a path that I should choose\(Do you wanna try? Do you wanna try?)\Wherever it may lead us response:	Until my life comes to an end
context: (I will keep believing in you)\In this ever-vivid place\(Break free yourself)\In order to grasp my endless dream\If there is a path that I should choose\(Do you wanna try? Do you wanna try?)\Wherever it may lead us\Until my life comes to an end response:	I will accept any pain that comes my way
context: In this ever-vivid place\(Break free yourself)\In order to grasp my endless dream\If there is a path that I should choose\(Do you wanna try? Do you wanna try?)\Wherever it may lead us\Until my life comes to an end\I will accept any pain that comes my way response:	(We can try again, we can try again)
context: (Break free yourself)\In order to grasp my endless dream\If there is a path that I should choose\(Do you wanna try? Do you wanna try?)\Wherever it may lead us\Until my life comes to an end\I will accept any pain that comes my way\(We can try again, we can try again) response:	Even if we can't see tomorrow
context: In order to grasp my endless dream\If there is a path that I should choose\(Do you wanna try? Do you wanna try?)\Wherever it may lead us\Until my life comes to an end\I will accept any pain that comes my way\(We can try again, we can try again)\Even if we can't see tomorrow response:	Holding onto feelings too intense to voice
context: If there is a path that I should choose\(Do you wanna try? Do you wanna try?)\Wherever it may lead us\Until my life comes to an end\I will accept any pain that comes my way\(We can try again, we can try again)\Even if we can't see tomorrow\Holding onto feelings too intense to voice response:	I'll keep screaming them in my heart
context: (Do you wanna try? Do you wanna try?)\Wherever it may lead us\Until my life comes to an end\I will accept any pain that comes my way\(We can try again, we can try again)\Even if we can't see tomorrow\Holding onto feelings too intense to voice\I'll keep screaming them in my heart response:	Petit Clover!
context: Wherever it may lead us\Until my life comes to an end\I will accept any pain that comes my way\(We can try again, we can try again)\Even if we can't see tomorrow\Holding onto feelings too intense to voice\I'll keep screaming them in my heart\Petit Clover! response:	Family
context: Until my life comes to an end\I will accept any pain that comes my way\(We can try again, we can try again)\Even if we can't see tomorrow\Holding onto feelings too intense to voice\I'll keep screaming them in my heart\Petit Clover!\Family response:	Family.
context: I will accept any pain that comes my way\(We can try again, we can try again)\Even if we can't see tomorrow\Holding onto feelings too intense to voice\I'll keep screaming them in my heart\Petit Clover!\Family\Family. response:	Oh, my...
context: (We can try again, we can try again)\Even if we can't see tomorrow\Holding onto feelings too intense to voice\I'll keep screaming them in my heart\Petit Clover!\Family\Family.\Oh, my... response:	So you decided that you would treat all of the friends you encountered like family.
context: Even if we can't see tomorrow\Holding onto feelings too intense to voice\I'll keep screaming them in my heart\Petit Clover!\Family\Family.\Oh, my...\So you decided that you would treat all of the friends you encountered like family. response:	That's so wonderful.
context: Holding onto feelings too intense to voice\I'll keep screaming them in my heart\Petit Clover!\Family\Family.\Oh, my...\So you decided that you would treat all of the friends you encountered like family.\That's so wonderful. response:	Yeah.
context: I'll keep screaming them in my heart\Petit Clover!\Family\Family.\Oh, my...\So you decided that you would treat all of the friends you encountered like family.\That's so wonderful.\Yeah. response:	Family... So basically, it's like this...
context: Petit Clover!\Family\Family.\Oh, my...\So you decided that you would treat all of the friends you encountered like family.\That's so wonderful.\Yeah.\Family... So basically, it's like this... response:	Big Brother Klaus!
context: Family\Family.\Oh, my...\So you decided that you would treat all of the friends you encountered like family.\That's so wonderful.\Yeah.\Family... So basically, it's like this...\Big Brother Klaus! response:	That tickles!
context: Family.\Oh, my...\So you decided that you would treat all of the friends you encountered like family.\That's so wonderful.\Yeah.\Family... So basically, it's like this...\Big Brother Klaus!\That tickles! response:	Little Brother, allow me to bestow these upon you.
context: Oh, my...\So you decided that you would treat all of the friends you encountered like family.\That's so wonderful.\Yeah.\Family... So basically, it's like this...\Big Brother Klaus!\That tickles!\Little Brother, allow me to bestow these upon you. response:	Yay, glasses!
context: So you decided that you would treat all of the friends you encountered like family.\That's so wonderful.\Yeah.\Family... So basically, it's like this...\Big Brother Klaus!\That tickles!\Little Brother, allow me to bestow these upon you.\Yay, glasses! response:	Thanks, Big Brother!
context: That's so wonderful.\Yeah.\Family... So basically, it's like this...\Big Brother Klaus!\That tickles!\Little Brother, allow me to bestow these upon you.\Yay, glasses!\Thanks, Big Brother! response:	Not a chance...
context: Yeah.\Family... So basically, it's like this...\Big Brother Klaus!\That tickles!\Little Brother, allow me to bestow these upon you.\Yay, glasses!\Thanks, Big Brother!\Not a chance... response:	He's strong...
context: Family... So basically, it's like this...\Big Brother Klaus!\That tickles!\Little Brother, allow me to bestow these upon you.\Yay, glasses!\Thanks, Big Brother!\Not a chance...\He's strong... response:	But if I'm going to become the Wizard King, I can't be defeated here.
context: Big Brother Klaus!\That tickles!\Little Brother, allow me to bestow these upon you.\Yay, glasses!\Thanks, Big Brother!\Not a chance...\He's strong...\But if I'm going to become the Wizard King, I can't be defeated here. response:	Black Clover, Page 17: Destroyer.
context: That tickles!\Little Brother, allow me to bestow these upon you.\Yay, glasses!\Thanks, Big Brother!\Not a chance...\He's strong...\But if I'm going to become the Wizard King, I can't be defeated here.\Black Clover, Page 17: Destroyer. response:	Page 17 Destroyer
context: Little Brother, allow me to bestow these upon you.\Yay, glasses!\Thanks, Big Brother!\Not a chance...\He's strong...\But if I'm going to become the Wizard King, I can't be defeated here.\Black Clover, Page 17: Destroyer.\Page 17 Destroyer response:	Not giving up is my magic.