context: Edolas, the homeland of Carla and myself! response:	I'm glad we made it there to search for our missing friends,
context: Edolas, the homeland of Carla and myself!\I'm glad we made it there to search for our missing friends, response:	but there's a whole lot of things different in this world...
context: Edolas, the homeland of Carla and myself!\I'm glad we made it there to search for our missing friends,\but there's a whole lot of things different in this world... response:	We can't use magic? I never heard of something like that!
context: Edolas, the homeland of Carla and myself!\I'm glad we made it there to search for our missing friends,\but there's a whole lot of things different in this world...\We can't use magic? I never heard of something like that! response:	Everyone at the guild is acting odd...
context: Edolas, the homeland of Carla and myself!\I'm glad we made it there to search for our missing friends,\but there's a whole lot of things different in this world...\We can't use magic? I never heard of something like that!\Everyone at the guild is acting odd... response:	What in the world is going on?!
context: Edolas, the homeland of Carla and myself!\I'm glad we made it there to search for our missing friends,\but there's a whole lot of things different in this world...\We can't use magic? I never heard of something like that!\Everyone at the guild is acting odd...\What in the world is going on?! response:	Who the hell are you?
context: Edolas, the homeland of Carla and myself!\I'm glad we made it there to search for our missing friends,\but there's a whole lot of things different in this world...\We can't use magic? I never heard of something like that!\Everyone at the guild is acting odd...\What in the world is going on?!\Who the hell are you? response:	What the hell are you doing sneaking around under there?
context: Edolas, the homeland of Carla and myself!\I'm glad we made it there to search for our missing friends,\but there's a whole lot of things different in this world...\We can't use magic? I never heard of something like that!\Everyone at the guild is acting odd...\What in the world is going on?!\Who the hell are you?\What the hell are you doing sneaking around under there? response:	What's wrong with everyone?
context: I'm glad we made it there to search for our missing friends,\but there's a whole lot of things different in this world...\We can't use magic? I never heard of something like that!\Everyone at the guild is acting odd...\What in the world is going on?!\Who the hell are you?\What the hell are you doing sneaking around under there?\What's wrong with everyone? response:	Lucy-san is scary...
context: but there's a whole lot of things different in this world...\We can't use magic? I never heard of something like that!\Everyone at the guild is acting odd...\What in the world is going on?!\Who the hell are you?\What the hell are you doing sneaking around under there?\What's wrong with everyone?\Lucy-san is scary... response:	Natsu?
context: We can't use magic? I never heard of something like that!\Everyone at the guild is acting odd...\What in the world is going on?!\Who the hell are you?\What the hell are you doing sneaking around under there?\What's wrong with everyone?\Lucy-san is scary...\Natsu? response:	Now I take a closer look at ya, you're Natsu!
context: Everyone at the guild is acting odd...\What in the world is going on?!\Who the hell are you?\What the hell are you doing sneaking around under there?\What's wrong with everyone?\Lucy-san is scary...\Natsu?\Now I take a closer look at ya, you're Natsu! response:	Natsu, she says?
context: What in the world is going on?!\Who the hell are you?\What the hell are you doing sneaking around under there?\What's wrong with everyone?\Lucy-san is scary...\Natsu?\Now I take a closer look at ya, you're Natsu!\Natsu, she says? response:	What's with the outfit?
context: Who the hell are you?\What the hell are you doing sneaking around under there?\What's wrong with everyone?\Lucy-san is scary...\Natsu?\Now I take a closer look at ya, you're Natsu!\Natsu, she says?\What's with the outfit? response:	Natsu... Where have you...
context: What the hell are you doing sneaking around under there?\What's wrong with everyone?\Lucy-san is scary...\Natsu?\Now I take a closer look at ya, you're Natsu!\Natsu, she says?\What's with the outfit?\Natsu... Where have you... response:	Where have you been this whole time?
context: What's wrong with everyone?\Lucy-san is scary...\Natsu?\Now I take a closer look at ya, you're Natsu!\Natsu, she says?\What's with the outfit?\Natsu... Where have you...\Where have you been this whole time? response:	You had me worried, damn it!
context: Lucy-san is scary...\Natsu?\Now I take a closer look at ya, you're Natsu!\Natsu, she says?\What's with the outfit?\Natsu... Where have you...\Where have you been this whole time?\You had me worried, damn it! response:	Fairy Hunting.
context: Natsu?\Now I take a closer look at ya, you're Natsu!\Natsu, she says?\What's with the outfit?\Natsu... Where have you...\Where have you been this whole time?\You had me worried, damn it!\Fairy Hunting. response:	Lucy?
context: Now I take a closer look at ya, you're Natsu!\Natsu, she says?\What's with the outfit?\Natsu... Where have you...\Where have you been this whole time?\You had me worried, damn it!\Fairy Hunting.\Lucy? response:	Capital Punishment!
context: Natsu, she says?\What's with the outfit?\Natsu... Where have you...\Where have you been this whole time?\You had me worried, damn it!\Fairy Hunting.\Lucy?\Capital Punishment! response:	There it is!
context: What's with the outfit?\Natsu... Where have you...\Where have you been this whole time?\You had me worried, damn it!\Fairy Hunting.\Lucy?\Capital Punishment!\There it is! response:	The Screwdrive Crush!
context: Natsu... Where have you...\Where have you been this whole time?\You had me worried, damn it!\Fairy Hunting.\Lucy?\Capital Punishment!\There it is!\The Screwdrive Crush! response:	Natsu-san!
context: Where have you been this whole time?\You had me worried, damn it!\Fairy Hunting.\Lucy?\Capital Punishment!\There it is!\The Screwdrive Crush!\Natsu-san! response:	It's not nice to pick on him like that...
context: You had me worried, damn it!\Fairy Hunting.\Lucy?\Capital Punishment!\There it is!\The Screwdrive Crush!\Natsu-san!\It's not nice to pick on him like that... response:	I can't believe that's actually Cana!
context: Fairy Hunting.\Lucy?\Capital Punishment!\There it is!\The Screwdrive Crush!\Natsu-san!\It's not nice to pick on him like that...\I can't believe that's actually Cana! response:	And over here, too! I can't believe that's actually Elfman!
context: Lucy?\Capital Punishment!\There it is!\The Screwdrive Crush!\Natsu-san!\It's not nice to pick on him like that...\I can't believe that's actually Cana!\And over here, too! I can't believe that's actually Elfman! response:	How long are ya gonna keep sobbing, you wimp!
context: Capital Punishment!\There it is!\The Screwdrive Crush!\Natsu-san!\It's not nice to pick on him like that...\I can't believe that's actually Cana!\And over here, too! I can't believe that's actually Elfman!\How long are ya gonna keep sobbing, you wimp! response:	I'm so sorry!
context: There it is!\The Screwdrive Crush!\Natsu-san!\It's not nice to pick on him like that...\I can't believe that's actually Cana!\And over here, too! I can't believe that's actually Elfman!\How long are ya gonna keep sobbing, you wimp!\I'm so sorry! response:	I don't get this at all!
context: The Screwdrive Crush!\Natsu-san!\It's not nice to pick on him like that...\I can't believe that's actually Cana!\And over here, too! I can't believe that's actually Elfman!\How long are ya gonna keep sobbing, you wimp!\I'm so sorry!\I don't get this at all! response:	What in the world is going on?
context: Natsu-san!\It's not nice to pick on him like that...\I can't believe that's actually Cana!\And over here, too! I can't believe that's actually Elfman!\How long are ya gonna keep sobbing, you wimp!\I'm so sorry!\I don't get this at all!\What in the world is going on? response:	Well, at least I'm glad you're safe.
context: It's not nice to pick on him like that...\I can't believe that's actually Cana!\And over here, too! I can't believe that's actually Elfman!\How long are ya gonna keep sobbing, you wimp!\I'm so sorry!\I don't get this at all!\What in the world is going on?\Well, at least I'm glad you're safe. response:	Right, Juvia-chan?
context: I can't believe that's actually Cana!\And over here, too! I can't believe that's actually Elfman!\How long are ya gonna keep sobbing, you wimp!\I'm so sorry!\I don't get this at all!\What in the world is going on?\Well, at least I'm glad you're safe.\Right, Juvia-chan? response:	Shut up.
context: And over here, too! I can't believe that's actually Elfman!\How long are ya gonna keep sobbing, you wimp!\I'm so sorry!\I don't get this at all!\What in the world is going on?\Well, at least I'm glad you're safe.\Right, Juvia-chan?\Shut up. response:	Is this all the effect of Edolas?
context: How long are ya gonna keep sobbing, you wimp!\I'm so sorry!\I don't get this at all!\What in the world is going on?\Well, at least I'm glad you're safe.\Right, Juvia-chan?\Shut up.\Is this all the effect of Edolas? response:	Is everything and everyone completely backwards?
context: I'm so sorry!\I don't get this at all!\What in the world is going on?\Well, at least I'm glad you're safe.\Right, Juvia-chan?\Shut up.\Is this all the effect of Edolas?\Is everything and everyone completely backwards? response:	Mira's the same as always.
context: I don't get this at all!\What in the world is going on?\Well, at least I'm glad you're safe.\Right, Juvia-chan?\Shut up.\Is this all the effect of Edolas?\Is everything and everyone completely backwards?\Mira's the same as always. response:	Well, that's unexpectedly boring.
context: What in the world is going on?\Well, at least I'm glad you're safe.\Right, Juvia-chan?\Shut up.\Is this all the effect of Edolas?\Is everything and everyone completely backwards?\Mira's the same as always.\Well, that's unexpectedly boring. response:	By the way...
context: Well, at least I'm glad you're safe.\Right, Juvia-chan?\Shut up.\Is this all the effect of Edolas?\Is everything and everyone completely backwards?\Mira's the same as always.\Well, that's unexpectedly boring.\By the way... response:	Who are the girl and those cats?
context: Right, Juvia-chan?\Shut up.\Is this all the effect of Edolas?\Is everything and everyone completely backwards?\Mira's the same as always.\Well, that's unexpectedly boring.\By the way...\Who are the girl and those cats? response:	Cats?
context: Shut up.\Is this all the effect of Edolas?\Is everything and everyone completely backwards?\Mira's the same as always.\Well, that's unexpectedly boring.\By the way...\Who are the girl and those cats?\Cats? response:	Cats?!
context: Is this all the effect of Edolas?\Is everything and everyone completely backwards?\Mira's the same as always.\Well, that's unexpectedly boring.\By the way...\Who are the girl and those cats?\Cats?\Cats?! response:	There are cats here!
context: Is everything and everyone completely backwards?\Mira's the same as always.\Well, that's unexpectedly boring.\By the way...\Who are the girl and those cats?\Cats?\Cats?!\There are cats here! response:	Cats?!
context: Mira's the same as always.\Well, that's unexpectedly boring.\By the way...\Who are the girl and those cats?\Cats?\Cats?!\There are cats here!\Cats?! response:	What's the meaning of this?
context: Well, that's unexpectedly boring.\By the way...\Who are the girl and those cats?\Cats?\Cats?!\There are cats here!\Cats?!\What's the meaning of this? response:	Why are Exceeds here in a place like this?
context: By the way...\Who are the girl and those cats?\Cats?\Cats?!\There are cats here!\Cats?!\What's the meaning of this?\Why are Exceeds here in a place like this? response:	Exceeds?
context: Who are the girl and those cats?\Cats?\Cats?!\There are cats here!\Cats?!\What's the meaning of this?\Why are Exceeds here in a place like this?\Exceeds? response:	W-What?
context: Cats?\Cats?!\There are cats here!\Cats?!\What's the meaning of this?\Why are Exceeds here in a place like this?\Exceeds?\W-What? response:	What's going on here?
context: Cats?!\There are cats here!\Cats?!\What's the meaning of this?\Why are Exceeds here in a place like this?\Exceeds?\W-What?\What's going on here? response:	Why is everyone so scared when they hear the word Exceed?
context: There are cats here!\Cats?!\What's the meaning of this?\Why are Exceeds here in a place like this?\Exceeds?\W-What?\What's going on here?\Why is everyone so scared when they hear the word Exceed? response:	What's an Exceed?
context: Cats?!\What's the meaning of this?\Why are Exceeds here in a place like this?\Exceeds?\W-What?\What's going on here?\Why is everyone so scared when they hear the word Exceed?\What's an Exceed? response:	Carla...
context: What's the meaning of this?\Why are Exceeds here in a place like this?\Exceeds?\W-What?\What's going on here?\Why is everyone so scared when they hear the word Exceed?\What's an Exceed?\Carla... response:	Phew, it was getting really hot.
context: Why are Exceeds here in a place like this?\Exceeds?\W-What?\What's going on here?\Why is everyone so scared when they hear the word Exceed?\What's an Exceed?\Carla...\Phew, it was getting really hot. response:	You really look just like them.
context: Exceeds?\W-What?\What's going on here?\Why is everyone so scared when they hear the word Exceed?\What's an Exceed?\Carla...\Phew, it was getting really hot.\You really look just like them. response:	You two look like Exceeds!
context: W-What?\What's going on here?\Why is everyone so scared when they hear the word Exceed?\What's an Exceed?\Carla...\Phew, it was getting really hot.\You really look just like them.\You two look like Exceeds! response:	Uh, do they look like them?
context: What's going on here?\Why is everyone so scared when they hear the word Exceed?\What's an Exceed?\Carla...\Phew, it was getting really hot.\You really look just like them.\You two look like Exceeds!\Uh, do they look like them? response:	Or are they actually real ones?
context: Why is everyone so scared when they hear the word Exceed?\What's an Exceed?\Carla...\Phew, it was getting really hot.\You really look just like them.\You two look like Exceeds!\Uh, do they look like them?\Or are they actually real ones? response:	It's just like Nee-chan said...
context: What's an Exceed?\Carla...\Phew, it was getting really hot.\You really look just like them.\You two look like Exceeds!\Uh, do they look like them?\Or are they actually real ones?\It's just like Nee-chan said... response:	They just look exactly like Exceeds, is all.
context: Carla...\Phew, it was getting really hot.\You really look just like them.\You two look like Exceeds!\Uh, do they look like them?\Or are they actually real ones?\It's just like Nee-chan said...\They just look exactly like Exceeds, is all. response:	Well, guess that's that.
context: Phew, it was getting really hot.\You really look just like them.\You two look like Exceeds!\Uh, do they look like them?\Or are they actually real ones?\It's just like Nee-chan said...\They just look exactly like Exceeds, is all.\Well, guess that's that. response:	I suppose...
context: You really look just like them.\You two look like Exceeds!\Uh, do they look like them?\Or are they actually real ones?\It's just like Nee-chan said...\They just look exactly like Exceeds, is all.\Well, guess that's that.\I suppose... response:	They really do look just like cats, though...
context: You two look like Exceeds!\Uh, do they look like them?\Or are they actually real ones?\It's just like Nee-chan said...\They just look exactly like Exceeds, is all.\Well, guess that's that.\I suppose...\They really do look just like cats, though... response:	Uh...
context: Uh, do they look like them?\Or are they actually real ones?\It's just like Nee-chan said...\They just look exactly like Exceeds, is all.\Well, guess that's that.\I suppose...\They really do look just like cats, though...\Uh... response:	Hey, don't take it off!
context: Or are they actually real ones?\It's just like Nee-chan said...\They just look exactly like Exceeds, is all.\Well, guess that's that.\I suppose...\They really do look just like cats, though...\Uh...\Hey, don't take it off! response:	But it's all stuffy!
context: It's just like Nee-chan said...\They just look exactly like Exceeds, is all.\Well, guess that's that.\I suppose...\They really do look just like cats, though...\Uh...\Hey, don't take it off!\But it's all stuffy! response:	Deal with it!
context: They just look exactly like Exceeds, is all.\Well, guess that's that.\I suppose...\They really do look just like cats, though...\Uh...\Hey, don't take it off!\But it's all stuffy!\Deal with it! response:	Lucy-san is scary.
context: Well, guess that's that.\I suppose...\They really do look just like cats, though...\Uh...\Hey, don't take it off!\But it's all stuffy!\Deal with it!\Lucy-san is scary. response:	Now, spit it out! I was really damn worried about you!
context: I suppose...\They really do look just like cats, though...\Uh...\Hey, don't take it off!\But it's all stuffy!\Deal with it!\Lucy-san is scary.\Now, spit it out! I was really damn worried about you! response:	Where were you and what the hell were you doing?
context: They really do look just like cats, though...\Uh...\Hey, don't take it off!\But it's all stuffy!\Deal with it!\Lucy-san is scary.\Now, spit it out! I was really damn worried about you!\Where were you and what the hell were you doing? response:	Uh, how should I start...
context: Uh...\Hey, don't take it off!\But it's all stuffy!\Deal with it!\Lucy-san is scary.\Now, spit it out! I was really damn worried about you!\Where were you and what the hell were you doing?\Uh, how should I start... response:	Natsu, you have to explain everything carefully!
context: Hey, don't take it off!\But it's all stuffy!\Deal with it!\Lucy-san is scary.\Now, spit it out! I was really damn worried about you!\Where were you and what the hell were you doing?\Uh, how should I start...\Natsu, you have to explain everything carefully! response:	You know, that... It's like, uh...
context: But it's all stuffy!\Deal with it!\Lucy-san is scary.\Now, spit it out! I was really damn worried about you!\Where were you and what the hell were you doing?\Uh, how should I start...\Natsu, you have to explain everything carefully!\You know, that... It's like, uh... response:	You are so annoying!
context: Deal with it!\Lucy-san is scary.\Now, spit it out! I was really damn worried about you!\Where were you and what the hell were you doing?\Uh, how should I start...\Natsu, you have to explain everything carefully!\You know, that... It's like, uh...\You are so annoying! response:	There it is!
context: Lucy-san is scary.\Now, spit it out! I was really damn worried about you!\Where were you and what the hell were you doing?\Uh, how should I start...\Natsu, you have to explain everything carefully!\You know, that... It's like, uh...\You are so annoying!\There it is! response:	This time it's the Screwdrive Elbow Crush!
context: Now, spit it out! I was really damn worried about you!\Where were you and what the hell were you doing?\Uh, how should I start...\Natsu, you have to explain everything carefully!\You know, that... It's like, uh...\You are so annoying!\There it is!\This time it's the Screwdrive Elbow Crush! response:	The only difference is the elbow?
context: Where were you and what the hell were you doing?\Uh, how should I start...\Natsu, you have to explain everything carefully!\You know, that... It's like, uh...\You are so annoying!\There it is!\This time it's the Screwdrive Elbow Crush!\The only difference is the elbow? response:	Bis Bis...
context: Uh, how should I start...\Natsu, you have to explain everything carefully!\You know, that... It's like, uh...\You are so annoying!\There it is!\This time it's the Screwdrive Elbow Crush!\The only difference is the elbow?\Bis Bis... response:	What is it, Al Al?
context: Natsu, you have to explain everything carefully!\You know, that... It's like, uh...\You are so annoying!\There it is!\This time it's the Screwdrive Elbow Crush!\The only difference is the elbow?\Bis Bis...\What is it, Al Al? response:	Maybe we should get going on a job, just the two of us!
context: You know, that... It's like, uh...\You are so annoying!\There it is!\This time it's the Screwdrive Elbow Crush!\The only difference is the elbow?\Bis Bis...\What is it, Al Al?\Maybe we should get going on a job, just the two of us! response:	Let's go, let's go! What kind of job would you like, Al Al?
context: You are so annoying!\There it is!\This time it's the Screwdrive Elbow Crush!\The only difference is the elbow?\Bis Bis...\What is it, Al Al?\Maybe we should get going on a job, just the two of us!\Let's go, let's go! What kind of job would you like, Al Al? response:	Hmm, let me see...
context: There it is!\This time it's the Screwdrive Elbow Crush!\The only difference is the elbow?\Bis Bis...\What is it, Al Al?\Maybe we should get going on a job, just the two of us!\Let's go, let's go! What kind of job would you like, Al Al?\Hmm, let me see... response:	Let's go on a job that you enjoy, Bis Bis!
context: This time it's the Screwdrive Elbow Crush!\The only difference is the elbow?\Bis Bis...\What is it, Al Al?\Maybe we should get going on a job, just the two of us!\Let's go, let's go! What kind of job would you like, Al Al?\Hmm, let me see...\Let's go on a job that you enjoy, Bis Bis! response:	Al Al, you're so kind!
context: The only difference is the elbow?\Bis Bis...\What is it, Al Al?\Maybe we should get going on a job, just the two of us!\Let's go, let's go! What kind of job would you like, Al Al?\Hmm, let me see...\Let's go on a job that you enjoy, Bis Bis!\Al Al, you're so kind! response:	They really, really get along...
context: Bis Bis...\What is it, Al Al?\Maybe we should get going on a job, just the two of us!\Let's go, let's go! What kind of job would you like, Al Al?\Hmm, let me see...\Let's go on a job that you enjoy, Bis Bis!\Al Al, you're so kind!\They really, really get along... response:	Even with everything backwards, I think there should be limits...
context: What is it, Al Al?\Maybe we should get going on a job, just the two of us!\Let's go, let's go! What kind of job would you like, Al Al?\Hmm, let me see...\Let's go on a job that you enjoy, Bis Bis!\Al Al, you're so kind!\They really, really get along...\Even with everything backwards, I think there should be limits... response:	So, Juvia-chan... You said you were going on a job?
context: Maybe we should get going on a job, just the two of us!\Let's go, let's go! What kind of job would you like, Al Al?\Hmm, let me see...\Let's go on a job that you enjoy, Bis Bis!\Al Al, you're so kind!\They really, really get along...\Even with everything backwards, I think there should be limits...\So, Juvia-chan... You said you were going on a job? response:	I sure wish I could go with you...
context: Let's go, let's go! What kind of job would you like, Al Al?\Hmm, let me see...\Let's go on a job that you enjoy, Bis Bis!\Al Al, you're so kind!\They really, really get along...\Even with everything backwards, I think there should be limits...\So, Juvia-chan... You said you were going on a job?\I sure wish I could go with you... response:	And I told you to stay away from me.
context: Hmm, let me see...\Let's go on a job that you enjoy, Bis Bis!\Al Al, you're so kind!\They really, really get along...\Even with everything backwards, I think there should be limits...\So, Juvia-chan... You said you were going on a job?\I sure wish I could go with you...\And I told you to stay away from me. response:	You're so smothering...
context: Let's go on a job that you enjoy, Bis Bis!\Al Al, you're so kind!\They really, really get along...\Even with everything backwards, I think there should be limits...\So, Juvia-chan... You said you were going on a job?\I sure wish I could go with you...\And I told you to stay away from me.\You're so smothering... response:	Juvia is going on a job by herself.
context: Al Al, you're so kind!\They really, really get along...\Even with everything backwards, I think there should be limits...\So, Juvia-chan... You said you were going on a job?\I sure wish I could go with you...\And I told you to stay away from me.\You're so smothering...\Juvia is going on a job by herself. response:	Because you're no help at all.
context: They really, really get along...\Even with everything backwards, I think there should be limits...\So, Juvia-chan... You said you were going on a job?\I sure wish I could go with you...\And I told you to stay away from me.\You're so smothering...\Juvia is going on a job by herself.\Because you're no help at all. response:	Gray-san, don't you think you should give up?
context: Even with everything backwards, I think there should be limits...\So, Juvia-chan... You said you were going on a job?\I sure wish I could go with you...\And I told you to stay away from me.\You're so smothering...\Juvia is going on a job by herself.\Because you're no help at all.\Gray-san, don't you think you should give up? response:	It was true for Leon-kun, too... But I'm not seeing any hope here.
context: So, Juvia-chan... You said you were going on a job?\I sure wish I could go with you...\And I told you to stay away from me.\You're so smothering...\Juvia is going on a job by herself.\Because you're no help at all.\Gray-san, don't you think you should give up?\It was true for Leon-kun, too... But I'm not seeing any hope here. response:	Don't say the name of that bundled-up playboy in front of me!
context: I sure wish I could go with you...\And I told you to stay away from me.\You're so smothering...\Juvia is going on a job by herself.\Because you're no help at all.\Gray-san, don't you think you should give up?\It was true for Leon-kun, too... But I'm not seeing any hope here.\Don't say the name of that bundled-up playboy in front of me! response:	Juvia-chan, I'm begging you!
context: And I told you to stay away from me.\You're so smothering...\Juvia is going on a job by herself.\Because you're no help at all.\Gray-san, don't you think you should give up?\It was true for Leon-kun, too... But I'm not seeing any hope here.\Don't say the name of that bundled-up playboy in front of me!\Juvia-chan, I'm begging you! response:	You're a pest!
context: You're so smothering...\Juvia is going on a job by herself.\Because you're no help at all.\Gray-san, don't you think you should give up?\It was true for Leon-kun, too... But I'm not seeing any hope here.\Don't say the name of that bundled-up playboy in front of me!\Juvia-chan, I'm begging you!\You're a pest! response:	Help me!
context: Juvia is going on a job by herself.\Because you're no help at all.\Gray-san, don't you think you should give up?\It was true for Leon-kun, too... But I'm not seeing any hope here.\Don't say the name of that bundled-up playboy in front of me!\Juvia-chan, I'm begging you!\You're a pest!\Help me! response:	And help me!
context: Because you're no help at all.\Gray-san, don't you think you should give up?\It was true for Leon-kun, too... But I'm not seeing any hope here.\Don't say the name of that bundled-up playboy in front of me!\Juvia-chan, I'm begging you!\You're a pest!\Help me!\And help me! response:	Reedus?
context: Gray-san, don't you think you should give up?\It was true for Leon-kun, too... But I'm not seeing any hope here.\Don't say the name of that bundled-up playboy in front of me!\Juvia-chan, I'm begging you!\You're a pest!\Help me!\And help me!\Reedus? response:	Sheesh... Stop lounging around!
context: It was true for Leon-kun, too... But I'm not seeing any hope here.\Don't say the name of that bundled-up playboy in front of me!\Juvia-chan, I'm begging you!\You're a pest!\Help me!\And help me!\Reedus?\Sheesh... Stop lounging around! response:	You'll get yourself hurt!
context: Don't say the name of that bundled-up playboy in front of me!\Juvia-chan, I'm begging you!\You're a pest!\Help me!\And help me!\Reedus?\Sheesh... Stop lounging around!\You'll get yourself hurt! response:	You damn fake Exceed!
context: Juvia-chan, I'm begging you!\You're a pest!\Help me!\And help me!\Reedus?\Sheesh... Stop lounging around!\You'll get yourself hurt!\You damn fake Exceed! response:	Fake?!
context: You're a pest!\Help me!\And help me!\Reedus?\Sheesh... Stop lounging around!\You'll get yourself hurt!\You damn fake Exceed!\Fake?! response:	I don't really understand, but I'm not a fake!
context: Help me!\And help me!\Reedus?\Sheesh... Stop lounging around!\You'll get yourself hurt!\You damn fake Exceed!\Fake?!\I don't really understand, but I'm not a fake! response:	Gray, don't be a lazy bum! Get up!
context: And help me!\Reedus?\Sheesh... Stop lounging around!\You'll get yourself hurt!\You damn fake Exceed!\Fake?!\I don't really understand, but I'm not a fake!\Gray, don't be a lazy bum! Get up! response:	It's warm and comfy down here...
context: Reedus?\Sheesh... Stop lounging around!\You'll get yourself hurt!\You damn fake Exceed!\Fake?!\I don't really understand, but I'm not a fake!\Gray, don't be a lazy bum! Get up!\It's warm and comfy down here... response:	You're a lazy bum, and an embarrassment!
context: Sheesh... Stop lounging around!\You'll get yourself hurt!\You damn fake Exceed!\Fake?!\I don't really understand, but I'm not a fake!\Gray, don't be a lazy bum! Get up!\It's warm and comfy down here...\You're a lazy bum, and an embarrassment! response:	Technique 35: The Bitch Drop!
context: You'll get yourself hurt!\You damn fake Exceed!\Fake?!\I don't really understand, but I'm not a fake!\Gray, don't be a lazy bum! Get up!\It's warm and comfy down here...\You're a lazy bum, and an embarrassment!\Technique 35: The Bitch Drop! response:	Technique 28: The Give-Up-Already Lock!
context: You damn fake Exceed!\Fake?!\I don't really understand, but I'm not a fake!\Gray, don't be a lazy bum! Get up!\It's warm and comfy down here...\You're a lazy bum, and an embarrassment!\Technique 35: The Bitch Drop!\Technique 28: The Give-Up-Already Lock! response:	Lucy-san is scary.
context: Fake?!\I don't really understand, but I'm not a fake!\Gray, don't be a lazy bum! Get up!\It's warm and comfy down here...\You're a lazy bum, and an embarrassment!\Technique 35: The Bitch Drop!\Technique 28: The Give-Up-Already Lock!\Lucy-san is scary. response:	You ain't getting away, Natsu!
context: I don't really understand, but I'm not a fake!\Gray, don't be a lazy bum! Get up!\It's warm and comfy down here...\You're a lazy bum, and an embarrassment!\Technique 35: The Bitch Drop!\Technique 28: The Give-Up-Already Lock!\Lucy-san is scary.\You ain't getting away, Natsu! response:	Work, work!
context: Gray, don't be a lazy bum! Get up!\It's warm and comfy down here...\You're a lazy bum, and an embarrassment!\Technique 35: The Bitch Drop!\Technique 28: The Give-Up-Already Lock!\Lucy-san is scary.\You ain't getting away, Natsu!\Work, work! response:	Where are you hiding?
context: It's warm and comfy down here...\You're a lazy bum, and an embarrassment!\Technique 35: The Bitch Drop!\Technique 28: The Give-Up-Already Lock!\Lucy-san is scary.\You ain't getting away, Natsu!\Work, work!\Where are you hiding? response:	No use... The transmission lines are shot...
context: You're a lazy bum, and an embarrassment!\Technique 35: The Bitch Drop!\Technique 28: The Give-Up-Already Lock!\Lucy-san is scary.\You ain't getting away, Natsu!\Work, work!\Where are you hiding?\No use... The transmission lines are shot... response:	On to the next job!
context: Technique 35: The Bitch Drop!\Technique 28: The Give-Up-Already Lock!\Lucy-san is scary.\You ain't getting away, Natsu!\Work, work!\Where are you hiding?\No use... The transmission lines are shot...\On to the next job! response:	Keep it down, Nab. You suck!
context: Technique 28: The Give-Up-Already Lock!\Lucy-san is scary.\You ain't getting away, Natsu!\Work, work!\Where are you hiding?\No use... The transmission lines are shot...\On to the next job!\Keep it down, Nab. You suck! response:	What'd you say?!
context: Lucy-san is scary.\You ain't getting away, Natsu!\Work, work!\Where are you hiding?\No use... The transmission lines are shot...\On to the next job!\Keep it down, Nab. You suck!\What'd you say?! response:	What the hell you mean I suck, Levy?
context: You ain't getting away, Natsu!\Work, work!\Where are you hiding?\No use... The transmission lines are shot...\On to the next job!\Keep it down, Nab. You suck!\What'd you say?!\What the hell you mean I suck, Levy? response:	Can't you tell I'm doing some delicate maintenance right now?
context: Work, work!\Where are you hiding?\No use... The transmission lines are shot...\On to the next job!\Keep it down, Nab. You suck!\What'd you say?!\What the hell you mean I suck, Levy?\Can't you tell I'm doing some delicate maintenance right now? response:	With you running around all over the place, I can't concentrate!
context: Where are you hiding?\No use... The transmission lines are shot...\On to the next job!\Keep it down, Nab. You suck!\What'd you say?!\What the hell you mean I suck, Levy?\Can't you tell I'm doing some delicate maintenance right now?\With you running around all over the place, I can't concentrate! response:	Come on out, Natsu!
context: No use... The transmission lines are shot...\On to the next job!\Keep it down, Nab. You suck!\What'd you say?!\What the hell you mean I suck, Levy?\Can't you tell I'm doing some delicate maintenance right now?\With you running around all over the place, I can't concentrate!\Come on out, Natsu! response:	I'll try out my new technique on ya!
context: On to the next job!\Keep it down, Nab. You suck!\What'd you say?!\What the hell you mean I suck, Levy?\Can't you tell I'm doing some delicate maintenance right now?\With you running around all over the place, I can't concentrate!\Come on out, Natsu!\I'll try out my new technique on ya! response:	Keep it down, Lucy! You suck!
context: Keep it down, Nab. You suck!\What'd you say?!\What the hell you mean I suck, Levy?\Can't you tell I'm doing some delicate maintenance right now?\With you running around all over the place, I can't concentrate!\Come on out, Natsu!\I'll try out my new technique on ya!\Keep it down, Lucy! You suck! response:	What the hell did you say?
context: What'd you say?!\What the hell you mean I suck, Levy?\Can't you tell I'm doing some delicate maintenance right now?\With you running around all over the place, I can't concentrate!\Come on out, Natsu!\I'll try out my new technique on ya!\Keep it down, Lucy! You suck!\What the hell did you say? response:	I said I was in the middle of maintenance!
context: What the hell you mean I suck, Levy?\Can't you tell I'm doing some delicate maintenance right now?\With you running around all over the place, I can't concentrate!\Come on out, Natsu!\I'll try out my new technique on ya!\Keep it down, Lucy! You suck!\What the hell did you say?\I said I was in the middle of maintenance! response:	You damn amazon woman!
context: Can't you tell I'm doing some delicate maintenance right now?\With you running around all over the place, I can't concentrate!\Come on out, Natsu!\I'll try out my new technique on ya!\Keep it down, Lucy! You suck!\What the hell did you say?\I said I was in the middle of maintenance!\You damn amazon woman! response:	Then hurry the hell up with it!
context: With you running around all over the place, I can't concentrate!\Come on out, Natsu!\I'll try out my new technique on ya!\Keep it down, Lucy! You suck!\What the hell did you say?\I said I was in the middle of maintenance!\You damn amazon woman!\Then hurry the hell up with it! response:	You skinny mechanic!
context: Come on out, Natsu!\I'll try out my new technique on ya!\Keep it down, Lucy! You suck!\What the hell did you say?\I said I was in the middle of maintenance!\You damn amazon woman!\Then hurry the hell up with it!\You skinny mechanic! response:	Now, now... Calm down, you two.
context: I'll try out my new technique on ya!\Keep it down, Lucy! You suck!\What the hell did you say?\I said I was in the middle of maintenance!\You damn amazon woman!\Then hurry the hell up with it!\You skinny mechanic!\Now, now... Calm down, you two. response:	We're really counting on you, Levy-san.
context: Keep it down, Lucy! You suck!\What the hell did you say?\I said I was in the middle of maintenance!\You damn amazon woman!\Then hurry the hell up with it!\You skinny mechanic!\Now, now... Calm down, you two.\We're really counting on you, Levy-san. response:	Without your engineering, this guild would be...
context: What the hell did you say?\I said I was in the middle of maintenance!\You damn amazon woman!\Then hurry the hell up with it!\You skinny mechanic!\Now, now... Calm down, you two.\We're really counting on you, Levy-san.\Without your engineering, this guild would be... response:	We're counting on you to make it quick.
context: I said I was in the middle of maintenance!\You damn amazon woman!\Then hurry the hell up with it!\You skinny mechanic!\Now, now... Calm down, you two.\We're really counting on you, Levy-san.\Without your engineering, this guild would be...\We're counting on you to make it quick. response:	As long as you understand.
context: You damn amazon woman!\Then hurry the hell up with it!\You skinny mechanic!\Now, now... Calm down, you two.\We're really counting on you, Levy-san.\Without your engineering, this guild would be...\We're counting on you to make it quick.\As long as you understand. response:	Oh, yeah... It doesn't look like Erza-san is here...
context: Then hurry the hell up with it!\You skinny mechanic!\Now, now... Calm down, you two.\We're really counting on you, Levy-san.\Without your engineering, this guild would be...\We're counting on you to make it quick.\As long as you understand.\Oh, yeah... It doesn't look like Erza-san is here... response:	You gotta be kiddin' me...
context: You skinny mechanic!\Now, now... Calm down, you two.\We're really counting on you, Levy-san.\Without your engineering, this guild would be...\We're counting on you to make it quick.\As long as you understand.\Oh, yeah... It doesn't look like Erza-san is here...\You gotta be kiddin' me... response:	Hey, so what do you think Erza's like over here?
context: Now, now... Calm down, you two.\We're really counting on you, Levy-san.\Without your engineering, this guild would be...\We're counting on you to make it quick.\As long as you understand.\Oh, yeah... It doesn't look like Erza-san is here...\You gotta be kiddin' me...\Hey, so what do you think Erza's like over here? response:	Well, you know, probably backwards.
context: We're really counting on you, Levy-san.\Without your engineering, this guild would be...\We're counting on you to make it quick.\As long as you understand.\Oh, yeah... It doesn't look like Erza-san is here...\You gotta be kiddin' me...\Hey, so what do you think Erza's like over here?\Well, you know, probably backwards. response:	Natsu-san...
context: Without your engineering, this guild would be...\We're counting on you to make it quick.\As long as you understand.\Oh, yeah... It doesn't look like Erza-san is here...\You gotta be kiddin' me...\Hey, so what do you think Erza's like over here?\Well, you know, probably backwards.\Natsu-san... response:	What's the opposite of Erza, anyway?
context: We're counting on you to make it quick.\As long as you understand.\Oh, yeah... It doesn't look like Erza-san is here...\You gotta be kiddin' me...\Hey, so what do you think Erza's like over here?\Well, you know, probably backwards.\Natsu-san...\What's the opposite of Erza, anyway? response:	Hmm, good question...
context: As long as you understand.\Oh, yeah... It doesn't look like Erza-san is here...\You gotta be kiddin' me...\Hey, so what do you think Erza's like over here?\Well, you know, probably backwards.\Natsu-san...\What's the opposite of Erza, anyway?\Hmm, good question... response:	You fool!
context: Oh, yeah... It doesn't look like Erza-san is here...\You gotta be kiddin' me...\Hey, so what do you think Erza's like over here?\Well, you know, probably backwards.\Natsu-san...\What's the opposite of Erza, anyway?\Hmm, good question...\You fool! response:	How many times do I have to tell you?
context: You gotta be kiddin' me...\Hey, so what do you think Erza's like over here?\Well, you know, probably backwards.\Natsu-san...\What's the opposite of Erza, anyway?\Hmm, good question...\You fool!\How many times do I have to tell you? response:	I'm sorry! I'm sorry!
context: Hey, so what do you think Erza's like over here?\Well, you know, probably backwards.\Natsu-san...\What's the opposite of Erza, anyway?\Hmm, good question...\You fool!\How many times do I have to tell you?\I'm sorry! I'm sorry! response:	I'll never hold you back again, I promise, Natsu-san!
context: Well, you know, probably backwards.\Natsu-san...\What's the opposite of Erza, anyway?\Hmm, good question...\You fool!\How many times do I have to tell you?\I'm sorry! I'm sorry!\I'll never hold you back again, I promise, Natsu-san! response:	Fine, as long as you understand!
context: Natsu-san...\What's the opposite of Erza, anyway?\Hmm, good question...\You fool!\How many times do I have to tell you?\I'm sorry! I'm sorry!\I'll never hold you back again, I promise, Natsu-san!\Fine, as long as you understand! response:	I'm so honored to have your leadership!
context: What's the opposite of Erza, anyway?\Hmm, good question...\You fool!\How many times do I have to tell you?\I'm sorry! I'm sorry!\I'll never hold you back again, I promise, Natsu-san!\Fine, as long as you understand!\I'm so honored to have your leadership! response:	Like that?
context: Hmm, good question...\You fool!\How many times do I have to tell you?\I'm sorry! I'm sorry!\I'll never hold you back again, I promise, Natsu-san!\Fine, as long as you understand!\I'm so honored to have your leadership!\Like that? response:	Isn't that just your secret desire, Natsu?
context: You fool!\How many times do I have to tell you?\I'm sorry! I'm sorry!\I'll never hold you back again, I promise, Natsu-san!\Fine, as long as you understand!\I'm so honored to have your leadership!\Like that?\Isn't that just your secret desire, Natsu? response:	Oh yeah?
context: How many times do I have to tell you?\I'm sorry! I'm sorry!\I'll never hold you back again, I promise, Natsu-san!\Fine, as long as you understand!\I'm so honored to have your leadership!\Like that?\Isn't that just your secret desire, Natsu?\Oh yeah? response:	Then what do you think, Happy?
context: I'm sorry! I'm sorry!\I'll never hold you back again, I promise, Natsu-san!\Fine, as long as you understand!\I'm so honored to have your leadership!\Like that?\Isn't that just your secret desire, Natsu?\Oh yeah?\Then what do you think, Happy? response:	I think she'd be like this, definitely!
context: I'll never hold you back again, I promise, Natsu-san!\Fine, as long as you understand!\I'm so honored to have your leadership!\Like that?\Isn't that just your secret desire, Natsu?\Oh yeah?\Then what do you think, Happy?\I think she'd be like this, definitely! response:	Master Happy, leave this situation to me!
context: Fine, as long as you understand!\I'm so honored to have your leadership!\Like that?\Isn't that just your secret desire, Natsu?\Oh yeah?\Then what do you think, Happy?\I think she'd be like this, definitely!\Master Happy, leave this situation to me! response:	Sure, break a leg!
context: I'm so honored to have your leadership!\Like that?\Isn't that just your secret desire, Natsu?\Oh yeah?\Then what do you think, Happy?\I think she'd be like this, definitely!\Master Happy, leave this situation to me!\Sure, break a leg! response:	Master Happy, I will protect you, no matter what!
context: Like that?\Isn't that just your secret desire, Natsu?\Oh yeah?\Then what do you think, Happy?\I think she'd be like this, definitely!\Master Happy, leave this situation to me!\Sure, break a leg!\Master Happy, I will protect you, no matter what! response:	Sure, that's a real load off.
context: Isn't that just your secret desire, Natsu?\Oh yeah?\Then what do you think, Happy?\I think she'd be like this, definitely!\Master Happy, leave this situation to me!\Sure, break a leg!\Master Happy, I will protect you, no matter what!\Sure, that's a real load off. response:	Go forth, my servant Erza...
context: Oh yeah?\Then what do you think, Happy?\I think she'd be like this, definitely!\Master Happy, leave this situation to me!\Sure, break a leg!\Master Happy, I will protect you, no matter what!\Sure, that's a real load off.\Go forth, my servant Erza... response:	At your command!
context: Then what do you think, Happy?\I think she'd be like this, definitely!\Master Happy, leave this situation to me!\Sure, break a leg!\Master Happy, I will protect you, no matter what!\Sure, that's a real load off.\Go forth, my servant Erza...\At your command! response:	Like that?
context: I think she'd be like this, definitely!\Master Happy, leave this situation to me!\Sure, break a leg!\Master Happy, I will protect you, no matter what!\Sure, that's a real load off.\Go forth, my servant Erza...\At your command!\Like that? response:	No, I think your desire is even worse...
context: Master Happy, leave this situation to me!\Sure, break a leg!\Master Happy, I will protect you, no matter what!\Sure, that's a real load off.\Go forth, my servant Erza...\At your command!\Like that?\No, I think your desire is even worse... response:	I think she'll be like this!
context: Sure, break a leg!\Master Happy, I will protect you, no matter what!\Sure, that's a real load off.\Go forth, my servant Erza...\At your command!\Like that?\No, I think your desire is even worse...\I think she'll be like this! response:	I improved my cooking skills for you, Wendy!
context: Master Happy, I will protect you, no matter what!\Sure, that's a real load off.\Go forth, my servant Erza...\At your command!\Like that?\No, I think your desire is even worse...\I think she'll be like this!\I improved my cooking skills for you, Wendy! response:	Now, eat your fill!
context: Sure, that's a real load off.\Go forth, my servant Erza...\At your command!\Like that?\No, I think your desire is even worse...\I think she'll be like this!\I improved my cooking skills for you, Wendy!\Now, eat your fill! response:	Thank you very much! Thanks for the food!
context: Go forth, my servant Erza...\At your command!\Like that?\No, I think your desire is even worse...\I think she'll be like this!\I improved my cooking skills for you, Wendy!\Now, eat your fill!\Thank you very much! Thanks for the food! response:	If you eat too much, you'll get cavities...
context: At your command!\Like that?\No, I think your desire is even worse...\I think she'll be like this!\I improved my cooking skills for you, Wendy!\Now, eat your fill!\Thank you very much! Thanks for the food!\If you eat too much, you'll get cavities... response:	Like that!
context: Like that?\No, I think your desire is even worse...\I think she'll be like this!\I improved my cooking skills for you, Wendy!\Now, eat your fill!\Thank you very much! Thanks for the food!\If you eat too much, you'll get cavities...\Like that! response:	That's where she went?!
context: No, I think your desire is even worse...\I think she'll be like this!\I improved my cooking skills for you, Wendy!\Now, eat your fill!\Thank you very much! Thanks for the food!\If you eat too much, you'll get cavities...\Like that!\That's where she went?! response:	Will you people stop fantasizing about such trifling trifles?!
context: I think she'll be like this!\I improved my cooking skills for you, Wendy!\Now, eat your fill!\Thank you very much! Thanks for the food!\If you eat too much, you'll get cavities...\Like that!\That's where she went?!\Will you people stop fantasizing about such trifling trifles?! response:	But...
context: I improved my cooking skills for you, Wendy!\Now, eat your fill!\Thank you very much! Thanks for the food!\If you eat too much, you'll get cavities...\Like that!\That's where she went?!\Will you people stop fantasizing about such trifling trifles?!\But... response:	An opposite Erza-san...
context: Now, eat your fill!\Thank you very much! Thanks for the food!\If you eat too much, you'll get cavities...\Like that!\That's where she went?!\Will you people stop fantasizing about such trifling trifles?!\But...\An opposite Erza-san... response:	What would she really be like?
context: Thank you very much! Thanks for the food!\If you eat too much, you'll get cavities...\Like that!\That's where she went?!\Will you people stop fantasizing about such trifling trifles?!\But...\An opposite Erza-san...\What would she really be like? response:	I found you, Natsu!
context: If you eat too much, you'll get cavities...\Like that!\That's where she went?!\Will you people stop fantasizing about such trifling trifles?!\But...\An opposite Erza-san...\What would she really be like?\I found you, Natsu! response:	Hey, you...
context: Like that!\That's where she went?!\Will you people stop fantasizing about such trifling trifles?!\But...\An opposite Erza-san...\What would she really be like?\I found you, Natsu!\Hey, you... response:	Okay! Time to try out my new technique!
context: That's where she went?!\Will you people stop fantasizing about such trifling trifles?!\But...\An opposite Erza-san...\What would she really be like?\I found you, Natsu!\Hey, you...\Okay! Time to try out my new technique! response:	I said, stop it!
context: Will you people stop fantasizing about such trifling trifles?!\But...\An opposite Erza-san...\What would she really be like?\I found you, Natsu!\Hey, you...\Okay! Time to try out my new technique!\I said, stop it! response:	If you don't cut it out, even if you are Lucy, I'm not gonna...
context: But...\An opposite Erza-san...\What would she really be like?\I found you, Natsu!\Hey, you...\Okay! Time to try out my new technique!\I said, stop it!\If you don't cut it out, even if you are Lucy, I'm not gonna... response:	You wanna go?
context: An opposite Erza-san...\What would she really be like?\I found you, Natsu!\Hey, you...\Okay! Time to try out my new technique!\I said, stop it!\If you don't cut it out, even if you are Lucy, I'm not gonna...\You wanna go? response:	Be my guest.
context: What would she really be like?\I found you, Natsu!\Hey, you...\Okay! Time to try out my new technique!\I said, stop it!\If you don't cut it out, even if you are Lucy, I'm not gonna...\You wanna go?\Be my guest. response:	S-She's strong!
context: I found you, Natsu!\Hey, you...\Okay! Time to try out my new technique!\I said, stop it!\If you don't cut it out, even if you are Lucy, I'm not gonna...\You wanna go?\Be my guest.\S-She's strong! response:	Natsu, are you okay?
context: Hey, you...\Okay! Time to try out my new technique!\I said, stop it!\If you don't cut it out, even if you are Lucy, I'm not gonna...\You wanna go?\Be my guest.\S-She's strong!\Natsu, are you okay? response:	I'm... not okay.
context: Okay! Time to try out my new technique!\I said, stop it!\If you don't cut it out, even if you are Lucy, I'm not gonna...\You wanna go?\Be my guest.\S-She's strong!\Natsu, are you okay?\I'm... not okay. response:	You don't got the guts, chump.
context: I said, stop it!\If you don't cut it out, even if you are Lucy, I'm not gonna...\You wanna go?\Be my guest.\S-She's strong!\Natsu, are you okay?\I'm... not okay.\You don't got the guts, chump. response:	Natsu-san actually talked back to Lucy-san!
context: If you don't cut it out, even if you are Lucy, I'm not gonna...\You wanna go?\Be my guest.\S-She's strong!\Natsu, are you okay?\I'm... not okay.\You don't got the guts, chump.\Natsu-san actually talked back to Lucy-san! response:	That's quite a rare occurrence.
context: You wanna go?\Be my guest.\S-She's strong!\Natsu, are you okay?\I'm... not okay.\You don't got the guts, chump.\Natsu-san actually talked back to Lucy-san!\That's quite a rare occurrence. response:	But man, what an idiot.
context: Be my guest.\S-She's strong!\Natsu, are you okay?\I'm... not okay.\You don't got the guts, chump.\Natsu-san actually talked back to Lucy-san!\That's quite a rare occurrence.\But man, what an idiot. response:	Now, spit it out! What the hell were you doing, and where?
context: S-She's strong!\Natsu, are you okay?\I'm... not okay.\You don't got the guts, chump.\Natsu-san actually talked back to Lucy-san!\That's quite a rare occurrence.\But man, what an idiot.\Now, spit it out! What the hell were you doing, and where? response:	You see... I...
context: Natsu, are you okay?\I'm... not okay.\You don't got the guts, chump.\Natsu-san actually talked back to Lucy-san!\That's quite a rare occurrence.\But man, what an idiot.\Now, spit it out! What the hell were you doing, and where?\You see... I... response:	Happy, some help here?
context: I'm... not okay.\You don't got the guts, chump.\Natsu-san actually talked back to Lucy-san!\That's quite a rare occurrence.\But man, what an idiot.\Now, spit it out! What the hell were you doing, and where?\You see... I...\Happy, some help here? response:	This helmet has been very stuffy and I have no strength left.
context: You don't got the guts, chump.\Natsu-san actually talked back to Lucy-san!\That's quite a rare occurrence.\But man, what an idiot.\Now, spit it out! What the hell were you doing, and where?\You see... I...\Happy, some help here?\This helmet has been very stuffy and I have no strength left. response:	You cold-hearted...
context: Natsu-san actually talked back to Lucy-san!\That's quite a rare occurrence.\But man, what an idiot.\Now, spit it out! What the hell were you doing, and where?\You see... I...\Happy, some help here?\This helmet has been very stuffy and I have no strength left.\You cold-hearted... response:	Lucy... Bullying Natsu again?
context: That's quite a rare occurrence.\But man, what an idiot.\Now, spit it out! What the hell were you doing, and where?\You see... I...\Happy, some help here?\This helmet has been very stuffy and I have no strength left.\You cold-hearted...\Lucy... Bullying Natsu again? response:	Stop it, already.
context: But man, what an idiot.\Now, spit it out! What the hell were you doing, and where?\You see... I...\Happy, some help here?\This helmet has been very stuffy and I have no strength left.\You cold-hearted...\Lucy... Bullying Natsu again?\Stop it, already. response:	We're done here.
context: Now, spit it out! What the hell were you doing, and where?\You see... I...\Happy, some help here?\This helmet has been very stuffy and I have no strength left.\You cold-hearted...\Lucy... Bullying Natsu again?\Stop it, already.\We're done here. response:	No way...
context: You see... I...\Happy, some help here?\This helmet has been very stuffy and I have no strength left.\You cold-hearted...\Lucy... Bullying Natsu again?\Stop it, already.\We're done here.\No way... response:	You've come back!
context: Happy, some help here?\This helmet has been very stuffy and I have no strength left.\You cold-hearted...\Lucy... Bullying Natsu again?\Stop it, already.\We're done here.\No way...\You've come back! response:	I'm back, Mira-nee, Elf-niichan.
context: This helmet has been very stuffy and I have no strength left.\You cold-hearted...\Lucy... Bullying Natsu again?\Stop it, already.\We're done here.\No way...\You've come back!\I'm back, Mira-nee, Elf-niichan. response:	L-Lisanna...
context: You cold-hearted...\Lucy... Bullying Natsu again?\Stop it, already.\We're done here.\No way...\You've come back!\I'm back, Mira-nee, Elf-niichan.\L-Lisanna... response:	No way...
context: Lucy... Bullying Natsu again?\Stop it, already.\We're done here.\No way...\You've come back!\I'm back, Mira-nee, Elf-niichan.\L-Lisanna...\No way... response:	Lisanna...
context: Stop it, already.\We're done here.\No way...\You've come back!\I'm back, Mira-nee, Elf-niichan.\L-Lisanna...\No way...\Lisanna... response:	Jet, Droy... Don't bully Elf-niichan either!
context: We're done here.\No way...\You've come back!\I'm back, Mira-nee, Elf-niichan.\L-Lisanna...\No way...\Lisanna...\Jet, Droy... Don't bully Elf-niichan either! response:	But...
context: No way...\You've come back!\I'm back, Mira-nee, Elf-niichan.\L-Lisanna...\No way...\Lisanna...\Jet, Droy... Don't bully Elf-niichan either!\But... response:	You'll catch a cold.
context: You've come back!\I'm back, Mira-nee, Elf-niichan.\L-Lisanna...\No way...\Lisanna...\Jet, Droy... Don't bully Elf-niichan either!\But...\You'll catch a cold. response:	Um... Weren't you...
context: I'm back, Mira-nee, Elf-niichan.\L-Lisanna...\No way...\Lisanna...\Jet, Droy... Don't bully Elf-niichan either!\But...\You'll catch a cold.\Um... Weren't you... response:	I'm Lisanna!
context: L-Lisanna...\No way...\Lisanna...\Jet, Droy... Don't bully Elf-niichan either!\But...\You'll catch a cold.\Um... Weren't you...\I'm Lisanna! response:	Oh, I see... You're Mira's little sister?
context: No way...\Lisanna...\Jet, Droy... Don't bully Elf-niichan either!\But...\You'll catch a cold.\Um... Weren't you...\I'm Lisanna!\Oh, I see... You're Mira's little sister? response:	Don't be out here... Come on inside.
context: Lisanna...\Jet, Droy... Don't bully Elf-niichan either!\But...\You'll catch a cold.\Um... Weren't you...\I'm Lisanna!\Oh, I see... You're Mira's little sister?\Don't be out here... Come on inside. response:	Your name is Natsu, right?
context: Jet, Droy... Don't bully Elf-niichan either!\But...\You'll catch a cold.\Um... Weren't you...\I'm Lisanna!\Oh, I see... You're Mira's little sister?\Don't be out here... Come on inside.\Your name is Natsu, right? response:	I heard that you were raised by a dragon!
context: But...\You'll catch a cold.\Um... Weren't you...\I'm Lisanna!\Oh, I see... You're Mira's little sister?\Don't be out here... Come on inside.\Your name is Natsu, right?\I heard that you were raised by a dragon! response:	That's amazing!
context: You'll catch a cold.\Um... Weren't you...\I'm Lisanna!\Oh, I see... You're Mira's little sister?\Don't be out here... Come on inside.\Your name is Natsu, right?\I heard that you were raised by a dragon!\That's amazing! response:	Huh? Uh, yeah...
context: Um... Weren't you...\I'm Lisanna!\Oh, I see... You're Mira's little sister?\Don't be out here... Come on inside.\Your name is Natsu, right?\I heard that you were raised by a dragon!\That's amazing!\Huh? Uh, yeah... response:	I sure wish I could see a dragon...
context: I'm Lisanna!\Oh, I see... You're Mira's little sister?\Don't be out here... Come on inside.\Your name is Natsu, right?\I heard that you were raised by a dragon!\That's amazing!\Huh? Uh, yeah...\I sure wish I could see a dragon... response:	Yeah, you know?
context: Oh, I see... You're Mira's little sister?\Don't be out here... Come on inside.\Your name is Natsu, right?\I heard that you were raised by a dragon!\That's amazing!\Huh? Uh, yeah...\I sure wish I could see a dragon...\Yeah, you know? response:	Igneel is really awesome!
context: Don't be out here... Come on inside.\Your name is Natsu, right?\I heard that you were raised by a dragon!\That's amazing!\Huh? Uh, yeah...\I sure wish I could see a dragon...\Yeah, you know?\Igneel is really awesome! response:	He's so big and strong!
context: Your name is Natsu, right?\I heard that you were raised by a dragon!\That's amazing!\Huh? Uh, yeah...\I sure wish I could see a dragon...\Yeah, you know?\Igneel is really awesome!\He's so big and strong! response:	Have you ever heard of Dragon Slayer magic?
context: I heard that you were raised by a dragon!\That's amazing!\Huh? Uh, yeah...\I sure wish I could see a dragon...\Yeah, you know?\Igneel is really awesome!\He's so big and strong!\Have you ever heard of Dragon Slayer magic? response:	Come on, let's go back inside and talk.
context: That's amazing!\Huh? Uh, yeah...\I sure wish I could see a dragon...\Yeah, you know?\Igneel is really awesome!\He's so big and strong!\Have you ever heard of Dragon Slayer magic?\Come on, let's go back inside and talk. response:	Uh, sure!
context: Huh? Uh, yeah...\I sure wish I could see a dragon...\Yeah, you know?\Igneel is really awesome!\He's so big and strong!\Have you ever heard of Dragon Slayer magic?\Come on, let's go back inside and talk.\Uh, sure! response:	When we grow up...
context: I sure wish I could see a dragon...\Yeah, you know?\Igneel is really awesome!\He's so big and strong!\Have you ever heard of Dragon Slayer magic?\Come on, let's go back inside and talk.\Uh, sure!\When we grow up... response:	How pretty...
context: Yeah, you know?\Igneel is really awesome!\He's so big and strong!\Have you ever heard of Dragon Slayer magic?\Come on, let's go back inside and talk.\Uh, sure!\When we grow up...\How pretty... response:	I wish this instant would last forever...
context: Igneel is really awesome!\He's so big and strong!\Have you ever heard of Dragon Slayer magic?\Come on, let's go back inside and talk.\Uh, sure!\When we grow up...\How pretty...\I wish this instant would last forever... response:	Huh? Oh, right...
context: He's so big and strong!\Have you ever heard of Dragon Slayer magic?\Come on, let's go back inside and talk.\Uh, sure!\When we grow up...\How pretty...\I wish this instant would last forever...\Huh? Oh, right... response:	Wel-come Ho-me!
context: Have you ever heard of Dragon Slayer magic?\Come on, let's go back inside and talk.\Uh, sure!\When we grow up...\How pretty...\I wish this instant would last forever...\Huh? Oh, right...\Wel-come Ho-me! response:	I-I'm home?
context: Come on, let's go back inside and talk.\Uh, sure!\When we grow up...\How pretty...\I wish this instant would last forever...\Huh? Oh, right...\Wel-come Ho-me!\I-I'm home? response:	What are you doing, Lisanna?
context: Uh, sure!\When we grow up...\How pretty...\I wish this instant would last forever...\Huh? Oh, right...\Wel-come Ho-me!\I-I'm home?\What are you doing, Lisanna? response:	It's a grave for Elf-niichan's parakeet...
context: When we grow up...\How pretty...\I wish this instant would last forever...\Huh? Oh, right...\Wel-come Ho-me!\I-I'm home?\What are you doing, Lisanna?\It's a grave for Elf-niichan's parakeet... response:	He made that himself?
context: How pretty...\I wish this instant would last forever...\Huh? Oh, right...\Wel-come Ho-me!\I-I'm home?\What are you doing, Lisanna?\It's a grave for Elf-niichan's parakeet...\He made that himself? response:	He really loved it...
context: I wish this instant would last forever...\Huh? Oh, right...\Wel-come Ho-me!\I-I'm home?\What are you doing, Lisanna?\It's a grave for Elf-niichan's parakeet...\He made that himself?\He really loved it... response:	Pretty skilled...
context: Huh? Oh, right...\Wel-come Ho-me!\I-I'm home?\What are you doing, Lisanna?\It's a grave for Elf-niichan's parakeet...\He made that himself?\He really loved it...\Pretty skilled... response:	Then, you'll make my grave for me, right, Natsu?
context: Wel-come Ho-me!\I-I'm home?\What are you doing, Lisanna?\It's a grave for Elf-niichan's parakeet...\He made that himself?\He really loved it...\Pretty skilled...\Then, you'll make my grave for me, right, Natsu? response:	Why're you saying something like that?
context: I-I'm home?\What are you doing, Lisanna?\It's a grave for Elf-niichan's parakeet...\He made that himself?\He really loved it...\Pretty skilled...\Then, you'll make my grave for me, right, Natsu?\Why're you saying something like that? response:	You're gonna die too, Lisanna?
context: What are you doing, Lisanna?\It's a grave for Elf-niichan's parakeet...\He made that himself?\He really loved it...\Pretty skilled...\Then, you'll make my grave for me, right, Natsu?\Why're you saying something like that?\You're gonna die too, Lisanna? response:	Hey, stop it! Don't be morbid!
context: It's a grave for Elf-niichan's parakeet...\He made that himself?\He really loved it...\Pretty skilled...\Then, you'll make my grave for me, right, Natsu?\Why're you saying something like that?\You're gonna die too, Lisanna?\Hey, stop it! Don't be morbid! response:	Well, we all die sometime...
context: He made that himself?\He really loved it...\Pretty skilled...\Then, you'll make my grave for me, right, Natsu?\Why're you saying something like that?\You're gonna die too, Lisanna?\Hey, stop it! Don't be morbid!\Well, we all die sometime... response:	She stopped breathing, and then...
context: He really loved it...\Pretty skilled...\Then, you'll make my grave for me, right, Natsu?\Why're you saying something like that?\You're gonna die too, Lisanna?\Hey, stop it! Don't be morbid!\Well, we all die sometime...\She stopped breathing, and then... response:	There wasn't anything left?
context: Pretty skilled...\Then, you'll make my grave for me, right, Natsu?\Why're you saying something like that?\You're gonna die too, Lisanna?\Hey, stop it! Don't be morbid!\Well, we all die sometime...\She stopped breathing, and then...\There wasn't anything left? response:	If we could at least bury her...
context: Then, you'll make my grave for me, right, Natsu?\Why're you saying something like that?\You're gonna die too, Lisanna?\Hey, stop it! Don't be morbid!\Well, we all die sometime...\She stopped breathing, and then...\There wasn't anything left?\If we could at least bury her... response:	Hey, Natsu... There's a grave in the church, so why are you making one here?
context: Why're you saying something like that?\You're gonna die too, Lisanna?\Hey, stop it! Don't be morbid!\Well, we all die sometime...\She stopped breathing, and then...\There wasn't anything left?\If we could at least bury her...\Hey, Natsu... There's a grave in the church, so why are you making one here? response:	She's not in a place like that.
context: You're gonna die too, Lisanna?\Hey, stop it! Don't be morbid!\Well, we all die sometime...\She stopped breathing, and then...\There wasn't anything left?\If we could at least bury her...\Hey, Natsu... There's a grave in the church, so why are you making one here?\She's not in a place like that. response:	Besides, she likes the sunset here...
context: Hey, stop it! Don't be morbid!\Well, we all die sometime...\She stopped breathing, and then...\There wasn't anything left?\If we could at least bury her...\Hey, Natsu... There's a grave in the church, so why are you making one here?\She's not in a place like that.\Besides, she likes the sunset here... response:	Here, she'll be able to watch it all she wants.
context: Well, we all die sometime...\She stopped breathing, and then...\There wasn't anything left?\If we could at least bury her...\Hey, Natsu... There's a grave in the church, so why are you making one here?\She's not in a place like that.\Besides, she likes the sunset here...\Here, she'll be able to watch it all she wants. response:	Aye...
context: She stopped breathing, and then...\There wasn't anything left?\If we could at least bury her...\Hey, Natsu... There's a grave in the church, so why are you making one here?\She's not in a place like that.\Besides, she likes the sunset here...\Here, she'll be able to watch it all she wants.\Aye... response:	Even though I promised...
context: There wasn't anything left?\If we could at least bury her...\Hey, Natsu... There's a grave in the church, so why are you making one here?\She's not in a place like that.\Besides, she likes the sunset here...\Here, she'll be able to watch it all she wants.\Aye...\Even though I promised... response:	Even though I promised I'd find her...
context: If we could at least bury her...\Hey, Natsu... There's a grave in the church, so why are you making one here?\She's not in a place like that.\Besides, she likes the sunset here...\Here, she'll be able to watch it all she wants.\Aye...\Even though I promised...\Even though I promised I'd find her... response:	Aye...
context: Hey, Natsu... There's a grave in the church, so why are you making one here?\She's not in a place like that.\Besides, she likes the sunset here...\Here, she'll be able to watch it all she wants.\Aye...\Even though I promised...\Even though I promised I'd find her...\Aye... response:	Natsu!
context: She's not in a place like that.\Besides, she likes the sunset here...\Here, she'll be able to watch it all she wants.\Aye...\Even though I promised...\Even though I promised I'd find her...\Aye...\Natsu! response:	I'm heading out!
context: Besides, she likes the sunset here...\Here, she'll be able to watch it all she wants.\Aye...\Even though I promised...\Even though I promised I'd find her...\Aye...\Natsu!\I'm heading out! response:	Hey... If I disappear again sometime...
context: Here, she'll be able to watch it all she wants.\Aye...\Even though I promised...\Even though I promised I'd find her...\Aye...\Natsu!\I'm heading out!\Hey... If I disappear again sometime... response:	Will you come and find me, Natsu?
context: Aye...\Even though I promised...\Even though I promised I'd find her...\Aye...\Natsu!\I'm heading out!\Hey... If I disappear again sometime...\Will you come and find me, Natsu? response:	I've found you...
context: Even though I promised...\Even though I promised I'd find her...\Aye...\Natsu!\I'm heading out!\Hey... If I disappear again sometime...\Will you come and find me, Natsu?\I've found you... response:	Lisanna!
context: Even though I promised I'd find her...\Aye...\Natsu!\I'm heading out!\Hey... If I disappear again sometime...\Will you come and find me, Natsu?\I've found you...\Lisanna! response:	Hey!
context: Aye...\Natsu!\I'm heading out!\Hey... If I disappear again sometime...\Will you come and find me, Natsu?\I've found you...\Lisanna!\Hey! response:	Since when did you start acting like an animal?
context: Natsu!\I'm heading out!\Hey... If I disappear again sometime...\Will you come and find me, Natsu?\I've found you...\Lisanna!\Hey!\Since when did you start acting like an animal? response:	But Lisanna is alive... Right over there...
context: I'm heading out!\Hey... If I disappear again sometime...\Will you come and find me, Natsu?\I've found you...\Lisanna!\Hey!\Since when did you start acting like an animal?\But Lisanna is alive... Right over there... response:	What the hell are you talking about?
context: Hey... If I disappear again sometime...\Will you come and find me, Natsu?\I've found you...\Lisanna!\Hey!\Since when did you start acting like an animal?\But Lisanna is alive... Right over there...\What the hell are you talking about? response:	Whatever, just calm down.
context: Will you come and find me, Natsu?\I've found you...\Lisanna!\Hey!\Since when did you start acting like an animal?\But Lisanna is alive... Right over there...\What the hell are you talking about?\Whatever, just calm down. response:	Cry on my shoulder, just like old times.
context: I've found you...\Lisanna!\Hey!\Since when did you start acting like an animal?\But Lisanna is alive... Right over there...\What the hell are you talking about?\Whatever, just calm down.\Cry on my shoulder, just like old times. response:	We're best buds, right?
context: Lisanna!\Hey!\Since when did you start acting like an animal?\But Lisanna is alive... Right over there...\What the hell are you talking about?\Whatever, just calm down.\Cry on my shoulder, just like old times.\We're best buds, right? response:	Take off your clothes, Gray...
context: Hey!\Since when did you start acting like an animal?\But Lisanna is alive... Right over there...\What the hell are you talking about?\Whatever, just calm down.\Cry on my shoulder, just like old times.\We're best buds, right?\Take off your clothes, Gray... response:	You two sure are close!
context: Since when did you start acting like an animal?\But Lisanna is alive... Right over there...\What the hell are you talking about?\Whatever, just calm down.\Cry on my shoulder, just like old times.\We're best buds, right?\Take off your clothes, Gray...\You two sure are close! response:	Always fawning all over each other...
context: But Lisanna is alive... Right over there...\What the hell are you talking about?\Whatever, just calm down.\Cry on my shoulder, just like old times.\We're best buds, right?\Take off your clothes, Gray...\You two sure are close!\Always fawning all over each other... response:	Well, you and Levy fight too much, Lucy!
context: What the hell are you talking about?\Whatever, just calm down.\Cry on my shoulder, just like old times.\We're best buds, right?\Take off your clothes, Gray...\You two sure are close!\Always fawning all over each other...\Well, you and Levy fight too much, Lucy! response:	W-Why is Lisanna here?
context: Whatever, just calm down.\Cry on my shoulder, just like old times.\We're best buds, right?\Take off your clothes, Gray...\You two sure are close!\Always fawning all over each other...\Well, you and Levy fight too much, Lucy!\W-Why is Lisanna here? response:	Mira-san's little sister... She was supposed to have died, right?
context: Cry on my shoulder, just like old times.\We're best buds, right?\Take off your clothes, Gray...\You two sure are close!\Always fawning all over each other...\Well, you and Levy fight too much, Lucy!\W-Why is Lisanna here?\Mira-san's little sister... She was supposed to have died, right? response:	Then it's not that everyone has turned opposite.
context: We're best buds, right?\Take off your clothes, Gray...\You two sure are close!\Always fawning all over each other...\Well, you and Levy fight too much, Lucy!\W-Why is Lisanna here?\Mira-san's little sister... She was supposed to have died, right?\Then it's not that everyone has turned opposite. response:	See? Mira hasn't changed at all.
context: Take off your clothes, Gray...\You two sure are close!\Always fawning all over each other...\Well, you and Levy fight too much, Lucy!\W-Why is Lisanna here?\Mira-san's little sister... She was supposed to have died, right?\Then it's not that everyone has turned opposite.\See? Mira hasn't changed at all. response:	But the clincher is that.
context: You two sure are close!\Always fawning all over each other...\Well, you and Levy fight too much, Lucy!\W-Why is Lisanna here?\Mira-san's little sister... She was supposed to have died, right?\Then it's not that everyone has turned opposite.\See? Mira hasn't changed at all.\But the clincher is that. response:	Doesn't that girl look a bit like you, Wendy?
context: Always fawning all over each other...\Well, you and Levy fight too much, Lucy!\W-Why is Lisanna here?\Mira-san's little sister... She was supposed to have died, right?\Then it's not that everyone has turned opposite.\See? Mira hasn't changed at all.\But the clincher is that.\Doesn't that girl look a bit like you, Wendy? response:	You think?
context: Well, you and Levy fight too much, Lucy!\W-Why is Lisanna here?\Mira-san's little sister... She was supposed to have died, right?\Then it's not that everyone has turned opposite.\See? Mira hasn't changed at all.\But the clincher is that.\Doesn't that girl look a bit like you, Wendy?\You think? response:	Seems pretty similar.
context: W-Why is Lisanna here?\Mira-san's little sister... She was supposed to have died, right?\Then it's not that everyone has turned opposite.\See? Mira hasn't changed at all.\But the clincher is that.\Doesn't that girl look a bit like you, Wendy?\You think?\Seems pretty similar. response:	Me?!
context: Mira-san's little sister... She was supposed to have died, right?\Then it's not that everyone has turned opposite.\See? Mira hasn't changed at all.\But the clincher is that.\Doesn't that girl look a bit like you, Wendy?\You think?\Seems pretty similar.\Me?! response:	Not opposite... Different.
context: Then it's not that everyone has turned opposite.\See? Mira hasn't changed at all.\But the clincher is that.\Doesn't that girl look a bit like you, Wendy?\You think?\Seems pretty similar.\Me?!\Not opposite... Different. response:	T-Then that means...
context: See? Mira hasn't changed at all.\But the clincher is that.\Doesn't that girl look a bit like you, Wendy?\You think?\Seems pretty similar.\Me?!\Not opposite... Different.\T-Then that means... response:	Right.
context: But the clincher is that.\Doesn't that girl look a bit like you, Wendy?\You think?\Seems pretty similar.\Me?!\Not opposite... Different.\T-Then that means...\Right. response:	These people are not the ones we are looking for.
context: Doesn't that girl look a bit like you, Wendy?\You think?\Seems pretty similar.\Me?!\Not opposite... Different.\T-Then that means...\Right.\These people are not the ones we are looking for. response:	They're different people.
context: You think?\Seems pretty similar.\Me?!\Not opposite... Different.\T-Then that means...\Right.\These people are not the ones we are looking for.\They're different people. response:	They're from Edolas.
context: Seems pretty similar.\Me?!\Not opposite... Different.\T-Then that means...\Right.\These people are not the ones we are looking for.\They're different people.\They're from Edolas. response:	They were here originally!
context: Me?!\Not opposite... Different.\T-Then that means...\Right.\These people are not the ones we are looking for.\They're different people.\They're from Edolas.\They were here originally! response:	It's not so unbelievable.
context: Not opposite... Different.\T-Then that means...\Right.\These people are not the ones we are looking for.\They're different people.\They're from Edolas.\They were here originally!\It's not so unbelievable. response:	Like, parallel worlds.
context: T-Then that means...\Right.\These people are not the ones we are looking for.\They're different people.\They're from Edolas.\They were here originally!\It's not so unbelievable.\Like, parallel worlds. response:	Edolas has its own culture and history.
context: Right.\These people are not the ones we are looking for.\They're different people.\They're from Edolas.\They were here originally!\It's not so unbelievable.\Like, parallel worlds.\Edolas has its own culture and history. response:	There's a possibility it has its own Fairy Tail!
context: These people are not the ones we are looking for.\They're different people.\They're from Edolas.\They were here originally!\It's not so unbelievable.\Like, parallel worlds.\Edolas has its own culture and history.\There's a possibility it has its own Fairy Tail! response:	But that's...
context: They're different people.\They're from Edolas.\They were here originally!\It's not so unbelievable.\Like, parallel worlds.\Edolas has its own culture and history.\There's a possibility it has its own Fairy Tail!\But that's... response:	This is the Fairy Tail that was in Edolas to begin with?
context: They're from Edolas.\They were here originally!\It's not so unbelievable.\Like, parallel worlds.\Edolas has its own culture and history.\There's a possibility it has its own Fairy Tail!\But that's...\This is the Fairy Tail that was in Edolas to begin with? response:	Then where are the versions that we know?
context: They were here originally!\It's not so unbelievable.\Like, parallel worlds.\Edolas has its own culture and history.\There's a possibility it has its own Fairy Tail!\But that's...\This is the Fairy Tail that was in Edolas to begin with?\Then where are the versions that we know? response:	What the hell are you blabbing about?
context: It's not so unbelievable.\Like, parallel worlds.\Edolas has its own culture and history.\There's a possibility it has its own Fairy Tail!\But that's...\This is the Fairy Tail that was in Edolas to begin with?\Then where are the versions that we know?\What the hell are you blabbing about? response:	How should I know?
context: Like, parallel worlds.\Edolas has its own culture and history.\There's a possibility it has its own Fairy Tail!\But that's...\This is the Fairy Tail that was in Edolas to begin with?\Then where are the versions that we know?\What the hell are you blabbing about?\How should I know? response:	That's what we're trying to find out.
context: Edolas has its own culture and history.\There's a possibility it has its own Fairy Tail!\But that's...\This is the Fairy Tail that was in Edolas to begin with?\Then where are the versions that we know?\What the hell are you blabbing about?\How should I know?\That's what we're trying to find out. response:	It'll be trouble to stay here any longer. Let's go.
context: There's a possibility it has its own Fairy Tail!\But that's...\This is the Fairy Tail that was in Edolas to begin with?\Then where are the versions that we know?\What the hell are you blabbing about?\How should I know?\That's what we're trying to find out.\It'll be trouble to stay here any longer. Let's go. response:	Carla, where are you going?
context: But that's...\This is the Fairy Tail that was in Edolas to begin with?\Then where are the versions that we know?\What the hell are you blabbing about?\How should I know?\That's what we're trying to find out.\It'll be trouble to stay here any longer. Let's go.\Carla, where are you going? response:	To the Royal City!
context: This is the Fairy Tail that was in Edolas to begin with?\Then where are the versions that we know?\What the hell are you blabbing about?\How should I know?\That's what we're trying to find out.\It'll be trouble to stay here any longer. Let's go.\Carla, where are you going?\To the Royal City! response:	There should be a clue about what happened to the guild in the Royal City!
context: Then where are the versions that we know?\What the hell are you blabbing about?\How should I know?\That's what we're trying to find out.\It'll be trouble to stay here any longer. Let's go.\Carla, where are you going?\To the Royal City!\There should be a clue about what happened to the guild in the Royal City! response:	It's the Fairy Hunter!
context: What the hell are you blabbing about?\How should I know?\That's what we're trying to find out.\It'll be trouble to stay here any longer. Let's go.\Carla, where are you going?\To the Royal City!\There should be a clue about what happened to the guild in the Royal City!\It's the Fairy Hunter! response:	The Fairy Hunter is here!
context: How should I know?\That's what we're trying to find out.\It'll be trouble to stay here any longer. Let's go.\Carla, where are you going?\To the Royal City!\There should be a clue about what happened to the guild in the Royal City!\It's the Fairy Hunter!\The Fairy Hunter is here! response:	You over there, cat! Where do you think you're going? It's dangerous outside!
context: That's what we're trying to find out.\It'll be trouble to stay here any longer. Let's go.\Carla, where are you going?\To the Royal City!\There should be a clue about what happened to the guild in the Royal City!\It's the Fairy Hunter!\The Fairy Hunter is here!\You over there, cat! Where do you think you're going? It's dangerous outside! response:	Crap!
context: It'll be trouble to stay here any longer. Let's go.\Carla, where are you going?\To the Royal City!\There should be a clue about what happened to the guild in the Royal City!\It's the Fairy Hunter!\The Fairy Hunter is here!\You over there, cat! Where do you think you're going? It's dangerous outside!\Crap! response:	This location's been found out already?
context: Carla, where are you going?\To the Royal City!\There should be a clue about what happened to the guild in the Royal City!\It's the Fairy Hunter!\The Fairy Hunter is here!\You over there, cat! Where do you think you're going? It's dangerous outside!\Crap!\This location's been found out already? response:	The people from the Kingdom are after us again...
context: To the Royal City!\There should be a clue about what happened to the guild in the Royal City!\It's the Fairy Hunter!\The Fairy Hunter is here!\You over there, cat! Where do you think you're going? It's dangerous outside!\Crap!\This location's been found out already?\The people from the Kingdom are after us again... response:	This is terrible!
context: There should be a clue about what happened to the guild in the Royal City!\It's the Fairy Hunter!\The Fairy Hunter is here!\You over there, cat! Where do you think you're going? It's dangerous outside!\Crap!\This location's been found out already?\The people from the Kingdom are after us again...\This is terrible! response:	Kingdom?
context: It's the Fairy Hunter!\The Fairy Hunter is here!\You over there, cat! Where do you think you're going? It's dangerous outside!\Crap!\This location's been found out already?\The people from the Kingdom are after us again...\This is terrible!\Kingdom? response:	The people who sent us to Earthland.
context: The Fairy Hunter is here!\You over there, cat! Where do you think you're going? It's dangerous outside!\Crap!\This location's been found out already?\The people from the Kingdom are after us again...\This is terrible!\Kingdom?\The people who sent us to Earthland. response:	We're the enemies of Fairy Tail?
context: You over there, cat! Where do you think you're going? It's dangerous outside!\Crap!\This location's been found out already?\The people from the Kingdom are after us again...\This is terrible!\Kingdom?\The people who sent us to Earthland.\We're the enemies of Fairy Tail? response:	Reactor ready for ignition.
context: Crap!\This location's been found out already?\The people from the Kingdom are after us again...\This is terrible!\Kingdom?\The people who sent us to Earthland.\We're the enemies of Fairy Tail?\Reactor ready for ignition. response:	Coordinates set.
context: This location's been found out already?\The people from the Kingdom are after us again...\This is terrible!\Kingdom?\The people who sent us to Earthland.\We're the enemies of Fairy Tail?\Reactor ready for ignition.\Coordinates set. response:	Error compensation complete in 5, 4, 3, 2, 1...
context: The people from the Kingdom are after us again...\This is terrible!\Kingdom?\The people who sent us to Earthland.\We're the enemies of Fairy Tail?\Reactor ready for ignition.\Coordinates set.\Error compensation complete in 5, 4, 3, 2, 1... response:	Connected to the marker!
context: This is terrible!\Kingdom?\The people who sent us to Earthland.\We're the enemies of Fairy Tail?\Reactor ready for ignition.\Coordinates set.\Error compensation complete in 5, 4, 3, 2, 1...\Connected to the marker! response:	Shock absorber charged with magic!
context: Kingdom?\The people who sent us to Earthland.\We're the enemies of Fairy Tail?\Reactor ready for ignition.\Coordinates set.\Error compensation complete in 5, 4, 3, 2, 1...\Connected to the marker!\Shock absorber charged with magic! response:	How long until the transmission magic circle, Levy?
context: The people who sent us to Earthland.\We're the enemies of Fairy Tail?\Reactor ready for ignition.\Coordinates set.\Error compensation complete in 5, 4, 3, 2, 1...\Connected to the marker!\Shock absorber charged with magic!\How long until the transmission magic circle, Levy? response:	I'm working on it right now! Suck it, Lucy!
context: We're the enemies of Fairy Tail?\Reactor ready for ignition.\Coordinates set.\Error compensation complete in 5, 4, 3, 2, 1...\Connected to the marker!\Shock absorber charged with magic!\How long until the transmission magic circle, Levy?\I'm working on it right now! Suck it, Lucy! response:	It's gonna be too late!
context: Reactor ready for ignition.\Coordinates set.\Error compensation complete in 5, 4, 3, 2, 1...\Connected to the marker!\Shock absorber charged with magic!\How long until the transmission magic circle, Levy?\I'm working on it right now! Suck it, Lucy!\It's gonna be too late! response:	The Fairy Hunter is coming!
context: Coordinates set.\Error compensation complete in 5, 4, 3, 2, 1...\Connected to the marker!\Shock absorber charged with magic!\How long until the transmission magic circle, Levy?\I'm working on it right now! Suck it, Lucy!\It's gonna be too late!\The Fairy Hunter is coming! response:	I know that, sheesh!
context: Error compensation complete in 5, 4, 3, 2, 1...\Connected to the marker!\Shock absorber charged with magic!\How long until the transmission magic circle, Levy?\I'm working on it right now! Suck it, Lucy!\It's gonna be too late!\The Fairy Hunter is coming!\I know that, sheesh! response:	Stop blabbing and hurry up!
context: Connected to the marker!\Shock absorber charged with magic!\How long until the transmission magic circle, Levy?\I'm working on it right now! Suck it, Lucy!\It's gonna be too late!\The Fairy Hunter is coming!\I know that, sheesh!\Stop blabbing and hurry up! response:	Fairy Hunter?
context: Shock absorber charged with magic!\How long until the transmission magic circle, Levy?\I'm working on it right now! Suck it, Lucy!\It's gonna be too late!\The Fairy Hunter is coming!\I know that, sheesh!\Stop blabbing and hurry up!\Fairy Hunter? response:	40 output for transmission threshold...
context: How long until the transmission magic circle, Levy?\I'm working on it right now! Suck it, Lucy!\It's gonna be too late!\The Fairy Hunter is coming!\I know that, sheesh!\Stop blabbing and hurry up!\Fairy Hunter?\40 output for transmission threshold... response:	43...
context: I'm working on it right now! Suck it, Lucy!\It's gonna be too late!\The Fairy Hunter is coming!\I know that, sheesh!\Stop blabbing and hurry up!\Fairy Hunter?\40 output for transmission threshold...\43... response:	46...
context: It's gonna be too late!\The Fairy Hunter is coming!\I know that, sheesh!\Stop blabbing and hurry up!\Fairy Hunter?\40 output for transmission threshold...\43...\46... response:	51!
context: The Fairy Hunter is coming!\I know that, sheesh!\Stop blabbing and hurry up!\Fairy Hunter?\40 output for transmission threshold...\43...\46...\51! response:	What?
context: I know that, sheesh!\Stop blabbing and hurry up!\Fairy Hunter?\40 output for transmission threshold...\43...\46...\51!\What? response:	Keep your head on straight, you loser.
context: Stop blabbing and hurry up!\Fairy Hunter?\40 output for transmission threshold...\43...\46...\51!\What?\Keep your head on straight, you loser. response:	Hurry up, Levy!
context: Fairy Hunter?\40 output for transmission threshold...\43...\46...\51!\What?\Keep your head on straight, you loser.\Hurry up, Levy! response:	There's no time to waste!
context: 40 output for transmission threshold...\43...\46...\51!\What?\Keep your head on straight, you loser.\Hurry up, Levy!\There's no time to waste! response:	Shut up!
context: 43...\46...\51!\What?\Keep your head on straight, you loser.\Hurry up, Levy!\There's no time to waste!\Shut up! response:	Output at 61...
context: 46...\51!\What?\Keep your head on straight, you loser.\Hurry up, Levy!\There's no time to waste!\Shut up!\Output at 61... response:	63!
context: 51!\What?\Keep your head on straight, you loser.\Hurry up, Levy!\There's no time to waste!\Shut up!\Output at 61...\63! response:	Two minutes until transmission!
context: What?\Keep your head on straight, you loser.\Hurry up, Levy!\There's no time to waste!\Shut up!\Output at 61...\63!\Two minutes until transmission! response:	The air... is shaking...
context: Keep your head on straight, you loser.\Hurry up, Levy!\There's no time to waste!\Shut up!\Output at 61...\63!\Two minutes until transmission!\The air... is shaking... response:	She's coming!
context: Hurry up, Levy!\There's no time to waste!\Shut up!\Output at 61...\63!\Two minutes until transmission!\The air... is shaking...\She's coming! response:	What's that?
context: There's no time to waste!\Shut up!\Output at 61...\63!\Two minutes until transmission!\The air... is shaking...\She's coming!\What's that? response:	The Fairy Hunter!
context: Shut up!\Output at 61...\63!\Two minutes until transmission!\The air... is shaking...\She's coming!\What's that?\The Fairy Hunter! response:	What's that?
context: Output at 61...\63!\Two minutes until transmission!\The air... is shaking...\She's coming!\What's that?\The Fairy Hunter!\What's that? response:	The Kingdom is after Fairy Tail?
context: 63!\Two minutes until transmission!\The air... is shaking...\She's coming!\What's that?\The Fairy Hunter!\What's that?\The Kingdom is after Fairy Tail? response:	But why?
context: Two minutes until transmission!\The air... is shaking...\She's coming!\What's that?\The Fairy Hunter!\What's that?\The Kingdom is after Fairy Tail?\But why? response:	Isn't that obvious?
context: The air... is shaking...\She's coming!\What's that?\The Fairy Hunter!\What's that?\The Kingdom is after Fairy Tail?\But why?\Isn't that obvious? response:	Me?
context: She's coming!\What's that?\The Fairy Hunter!\What's that?\The Kingdom is after Fairy Tail?\But why?\Isn't that obvious?\Me? response:	By order of the King, all wizard guilds were abolished.
context: What's that?\The Fairy Hunter!\What's that?\The Kingdom is after Fairy Tail?\But why?\Isn't that obvious?\Me?\By order of the King, all wizard guilds were abolished. response:	Only one is left in the world...
context: The Fairy Hunter!\What's that?\The Kingdom is after Fairy Tail?\But why?\Isn't that obvious?\Me?\By order of the King, all wizard guilds were abolished.\Only one is left in the world... response:	The one right here.
context: What's that?\The Kingdom is after Fairy Tail?\But why?\Isn't that obvious?\Me?\By order of the King, all wizard guilds were abolished.\Only one is left in the world...\The one right here. response:	You came with Natsu, even though you didn't know?
context: The Kingdom is after Fairy Tail?\But why?\Isn't that obvious?\Me?\By order of the King, all wizard guilds were abolished.\Only one is left in the world...\The one right here.\You came with Natsu, even though you didn't know? response:	In other words, we're an underground guild.
context: But why?\Isn't that obvious?\Me?\By order of the King, all wizard guilds were abolished.\Only one is left in the world...\The one right here.\You came with Natsu, even though you didn't know?\In other words, we're an underground guild. response:	Okay! We've passed the critical point for transmission!
context: Isn't that obvious?\Me?\By order of the King, all wizard guilds were abolished.\Only one is left in the world...\The one right here.\You came with Natsu, even though you didn't know?\In other words, we're an underground guild.\Okay! We've passed the critical point for transmission! response:	Shock absorber activated!
context: Me?\By order of the King, all wizard guilds were abolished.\Only one is left in the world...\The one right here.\You came with Natsu, even though you didn't know?\In other words, we're an underground guild.\Okay! We've passed the critical point for transmission!\Shock absorber activated! response:	Transmission magic circle, expand!
context: By order of the King, all wizard guilds were abolished.\Only one is left in the world...\The one right here.\You came with Natsu, even though you didn't know?\In other words, we're an underground guild.\Okay! We've passed the critical point for transmission!\Shock absorber activated!\Transmission magic circle, expand! response:	What is it now?
context: Only one is left in the world...\The one right here.\You came with Natsu, even though you didn't know?\In other words, we're an underground guild.\Okay! We've passed the critical point for transmission!\Shock absorber activated!\Transmission magic circle, expand!\What is it now? response:	M-My body!
context: The one right here.\You came with Natsu, even though you didn't know?\In other words, we're an underground guild.\Okay! We've passed the critical point for transmission!\Shock absorber activated!\Transmission magic circle, expand!\What is it now?\M-My body! response:	We're floating!
context: You came with Natsu, even though you didn't know?\In other words, we're an underground guild.\Okay! We've passed the critical point for transmission!\Shock absorber activated!\Transmission magic circle, expand!\What is it now?\M-My body!\We're floating! response:	Everyone, grab onto something!
context: In other words, we're an underground guild.\Okay! We've passed the critical point for transmission!\Shock absorber activated!\Transmission magic circle, expand!\What is it now?\M-My body!\We're floating!\Everyone, grab onto something! response:	I want to grab onto you, Juvia-chan!
context: Okay! We've passed the critical point for transmission!\Shock absorber activated!\Transmission magic circle, expand!\What is it now?\M-My body!\We're floating!\Everyone, grab onto something!\I want to grab onto you, Juvia-chan! response:	God damn, you're suffocating!
context: Shock absorber activated!\Transmission magic circle, expand!\What is it now?\M-My body!\We're floating!\Everyone, grab onto something!\I want to grab onto you, Juvia-chan!\God damn, you're suffocating! response:	Transmission, activate!
context: Transmission magic circle, expand!\What is it now?\M-My body!\We're floating!\Everyone, grab onto something!\I want to grab onto you, Juvia-chan!\God damn, you're suffocating!\Transmission, activate! response:	Ah... Will we transfer safely, I wonder?
context: What is it now?\M-My body!\We're floating!\Everyone, grab onto something!\I want to grab onto you, Juvia-chan!\God damn, you're suffocating!\Transmission, activate!\Ah... Will we transfer safely, I wonder? response:	Cana-san, I will protect you!
context: M-My body!\We're floating!\Everyone, grab onto something!\I want to grab onto you, Juvia-chan!\God damn, you're suffocating!\Transmission, activate!\Ah... Will we transfer safely, I wonder?\Cana-san, I will protect you! response:	No, I will!
context: We're floating!\Everyone, grab onto something!\I want to grab onto you, Juvia-chan!\God damn, you're suffocating!\Transmission, activate!\Ah... Will we transfer safely, I wonder?\Cana-san, I will protect you!\No, I will! response:	Nee-chan, Lisanna... Hold onto me tight!
context: Everyone, grab onto something!\I want to grab onto you, Juvia-chan!\God damn, you're suffocating!\Transmission, activate!\Ah... Will we transfer safely, I wonder?\Cana-san, I will protect you!\No, I will!\Nee-chan, Lisanna... Hold onto me tight! response:	It's shaking... Shaking!
context: I want to grab onto you, Juvia-chan!\God damn, you're suffocating!\Transmission, activate!\Ah... Will we transfer safely, I wonder?\Cana-san, I will protect you!\No, I will!\Nee-chan, Lisanna... Hold onto me tight!\It's shaking... Shaking! response:	Transmission, eh?
context: God damn, you're suffocating!\Transmission, activate!\Ah... Will we transfer safely, I wonder?\Cana-san, I will protect you!\No, I will!\Nee-chan, Lisanna... Hold onto me tight!\It's shaking... Shaking!\Transmission, eh? response:	Transmission magic, I see.
context: Transmission, activate!\Ah... Will we transfer safely, I wonder?\Cana-san, I will protect you!\No, I will!\Nee-chan, Lisanna... Hold onto me tight!\It's shaking... Shaking!\Transmission, eh?\Transmission magic, I see. response:	Using that much magical power so foolishly...
context: Ah... Will we transfer safely, I wonder?\Cana-san, I will protect you!\No, I will!\Nee-chan, Lisanna... Hold onto me tight!\It's shaking... Shaking!\Transmission, eh?\Transmission magic, I see.\Using that much magical power so foolishly... response:	They really are quite the troublesome bunch.
context: Cana-san, I will protect you!\No, I will!\Nee-chan, Lisanna... Hold onto me tight!\It's shaking... Shaking!\Transmission, eh?\Transmission magic, I see.\Using that much magical power so foolishly...\They really are quite the troublesome bunch. response:	That damn underground guild...
context: No, I will!\Nee-chan, Lisanna... Hold onto me tight!\It's shaking... Shaking!\Transmission, eh?\Transmission magic, I see.\Using that much magical power so foolishly...\They really are quite the troublesome bunch.\That damn underground guild... response:	Sugar Boy, you're here?
context: Nee-chan, Lisanna... Hold onto me tight!\It's shaking... Shaking!\Transmission, eh?\Transmission magic, I see.\Using that much magical power so foolishly...\They really are quite the troublesome bunch.\That damn underground guild...\Sugar Boy, you're here? response:	Those fairies sure are quick at running, yes...
context: It's shaking... Shaking!\Transmission, eh?\Transmission magic, I see.\Using that much magical power so foolishly...\They really are quite the troublesome bunch.\That damn underground guild...\Sugar Boy, you're here?\Those fairies sure are quick at running, yes... response:	They flit from one place to another, like flies... Damn vermin...
context: Transmission, eh?\Transmission magic, I see.\Using that much magical power so foolishly...\They really are quite the troublesome bunch.\That damn underground guild...\Sugar Boy, you're here?\Those fairies sure are quick at running, yes...\They flit from one place to another, like flies... Damn vermin... response:	You were quite close, Fairy Hunter.
context: Transmission magic, I see.\Using that much magical power so foolishly...\They really are quite the troublesome bunch.\That damn underground guild...\Sugar Boy, you're here?\Those fairies sure are quick at running, yes...\They flit from one place to another, like flies... Damn vermin...\You were quite close, Fairy Hunter. response:	However, they won't be able to transfer too many more times.
context: Using that much magical power so foolishly...\They really are quite the troublesome bunch.\That damn underground guild...\Sugar Boy, you're here?\Those fairies sure are quick at running, yes...\They flit from one place to another, like flies... Damn vermin...\You were quite close, Fairy Hunter.\However, they won't be able to transfer too many more times. response:	It's only a matter of time until you catch your prey.
context: They really are quite the troublesome bunch.\That damn underground guild...\Sugar Boy, you're here?\Those fairies sure are quick at running, yes...\They flit from one place to another, like flies... Damn vermin...\You were quite close, Fairy Hunter.\However, they won't be able to transfer too many more times.\It's only a matter of time until you catch your prey. response:	On another subject, it seems the giant Anima plan was a success.
context: That damn underground guild...\Sugar Boy, you're here?\Those fairies sure are quick at running, yes...\They flit from one place to another, like flies... Damn vermin...\You were quite close, Fairy Hunter.\However, they won't be able to transfer too many more times.\It's only a matter of time until you catch your prey.\On another subject, it seems the giant Anima plan was a success. response:	So, all Magic Regiment Captains are to return to the Royal City.
context: Sugar Boy, you're here?\Those fairies sure are quick at running, yes...\They flit from one place to another, like flies... Damn vermin...\You were quite close, Fairy Hunter.\However, they won't be able to transfer too many more times.\It's only a matter of time until you catch your prey.\On another subject, it seems the giant Anima plan was a success.\So, all Magic Regiment Captains are to return to the Royal City. response:	The Earthland Fairy Tail was destroyed?
context: Those fairies sure are quick at running, yes...\They flit from one place to another, like flies... Damn vermin...\You were quite close, Fairy Hunter.\However, they won't be able to transfer too many more times.\It's only a matter of time until you catch your prey.\On another subject, it seems the giant Anima plan was a success.\So, all Magic Regiment Captains are to return to the Royal City.\The Earthland Fairy Tail was destroyed? response:	More accurately, absorbed.
context: They flit from one place to another, like flies... Damn vermin...\You were quite close, Fairy Hunter.\However, they won't be able to transfer too many more times.\It's only a matter of time until you catch your prey.\On another subject, it seems the giant Anima plan was a success.\So, all Magic Regiment Captains are to return to the Royal City.\The Earthland Fairy Tail was destroyed?\More accurately, absorbed. response:	Our king sure does things in a big way.
context: You were quite close, Fairy Hunter.\However, they won't be able to transfer too many more times.\It's only a matter of time until you catch your prey.\On another subject, it seems the giant Anima plan was a success.\So, all Magic Regiment Captains are to return to the Royal City.\The Earthland Fairy Tail was destroyed?\More accurately, absorbed.\Our king sure does things in a big way. response:	What happened to the wizards that were absorbed from Earthland?
context: However, they won't be able to transfer too many more times.\It's only a matter of time until you catch your prey.\On another subject, it seems the giant Anima plan was a success.\So, all Magic Regiment Captains are to return to the Royal City.\The Earthland Fairy Tail was destroyed?\More accurately, absorbed.\Our king sure does things in a big way.\What happened to the wizards that were absorbed from Earthland? response:	In the Royal City.
context: It's only a matter of time until you catch your prey.\On another subject, it seems the giant Anima plan was a success.\So, all Magic Regiment Captains are to return to the Royal City.\The Earthland Fairy Tail was destroyed?\More accurately, absorbed.\Our king sure does things in a big way.\What happened to the wizards that were absorbed from Earthland?\In the Royal City. response:	They've become a giant lacrima.
context: On another subject, it seems the giant Anima plan was a success.\So, all Magic Regiment Captains are to return to the Royal City.\The Earthland Fairy Tail was destroyed?\More accurately, absorbed.\Our king sure does things in a big way.\What happened to the wizards that were absorbed from Earthland?\In the Royal City.\They've become a giant lacrima. response:	Lovely.
context: So, all Magic Regiment Captains are to return to the Royal City.\The Earthland Fairy Tail was destroyed?\More accurately, absorbed.\Our king sure does things in a big way.\What happened to the wizards that were absorbed from Earthland?\In the Royal City.\They've become a giant lacrima.\Lovely. response:	Now Edolas doesn't need to worry about magic power for the time being.
context: The Earthland Fairy Tail was destroyed?\More accurately, absorbed.\Our king sure does things in a big way.\What happened to the wizards that were absorbed from Earthland?\In the Royal City.\They've become a giant lacrima.\Lovely.\Now Edolas doesn't need to worry about magic power for the time being. response:	Okay, children! Moving's complete!
context: More accurately, absorbed.\Our king sure does things in a big way.\What happened to the wizards that were absorbed from Earthland?\In the Royal City.\They've become a giant lacrima.\Lovely.\Now Edolas doesn't need to worry about magic power for the time being.\Okay, children! Moving's complete! response:	We're saved...
context: Our king sure does things in a big way.\What happened to the wizards that were absorbed from Earthland?\In the Royal City.\They've become a giant lacrima.\Lovely.\Now Edolas doesn't need to worry about magic power for the time being.\Okay, children! Moving's complete!\We're saved... response:	Looks like we were able to transfer in one piece.
context: What happened to the wizards that were absorbed from Earthland?\In the Royal City.\They've become a giant lacrima.\Lovely.\Now Edolas doesn't need to worry about magic power for the time being.\Okay, children! Moving's complete!\We're saved...\Looks like we were able to transfer in one piece. response:	Is everyone safe?
context: In the Royal City.\They've become a giant lacrima.\Lovely.\Now Edolas doesn't need to worry about magic power for the time being.\Okay, children! Moving's complete!\We're saved...\Looks like we were able to transfer in one piece.\Is everyone safe? response:	Move?
context: They've become a giant lacrima.\Lovely.\Now Edolas doesn't need to worry about magic power for the time being.\Okay, children! Moving's complete!\We're saved...\Looks like we were able to transfer in one piece.\Is everyone safe?\Move? response:	They moved the entire guild?
context: Lovely.\Now Edolas doesn't need to worry about magic power for the time being.\Okay, children! Moving's complete!\We're saved...\Looks like we were able to transfer in one piece.\Is everyone safe?\Move?\They moved the entire guild? response:	Wow...
context: Now Edolas doesn't need to worry about magic power for the time being.\Okay, children! Moving's complete!\We're saved...\Looks like we were able to transfer in one piece.\Is everyone safe?\Move?\They moved the entire guild?\Wow... response:	See, Juvia-chan? All my layers came in handy, right?
context: Okay, children! Moving's complete!\We're saved...\Looks like we were able to transfer in one piece.\Is everyone safe?\Move?\They moved the entire guild?\Wow...\See, Juvia-chan? All my layers came in handy, right? response:	I'll give you my thanks. For now.
context: We're saved...\Looks like we were able to transfer in one piece.\Is everyone safe?\Move?\They moved the entire guild?\Wow...\See, Juvia-chan? All my layers came in handy, right?\I'll give you my thanks. For now. response:	Too much, as always...
context: Looks like we were able to transfer in one piece.\Is everyone safe?\Move?\They moved the entire guild?\Wow...\See, Juvia-chan? All my layers came in handy, right?\I'll give you my thanks. For now.\Too much, as always... response:	Are you okay, Cana-san?
context: Is everyone safe?\Move?\They moved the entire guild?\Wow...\See, Juvia-chan? All my layers came in handy, right?\I'll give you my thanks. For now.\Too much, as always...\Are you okay, Cana-san? response:	Yes, somehow...
context: Move?\They moved the entire guild?\Wow...\See, Juvia-chan? All my layers came in handy, right?\I'll give you my thanks. For now.\Too much, as always...\Are you okay, Cana-san?\Yes, somehow... response:	Lisanna, are you injured?
context: They moved the entire guild?\Wow...\See, Juvia-chan? All my layers came in handy, right?\I'll give you my thanks. For now.\Too much, as always...\Are you okay, Cana-san?\Yes, somehow...\Lisanna, are you injured? response:	I'm fine, Elf-niichan.
context: Wow...\See, Juvia-chan? All my layers came in handy, right?\I'll give you my thanks. For now.\Too much, as always...\Are you okay, Cana-san?\Yes, somehow...\Lisanna, are you injured?\I'm fine, Elf-niichan. response:	What the hell were you taking your time for?
context: See, Juvia-chan? All my layers came in handy, right?\I'll give you my thanks. For now.\Too much, as always...\Are you okay, Cana-san?\Yes, somehow...\Lisanna, are you injured?\I'm fine, Elf-niichan.\What the hell were you taking your time for? response:	That was damn close!
context: I'll give you my thanks. For now.\Too much, as always...\Are you okay, Cana-san?\Yes, somehow...\Lisanna, are you injured?\I'm fine, Elf-niichan.\What the hell were you taking your time for?\That was damn close! response:	Shut up! Try it yourself sometime!
context: Too much, as always...\Are you okay, Cana-san?\Yes, somehow...\Lisanna, are you injured?\I'm fine, Elf-niichan.\What the hell were you taking your time for?\That was damn close!\Shut up! Try it yourself sometime! response:	Why does it shake so much, anyway?
context: Are you okay, Cana-san?\Yes, somehow...\Lisanna, are you injured?\I'm fine, Elf-niichan.\What the hell were you taking your time for?\That was damn close!\Shut up! Try it yourself sometime!\Why does it shake so much, anyway? response:	'Cause you're too fat, that's why!
context: Yes, somehow...\Lisanna, are you injured?\I'm fine, Elf-niichan.\What the hell were you taking your time for?\That was damn close!\Shut up! Try it yourself sometime!\Why does it shake so much, anyway?\'Cause you're too fat, that's why! response:	Oh, yeah?! Say that again!
context: Lisanna, are you injured?\I'm fine, Elf-niichan.\What the hell were you taking your time for?\That was damn close!\Shut up! Try it yourself sometime!\Why does it shake so much, anyway?\'Cause you're too fat, that's why!\Oh, yeah?! Say that again! response:	Why, you...
context: I'm fine, Elf-niichan.\What the hell were you taking your time for?\That was damn close!\Shut up! Try it yourself sometime!\Why does it shake so much, anyway?\'Cause you're too fat, that's why!\Oh, yeah?! Say that again!\Why, you... response:	Who was that person before...
context: What the hell were you taking your time for?\That was damn close!\Shut up! Try it yourself sometime!\Why does it shake so much, anyway?\'Cause you're too fat, that's why!\Oh, yeah?! Say that again!\Why, you...\Who was that person before... response:	What's the matter, Natsu?
context: That was damn close!\Shut up! Try it yourself sometime!\Why does it shake so much, anyway?\'Cause you're too fat, that's why!\Oh, yeah?! Say that again!\Why, you...\Who was that person before...\What's the matter, Natsu? response:	Has it been so long you forgot?
context: Shut up! Try it yourself sometime!\Why does it shake so much, anyway?\'Cause you're too fat, that's why!\Oh, yeah?! Say that again!\Why, you...\Who was that person before...\What's the matter, Natsu?\Has it been so long you forgot? response:	As if!
context: Why does it shake so much, anyway?\'Cause you're too fat, that's why!\Oh, yeah?! Say that again!\Why, you...\Who was that person before...\What's the matter, Natsu?\Has it been so long you forgot?\As if! response:	She's one of the captains of the Kingdom's Magic Regiments...
context: 'Cause you're too fat, that's why!\Oh, yeah?! Say that again!\Why, you...\Who was that person before...\What's the matter, Natsu?\Has it been so long you forgot?\As if!\She's one of the captains of the Kingdom's Magic Regiments... response:	Erza Knightwalker.
context: Oh, yeah?! Say that again!\Why, you...\Who was that person before...\What's the matter, Natsu?\Has it been so long you forgot?\As if!\She's one of the captains of the Kingdom's Magic Regiments...\Erza Knightwalker. response:	Also known as Erza the Fairy Hunter.
context: Why, you...\Who was that person before...\What's the matter, Natsu?\Has it been so long you forgot?\As if!\She's one of the captains of the Kingdom's Magic Regiments...\Erza Knightwalker.\Also known as Erza the Fairy Hunter. response:	What...?
context: Who was that person before...\What's the matter, Natsu?\Has it been so long you forgot?\As if!\She's one of the captains of the Kingdom's Magic Regiments...\Erza Knightwalker.\Also known as Erza the Fairy Hunter.\What...? response:	Erza is...
context: What's the matter, Natsu?\Has it been so long you forgot?\As if!\She's one of the captains of the Kingdom's Magic Regiments...\Erza Knightwalker.\Also known as Erza the Fairy Hunter.\What...?\Erza is... response:	The Lucy here is pretty scary.
context: Has it been so long you forgot?\As if!\She's one of the captains of the Kingdom's Magic Regiments...\Erza Knightwalker.\Also known as Erza the Fairy Hunter.\What...?\Erza is...\The Lucy here is pretty scary. response:	Really? I think the Lucy over there is plenty scary herself.
context: As if!\She's one of the captains of the Kingdom's Magic Regiments...\Erza Knightwalker.\Also known as Erza the Fairy Hunter.\What...?\Erza is...\The Lucy here is pretty scary.\Really? I think the Lucy over there is plenty scary herself. response:	You might have a point there!
context: She's one of the captains of the Kingdom's Magic Regiments...\Erza Knightwalker.\Also known as Erza the Fairy Hunter.\What...?\Erza is...\The Lucy here is pretty scary.\Really? I think the Lucy over there is plenty scary herself.\You might have a point there! response:	Now that I think about it, Lucy here is scary enough to give Lucy there a run for her money.
context: Erza Knightwalker.\Also known as Erza the Fairy Hunter.\What...?\Erza is...\The Lucy here is pretty scary.\Really? I think the Lucy over there is plenty scary herself.\You might have a point there!\Now that I think about it, Lucy here is scary enough to give Lucy there a run for her money. response:	Uh, I'm starting to get confused.
context: Also known as Erza the Fairy Hunter.\What...?\Erza is...\The Lucy here is pretty scary.\Really? I think the Lucy over there is plenty scary herself.\You might have a point there!\Now that I think about it, Lucy here is scary enough to give Lucy there a run for her money.\Uh, I'm starting to get confused. response:	If we're there, and they're here, then which is which?
context: What...?\Erza is...\The Lucy here is pretty scary.\Really? I think the Lucy over there is plenty scary herself.\You might have a point there!\Now that I think about it, Lucy here is scary enough to give Lucy there a run for her money.\Uh, I'm starting to get confused.\If we're there, and they're here, then which is which? response:	Next time: The Key of Hope!
context: Erza is...\The Lucy here is pretty scary.\Really? I think the Lucy over there is plenty scary herself.\You might have a point there!\Now that I think about it, Lucy here is scary enough to give Lucy there a run for her money.\Uh, I'm starting to get confused.\If we're there, and they're here, then which is which?\Next time: The Key of Hope! response:	Let's make it simple and call them Lucy A and Lucy B!
context: The Lucy here is pretty scary.\Really? I think the Lucy over there is plenty scary herself.\You might have a point there!\Now that I think about it, Lucy here is scary enough to give Lucy there a run for her money.\Uh, I'm starting to get confused.\If we're there, and they're here, then which is which?\Next time: The Key of Hope!\Let's make it simple and call them Lucy A and Lucy B! response:	Then this one's Lucy A, and that one's Lucy B, right?
context: Really? I think the Lucy over there is plenty scary herself.\You might have a point there!\Now that I think about it, Lucy here is scary enough to give Lucy there a run for her money.\Uh, I'm starting to get confused.\If we're there, and they're here, then which is which?\Next time: The Key of Hope!\Let's make it simple and call them Lucy A and Lucy B!\Then this one's Lucy A, and that one's Lucy B, right? response:	Which one is which?