context: Okay, for today's homeroom period, response:	Let's talk about
context: Okay, for today's homeroom period,\Let's talk about response:	this year's Literary Fest.
context: Okay, for today's homeroom period,\Let's talk about\this year's Literary Fest. response:	I wonder what we're going to do this year.
context: Okay, for today's homeroom period,\Let's talk about\this year's Literary Fest.\I wonder what we're going to do this year. response:	I am looking forward to it, you know?
context: Okay, for today's homeroom period,\Let's talk about\this year's Literary Fest.\I wonder what we're going to do this year.\I am looking forward to it, you know? response:	So Japanese schools have Literary Fest too.
context: Okay, for today's homeroom period,\Let's talk about\this year's Literary Fest.\I wonder what we're going to do this year.\I am looking forward to it, you know?\So Japanese schools have Literary Fest too. response:	Every class and club
context: Okay, for today's homeroom period,\Let's talk about\this year's Literary Fest.\I wonder what we're going to do this year.\I am looking forward to it, you know?\So Japanese schools have Literary Fest too.\Every class and club response:	does something different.
context: Okay, for today's homeroom period,\Let's talk about\this year's Literary Fest.\I wonder what we're going to do this year.\I am looking forward to it, you know?\So Japanese schools have Literary Fest too.\Every class and club\does something different. response:	Last year, we did an ensemble.
context: Let's talk about\this year's Literary Fest.\I wonder what we're going to do this year.\I am looking forward to it, you know?\So Japanese schools have Literary Fest too.\Every class and club\does something different.\Last year, we did an ensemble. response:	We all voted yesterday,
context: this year's Literary Fest.\I wonder what we're going to do this year.\I am looking forward to it, you know?\So Japanese schools have Literary Fest too.\Every class and club\does something different.\Last year, we did an ensemble.\We all voted yesterday, response:	and the result for Class 5-2 is a play.
context: I wonder what we're going to do this year.\I am looking forward to it, you know?\So Japanese schools have Literary Fest too.\Every class and club\does something different.\Last year, we did an ensemble.\We all voted yesterday,\and the result for Class 5-2 is a play. response:	It's a play!
context: I am looking forward to it, you know?\So Japanese schools have Literary Fest too.\Every class and club\does something different.\Last year, we did an ensemble.\We all voted yesterday,\and the result for Class 5-2 is a play.\It's a play! response:	It's a play!
context: So Japanese schools have Literary Fest too.\Every class and club\does something different.\Last year, we did an ensemble.\We all voted yesterday,\and the result for Class 5-2 is a play.\It's a play!\It's a play! response:	I wonder what the story is going to be.
context: Every class and club\does something different.\Last year, we did an ensemble.\We all voted yesterday,\and the result for Class 5-2 is a play.\It's a play!\It's a play!\I wonder what the story is going to be. response:	Class 6-1 is also doing a play,
context: does something different.\Last year, we did an ensemble.\We all voted yesterday,\and the result for Class 5-2 is a play.\It's a play!\It's a play!\I wonder what the story is going to be.\Class 6-1 is also doing a play, response:	But they will be doing
context: Last year, we did an ensemble.\We all voted yesterday,\and the result for Class 5-2 is a play.\It's a play!\It's a play!\I wonder what the story is going to be.\Class 6-1 is also doing a play,\But they will be doing response:	an ancient Japanese story,
context: We all voted yesterday,\and the result for Class 5-2 is a play.\It's a play!\It's a play!\I wonder what the story is going to be.\Class 6-1 is also doing a play,\But they will be doing\an ancient Japanese story, response:	So I thought,
context: and the result for Class 5-2 is a play.\It's a play!\It's a play!\I wonder what the story is going to be.\Class 6-1 is also doing a play,\But they will be doing\an ancient Japanese story,\So I thought, response:	how about let's do a western play?
context: It's a play!\It's a play!\I wonder what the story is going to be.\Class 6-1 is also doing a play,\But they will be doing\an ancient Japanese story,\So I thought,\how about let's do a western play? response:	What do you think?
context: It's a play!\I wonder what the story is going to be.\Class 6-1 is also doing a play,\But they will be doing\an ancient Japanese story,\So I thought,\how about let's do a western play?\What do you think? response:	The dream that the card showed me'
context: I wonder what the story is going to be.\Class 6-1 is also doing a play,\But they will be doing\an ancient Japanese story,\So I thought,\how about let's do a western play?\What do you think?\The dream that the card showed me' response:	That was Mizuki-sensei after all.
context: Class 6-1 is also doing a play,\But they will be doing\an ancient Japanese story,\So I thought,\how about let's do a western play?\What do you think?\The dream that the card showed me'\That was Mizuki-sensei after all. response:	Besides, Kero said
context: But they will be doing\an ancient Japanese story,\So I thought,\how about let's do a western play?\What do you think?\The dream that the card showed me'\That was Mizuki-sensei after all.\Besides, Kero said response:	what Dream showed was a prophetic dream.
context: an ancient Japanese story,\So I thought,\how about let's do a western play?\What do you think?\The dream that the card showed me'\That was Mizuki-sensei after all.\Besides, Kero said\what Dream showed was a prophetic dream. response:	Does it mean
context: So I thought,\how about let's do a western play?\What do you think?\The dream that the card showed me'\That was Mizuki-sensei after all.\Besides, Kero said\what Dream showed was a prophetic dream.\Does it mean response:	something like what's in the dream will happen some day?
context: how about let's do a western play?\What do you think?\The dream that the card showed me'\That was Mizuki-sensei after all.\Besides, Kero said\what Dream showed was a prophetic dream.\Does it mean\something like what's in the dream will happen some day? response:	But
context: What do you think?\The dream that the card showed me'\That was Mizuki-sensei after all.\Besides, Kero said\what Dream showed was a prophetic dream.\Does it mean\something like what's in the dream will happen some day?\But response:	whenever I'm looking at Mizuki-sensei'
context: The dream that the card showed me'\That was Mizuki-sensei after all.\Besides, Kero said\what Dream showed was a prophetic dream.\Does it mean\something like what's in the dream will happen some day?\But\whenever I'm looking at Mizuki-sensei' response:	I always feel so schweeet!
context: That was Mizuki-sensei after all.\Besides, Kero said\what Dream showed was a prophetic dream.\Does it mean\something like what's in the dream will happen some day?\But\whenever I'm looking at Mizuki-sensei'\I always feel so schweeet! response:	So, the title of the play
context: Besides, Kero said\what Dream showed was a prophetic dream.\Does it mean\something like what's in the dream will happen some day?\But\whenever I'm looking at Mizuki-sensei'\I always feel so schweeet!\So, the title of the play response:	you have all been waiting for'
context: what Dream showed was a prophetic dream.\Does it mean\something like what's in the dream will happen some day?\But\whenever I'm looking at Mizuki-sensei'\I always feel so schweeet!\So, the title of the play\you have all been waiting for' response:	SLEEPING BEAUTY
context: Does it mean\something like what's in the dream will happen some day?\But\whenever I'm looking at Mizuki-sensei'\I always feel so schweeet!\So, the title of the play\you have all been waiting for'\SLEEPING BEAUTY response:	Then we will decide who play the role.
context: something like what's in the dream will happen some day?\But\whenever I'm looking at Mizuki-sensei'\I always feel so schweeet!\So, the title of the play\you have all been waiting for'\SLEEPING BEAUTY\Then we will decide who play the role. response:	In order to let everyone
context: But\whenever I'm looking at Mizuki-sensei'\I always feel so schweeet!\So, the title of the play\you have all been waiting for'\SLEEPING BEAUTY\Then we will decide who play the role.\In order to let everyone response:	have a fair chance to play any role,
context: whenever I'm looking at Mizuki-sensei'\I always feel so schweeet!\So, the title of the play\you have all been waiting for'\SLEEPING BEAUTY\Then we will decide who play the role.\In order to let everyone\have a fair chance to play any role, response:	We will use the method of amidakuji.
context: I always feel so schweeet!\So, the title of the play\you have all been waiting for'\SLEEPING BEAUTY\Then we will decide who play the role.\In order to let everyone\have a fair chance to play any role,\We will use the method of amidakuji. response:	Now then come up here
context: So, the title of the play\you have all been waiting for'\SLEEPING BEAUTY\Then we will decide who play the role.\In order to let everyone\have a fair chance to play any role,\We will use the method of amidakuji.\Now then come up here response:	in the order of your class number.
context: you have all been waiting for'\SLEEPING BEAUTY\Then we will decide who play the role.\In order to let everyone\have a fair chance to play any role,\We will use the method of amidakuji.\Now then come up here\in the order of your class number. response:	Yes!
context: SLEEPING BEAUTY\Then we will decide who play the role.\In order to let everyone\have a fair chance to play any role,\We will use the method of amidakuji.\Now then come up here\in the order of your class number.\Yes! response:	I wonder what role I'm getting'
context: Then we will decide who play the role.\In order to let everyone\have a fair chance to play any role,\We will use the method of amidakuji.\Now then come up here\in the order of your class number.\Yes!\I wonder what role I'm getting' response:	Whatever role you are playing,
context: In order to let everyone\have a fair chance to play any role,\We will use the method of amidakuji.\Now then come up here\in the order of your class number.\Yes!\I wonder what role I'm getting'\Whatever role you are playing, response:	I will make the costume for you for sure!
context: have a fair chance to play any role,\We will use the method of amidakuji.\Now then come up here\in the order of your class number.\Yes!\I wonder what role I'm getting'\Whatever role you are playing,\I will make the costume for you for sure! response:	To' Tomoyo-chan'
context: We will use the method of amidakuji.\Now then come up here\in the order of your class number.\Yes!\I wonder what role I'm getting'\Whatever role you are playing,\I will make the costume for you for sure!\To' Tomoyo-chan' response:	You don't need to be so alert like that.
context: Now then come up here\in the order of your class number.\Yes!\I wonder what role I'm getting'\Whatever role you are playing,\I will make the costume for you for sure!\To' Tomoyo-chan'\You don't need to be so alert like that. response:	It will be very soon.
context: in the order of your class number.\Yes!\I wonder what role I'm getting'\Whatever role you are playing,\I will make the costume for you for sure!\To' Tomoyo-chan'\You don't need to be so alert like that.\It will be very soon. response:	Let's get back to our seats.
context: Yes!\I wonder what role I'm getting'\Whatever role you are playing,\I will make the costume for you for sure!\To' Tomoyo-chan'\You don't need to be so alert like that.\It will be very soon.\Let's get back to our seats. response:	Shao Lan?
context: I wonder what role I'm getting'\Whatever role you are playing,\I will make the costume for you for sure!\To' Tomoyo-chan'\You don't need to be so alert like that.\It will be very soon.\Let's get back to our seats.\Shao Lan? response:	What's wrong?
context: Whatever role you are playing,\I will make the costume for you for sure!\To' Tomoyo-chan'\You don't need to be so alert like that.\It will be very soon.\Let's get back to our seats.\Shao Lan?\What's wrong? response:	Mizuki-sensei said,
context: I will make the costume for you for sure!\To' Tomoyo-chan'\You don't need to be so alert like that.\It will be very soon.\Let's get back to our seats.\Shao Lan?\What's wrong?\Mizuki-sensei said, response:	'It will be very soon.'
context: To' Tomoyo-chan'\You don't need to be so alert like that.\It will be very soon.\Let's get back to our seats.\Shao Lan?\What's wrong?\Mizuki-sensei said,\'It will be very soon.' response:	What will be?
context: You don't need to be so alert like that.\It will be very soon.\Let's get back to our seats.\Shao Lan?\What's wrong?\Mizuki-sensei said,\'It will be very soon.'\What will be? response:	I don't know.
context: It will be very soon.\Let's get back to our seats.\Shao Lan?\What's wrong?\Mizuki-sensei said,\'It will be very soon.'\What will be?\I don't know. response:	But she does have something in her mind after all.
context: Let's get back to our seats.\Shao Lan?\What's wrong?\Mizuki-sensei said,\'It will be very soon.'\What will be?\I don't know.\But she does have something in her mind after all. response:	Okay, let's reveal the results!
context: Shao Lan?\What's wrong?\Mizuki-sensei said,\'It will be very soon.'\What will be?\I don't know.\But she does have something in her mind after all.\Okay, let's reveal the results! response:	Sleeping Beauty is the story
context: What's wrong?\Mizuki-sensei said,\'It will be very soon.'\What will be?\I don't know.\But she does have something in her mind after all.\Okay, let's reveal the results!\Sleeping Beauty is the story response:	of a sleeping princess' who was woken up
context: Mizuki-sensei said,\'It will be very soon.'\What will be?\I don't know.\But she does have something in her mind after all.\Okay, let's reveal the results!\Sleeping Beauty is the story\of a sleeping princess' who was woken up response:	by the kiss of a prince, right?
context: 'It will be very soon.'\What will be?\I don't know.\But she does have something in her mind after all.\Okay, let's reveal the results!\Sleeping Beauty is the story\of a sleeping princess' who was woken up\by the kiss of a prince, right? response:	That is correct.
context: What will be?\I don't know.\But she does have something in her mind after all.\Okay, let's reveal the results!\Sleeping Beauty is the story\of a sleeping princess' who was woken up\by the kiss of a prince, right?\That is correct. response:	Then if I get to play the Princess,
context: I don't know.\But she does have something in her mind after all.\Okay, let's reveal the results!\Sleeping Beauty is the story\of a sleeping princess' who was woken up\by the kiss of a prince, right?\That is correct.\Then if I get to play the Princess, response:	and Shao Lang gets to play the Prince'
context: But she does have something in her mind after all.\Okay, let's reveal the results!\Sleeping Beauty is the story\of a sleeping princess' who was woken up\by the kiss of a prince, right?\That is correct.\Then if I get to play the Princess,\and Shao Lang gets to play the Prince' response:	Oh, what a beautiful Princess!
context: Okay, let's reveal the results!\Sleeping Beauty is the story\of a sleeping princess' who was woken up\by the kiss of a prince, right?\That is correct.\Then if I get to play the Princess,\and Shao Lang gets to play the Prince'\Oh, what a beautiful Princess! response:	I will wake her with my kiss'
context: Sleeping Beauty is the story\of a sleeping princess' who was woken up\by the kiss of a prince, right?\That is correct.\Then if I get to play the Princess,\and Shao Lang gets to play the Prince'\Oh, what a beautiful Princess!\I will wake her with my kiss' response:	Oh my!
context: of a sleeping princess' who was woken up\by the kiss of a prince, right?\That is correct.\Then if I get to play the Princess,\and Shao Lang gets to play the Prince'\Oh, what a beautiful Princess!\I will wake her with my kiss'\Oh my! response:	I don't wanna be the Prince.
context: by the kiss of a prince, right?\That is correct.\Then if I get to play the Princess,\and Shao Lang gets to play the Prince'\Oh, what a beautiful Princess!\I will wake her with my kiss'\Oh my!\I don't wanna be the Prince. response:	Let's see'
context: That is correct.\Then if I get to play the Princess,\and Shao Lang gets to play the Prince'\Oh, what a beautiful Princess!\I will wake her with my kiss'\Oh my!\I don't wanna be the Prince.\Let's see' response:	The Princess and the Prince are'
context: Then if I get to play the Princess,\and Shao Lang gets to play the Prince'\Oh, what a beautiful Princess!\I will wake her with my kiss'\Oh my!\I don't wanna be the Prince.\Let's see'\The Princess and the Prince are' response:	You're playing the Prince?
context: and Shao Lang gets to play the Prince'\Oh, what a beautiful Princess!\I will wake her with my kiss'\Oh my!\I don't wanna be the Prince.\Let's see'\The Princess and the Prince are'\You're playing the Prince? response:	I am sure you will play a very cute prince!
context: Oh, what a beautiful Princess!\I will wake her with my kiss'\Oh my!\I don't wanna be the Prince.\Let's see'\The Princess and the Prince are'\You're playing the Prince?\I am sure you will play a very cute prince! response:	I will ask the teachers
context: I will wake her with my kiss'\Oh my!\I don't wanna be the Prince.\Let's see'\The Princess and the Prince are'\You're playing the Prince?\I am sure you will play a very cute prince!\I will ask the teachers response:	to let me make your costume!
context: Oh my!\I don't wanna be the Prince.\Let's see'\The Princess and the Prince are'\You're playing the Prince?\I am sure you will play a very cute prince!\I will ask the teachers\to let me make your costume! response:	I am really looking forward to this!
context: I don't wanna be the Prince.\Let's see'\The Princess and the Prince are'\You're playing the Prince?\I am sure you will play a very cute prince!\I will ask the teachers\to let me make your costume!\I am really looking forward to this! response:	The play is the Sleeping Beauty, right?
context: Let's see'\The Princess and the Prince are'\You're playing the Prince?\I am sure you will play a very cute prince!\I will ask the teachers\to let me make your costume!\I am really looking forward to this!\The play is the Sleeping Beauty, right? response:	Then the main character is the Princess.
context: The Princess and the Prince are'\You're playing the Prince?\I am sure you will play a very cute prince!\I will ask the teachers\to let me make your costume!\I am really looking forward to this!\The play is the Sleeping Beauty, right?\Then the main character is the Princess. response:	Who is it?
context: You're playing the Prince?\I am sure you will play a very cute prince!\I will ask the teachers\to let me make your costume!\I am really looking forward to this!\The play is the Sleeping Beauty, right?\Then the main character is the Princess.\Who is it? response:	Li-kun'
context: I am sure you will play a very cute prince!\I will ask the teachers\to let me make your costume!\I am really looking forward to this!\The play is the Sleeping Beauty, right?\Then the main character is the Princess.\Who is it?\Li-kun' response:	What's up with that?!
context: I will ask the teachers\to let me make your costume!\I am really looking forward to this!\The play is the Sleeping Beauty, right?\Then the main character is the Princess.\Who is it?\Li-kun'\What's up with that?! response:	But it's all decided by amidakuji.
context: to let me make your costume!\I am really looking forward to this!\The play is the Sleeping Beauty, right?\Then the main character is the Princess.\Who is it?\Li-kun'\What's up with that?!\But it's all decided by amidakuji. response:	I will work hard on Li-kun's costume too!
context: I am really looking forward to this!\The play is the Sleeping Beauty, right?\Then the main character is the Princess.\Who is it?\Li-kun'\What's up with that?!\But it's all decided by amidakuji.\I will work hard on Li-kun's costume too! response:	Because he is Sakura-chan's co-star!
context: The play is the Sleeping Beauty, right?\Then the main character is the Princess.\Who is it?\Li-kun'\What's up with that?!\But it's all decided by amidakuji.\I will work hard on Li-kun's costume too!\Because he is Sakura-chan's co-star! response:	But now a girl plays a boy's role
context: Then the main character is the Princess.\Who is it?\Li-kun'\What's up with that?!\But it's all decided by amidakuji.\I will work hard on Li-kun's costume too!\Because he is Sakura-chan's co-star!\But now a girl plays a boy's role response:	and vice versa.
context: Who is it?\Li-kun'\What's up with that?!\But it's all decided by amidakuji.\I will work hard on Li-kun's costume too!\Because he is Sakura-chan's co-star!\But now a girl plays a boy's role\and vice versa. response:	Mizuki-sensei said everyone
context: Li-kun'\What's up with that?!\But it's all decided by amidakuji.\I will work hard on Li-kun's costume too!\Because he is Sakura-chan's co-star!\But now a girl plays a boy's role\and vice versa.\Mizuki-sensei said everyone response:	has a fair chance to play any role'
context: What's up with that?!\But it's all decided by amidakuji.\I will work hard on Li-kun's costume too!\Because he is Sakura-chan's co-star!\But now a girl plays a boy's role\and vice versa.\Mizuki-sensei said everyone\has a fair chance to play any role' response:	Mizuki-sensei?
context: But it's all decided by amidakuji.\I will work hard on Li-kun's costume too!\Because he is Sakura-chan's co-star!\But now a girl plays a boy's role\and vice versa.\Mizuki-sensei said everyone\has a fair chance to play any role'\Mizuki-sensei? response:	She appeared in what Dream showed you, didn't she?
context: I will work hard on Li-kun's costume too!\Because he is Sakura-chan's co-star!\But now a girl plays a boy's role\and vice versa.\Mizuki-sensei said everyone\has a fair chance to play any role'\Mizuki-sensei?\She appeared in what Dream showed you, didn't she? response:	Even that brat's alert around her.
context: Because he is Sakura-chan's co-star!\But now a girl plays a boy's role\and vice versa.\Mizuki-sensei said everyone\has a fair chance to play any role'\Mizuki-sensei?\She appeared in what Dream showed you, didn't she?\Even that brat's alert around her. response:	Who is she?
context: But now a girl plays a boy's role\and vice versa.\Mizuki-sensei said everyone\has a fair chance to play any role'\Mizuki-sensei?\She appeared in what Dream showed you, didn't she?\Even that brat's alert around her.\Who is she? response:	I'm sure I could sense power in her.
context: and vice versa.\Mizuki-sensei said everyone\has a fair chance to play any role'\Mizuki-sensei?\She appeared in what Dream showed you, didn't she?\Even that brat's alert around her.\Who is she?\I'm sure I could sense power in her. response:	She has something real
context: Mizuki-sensei said everyone\has a fair chance to play any role'\Mizuki-sensei?\She appeared in what Dream showed you, didn't she?\Even that brat's alert around her.\Who is she?\I'm sure I could sense power in her.\She has something real response:	powerful with her.
context: has a fair chance to play any role'\Mizuki-sensei?\She appeared in what Dream showed you, didn't she?\Even that brat's alert around her.\Who is she?\I'm sure I could sense power in her.\She has something real\powerful with her. response:	And so'
context: Mizuki-sensei?\She appeared in what Dream showed you, didn't she?\Even that brat's alert around her.\Who is she?\I'm sure I could sense power in her.\She has something real\powerful with her.\And so' response:	I'm going to the Literary Fest too.
context: She appeared in what Dream showed you, didn't she?\Even that brat's alert around her.\Who is she?\I'm sure I could sense power in her.\She has something real\powerful with her.\And so'\I'm going to the Literary Fest too. response:	What's that all about?!
context: Even that brat's alert around her.\Who is she?\I'm sure I could sense power in her.\She has something real\powerful with her.\And so'\I'm going to the Literary Fest too.\What's that all about?! response:	I'm going to check out that Mizuki-sensei
context: Who is she?\I'm sure I could sense power in her.\She has something real\powerful with her.\And so'\I'm going to the Literary Fest too.\What's that all about?!\I'm going to check out that Mizuki-sensei response:	and watch you in action!
context: I'm sure I could sense power in her.\She has something real\powerful with her.\And so'\I'm going to the Literary Fest too.\What's that all about?!\I'm going to check out that Mizuki-sensei\and watch you in action! response:	Kero-chan! You just wanna go to the fest, don't you?
context: She has something real\powerful with her.\And so'\I'm going to the Literary Fest too.\What's that all about?!\I'm going to check out that Mizuki-sensei\and watch you in action!\Kero-chan! You just wanna go to the fest, don't you? response:	That is so true!
context: powerful with her.\And so'\I'm going to the Literary Fest too.\What's that all about?!\I'm going to check out that Mizuki-sensei\and watch you in action!\Kero-chan! You just wanna go to the fest, don't you?\That is so true! response:	So it is.
context: And so'\I'm going to the Literary Fest too.\What's that all about?!\I'm going to check out that Mizuki-sensei\and watch you in action!\Kero-chan! You just wanna go to the fest, don't you?\That is so true!\So it is. response:	'I have this sword and courage in me!'
context: I'm going to the Literary Fest too.\What's that all about?!\I'm going to check out that Mizuki-sensei\and watch you in action!\Kero-chan! You just wanna go to the fest, don't you?\That is so true!\So it is.\'I have this sword and courage in me!' response:	'I promise'
context: What's that all about?!\I'm going to check out that Mizuki-sensei\and watch you in action!\Kero-chan! You just wanna go to the fest, don't you?\That is so true!\So it is.\'I have this sword and courage in me!'\'I promise' response:	'I will break the curse for the Princess!'
context: I'm going to check out that Mizuki-sensei\and watch you in action!\Kero-chan! You just wanna go to the fest, don't you?\That is so true!\So it is.\'I have this sword and courage in me!'\'I promise'\'I will break the curse for the Princess!' response:	This is so hard!
context: and watch you in action!\Kero-chan! You just wanna go to the fest, don't you?\That is so true!\So it is.\'I have this sword and courage in me!'\'I promise'\'I will break the curse for the Princess!'\This is so hard! response:	I wonder if I can do this right'
context: Kero-chan! You just wanna go to the fest, don't you?\That is so true!\So it is.\'I have this sword and courage in me!'\'I promise'\'I will break the curse for the Princess!'\This is so hard!\I wonder if I can do this right' response:	'O' Oh my! I' I wonder what' this is'
context: That is so true!\So it is.\'I have this sword and courage in me!'\'I promise'\'I will break the curse for the Princess!'\This is so hard!\I wonder if I can do this right'\'O' Oh my! I' I wonder what' this is' response:	Li, you're practicing too?
context: So it is.\'I have this sword and courage in me!'\'I promise'\'I will break the curse for the Princess!'\This is so hard!\I wonder if I can do this right'\'O' Oh my! I' I wonder what' this is'\Li, you're practicing too? response:	Are you okay?
context: 'I have this sword and courage in me!'\'I promise'\'I will break the curse for the Princess!'\This is so hard!\I wonder if I can do this right'\'O' Oh my! I' I wonder what' this is'\Li, you're practicing too?\Are you okay? response:	You're practicing over here.
context: 'I promise'\'I will break the curse for the Princess!'\This is so hard!\I wonder if I can do this right'\'O' Oh my! I' I wonder what' this is'\Li, you're practicing too?\Are you okay?\You're practicing over here. response:	Me too!
context: 'I will break the curse for the Princess!'\This is so hard!\I wonder if I can do this right'\'O' Oh my! I' I wonder what' this is'\Li, you're practicing too?\Are you okay?\You're practicing over here.\Me too! response:	I've never played a princess or a prince,
context: This is so hard!\I wonder if I can do this right'\'O' Oh my! I' I wonder what' this is'\Li, you're practicing too?\Are you okay?\You're practicing over here.\Me too!\I've never played a princess or a prince, response:	So I'm nervous.
context: I wonder if I can do this right'\'O' Oh my! I' I wonder what' this is'\Li, you're practicing too?\Are you okay?\You're practicing over here.\Me too!\I've never played a princess or a prince,\So I'm nervous. response:	Me too.
context: 'O' Oh my! I' I wonder what' this is'\Li, you're practicing too?\Are you okay?\You're practicing over here.\Me too!\I've never played a princess or a prince,\So I'm nervous.\Me too. response:	So, have you done anything in Literary Fest in your school in Hong Kong before?
context: Li, you're practicing too?\Are you okay?\You're practicing over here.\Me too!\I've never played a princess or a prince,\So I'm nervous.\Me too.\So, have you done anything in Literary Fest in your school in Hong Kong before? response:	Like twice'
context: Are you okay?\You're practicing over here.\Me too!\I've never played a princess or a prince,\So I'm nervous.\Me too.\So, have you done anything in Literary Fest in your school in Hong Kong before?\Like twice' response:	What did you play?
context: You're practicing over here.\Me too!\I've never played a princess or a prince,\So I'm nervous.\Me too.\So, have you done anything in Literary Fest in your school in Hong Kong before?\Like twice'\What did you play? response:	I sang'
context: Me too!\I've never played a princess or a prince,\So I'm nervous.\Me too.\So, have you done anything in Literary Fest in your school in Hong Kong before?\Like twice'\What did you play?\I sang' response:	What song did you sing?
context: I've never played a princess or a prince,\So I'm nervous.\Me too.\So, have you done anything in Literary Fest in your school in Hong Kong before?\Like twice'\What did you play?\I sang'\What song did you sing? response:	Sing it!
context: So I'm nervous.\Me too.\So, have you done anything in Literary Fest in your school in Hong Kong before?\Like twice'\What did you play?\I sang'\What song did you sing?\Sing it! response:	I don't like singing
context: Me too.\So, have you done anything in Literary Fest in your school in Hong Kong before?\Like twice'\What did you play?\I sang'\What song did you sing?\Sing it!\I don't like singing response:	in front of people.
context: So, have you done anything in Literary Fest in your school in Hong Kong before?\Like twice'\What did you play?\I sang'\What song did you sing?\Sing it!\I don't like singing\in front of people. response:	I see'
context: Like twice'\What did you play?\I sang'\What song did you sing?\Sing it!\I don't like singing\in front of people.\I see' response:	Sing it one of these days, okay?
context: What did you play?\I sang'\What song did you sing?\Sing it!\I don't like singing\in front of people.\I see'\Sing it one of these days, okay? response:	Hello!
context: I sang'\What song did you sing?\Sing it!\I don't like singing\in front of people.\I see'\Sing it one of these days, okay?\Hello! response:	Yukito-san!
context: What song did you sing?\Sing it!\I don't like singing\in front of people.\I see'\Sing it one of these days, okay?\Hello!\Yukito-san! response:	You guys having lunch break?
context: Sing it!\I don't like singing\in front of people.\I see'\Sing it one of these days, okay?\Hello!\Yukito-san!\You guys having lunch break? response:	Yes!
context: I don't like singing\in front of people.\I see'\Sing it one of these days, okay?\Hello!\Yukito-san!\You guys having lunch break?\Yes! response:	Our teacher is absent today,
context: in front of people.\I see'\Sing it one of these days, okay?\Hello!\Yukito-san!\You guys having lunch break?\Yes!\Our teacher is absent today, response:	so we have a self-study period.
context: I see'\Sing it one of these days, okay?\Hello!\Yukito-san!\You guys having lunch break?\Yes!\Our teacher is absent today,\so we have a self-study period. response:	I was thinking of eating a little'
context: Sing it one of these days, okay?\Hello!\Yukito-san!\You guys having lunch break?\Yes!\Our teacher is absent today,\so we have a self-study period.\I was thinking of eating a little' response:	Why don't we eat together?
context: Hello!\Yukito-san!\You guys having lunch break?\Yes!\Our teacher is absent today,\so we have a self-study period.\I was thinking of eating a little'\Why don't we eat together? response:	Sure!
context: Yukito-san!\You guys having lunch break?\Yes!\Our teacher is absent today,\so we have a self-study period.\I was thinking of eating a little'\Why don't we eat together?\Sure! response:	Okay, let's eat!
context: You guys having lunch break?\Yes!\Our teacher is absent today,\so we have a self-study period.\I was thinking of eating a little'\Why don't we eat together?\Sure!\Okay, let's eat! response:	Th' This'
context: Yes!\Our teacher is absent today,\so we have a self-study period.\I was thinking of eating a little'\Why don't we eat together?\Sure!\Okay, let's eat!\Th' This' response:	All of these'
context: Our teacher is absent today,\so we have a self-study period.\I was thinking of eating a little'\Why don't we eat together?\Sure!\Okay, let's eat!\Th' This'\All of these' response:	I hope it's enough for three people'
context: so we have a self-study period.\I was thinking of eating a little'\Why don't we eat together?\Sure!\Okay, let's eat!\Th' This'\All of these'\I hope it's enough for three people' response:	May be not enough.
context: I was thinking of eating a little'\Why don't we eat together?\Sure!\Okay, let's eat!\Th' This'\All of these'\I hope it's enough for three people'\May be not enough. response:	Come to think of it, isn't it the time for your school's Literary Fest?
context: Why don't we eat together?\Sure!\Okay, let's eat!\Th' This'\All of these'\I hope it's enough for three people'\May be not enough.\Come to think of it, isn't it the time for your school's Literary Fest? response:	Th' That's right.
context: Sure!\Okay, let's eat!\Th' This'\All of these'\I hope it's enough for three people'\May be not enough.\Come to think of it, isn't it the time for your school's Literary Fest?\Th' That's right. response:	What is your class doing?
context: Okay, let's eat!\Th' This'\All of these'\I hope it's enough for three people'\May be not enough.\Come to think of it, isn't it the time for your school's Literary Fest?\Th' That's right.\What is your class doing? response:	A' A play.
context: Th' This'\All of these'\I hope it's enough for three people'\May be not enough.\Come to think of it, isn't it the time for your school's Literary Fest?\Th' That's right.\What is your class doing?\A' A play. response:	Which play?
context: All of these'\I hope it's enough for three people'\May be not enough.\Come to think of it, isn't it the time for your school's Literary Fest?\Th' That's right.\What is your class doing?\A' A play.\Which play? response:	Sle' Sleeping Beauty.
context: I hope it's enough for three people'\May be not enough.\Come to think of it, isn't it the time for your school's Literary Fest?\Th' That's right.\What is your class doing?\A' A play.\Which play?\Sle' Sleeping Beauty. response:	Both of you are going to be in it, right?
context: May be not enough.\Come to think of it, isn't it the time for your school's Literary Fest?\Th' That's right.\What is your class doing?\A' A play.\Which play?\Sle' Sleeping Beauty.\Both of you are going to be in it, right? response:	What roles do you play?
context: Come to think of it, isn't it the time for your school's Literary Fest?\Th' That's right.\What is your class doing?\A' A play.\Which play?\Sle' Sleeping Beauty.\Both of you are going to be in it, right?\What roles do you play? response:	Whatever roles you play,
context: Th' That's right.\What is your class doing?\A' A play.\Which play?\Sle' Sleeping Beauty.\Both of you are going to be in it, right?\What roles do you play?\Whatever roles you play, response:	I'll make sure I won't miss it.
context: What is your class doing?\A' A play.\Which play?\Sle' Sleeping Beauty.\Both of you are going to be in it, right?\What roles do you play?\Whatever roles you play,\I'll make sure I won't miss it. response:	Umm'
context: A' A play.\Which play?\Sle' Sleeping Beauty.\Both of you are going to be in it, right?\What roles do you play?\Whatever roles you play,\I'll make sure I won't miss it.\Umm' response:	You coming'
context: Which play?\Sle' Sleeping Beauty.\Both of you are going to be in it, right?\What roles do you play?\Whatever roles you play,\I'll make sure I won't miss it.\Umm'\You coming' response:	Yeah. As usual of course!
context: Sle' Sleeping Beauty.\Both of you are going to be in it, right?\What roles do you play?\Whatever roles you play,\I'll make sure I won't miss it.\Umm'\You coming'\Yeah. As usual of course! response:	Good luck!
context: Both of you are going to be in it, right?\What roles do you play?\Whatever roles you play,\I'll make sure I won't miss it.\Umm'\You coming'\Yeah. As usual of course!\Good luck! response:	Yes!
context: What roles do you play?\Whatever roles you play,\I'll make sure I won't miss it.\Umm'\You coming'\Yeah. As usual of course!\Good luck!\Yes! response:	Yukito-san is coming to watch.
context: Whatever roles you play,\I'll make sure I won't miss it.\Umm'\You coming'\Yeah. As usual of course!\Good luck!\Yes!\Yukito-san is coming to watch. response:	I gotta practice harder.
context: I'll make sure I won't miss it.\Umm'\You coming'\Yeah. As usual of course!\Good luck!\Yes!\Yukito-san is coming to watch.\I gotta practice harder. response:	Li-kun.
context: Umm'\You coming'\Yeah. As usual of course!\Good luck!\Yes!\Yukito-san is coming to watch.\I gotta practice harder.\Li-kun. response:	Do you want to practice together?
context: You coming'\Yeah. As usual of course!\Good luck!\Yes!\Yukito-san is coming to watch.\I gotta practice harder.\Li-kun.\Do you want to practice together? response:	There're many scenes I get to play against you'
context: Yeah. As usual of course!\Good luck!\Yes!\Yukito-san is coming to watch.\I gotta practice harder.\Li-kun.\Do you want to practice together?\There're many scenes I get to play against you' response:	I thought practicing together
context: Good luck!\Yes!\Yukito-san is coming to watch.\I gotta practice harder.\Li-kun.\Do you want to practice together?\There're many scenes I get to play against you'\I thought practicing together response:	might be a good idea.
context: Yes!\Yukito-san is coming to watch.\I gotta practice harder.\Li-kun.\Do you want to practice together?\There're many scenes I get to play against you'\I thought practicing together\might be a good idea. response:	But you don't have time, do you?
context: Yukito-san is coming to watch.\I gotta practice harder.\Li-kun.\Do you want to practice together?\There're many scenes I get to play against you'\I thought practicing together\might be a good idea.\But you don't have time, do you? response:	When?
context: I gotta practice harder.\Li-kun.\Do you want to practice together?\There're many scenes I get to play against you'\I thought practicing together\might be a good idea.\But you don't have time, do you?\When? response:	To practice'
context: Li-kun.\Do you want to practice together?\There're many scenes I get to play against you'\I thought practicing together\might be a good idea.\But you don't have time, do you?\When?\To practice' response:	Are you sure?
context: Do you want to practice together?\There're many scenes I get to play against you'\I thought practicing together\might be a good idea.\But you don't have time, do you?\When?\To practice'\Are you sure? response:	I don't want to do bad either.
context: There're many scenes I get to play against you'\I thought practicing together\might be a good idea.\But you don't have time, do you?\When?\To practice'\Are you sure?\I don't want to do bad either. response:	Thanks!
context: I thought practicing together\might be a good idea.\But you don't have time, do you?\When?\To practice'\Are you sure?\I don't want to do bad either.\Thanks! response:	How about tomorrow morning before school starts?
context: might be a good idea.\But you don't have time, do you?\When?\To practice'\Are you sure?\I don't want to do bad either.\Thanks!\How about tomorrow morning before school starts? response:	What's going on?
context: But you don't have time, do you?\When?\To practice'\Are you sure?\I don't want to do bad either.\Thanks!\How about tomorrow morning before school starts?\What's going on? response:	Why are there so many alarm clocks?
context: When?\To practice'\Are you sure?\I don't want to do bad either.\Thanks!\How about tomorrow morning before school starts?\What's going on?\Why are there so many alarm clocks? response:	They're Father's and Touya's.
context: To practice'\Are you sure?\I don't want to do bad either.\Thanks!\How about tomorrow morning before school starts?\What's going on?\Why are there so many alarm clocks?\They're Father's and Touya's. response:	I'm practicing for the play with Li-kun
context: Are you sure?\I don't want to do bad either.\Thanks!\How about tomorrow morning before school starts?\What's going on?\Why are there so many alarm clocks?\They're Father's and Touya's.\I'm practicing for the play with Li-kun response:	from today on'
context: I don't want to do bad either.\Thanks!\How about tomorrow morning before school starts?\What's going on?\Why are there so many alarm clocks?\They're Father's and Touya's.\I'm practicing for the play with Li-kun\from today on' response:	I can't be late.
context: Thanks!\How about tomorrow morning before school starts?\What's going on?\Why are there so many alarm clocks?\They're Father's and Touya's.\I'm practicing for the play with Li-kun\from today on'\I can't be late. response:	It's rare you are practicing on your own'
context: How about tomorrow morning before school starts?\What's going on?\Why are there so many alarm clocks?\They're Father's and Touya's.\I'm practicing for the play with Li-kun\from today on'\I can't be late.\It's rare you are practicing on your own' response:	I respect you.
context: What's going on?\Why are there so many alarm clocks?\They're Father's and Touya's.\I'm practicing for the play with Li-kun\from today on'\I can't be late.\It's rare you are practicing on your own'\I respect you. response:	Because' Yukito-san's coming to watch!
context: Why are there so many alarm clocks?\They're Father's and Touya's.\I'm practicing for the play with Li-kun\from today on'\I can't be late.\It's rare you are practicing on your own'\I respect you.\Because' Yukito-san's coming to watch! response:	Since I'm not bringing lunch today,
context: They're Father's and Touya's.\I'm practicing for the play with Li-kun\from today on'\I can't be late.\It's rare you are practicing on your own'\I respect you.\Because' Yukito-san's coming to watch!\Since I'm not bringing lunch today, response:	I wonder what to eat for breakfast!
context: I'm practicing for the play with Li-kun\from today on'\I can't be late.\It's rare you are practicing on your own'\I respect you.\Because' Yukito-san's coming to watch!\Since I'm not bringing lunch today,\I wonder what to eat for breakfast! response:	Onii-chan?
context: from today on'\I can't be late.\It's rare you are practicing on your own'\I respect you.\Because' Yukito-san's coming to watch!\Since I'm not bringing lunch today,\I wonder what to eat for breakfast!\Onii-chan? response:	You don't have morning practice today, right?
context: I can't be late.\It's rare you are practicing on your own'\I respect you.\Because' Yukito-san's coming to watch!\Since I'm not bringing lunch today,\I wonder what to eat for breakfast!\Onii-chan?\You don't have morning practice today, right? response:	Why are you up so early?
context: It's rare you are practicing on your own'\I respect you.\Because' Yukito-san's coming to watch!\Since I'm not bringing lunch today,\I wonder what to eat for breakfast!\Onii-chan?\You don't have morning practice today, right?\Why are you up so early? response:	I happened to have woken up.
context: I respect you.\Because' Yukito-san's coming to watch!\Since I'm not bringing lunch today,\I wonder what to eat for breakfast!\Onii-chan?\You don't have morning practice today, right?\Why are you up so early?\I happened to have woken up. response:	Is this mine?
context: Because' Yukito-san's coming to watch!\Since I'm not bringing lunch today,\I wonder what to eat for breakfast!\Onii-chan?\You don't have morning practice today, right?\Why are you up so early?\I happened to have woken up.\Is this mine? response:	Don't eat it if you don't want to.
context: Since I'm not bringing lunch today,\I wonder what to eat for breakfast!\Onii-chan?\You don't have morning practice today, right?\Why are you up so early?\I happened to have woken up.\Is this mine?\Don't eat it if you don't want to. response:	I'll eat it!
context: I wonder what to eat for breakfast!\Onii-chan?\You don't have morning practice today, right?\Why are you up so early?\I happened to have woken up.\Is this mine?\Don't eat it if you don't want to.\I'll eat it! response:	I wonder if he's up early
context: Onii-chan?\You don't have morning practice today, right?\Why are you up so early?\I happened to have woken up.\Is this mine?\Don't eat it if you don't want to.\I'll eat it!\I wonder if he's up early response:	in order to make breakfast for me'
context: You don't have morning practice today, right?\Why are you up so early?\I happened to have woken up.\Is this mine?\Don't eat it if you don't want to.\I'll eat it!\I wonder if he's up early\in order to make breakfast for me' response:	Sakura' When you caught a cold that one time'
context: Why are you up so early?\I happened to have woken up.\Is this mine?\Don't eat it if you don't want to.\I'll eat it!\I wonder if he's up early\in order to make breakfast for me'\Sakura' When you caught a cold that one time' response:	Mirror!
context: I happened to have woken up.\Is this mine?\Don't eat it if you don't want to.\I'll eat it!\I wonder if he's up early\in order to make breakfast for me'\Sakura' When you caught a cold that one time'\Mirror! response:	This way I'll be okay'
context: Is this mine?\Don't eat it if you don't want to.\I'll eat it!\I wonder if he's up early\in order to make breakfast for me'\Sakura' When you caught a cold that one time'\Mirror!\This way I'll be okay' response:	Wh' What about it?
context: Don't eat it if you don't want to.\I'll eat it!\I wonder if he's up early\in order to make breakfast for me'\Sakura' When you caught a cold that one time'\Mirror!\This way I'll be okay'\Wh' What about it? response:	You're done?
context: I'll eat it!\I wonder if he's up early\in order to make breakfast for me'\Sakura' When you caught a cold that one time'\Mirror!\This way I'll be okay'\Wh' What about it?\You're done? response:	Save some so that I can have more later.
context: I wonder if he's up early\in order to make breakfast for me'\Sakura' When you caught a cold that one time'\Mirror!\This way I'll be okay'\Wh' What about it?\You're done?\Save some so that I can have more later. response:	I'll just make more later.
context: in order to make breakfast for me'\Sakura' When you caught a cold that one time'\Mirror!\This way I'll be okay'\Wh' What about it?\You're done?\Save some so that I can have more later.\I'll just make more later. response:	What about the medicine?
context: Sakura' When you caught a cold that one time'\Mirror!\This way I'll be okay'\Wh' What about it?\You're done?\Save some so that I can have more later.\I'll just make more later.\What about the medicine? response:	You don't need to take it
context: Mirror!\This way I'll be okay'\Wh' What about it?\You're done?\Save some so that I can have more later.\I'll just make more later.\What about the medicine?\You don't need to take it response:	unless you're sick.
context: This way I'll be okay'\Wh' What about it?\You're done?\Save some so that I can have more later.\I'll just make more later.\What about the medicine?\You don't need to take it\unless you're sick. response:	You aren't Sakura, right?
context: Wh' What about it?\You're done?\Save some so that I can have more later.\I'll just make more later.\What about the medicine?\You don't need to take it\unless you're sick.\You aren't Sakura, right? response:	Don't do crazy things like that again.
context: You're done?\Save some so that I can have more later.\I'll just make more later.\What about the medicine?\You don't need to take it\unless you're sick.\You aren't Sakura, right?\Don't do crazy things like that again. response:	What was he trying to say?
context: Save some so that I can have more later.\I'll just make more later.\What about the medicine?\You don't need to take it\unless you're sick.\You aren't Sakura, right?\Don't do crazy things like that again.\What was he trying to say? response:	Could it be that
context: I'll just make more later.\What about the medicine?\You don't need to take it\unless you're sick.\You aren't Sakura, right?\Don't do crazy things like that again.\What was he trying to say?\Could it be that response:	he knows I'm gathering the Clow Cards'?
context: What about the medicine?\You don't need to take it\unless you're sick.\You aren't Sakura, right?\Don't do crazy things like that again.\What was he trying to say?\Could it be that\he knows I'm gathering the Clow Cards'? response:	It can't be. If he knows,
context: You don't need to take it\unless you're sick.\You aren't Sakura, right?\Don't do crazy things like that again.\What was he trying to say?\Could it be that\he knows I'm gathering the Clow Cards'?\It can't be. If he knows, response:	he'd be scolding me already.
context: unless you're sick.\You aren't Sakura, right?\Don't do crazy things like that again.\What was he trying to say?\Could it be that\he knows I'm gathering the Clow Cards'?\It can't be. If he knows,\he'd be scolding me already. response:	Mizuki-sensei'
context: You aren't Sakura, right?\Don't do crazy things like that again.\What was he trying to say?\Could it be that\he knows I'm gathering the Clow Cards'?\It can't be. If he knows,\he'd be scolding me already.\Mizuki-sensei' response:	I gotta hurry up to school!
context: Don't do crazy things like that again.\What was he trying to say?\Could it be that\he knows I'm gathering the Clow Cards'?\It can't be. If he knows,\he'd be scolding me already.\Mizuki-sensei'\I gotta hurry up to school! response:	Good morning!
context: What was he trying to say?\Could it be that\he knows I'm gathering the Clow Cards'?\It can't be. If he knows,\he'd be scolding me already.\Mizuki-sensei'\I gotta hurry up to school!\Good morning! response:	Good morning!
context: Could it be that\he knows I'm gathering the Clow Cards'?\It can't be. If he knows,\he'd be scolding me already.\Mizuki-sensei'\I gotta hurry up to school!\Good morning!\Good morning! response:	You got here even before I did!
context: he knows I'm gathering the Clow Cards'?\It can't be. If he knows,\he'd be scolding me already.\Mizuki-sensei'\I gotta hurry up to school!\Good morning!\Good morning!\You got here even before I did! response:	You're so early!
context: It can't be. If he knows,\he'd be scolding me already.\Mizuki-sensei'\I gotta hurry up to school!\Good morning!\Good morning!\You got here even before I did!\You're so early! response:	Hey, since the weather's so nice,
context: he'd be scolding me already.\Mizuki-sensei'\I gotta hurry up to school!\Good morning!\Good morning!\You got here even before I did!\You're so early!\Hey, since the weather's so nice, response:	how about practicing outside?
context: Mizuki-sensei'\I gotta hurry up to school!\Good morning!\Good morning!\You got here even before I did!\You're so early!\Hey, since the weather's so nice,\how about practicing outside? response:	I wonder what this is'
context: I gotta hurry up to school!\Good morning!\Good morning!\You got here even before I did!\You're so early!\Hey, since the weather's so nice,\how about practicing outside?\I wonder what this is' response:	And like that, the Princess walked towards the spindle'
context: Good morning!\Good morning!\You got here even before I did!\You're so early!\Hey, since the weather's so nice,\how about practicing outside?\I wonder what this is'\And like that, the Princess walked towards the spindle' response:	'and tried to touch it with her finger.
context: Good morning!\You got here even before I did!\You're so early!\Hey, since the weather's so nice,\how about practicing outside?\I wonder what this is'\And like that, the Princess walked towards the spindle'\'and tried to touch it with her finger. response:	Awesome!
context: You got here even before I did!\You're so early!\Hey, since the weather's so nice,\how about practicing outside?\I wonder what this is'\And like that, the Princess walked towards the spindle'\'and tried to touch it with her finger.\Awesome! response:	You remembered almost all the lines!
context: You're so early!\Hey, since the weather's so nice,\how about practicing outside?\I wonder what this is'\And like that, the Princess walked towards the spindle'\'and tried to touch it with her finger.\Awesome!\You remembered almost all the lines! response:	The Princess doesn't have many lines, that's all.
context: Hey, since the weather's so nice,\how about practicing outside?\I wonder what this is'\And like that, the Princess walked towards the spindle'\'and tried to touch it with her finger.\Awesome!\You remembered almost all the lines!\The Princess doesn't have many lines, that's all. response:	Okay, let's skip
context: how about practicing outside?\I wonder what this is'\And like that, the Princess walked towards the spindle'\'and tried to touch it with her finger.\Awesome!\You remembered almost all the lines!\The Princess doesn't have many lines, that's all.\Okay, let's skip response:	the scenes with the fairies.
context: I wonder what this is'\And like that, the Princess walked towards the spindle'\'and tried to touch it with her finger.\Awesome!\You remembered almost all the lines!\The Princess doesn't have many lines, that's all.\Okay, let's skip\the scenes with the fairies. response:	Oh! What a beautiful Princess!
context: And like that, the Princess walked towards the spindle'\'and tried to touch it with her finger.\Awesome!\You remembered almost all the lines!\The Princess doesn't have many lines, that's all.\Okay, let's skip\the scenes with the fairies.\Oh! What a beautiful Princess! response:	If I can wake the Princess
context: 'and tried to touch it with her finger.\Awesome!\You remembered almost all the lines!\The Princess doesn't have many lines, that's all.\Okay, let's skip\the scenes with the fairies.\Oh! What a beautiful Princess!\If I can wake the Princess response:	with my kiss'
context: Awesome!\You remembered almost all the lines!\The Princess doesn't have many lines, that's all.\Okay, let's skip\the scenes with the fairies.\Oh! What a beautiful Princess!\If I can wake the Princess\with my kiss' response:	I swear by this sword!
context: You remembered almost all the lines!\The Princess doesn't have many lines, that's all.\Okay, let's skip\the scenes with the fairies.\Oh! What a beautiful Princess!\If I can wake the Princess\with my kiss'\I swear by this sword! response:	I will love this beautiful princess
context: The Princess doesn't have many lines, that's all.\Okay, let's skip\the scenes with the fairies.\Oh! What a beautiful Princess!\If I can wake the Princess\with my kiss'\I swear by this sword!\I will love this beautiful princess response:	of the forest of thorns with all my heart.
context: Okay, let's skip\the scenes with the fairies.\Oh! What a beautiful Princess!\If I can wake the Princess\with my kiss'\I swear by this sword!\I will love this beautiful princess\of the forest of thorns with all my heart. response:	And with this kiss'
context: the scenes with the fairies.\Oh! What a beautiful Princess!\If I can wake the Princess\with my kiss'\I swear by this sword!\I will love this beautiful princess\of the forest of thorns with all my heart.\And with this kiss' response:	L' Li-kun!
context: Oh! What a beautiful Princess!\If I can wake the Princess\with my kiss'\I swear by this sword!\I will love this beautiful princess\of the forest of thorns with all my heart.\And with this kiss'\L' Li-kun! response:	What?!
context: If I can wake the Princess\with my kiss'\I swear by this sword!\I will love this beautiful princess\of the forest of thorns with all my heart.\And with this kiss'\L' Li-kun!\What?! response:	Wind Descend!
context: with my kiss'\I swear by this sword!\I will love this beautiful princess\of the forest of thorns with all my heart.\And with this kiss'\L' Li-kun!\What?!\Wind Descend! response:	Key which hides the forces of darkness,
context: I swear by this sword!\I will love this beautiful princess\of the forest of thorns with all my heart.\And with this kiss'\L' Li-kun!\What?!\Wind Descend!\Key which hides the forces of darkness, response:	Reveal thy true form before me.
context: I will love this beautiful princess\of the forest of thorns with all my heart.\And with this kiss'\L' Li-kun!\What?!\Wind Descend!\Key which hides the forces of darkness,\Reveal thy true form before me. response:	I, Sakura, command thee under contract.
context: of the forest of thorns with all my heart.\And with this kiss'\L' Li-kun!\What?!\Wind Descend!\Key which hides the forces of darkness,\Reveal thy true form before me.\I, Sakura, command thee under contract. response:	Release!
context: And with this kiss'\L' Li-kun!\What?!\Wind Descend!\Key which hides the forces of darkness,\Reveal thy true form before me.\I, Sakura, command thee under contract.\Release! response:	Fly!
context: L' Li-kun!\What?!\Wind Descend!\Key which hides the forces of darkness,\Reveal thy true form before me.\I, Sakura, command thee under contract.\Release!\Fly! response:	What's going on?!
context: What?!\Wind Descend!\Key which hides the forces of darkness,\Reveal thy true form before me.\I, Sakura, command thee under contract.\Release!\Fly!\What's going on?! response:	It's the act of a Clow Card!
context: Wind Descend!\Key which hides the forces of darkness,\Reveal thy true form before me.\I, Sakura, command thee under contract.\Release!\Fly!\What's going on?!\It's the act of a Clow Card! response:	But I didn't sense it at all!
context: Key which hides the forces of darkness,\Reveal thy true form before me.\I, Sakura, command thee under contract.\Release!\Fly!\What's going on?!\It's the act of a Clow Card!\But I didn't sense it at all! response:	What card is this?!
context: Reveal thy true form before me.\I, Sakura, command thee under contract.\Release!\Fly!\What's going on?!\It's the act of a Clow Card!\But I didn't sense it at all!\What card is this?! response:	I'm afraid, it's Sand,
context: I, Sakura, command thee under contract.\Release!\Fly!\What's going on?!\It's the act of a Clow Card!\But I didn't sense it at all!\What card is this?!\I'm afraid, it's Sand, response:	the card of the sand.
context: Release!\Fly!\What's going on?!\It's the act of a Clow Card!\But I didn't sense it at all!\What card is this?!\I'm afraid, it's Sand,\the card of the sand. response:	How do I turn it back?
context: Fly!\What's going on?!\It's the act of a Clow Card!\But I didn't sense it at all!\What card is this?!\I'm afraid, it's Sand,\the card of the sand.\How do I turn it back? response:	First, we need to stop it from moving!
context: What's going on?!\It's the act of a Clow Card!\But I didn't sense it at all!\What card is this?!\I'm afraid, it's Sand,\the card of the sand.\How do I turn it back?\First, we need to stop it from moving! response:	Li-kun!
context: It's the act of a Clow Card!\But I didn't sense it at all!\What card is this?!\I'm afraid, it's Sand,\the card of the sand.\How do I turn it back?\First, we need to stop it from moving!\Li-kun! response:	Li-kun!
context: But I didn't sense it at all!\What card is this?!\I'm afraid, it's Sand,\the card of the sand.\How do I turn it back?\First, we need to stop it from moving!\Li-kun!\Li-kun! response:	Don't come!
context: What card is this?!\I'm afraid, it's Sand,\the card of the sand.\How do I turn it back?\First, we need to stop it from moving!\Li-kun!\Li-kun!\Don't come! response:	But!
context: I'm afraid, it's Sand,\the card of the sand.\How do I turn it back?\First, we need to stop it from moving!\Li-kun!\Li-kun!\Don't come!\But! response:	Do what I say!
context: the card of the sand.\How do I turn it back?\First, we need to stop it from moving!\Li-kun!\Li-kun!\Don't come!\But!\Do what I say! response:	Yes.
context: How do I turn it back?\First, we need to stop it from moving!\Li-kun!\Li-kun!\Don't come!\But!\Do what I say!\Yes. response:	Use Watery and envelop this area!
context: First, we need to stop it from moving!\Li-kun!\Li-kun!\Don't come!\But!\Do what I say!\Yes.\Use Watery and envelop this area! response:	But it'll fill this place up, and besides,
context: Li-kun!\Li-kun!\Don't come!\But!\Do what I say!\Yes.\Use Watery and envelop this area!\But it'll fill this place up, and besides, response:	that won't stop it from moving!
context: Li-kun!\Don't come!\But!\Do what I say!\Yes.\Use Watery and envelop this area!\But it'll fill this place up, and besides,\that won't stop it from moving! response:	Just do it!
context: Don't come!\But!\Do what I say!\Yes.\Use Watery and envelop this area!\But it'll fill this place up, and besides,\that won't stop it from moving!\Just do it! response:	Water, pour over the sand!
context: But!\Do what I say!\Yes.\Use Watery and envelop this area!\But it'll fill this place up, and besides,\that won't stop it from moving!\Just do it!\Water, pour over the sand! response:	Watery!
context: Do what I say!\Yes.\Use Watery and envelop this area!\But it'll fill this place up, and besides,\that won't stop it from moving!\Just do it!\Water, pour over the sand!\Watery! response:	Freeze!
context: Yes.\Use Watery and envelop this area!\But it'll fill this place up, and besides,\that won't stop it from moving!\Just do it!\Water, pour over the sand!\Watery!\Freeze! response:	Freeze!
context: Use Watery and envelop this area!\But it'll fill this place up, and besides,\that won't stop it from moving!\Just do it!\Water, pour over the sand!\Watery!\Freeze!\Freeze! response:	Now!
context: But it'll fill this place up, and besides,\that won't stop it from moving!\Just do it!\Water, pour over the sand!\Watery!\Freeze!\Freeze!\Now! response:	Return to thy form which thou should be!
context: that won't stop it from moving!\Just do it!\Water, pour over the sand!\Watery!\Freeze!\Freeze!\Now!\Return to thy form which thou should be! response:	Clow Card!
context: Just do it!\Water, pour over the sand!\Watery!\Freeze!\Freeze!\Now!\Return to thy form which thou should be!\Clow Card! response:	Li-kun!
context: Water, pour over the sand!\Watery!\Freeze!\Freeze!\Now!\Return to thy form which thou should be!\Clow Card!\Li-kun! response:	Are you okay?
context: Watery!\Freeze!\Freeze!\Now!\Return to thy form which thou should be!\Clow Card!\Li-kun!\Are you okay? response:	Yeah. Kinda'
context: Freeze!\Freeze!\Now!\Return to thy form which thou should be!\Clow Card!\Li-kun!\Are you okay?\Yeah. Kinda' response:	Here.
context: Freeze!\Now!\Return to thy form which thou should be!\Clow Card!\Li-kun!\Are you okay?\Yeah. Kinda'\Here. response:	It's yours.
context: Now!\Return to thy form which thou should be!\Clow Card!\Li-kun!\Are you okay?\Yeah. Kinda'\Here.\It's yours. response:	Why?
context: Return to thy form which thou should be!\Clow Card!\Li-kun!\Are you okay?\Yeah. Kinda'\Here.\It's yours.\Why? response:	You were the one who thought of how to capture it,
context: Clow Card!\Li-kun!\Are you okay?\Yeah. Kinda'\Here.\It's yours.\Why?\You were the one who thought of how to capture it, response:	And earlier
context: Li-kun!\Are you okay?\Yeah. Kinda'\Here.\It's yours.\Why?\You were the one who thought of how to capture it,\And earlier response:	you let me have the card, Cloud.
context: Are you okay?\Yeah. Kinda'\Here.\It's yours.\Why?\You were the one who thought of how to capture it,\And earlier\you let me have the card, Cloud. response:	But you do understand
context: Yeah. Kinda'\Here.\It's yours.\Why?\You were the one who thought of how to capture it,\And earlier\you let me have the card, Cloud.\But you do understand response:	I'm fighting you
context: Here.\It's yours.\Why?\You were the one who thought of how to capture it,\And earlier\you let me have the card, Cloud.\But you do understand\I'm fighting you response:	over the Clow Cards.
context: It's yours.\Why?\You were the one who thought of how to capture it,\And earlier\you let me have the card, Cloud.\But you do understand\I'm fighting you\over the Clow Cards. response:	But this card is yours.
context: Why?\You were the one who thought of how to capture it,\And earlier\you let me have the card, Cloud.\But you do understand\I'm fighting you\over the Clow Cards.\But this card is yours. response:	Here.
context: You were the one who thought of how to capture it,\And earlier\you let me have the card, Cloud.\But you do understand\I'm fighting you\over the Clow Cards.\But this card is yours.\Here. response:	I'm not gonna give it back
context: And earlier\you let me have the card, Cloud.\But you do understand\I'm fighting you\over the Clow Cards.\But this card is yours.\Here.\I'm not gonna give it back response:	if you regret later.
context: you let me have the card, Cloud.\But you do understand\I'm fighting you\over the Clow Cards.\But this card is yours.\Here.\I'm not gonna give it back\if you regret later. response:	It's almost time the others come in.
context: But you do understand\I'm fighting you\over the Clow Cards.\But this card is yours.\Here.\I'm not gonna give it back\if you regret later.\It's almost time the others come in. response:	Thank goodness, the card was active
context: I'm fighting you\over the Clow Cards.\But this card is yours.\Here.\I'm not gonna give it back\if you regret later.\It's almost time the others come in.\Thank goodness, the card was active response:	before school starts'
context: over the Clow Cards.\But this card is yours.\Here.\I'm not gonna give it back\if you regret later.\It's almost time the others come in.\Thank goodness, the card was active\before school starts' response:	I wonder if it's a coincidence'
context: But this card is yours.\Here.\I'm not gonna give it back\if you regret later.\It's almost time the others come in.\Thank goodness, the card was active\before school starts'\I wonder if it's a coincidence' response:	Maybe it knows
context: Here.\I'm not gonna give it back\if you regret later.\It's almost time the others come in.\Thank goodness, the card was active\before school starts'\I wonder if it's a coincidence'\Maybe it knows response:	only the two of us are here at this hour'
context: I'm not gonna give it back\if you regret later.\It's almost time the others come in.\Thank goodness, the card was active\before school starts'\I wonder if it's a coincidence'\Maybe it knows\only the two of us are here at this hour' response:	Why?
context: if you regret later.\It's almost time the others come in.\Thank goodness, the card was active\before school starts'\I wonder if it's a coincidence'\Maybe it knows\only the two of us are here at this hour'\Why? response:	Nothing. I hope I'm just thinking too much.
context: It's almost time the others come in.\Thank goodness, the card was active\before school starts'\I wonder if it's a coincidence'\Maybe it knows\only the two of us are here at this hour'\Why?\Nothing. I hope I'm just thinking too much. response:	It will be very soon.