context: Jellal Fernandez... response:	I hereby place you under arrest for the crime of high treason against the state.
context: Jellal Fernandez...\I hereby place you under arrest for the crime of high treason against the state. response:	Please, wait!
context: Jellal Fernandez...\I hereby place you under arrest for the crime of high treason against the state.\Please, wait! response:	A Guild for Only One.
context: Jellal Fernandez...\I hereby place you under arrest for the crime of high treason against the state.\Please, wait!\A Guild for Only One. response:	Jellal has lost his memories!
context: Jellal Fernandez...\I hereby place you under arrest for the crime of high treason against the state.\Please, wait!\A Guild for Only One.\Jellal has lost his memories! response:	He doesn't remember a thing!
context: Jellal Fernandez...\I hereby place you under arrest for the crime of high treason against the state.\Please, wait!\A Guild for Only One.\Jellal has lost his memories!\He doesn't remember a thing! response:	By clause 13 of the criminal code, that is not a valid defense.
context: Jellal Fernandez...\I hereby place you under arrest for the crime of high treason against the state.\Please, wait!\A Guild for Only One.\Jellal has lost his memories!\He doesn't remember a thing!\By clause 13 of the criminal code, that is not a valid defense. response:	You can release them from the runes now.
context: Jellal Fernandez...\I hereby place you under arrest for the crime of high treason against the state.\Please, wait!\A Guild for Only One.\Jellal has lost his memories!\He doesn't remember a thing!\By clause 13 of the criminal code, that is not a valid defense.\You can release them from the runes now. response:	But...!
context: I hereby place you under arrest for the crime of high treason against the state.\Please, wait!\A Guild for Only One.\Jellal has lost his memories!\He doesn't remember a thing!\By clause 13 of the criminal code, that is not a valid defense.\You can release them from the runes now.\But...! response:	It's okay. I have no intention of resisting.
context: Please, wait!\A Guild for Only One.\Jellal has lost his memories!\He doesn't remember a thing!\By clause 13 of the criminal code, that is not a valid defense.\You can release them from the runes now.\But...!\It's okay. I have no intention of resisting. response:	I never was able to remember you...
context: A Guild for Only One.\Jellal has lost his memories!\He doesn't remember a thing!\By clause 13 of the criminal code, that is not a valid defense.\You can release them from the runes now.\But...!\It's okay. I have no intention of resisting.\I never was able to remember you... response:	I am truly sorry, Wendy...
context: Jellal has lost his memories!\He doesn't remember a thing!\By clause 13 of the criminal code, that is not a valid defense.\You can release them from the runes now.\But...!\It's okay. I have no intention of resisting.\I never was able to remember you...\I am truly sorry, Wendy... response:	She tells me that long ago, she was saved by you.
context: He doesn't remember a thing!\By clause 13 of the criminal code, that is not a valid defense.\You can release them from the runes now.\But...!\It's okay. I have no intention of resisting.\I never was able to remember you...\I am truly sorry, Wendy...\She tells me that long ago, she was saved by you. response:	I see.
context: By clause 13 of the criminal code, that is not a valid defense.\You can release them from the runes now.\But...!\It's okay. I have no intention of resisting.\I never was able to remember you...\I am truly sorry, Wendy...\She tells me that long ago, she was saved by you.\I see. response:	I do not know how much suffering I must have caused all of you.
context: You can release them from the runes now.\But...!\It's okay. I have no intention of resisting.\I never was able to remember you...\I am truly sorry, Wendy...\She tells me that long ago, she was saved by you.\I see.\I do not know how much suffering I must have caused all of you. response:	But to hear that I saved someone makes me glad.
context: But...!\It's okay. I have no intention of resisting.\I never was able to remember you...\I am truly sorry, Wendy...\She tells me that long ago, she was saved by you.\I see.\I do not know how much suffering I must have caused all of you.\But to hear that I saved someone makes me glad. response:	Erza.
context: It's okay. I have no intention of resisting.\I never was able to remember you...\I am truly sorry, Wendy...\She tells me that long ago, she was saved by you.\I see.\I do not know how much suffering I must have caused all of you.\But to hear that I saved someone makes me glad.\Erza. response:	Thank you for everything.
context: I never was able to remember you...\I am truly sorry, Wendy...\She tells me that long ago, she was saved by you.\I see.\I do not know how much suffering I must have caused all of you.\But to hear that I saved someone makes me glad.\Erza.\Thank you for everything. response:	I must stop him.
context: I am truly sorry, Wendy...\She tells me that long ago, she was saved by you.\I see.\I do not know how much suffering I must have caused all of you.\But to hear that I saved someone makes me glad.\Erza.\Thank you for everything.\I must stop him. response:	It's for me to stop him.
context: She tells me that long ago, she was saved by you.\I see.\I do not know how much suffering I must have caused all of you.\But to hear that I saved someone makes me glad.\Erza.\Thank you for everything.\I must stop him.\It's for me to stop him. response:	Jellal is going away...
context: I see.\I do not know how much suffering I must have caused all of you.\But to hear that I saved someone makes me glad.\Erza.\Thank you for everything.\I must stop him.\It's for me to stop him.\Jellal is going away... response:	Jellal, finally awakened from his long nightmare, is...
context: I do not know how much suffering I must have caused all of you.\But to hear that I saved someone makes me glad.\Erza.\Thank you for everything.\I must stop him.\It's for me to stop him.\Jellal is going away...\Jellal, finally awakened from his long nightmare, is... response:	How can I just let him be shut up in the darkness yet again?
context: But to hear that I saved someone makes me glad.\Erza.\Thank you for everything.\I must stop him.\It's for me to stop him.\Jellal is going away...\Jellal, finally awakened from his long nightmare, is...\How can I just let him be shut up in the darkness yet again? response:	Is there nothing left you wish to say?
context: Erza.\Thank you for everything.\I must stop him.\It's for me to stop him.\Jellal is going away...\Jellal, finally awakened from his long nightmare, is...\How can I just let him be shut up in the darkness yet again?\Is there nothing left you wish to say? response:	It's pretty much guaranteed you'll be executed or given life without parole.
context: Thank you for everything.\I must stop him.\It's for me to stop him.\Jellal is going away...\Jellal, finally awakened from his long nightmare, is...\How can I just let him be shut up in the darkness yet again?\Is there nothing left you wish to say?\It's pretty much guaranteed you'll be executed or given life without parole. response:	But that's...
context: I must stop him.\It's for me to stop him.\Jellal is going away...\Jellal, finally awakened from his long nightmare, is...\How can I just let him be shut up in the darkness yet again?\Is there nothing left you wish to say?\It's pretty much guaranteed you'll be executed or given life without parole.\But that's... response:	You'll never see another human face again.
context: It's for me to stop him.\Jellal is going away...\Jellal, finally awakened from his long nightmare, is...\How can I just let him be shut up in the darkness yet again?\Is there nothing left you wish to say?\It's pretty much guaranteed you'll be executed or given life without parole.\But that's...\You'll never see another human face again. response:	No...
context: Jellal is going away...\Jellal, finally awakened from his long nightmare, is...\How can I just let him be shut up in the darkness yet again?\Is there nothing left you wish to say?\It's pretty much guaranteed you'll be executed or given life without parole.\But that's...\You'll never see another human face again.\No... response:	I won't let you take him!
context: Jellal, finally awakened from his long nightmare, is...\How can I just let him be shut up in the darkness yet again?\Is there nothing left you wish to say?\It's pretty much guaranteed you'll be executed or given life without parole.\But that's...\You'll never see another human face again.\No...\I won't let you take him! response:	You ain't takin' him!
context: How can I just let him be shut up in the darkness yet again?\Is there nothing left you wish to say?\It's pretty much guaranteed you'll be executed or given life without parole.\But that's...\You'll never see another human face again.\No...\I won't let you take him!\You ain't takin' him! response:	Natsu!
context: Is there nothing left you wish to say?\It's pretty much guaranteed you'll be executed or given life without parole.\But that's...\You'll never see another human face again.\No...\I won't let you take him!\You ain't takin' him!\Natsu! response:	They're from the Council!
context: It's pretty much guaranteed you'll be executed or given life without parole.\But that's...\You'll never see another human face again.\No...\I won't let you take him!\You ain't takin' him!\Natsu!\They're from the Council! response:	Why, you...
context: But that's...\You'll never see another human face again.\No...\I won't let you take him!\You ain't takin' him!\Natsu!\They're from the Council!\Why, you... response:	Move it!
context: You'll never see another human face again.\No...\I won't let you take him!\You ain't takin' him!\Natsu!\They're from the Council!\Why, you...\Move it! response:	He's our ally!
context: No...\I won't let you take him!\You ain't takin' him!\Natsu!\They're from the Council!\Why, you...\Move it!\He's our ally! response:	We're takin' him back with us!
context: I won't let you take him!\You ain't takin' him!\Natsu!\They're from the Council!\Why, you...\Move it!\He's our ally!\We're takin' him back with us! response:	Natsu-san...
context: You ain't takin' him!\Natsu!\They're from the Council!\Why, you...\Move it!\He's our ally!\We're takin' him back with us!\Natsu-san... response:	L-Leave me be...
context: Natsu!\They're from the Council!\Why, you...\Move it!\He's our ally!\We're takin' him back with us!\Natsu-san...\L-Leave me be... response:	Restrain them!
context: They're from the Council!\Why, you...\Move it!\He's our ally!\We're takin' him back with us!\Natsu-san...\L-Leave me be...\Restrain them! response:	Go, Natsu!
context: Why, you...\Move it!\He's our ally!\We're takin' him back with us!\Natsu-san...\L-Leave me be...\Restrain them!\Go, Natsu! response:	Gray?
context: Move it!\He's our ally!\We're takin' him back with us!\Natsu-san...\L-Leave me be...\Restrain them!\Go, Natsu!\Gray? response:	There's no stopping Natsu now, after all!
context: He's our ally!\We're takin' him back with us!\Natsu-san...\L-Leave me be...\Restrain them!\Go, Natsu!\Gray?\There's no stopping Natsu now, after all! response:	It don't sit right!
context: We're takin' him back with us!\Natsu-san...\L-Leave me be...\Restrain them!\Go, Natsu!\Gray?\There's no stopping Natsu now, after all!\It don't sit right! response:	He helped defend you from Nirvana!
context: Natsu-san...\L-Leave me be...\Restrain them!\Go, Natsu!\Gray?\There's no stopping Natsu now, after all!\It don't sit right!\He helped defend you from Nirvana! response:	And you don't got even one word of thanks?!
context: L-Leave me be...\Restrain them!\Go, Natsu!\Gray?\There's no stopping Natsu now, after all!\It don't sit right!\He helped defend you from Nirvana!\And you don't got even one word of thanks?! response:	There is truth to that.
context: Restrain them!\Go, Natsu!\Gray?\There's no stopping Natsu now, after all!\It don't sit right!\He helped defend you from Nirvana!\And you don't got even one word of thanks?!\There is truth to that. response:	It is unjust to arrest a man like that!
context: Go, Natsu!\Gray?\There's no stopping Natsu now, after all!\It don't sit right!\He helped defend you from Nirvana!\And you don't got even one word of thanks?!\There is truth to that.\It is unjust to arrest a man like that! response:	It pains me to say it, but if that man is taken away, Erza-san will be saddened!
context: Gray?\There's no stopping Natsu now, after all!\It don't sit right!\He helped defend you from Nirvana!\And you don't got even one word of thanks?!\There is truth to that.\It is unjust to arrest a man like that!\It pains me to say it, but if that man is taken away, Erza-san will be saddened! response:	Don't blame me if anyone gets hurt!
context: There's no stopping Natsu now, after all!\It don't sit right!\He helped defend you from Nirvana!\And you don't got even one word of thanks?!\There is truth to that.\It is unjust to arrest a man like that!\It pains me to say it, but if that man is taken away, Erza-san will be saddened!\Don't blame me if anyone gets hurt! response:	Please! Don't take Jellal with you!
context: It don't sit right!\He helped defend you from Nirvana!\And you don't got even one word of thanks?!\There is truth to that.\It is unjust to arrest a man like that!\It pains me to say it, but if that man is taken away, Erza-san will be saddened!\Don't blame me if anyone gets hurt!\Please! Don't take Jellal with you! response:	Come here, Jellal!
context: He helped defend you from Nirvana!\And you don't got even one word of thanks?!\There is truth to that.\It is unjust to arrest a man like that!\It pains me to say it, but if that man is taken away, Erza-san will be saddened!\Don't blame me if anyone gets hurt!\Please! Don't take Jellal with you!\Come here, Jellal! response:	You can't leave Erza!
context: And you don't got even one word of thanks?!\There is truth to that.\It is unjust to arrest a man like that!\It pains me to say it, but if that man is taken away, Erza-san will be saddened!\Don't blame me if anyone gets hurt!\Please! Don't take Jellal with you!\Come here, Jellal!\You can't leave Erza! response:	You've got to stay by her side! For her!
context: There is truth to that.\It is unjust to arrest a man like that!\It pains me to say it, but if that man is taken away, Erza-san will be saddened!\Don't blame me if anyone gets hurt!\Please! Don't take Jellal with you!\Come here, Jellal!\You can't leave Erza!\You've got to stay by her side! For her! response:	So come here! We stand with you!
context: It is unjust to arrest a man like that!\It pains me to say it, but if that man is taken away, Erza-san will be saddened!\Don't blame me if anyone gets hurt!\Please! Don't take Jellal with you!\Come here, Jellal!\You can't leave Erza!\You've got to stay by her side! For her!\So come here! We stand with you! response:	We're allies, right?!
context: It pains me to say it, but if that man is taken away, Erza-san will be saddened!\Don't blame me if anyone gets hurt!\Please! Don't take Jellal with you!\Come here, Jellal!\You can't leave Erza!\You've got to stay by her side! For her!\So come here! We stand with you!\We're allies, right?! response:	Arrest them all!
context: Don't blame me if anyone gets hurt!\Please! Don't take Jellal with you!\Come here, Jellal!\You can't leave Erza!\You've got to stay by her side! For her!\So come here! We stand with you!\We're allies, right?!\Arrest them all! response:	For obstructing government officials and aiding in the escape of a criminal!
context: Please! Don't take Jellal with you!\Come here, Jellal!\You can't leave Erza!\You've got to stay by her side! For her!\So come here! We stand with you!\We're allies, right?!\Arrest them all!\For obstructing government officials and aiding in the escape of a criminal! response:	Enough!
context: Come here, Jellal!\You can't leave Erza!\You've got to stay by her side! For her!\So come here! We stand with you!\We're allies, right?!\Arrest them all!\For obstructing government officials and aiding in the escape of a criminal!\Enough! response:	That's far enough!
context: You can't leave Erza!\You've got to stay by her side! For her!\So come here! We stand with you!\We're allies, right?!\Arrest them all!\For obstructing government officials and aiding in the escape of a criminal!\Enough!\That's far enough! response:	I apologize for the fuss we've caused.
context: You've got to stay by her side! For her!\So come here! We stand with you!\We're allies, right?!\Arrest them all!\For obstructing government officials and aiding in the escape of a criminal!\Enough!\That's far enough!\I apologize for the fuss we've caused. response:	Jellal...
context: So come here! We stand with you!\We're allies, right?!\Arrest them all!\For obstructing government officials and aiding in the escape of a criminal!\Enough!\That's far enough!\I apologize for the fuss we've caused.\Jellal... response:	Take him.
context: We're allies, right?!\Arrest them all!\For obstructing government officials and aiding in the escape of a criminal!\Enough!\That's far enough!\I apologize for the fuss we've caused.\Jellal...\Take him. response:	Erza!
context: Arrest them all!\For obstructing government officials and aiding in the escape of a criminal!\Enough!\That's far enough!\I apologize for the fuss we've caused.\Jellal...\Take him.\Erza! response:	Sit down!
context: For obstructing government officials and aiding in the escape of a criminal!\Enough!\That's far enough!\I apologize for the fuss we've caused.\Jellal...\Take him.\Erza!\Sit down! response:	Yes, ma'am.
context: Enough!\That's far enough!\I apologize for the fuss we've caused.\Jellal...\Take him.\Erza!\Sit down!\Yes, ma'am. response:	Oh, right...
context: That's far enough!\I apologize for the fuss we've caused.\Jellal...\Take him.\Erza!\Sit down!\Yes, ma'am.\Oh, right... response:	It was the color of your hair.
context: I apologize for the fuss we've caused.\Jellal...\Take him.\Erza!\Sit down!\Yes, ma'am.\Oh, right...\It was the color of your hair. response:	Farewell, Erza.
context: Jellal...\Take him.\Erza!\Sit down!\Yes, ma'am.\Oh, right...\It was the color of your hair.\Farewell, Erza. response:	Where did Erza go?
context: Take him.\Erza!\Sit down!\Yes, ma'am.\Oh, right...\It was the color of your hair.\Farewell, Erza.\Where did Erza go? response:	Let's leave her alone for a little while.
context: Erza!\Sit down!\Yes, ma'am.\Oh, right...\It was the color of your hair.\Farewell, Erza.\Where did Erza go?\Let's leave her alone for a little while. response:	Aye...
context: Sit down!\Yes, ma'am.\Oh, right...\It was the color of your hair.\Farewell, Erza.\Where did Erza go?\Let's leave her alone for a little while.\Aye... response:	To hear that I saved someone makes me glad.
context: Yes, ma'am.\Oh, right...\It was the color of your hair.\Farewell, Erza.\Where did Erza go?\Let's leave her alone for a little while.\Aye...\To hear that I saved someone makes me glad. response:	Jellal Fernandez.
context: Oh, right...\It was the color of your hair.\Farewell, Erza.\Where did Erza go?\Let's leave her alone for a little while.\Aye...\To hear that I saved someone makes me glad.\Jellal Fernandez. response:	Whoa, that's hard to remember!
context: It was the color of your hair.\Farewell, Erza.\Where did Erza go?\Let's leave her alone for a little while.\Aye...\To hear that I saved someone makes me glad.\Jellal Fernandez.\Whoa, that's hard to remember! response:	That name's gonna tie my tongue in knots!
context: Farewell, Erza.\Where did Erza go?\Let's leave her alone for a little while.\Aye...\To hear that I saved someone makes me glad.\Jellal Fernandez.\Whoa, that's hard to remember!\That name's gonna tie my tongue in knots! response:	Your name, Wally Buchanan, seems hard to remember, too.
context: Where did Erza go?\Let's leave her alone for a little while.\Aye...\To hear that I saved someone makes me glad.\Jellal Fernandez.\Whoa, that's hard to remember!\That name's gonna tie my tongue in knots!\Your name, Wally Buchanan, seems hard to remember, too. response:	Erza, how about you?
context: Let's leave her alone for a little while.\Aye...\To hear that I saved someone makes me glad.\Jellal Fernandez.\Whoa, that's hard to remember!\That name's gonna tie my tongue in knots!\Your name, Wally Buchanan, seems hard to remember, too.\Erza, how about you? response:	I am Erza.
context: Aye...\To hear that I saved someone makes me glad.\Jellal Fernandez.\Whoa, that's hard to remember!\That name's gonna tie my tongue in knots!\Your name, Wally Buchanan, seems hard to remember, too.\Erza, how about you?\I am Erza. response:	Just plain Erza.
context: To hear that I saved someone makes me glad.\Jellal Fernandez.\Whoa, that's hard to remember!\That name's gonna tie my tongue in knots!\Your name, Wally Buchanan, seems hard to remember, too.\Erza, how about you?\I am Erza.\Just plain Erza. response:	That's kind of sad...
context: Jellal Fernandez.\Whoa, that's hard to remember!\That name's gonna tie my tongue in knots!\Your name, Wally Buchanan, seems hard to remember, too.\Erza, how about you?\I am Erza.\Just plain Erza.\That's kind of sad... response:	What?
context: Whoa, that's hard to remember!\That name's gonna tie my tongue in knots!\Your name, Wally Buchanan, seems hard to remember, too.\Erza, how about you?\I am Erza.\Just plain Erza.\That's kind of sad...\What? response:	It's a pretty scarlet.
context: That name's gonna tie my tongue in knots!\Your name, Wally Buchanan, seems hard to remember, too.\Erza, how about you?\I am Erza.\Just plain Erza.\That's kind of sad...\What?\It's a pretty scarlet. response:	Scarlet?
context: Your name, Wally Buchanan, seems hard to remember, too.\Erza, how about you?\I am Erza.\Just plain Erza.\That's kind of sad...\What?\It's a pretty scarlet.\Scarlet? response:	I know! Let's name you Erza Scarlet!
context: Erza, how about you?\I am Erza.\Just plain Erza.\That's kind of sad...\What?\It's a pretty scarlet.\Scarlet?\I know! Let's name you Erza Scarlet! response:	Name you? Don't just go naming other people...
context: I am Erza.\Just plain Erza.\That's kind of sad...\What?\It's a pretty scarlet.\Scarlet?\I know! Let's name you Erza Scarlet!\Name you? Don't just go naming other people... response:	Scarlet...
context: Just plain Erza.\That's kind of sad...\What?\It's a pretty scarlet.\Scarlet?\I know! Let's name you Erza Scarlet!\Name you? Don't just go naming other people...\Scarlet... response:	Erza Scarlet...
context: That's kind of sad...\What?\It's a pretty scarlet.\Scarlet?\I know! Let's name you Erza Scarlet!\Name you? Don't just go naming other people...\Scarlet...\Erza Scarlet... response:	Scarlet. The color of your hair.
context: What?\It's a pretty scarlet.\Scarlet?\I know! Let's name you Erza Scarlet!\Name you? Don't just go naming other people...\Scarlet...\Erza Scarlet...\Scarlet. The color of your hair. response:	That way, I'll never forget.
context: It's a pretty scarlet.\Scarlet?\I know! Let's name you Erza Scarlet!\Name you? Don't just go naming other people...\Scarlet...\Erza Scarlet...\Scarlet. The color of your hair.\That way, I'll never forget. response:	Jellal...
context: Scarlet?\I know! Let's name you Erza Scarlet!\Name you? Don't just go naming other people...\Scarlet...\Erza Scarlet...\Scarlet. The color of your hair.\That way, I'll never forget.\Jellal... response:	That morning's dawn
context: I know! Let's name you Erza Scarlet!\Name you? Don't just go naming other people...\Scarlet...\Erza Scarlet...\Scarlet. The color of your hair.\That way, I'll never forget.\Jellal...\That morning's dawn response:	was painted a beautiful scarlet,
context: Name you? Don't just go naming other people...\Scarlet...\Erza Scarlet...\Scarlet. The color of your hair.\That way, I'll never forget.\Jellal...\That morning's dawn\was painted a beautiful scarlet, response:	the likes of which I had never seen before.
context: Scarlet...\Erza Scarlet...\Scarlet. The color of your hair.\That way, I'll never forget.\Jellal...\That morning's dawn\was painted a beautiful scarlet,\the likes of which I had never seen before. response:	Like the color of Erza's hair,
context: Erza Scarlet...\Scarlet. The color of your hair.\That way, I'll never forget.\Jellal...\That morning's dawn\was painted a beautiful scarlet,\the likes of which I had never seen before.\Like the color of Erza's hair, response:	it was warm, and passionate...
context: Scarlet. The color of your hair.\That way, I'll never forget.\Jellal...\That morning's dawn\was painted a beautiful scarlet,\the likes of which I had never seen before.\Like the color of Erza's hair,\it was warm, and passionate... response:	If she could only lift her face, a beautiful sky would be spread out before her...
context: That way, I'll never forget.\Jellal...\That morning's dawn\was painted a beautiful scarlet,\the likes of which I had never seen before.\Like the color of Erza's hair,\it was warm, and passionate...\If she could only lift her face, a beautiful sky would be spread out before her... response:	If she could only lift her face...
context: Jellal...\That morning's dawn\was painted a beautiful scarlet,\the likes of which I had never seen before.\Like the color of Erza's hair,\it was warm, and passionate...\If she could only lift her face, a beautiful sky would be spread out before her...\If she could only lift her face... response:	So cute!
context: That morning's dawn\was painted a beautiful scarlet,\the likes of which I had never seen before.\Like the color of Erza's hair,\it was warm, and passionate...\If she could only lift her face, a beautiful sky would be spread out before her...\If she could only lift her face...\So cute! response:	Oh? I'm far cuter.
context: was painted a beautiful scarlet,\the likes of which I had never seen before.\Like the color of Erza's hair,\it was warm, and passionate...\If she could only lift her face, a beautiful sky would be spread out before her...\If she could only lift her face...\So cute!\Oh? I'm far cuter. response:	The entire village here is part of the guild,
context: the likes of which I had never seen before.\Like the color of Erza's hair,\it was warm, and passionate...\If she could only lift her face, a beautiful sky would be spread out before her...\If she could only lift her face...\So cute!\Oh? I'm far cuter.\The entire village here is part of the guild, response:	so clothing production is a thriving business!
context: Like the color of Erza's hair,\it was warm, and passionate...\If she could only lift her face, a beautiful sky would be spread out before her...\If she could only lift her face...\So cute!\Oh? I'm far cuter.\The entire village here is part of the guild,\so clothing production is a thriving business! response:	Is it some kind of Nirvit traditional sewing?
context: it was warm, and passionate...\If she could only lift her face, a beautiful sky would be spread out before her...\If she could only lift her face...\So cute!\Oh? I'm far cuter.\The entire village here is part of the guild,\so clothing production is a thriving business!\Is it some kind of Nirvit traditional sewing? response:	Now that I think about it... Maybe it is?
context: If she could only lift her face, a beautiful sky would be spread out before her...\If she could only lift her face...\So cute!\Oh? I'm far cuter.\The entire village here is part of the guild,\so clothing production is a thriving business!\Is it some kind of Nirvit traditional sewing?\Now that I think about it... Maybe it is? response:	You didn't realize that the guild was all descendants of the Nirvit, did you?
context: If she could only lift her face...\So cute!\Oh? I'm far cuter.\The entire village here is part of the guild,\so clothing production is a thriving business!\Is it some kind of Nirvit traditional sewing?\Now that I think about it... Maybe it is?\You didn't realize that the guild was all descendants of the Nirvit, did you? response:	Well, I'm the only one who joined afterwards.
context: So cute!\Oh? I'm far cuter.\The entire village here is part of the guild,\so clothing production is a thriving business!\Is it some kind of Nirvit traditional sewing?\Now that I think about it... Maybe it is?\You didn't realize that the guild was all descendants of the Nirvit, did you?\Well, I'm the only one who joined afterwards. response:	Erza, won't you try them on? They're really cute!
context: Oh? I'm far cuter.\The entire village here is part of the guild,\so clothing production is a thriving business!\Is it some kind of Nirvit traditional sewing?\Now that I think about it... Maybe it is?\You didn't realize that the guild was all descendants of the Nirvit, did you?\Well, I'm the only one who joined afterwards.\Erza, won't you try them on? They're really cute! response:	Sure... You're right.
context: The entire village here is part of the guild,\so clothing production is a thriving business!\Is it some kind of Nirvit traditional sewing?\Now that I think about it... Maybe it is?\You didn't realize that the guild was all descendants of the Nirvit, did you?\Well, I'm the only one who joined afterwards.\Erza, won't you try them on? They're really cute!\Sure... You're right. response:	Speaking of which, Wendy... When did Caitshelter join the League of Guilds?
context: so clothing production is a thriving business!\Is it some kind of Nirvit traditional sewing?\Now that I think about it... Maybe it is?\You didn't realize that the guild was all descendants of the Nirvit, did you?\Well, I'm the only one who joined afterwards.\Erza, won't you try them on? They're really cute!\Sure... You're right.\Speaking of which, Wendy... When did Caitshelter join the League of Guilds? response:	I apologize for being blunt, but until this mission began,
context: Is it some kind of Nirvit traditional sewing?\Now that I think about it... Maybe it is?\You didn't realize that the guild was all descendants of the Nirvit, did you?\Well, I'm the only one who joined afterwards.\Erza, won't you try them on? They're really cute!\Sure... You're right.\Speaking of which, Wendy... When did Caitshelter join the League of Guilds?\I apologize for being blunt, but until this mission began, response:	I had not even heard your guild's name.
context: Now that I think about it... Maybe it is?\You didn't realize that the guild was all descendants of the Nirvit, did you?\Well, I'm the only one who joined afterwards.\Erza, won't you try them on? They're really cute!\Sure... You're right.\Speaking of which, Wendy... When did Caitshelter join the League of Guilds?\I apologize for being blunt, but until this mission began,\I had not even heard your guild's name. response:	Now that you mention it, neither had I.
context: You didn't realize that the guild was all descendants of the Nirvit, did you?\Well, I'm the only one who joined afterwards.\Erza, won't you try them on? They're really cute!\Sure... You're right.\Speaking of which, Wendy... When did Caitshelter join the League of Guilds?\I apologize for being blunt, but until this mission began,\I had not even heard your guild's name.\Now that you mention it, neither had I. response:	Is that so?
context: Well, I'm the only one who joined afterwards.\Erza, won't you try them on? They're really cute!\Sure... You're right.\Speaking of which, Wendy... When did Caitshelter join the League of Guilds?\I apologize for being blunt, but until this mission began,\I had not even heard your guild's name.\Now that you mention it, neither had I.\Is that so? response:	My guild must really be one of the more obscure ones...
context: Erza, won't you try them on? They're really cute!\Sure... You're right.\Speaking of which, Wendy... When did Caitshelter join the League of Guilds?\I apologize for being blunt, but until this mission began,\I had not even heard your guild's name.\Now that you mention it, neither had I.\Is that so?\My guild must really be one of the more obscure ones... response:	Who cares? Everyone is waiting...
context: Sure... You're right.\Speaking of which, Wendy... When did Caitshelter join the League of Guilds?\I apologize for being blunt, but until this mission began,\I had not even heard your guild's name.\Now that you mention it, neither had I.\Is that so?\My guild must really be one of the more obscure ones...\Who cares? Everyone is waiting... response:	Fairy Tail...
context: Speaking of which, Wendy... When did Caitshelter join the League of Guilds?\I apologize for being blunt, but until this mission began,\I had not even heard your guild's name.\Now that you mention it, neither had I.\Is that so?\My guild must really be one of the more obscure ones...\Who cares? Everyone is waiting...\Fairy Tail... response:	Blue Pegasus...
context: I apologize for being blunt, but until this mission began,\I had not even heard your guild's name.\Now that you mention it, neither had I.\Is that so?\My guild must really be one of the more obscure ones...\Who cares? Everyone is waiting...\Fairy Tail...\Blue Pegasus... response:	Lamia Scale...
context: I had not even heard your guild's name.\Now that you mention it, neither had I.\Is that so?\My guild must really be one of the more obscure ones...\Who cares? Everyone is waiting...\Fairy Tail...\Blue Pegasus...\Lamia Scale... response:	Also, Wendy and Carla.
context: Now that you mention it, neither had I.\Is that so?\My guild must really be one of the more obscure ones...\Who cares? Everyone is waiting...\Fairy Tail...\Blue Pegasus...\Lamia Scale...\Also, Wendy and Carla. response:	You have done well in defeating Oracion Seis and stopping Nirvana.
context: Is that so?\My guild must really be one of the more obscure ones...\Who cares? Everyone is waiting...\Fairy Tail...\Blue Pegasus...\Lamia Scale...\Also, Wendy and Carla.\You have done well in defeating Oracion Seis and stopping Nirvana. response:	As a representative for the local League of Guilds,
context: My guild must really be one of the more obscure ones...\Who cares? Everyone is waiting...\Fairy Tail...\Blue Pegasus...\Lamia Scale...\Also, Wendy and Carla.\You have done well in defeating Oracion Seis and stopping Nirvana.\As a representative for the local League of Guilds, response:	I, Robaul, say job well done.
context: Who cares? Everyone is waiting...\Fairy Tail...\Blue Pegasus...\Lamia Scale...\Also, Wendy and Carla.\You have done well in defeating Oracion Seis and stopping Nirvana.\As a representative for the local League of Guilds,\I, Robaul, say job well done. response:	Thank you.
context: Fairy Tail...\Blue Pegasus...\Lamia Scale...\Also, Wendy and Carla.\You have done well in defeating Oracion Seis and stopping Nirvana.\As a representative for the local League of Guilds,\I, Robaul, say job well done.\Thank you. response:	Nabula!
context: Blue Pegasus...\Lamia Scale...\Also, Wendy and Carla.\You have done well in defeating Oracion Seis and stopping Nirvana.\As a representative for the local League of Guilds,\I, Robaul, say job well done.\Thank you.\Nabula! response:	Thank you!
context: Lamia Scale...\Also, Wendy and Carla.\You have done well in defeating Oracion Seis and stopping Nirvana.\As a representative for the local League of Guilds,\I, Robaul, say job well done.\Thank you.\Nabula!\Thank you! response:	It was our pleasure, Master Robaul!
context: Also, Wendy and Carla.\You have done well in defeating Oracion Seis and stopping Nirvana.\As a representative for the local League of Guilds,\I, Robaul, say job well done.\Thank you.\Nabula!\Thank you!\It was our pleasure, Master Robaul! response:	The fight with Oracion Seis was one fierce battle after the next!
context: You have done well in defeating Oracion Seis and stopping Nirvana.\As a representative for the local League of Guilds,\I, Robaul, say job well done.\Thank you.\Nabula!\Thank you!\It was our pleasure, Master Robaul!\The fight with Oracion Seis was one fierce battle after the next! response:	There was not a single easy battle!
context: As a representative for the local League of Guilds,\I, Robaul, say job well done.\Thank you.\Nabula!\Thank you!\It was our pleasure, Master Robaul!\The fight with Oracion Seis was one fierce battle after the next!\There was not a single easy battle! response:	But the bonds between us allies
context: I, Robaul, say job well done.\Thank you.\Nabula!\Thank you!\It was our pleasure, Master Robaul!\The fight with Oracion Seis was one fierce battle after the next!\There was not a single easy battle!\But the bonds between us allies response:	led us on the path to victory!
context: Thank you.\Nabula!\Thank you!\It was our pleasure, Master Robaul!\The fight with Oracion Seis was one fierce battle after the next!\There was not a single easy battle!\But the bonds between us allies\led us on the path to victory! response:	You said it, Sensei!
context: Nabula!\Thank you!\It was our pleasure, Master Robaul!\The fight with Oracion Seis was one fierce battle after the next!\There was not a single easy battle!\But the bonds between us allies\led us on the path to victory!\You said it, Sensei! response:	Men.
context: Thank you!\It was our pleasure, Master Robaul!\The fight with Oracion Seis was one fierce battle after the next!\There was not a single easy battle!\But the bonds between us allies\led us on the path to victory!\You said it, Sensei!\Men. response:	Oh sure, just take all the good parts for yourself.
context: It was our pleasure, Master Robaul!\The fight with Oracion Seis was one fierce battle after the next!\There was not a single easy battle!\But the bonds between us allies\led us on the path to victory!\You said it, Sensei!\Men.\Oh sure, just take all the good parts for yourself. response:	Men.
context: The fight with Oracion Seis was one fierce battle after the next!\There was not a single easy battle!\But the bonds between us allies\led us on the path to victory!\You said it, Sensei!\Men.\Oh sure, just take all the good parts for yourself.\Men. response:	Did he even fight anyone?
context: There was not a single easy battle!\But the bonds between us allies\led us on the path to victory!\You said it, Sensei!\Men.\Oh sure, just take all the good parts for yourself.\Men.\Did he even fight anyone? response:	It's finally over...
context: But the bonds between us allies\led us on the path to victory!\You said it, Sensei!\Men.\Oh sure, just take all the good parts for yourself.\Men.\Did he even fight anyone?\It's finally over... response:	You two did well yourself!
context: led us on the path to victory!\You said it, Sensei!\Men.\Oh sure, just take all the good parts for yourself.\Men.\Did he even fight anyone?\It's finally over...\You two did well yourself! response:	Jura-san...
context: You said it, Sensei!\Men.\Oh sure, just take all the good parts for yourself.\Men.\Did he even fight anyone?\It's finally over...\You two did well yourself!\Jura-san... response:	You're supposed to throw a party now, right?
context: Men.\Oh sure, just take all the good parts for yourself.\Men.\Did he even fight anyone?\It's finally over...\You two did well yourself!\Jura-san...\You're supposed to throw a party now, right? response:	Aye, sir!
context: Oh sure, just take all the good parts for yourself.\Men.\Did he even fight anyone?\It's finally over...\You two did well yourself!\Jura-san...\You're supposed to throw a party now, right?\Aye, sir! response:	Ichiya...
context: Men.\Did he even fight anyone?\It's finally over...\You two did well yourself!\Jura-san...\You're supposed to throw a party now, right?\Aye, sir!\Ichiya... response:	Ichiya...
context: Did he even fight anyone?\It's finally over...\You two did well yourself!\Jura-san...\You're supposed to throw a party now, right?\Aye, sir!\Ichiya...\Ichiya... response:	A party?
context: It's finally over...\You two did well yourself!\Jura-san...\You're supposed to throw a party now, right?\Aye, sir!\Ichiya...\Ichiya...\A party? response:	And off go the clothes!
context: You two did well yourself!\Jura-san...\You're supposed to throw a party now, right?\Aye, sir!\Ichiya...\Ichiya...\A party?\And off go the clothes! response:	You, too!
context: Jura-san...\You're supposed to throw a party now, right?\Aye, sir!\Ichiya...\Ichiya...\A party?\And off go the clothes!\You, too! response:	Now... Everyone from Caitshelter, join in!
context: You're supposed to throw a party now, right?\Aye, sir!\Ichiya...\Ichiya...\A party?\And off go the clothes!\You, too!\Now... Everyone from Caitshelter, join in! response:	Everyone...
context: Aye, sir!\Ichiya...\Ichiya...\A party?\And off go the clothes!\You, too!\Now... Everyone from Caitshelter, join in!\Everyone... response:	I am truly sorry about hiding our legacy as Nirvit.
context: Ichiya...\Ichiya...\A party?\And off go the clothes!\You, too!\Now... Everyone from Caitshelter, join in!\Everyone...\I am truly sorry about hiding our legacy as Nirvit. response:	You ruined the mood to say that?
context: Ichiya...\A party?\And off go the clothes!\You, too!\Now... Everyone from Caitshelter, join in!\Everyone...\I am truly sorry about hiding our legacy as Nirvit.\You ruined the mood to say that? response:	We really don't mind at all.
context: A party?\And off go the clothes!\You, too!\Now... Everyone from Caitshelter, join in!\Everyone...\I am truly sorry about hiding our legacy as Nirvit.\You ruined the mood to say that?\We really don't mind at all. response:	Right?
context: And off go the clothes!\You, too!\Now... Everyone from Caitshelter, join in!\Everyone...\I am truly sorry about hiding our legacy as Nirvit.\You ruined the mood to say that?\We really don't mind at all.\Right? response:	Right!
context: You, too!\Now... Everyone from Caitshelter, join in!\Everyone...\I am truly sorry about hiding our legacy as Nirvit.\You ruined the mood to say that?\We really don't mind at all.\Right?\Right! response:	Master, I don't mind either.
context: Now... Everyone from Caitshelter, join in!\Everyone...\I am truly sorry about hiding our legacy as Nirvit.\You ruined the mood to say that?\We really don't mind at all.\Right?\Right!\Master, I don't mind either. response:	Everyone, please listen carefully to what I am about to say.
context: Everyone...\I am truly sorry about hiding our legacy as Nirvit.\You ruined the mood to say that?\We really don't mind at all.\Right?\Right!\Master, I don't mind either.\Everyone, please listen carefully to what I am about to say. response:	To start, we are not the descendants of the Nirvit.
context: I am truly sorry about hiding our legacy as Nirvit.\You ruined the mood to say that?\We really don't mind at all.\Right?\Right!\Master, I don't mind either.\Everyone, please listen carefully to what I am about to say.\To start, we are not the descendants of the Nirvit. response:	We are the Nirvit themselves!
context: You ruined the mood to say that?\We really don't mind at all.\Right?\Right!\Master, I don't mind either.\Everyone, please listen carefully to what I am about to say.\To start, we are not the descendants of the Nirvit.\We are the Nirvit themselves! response:	400 years ago, it was I who created Nirvana.
context: We really don't mind at all.\Right?\Right!\Master, I don't mind either.\Everyone, please listen carefully to what I am about to say.\To start, we are not the descendants of the Nirvit.\We are the Nirvit themselves!\400 years ago, it was I who created Nirvana. response:	What?
context: Right?\Right!\Master, I don't mind either.\Everyone, please listen carefully to what I am about to say.\To start, we are not the descendants of the Nirvit.\We are the Nirvit themselves!\400 years ago, it was I who created Nirvana.\What? response:	No way!
context: Right!\Master, I don't mind either.\Everyone, please listen carefully to what I am about to say.\To start, we are not the descendants of the Nirvit.\We are the Nirvit themselves!\400 years ago, it was I who created Nirvana.\What?\No way! response:	400 years ago?
context: Master, I don't mind either.\Everyone, please listen carefully to what I am about to say.\To start, we are not the descendants of the Nirvit.\We are the Nirvit themselves!\400 years ago, it was I who created Nirvana.\What?\No way!\400 years ago? response:	400 years ago, in order to stop the war that was raging across the world,
context: Everyone, please listen carefully to what I am about to say.\To start, we are not the descendants of the Nirvit.\We are the Nirvit themselves!\400 years ago, it was I who created Nirvana.\What?\No way!\400 years ago?\400 years ago, in order to stop the war that was raging across the world, response:	I created Nirvana, a magic that inverts light and darkness.
context: To start, we are not the descendants of the Nirvit.\We are the Nirvit themselves!\400 years ago, it was I who created Nirvana.\What?\No way!\400 years ago?\400 years ago, in order to stop the war that was raging across the world,\I created Nirvana, a magic that inverts light and darkness. response:	Nirvana became our country,
context: We are the Nirvit themselves!\400 years ago, it was I who created Nirvana.\What?\No way!\400 years ago?\400 years ago, in order to stop the war that was raging across the world,\I created Nirvana, a magic that inverts light and darkness.\Nirvana became our country, response:	and, for a time, we realized peace.
context: 400 years ago, it was I who created Nirvana.\What?\No way!\400 years ago?\400 years ago, in order to stop the war that was raging across the world,\I created Nirvana, a magic that inverts light and darkness.\Nirvana became our country,\and, for a time, we realized peace. response:	However...
context: What?\No way!\400 years ago?\400 years ago, in order to stop the war that was raging across the world,\I created Nirvana, a magic that inverts light and darkness.\Nirvana became our country,\and, for a time, we realized peace.\However... response:	Great power will, without fail, give rise to a great power opposing it.
context: No way!\400 years ago?\400 years ago, in order to stop the war that was raging across the world,\I created Nirvana, a magic that inverts light and darkness.\Nirvana became our country,\and, for a time, we realized peace.\However...\Great power will, without fail, give rise to a great power opposing it. response:	As much as Nirvana changed darkness for light, Nirvana itself became wrapped in darkness.
context: 400 years ago?\400 years ago, in order to stop the war that was raging across the world,\I created Nirvana, a magic that inverts light and darkness.\Nirvana became our country,\and, for a time, we realized peace.\However...\Great power will, without fail, give rise to a great power opposing it.\As much as Nirvana changed darkness for light, Nirvana itself became wrapped in darkness. response:	It was to maintain balance.
context: 400 years ago, in order to stop the war that was raging across the world,\I created Nirvana, a magic that inverts light and darkness.\Nirvana became our country,\and, for a time, we realized peace.\However...\Great power will, without fail, give rise to a great power opposing it.\As much as Nirvana changed darkness for light, Nirvana itself became wrapped in darkness.\It was to maintain balance. response:	It was impossible to change people's personalities to light without limit.
context: I created Nirvana, a magic that inverts light and darkness.\Nirvana became our country,\and, for a time, we realized peace.\However...\Great power will, without fail, give rise to a great power opposing it.\As much as Nirvana changed darkness for light, Nirvana itself became wrapped in darkness.\It was to maintain balance.\It was impossible to change people's personalities to light without limit. response:	As light rises to oppose the darkness,
context: Nirvana became our country,\and, for a time, we realized peace.\However...\Great power will, without fail, give rise to a great power opposing it.\As much as Nirvana changed darkness for light, Nirvana itself became wrapped in darkness.\It was to maintain balance.\It was impossible to change people's personalities to light without limit.\As light rises to oppose the darkness, response:	so does darkness rise to oppose the light, without fail.
context: and, for a time, we realized peace.\However...\Great power will, without fail, give rise to a great power opposing it.\As much as Nirvana changed darkness for light, Nirvana itself became wrapped in darkness.\It was to maintain balance.\It was impossible to change people's personalities to light without limit.\As light rises to oppose the darkness,\so does darkness rise to oppose the light, without fail. response:	Now that you mention it...
context: However...\Great power will, without fail, give rise to a great power opposing it.\As much as Nirvana changed darkness for light, Nirvana itself became wrapped in darkness.\It was to maintain balance.\It was impossible to change people's personalities to light without limit.\As light rises to oppose the darkness,\so does darkness rise to oppose the light, without fail.\Now that you mention it... response:	The darkness lost from the various peoples came back upon us Nirvit.
context: Great power will, without fail, give rise to a great power opposing it.\As much as Nirvana changed darkness for light, Nirvana itself became wrapped in darkness.\It was to maintain balance.\It was impossible to change people's personalities to light without limit.\As light rises to oppose the darkness,\so does darkness rise to oppose the light, without fail.\Now that you mention it...\The darkness lost from the various peoples came back upon us Nirvit. response:	No...
context: As much as Nirvana changed darkness for light, Nirvana itself became wrapped in darkness.\It was to maintain balance.\It was impossible to change people's personalities to light without limit.\As light rises to oppose the darkness,\so does darkness rise to oppose the light, without fail.\Now that you mention it...\The darkness lost from the various peoples came back upon us Nirvit.\No... response:	It was hell.
context: It was to maintain balance.\It was impossible to change people's personalities to light without limit.\As light rises to oppose the darkness,\so does darkness rise to oppose the light, without fail.\Now that you mention it...\The darkness lost from the various peoples came back upon us Nirvit.\No...\It was hell. response:	We killed each other... Until no one was left.
context: It was impossible to change people's personalities to light without limit.\As light rises to oppose the darkness,\so does darkness rise to oppose the light, without fail.\Now that you mention it...\The darkness lost from the various peoples came back upon us Nirvit.\No...\It was hell.\We killed each other... Until no one was left. response:	I am the only survivor.
context: As light rises to oppose the darkness,\so does darkness rise to oppose the light, without fail.\Now that you mention it...\The darkness lost from the various peoples came back upon us Nirvit.\No...\It was hell.\We killed each other... Until no one was left.\I am the only survivor. response:	Well, at this point, that's not exactly right.
context: so does darkness rise to oppose the light, without fail.\Now that you mention it...\The darkness lost from the various peoples came back upon us Nirvit.\No...\It was hell.\We killed each other... Until no one was left.\I am the only survivor.\Well, at this point, that's not exactly right. response:	My physical body has long perished... I am what you might call a spectral form now.
context: Now that you mention it...\The darkness lost from the various peoples came back upon us Nirvit.\No...\It was hell.\We killed each other... Until no one was left.\I am the only survivor.\Well, at this point, that's not exactly right.\My physical body has long perished... I am what you might call a spectral form now. response:	Or rather, a weak ghost trying to atone for his sins of the past.
context: The darkness lost from the various peoples came back upon us Nirvit.\No...\It was hell.\We killed each other... Until no one was left.\I am the only survivor.\Well, at this point, that's not exactly right.\My physical body has long perished... I am what you might call a spectral form now.\Or rather, a weak ghost trying to atone for his sins of the past. response:	I watched over Nirvana for 400 years until someone appeared who would be able to destroy it.
context: No...\It was hell.\We killed each other... Until no one was left.\I am the only survivor.\Well, at this point, that's not exactly right.\My physical body has long perished... I am what you might call a spectral form now.\Or rather, a weak ghost trying to atone for his sins of the past.\I watched over Nirvana for 400 years until someone appeared who would be able to destroy it. response:	And now...
context: It was hell.\We killed each other... Until no one was left.\I am the only survivor.\Well, at this point, that's not exactly right.\My physical body has long perished... I am what you might call a spectral form now.\Or rather, a weak ghost trying to atone for his sins of the past.\I watched over Nirvana for 400 years until someone appeared who would be able to destroy it.\And now... response:	W-What are you saying...?
context: We killed each other... Until no one was left.\I am the only survivor.\Well, at this point, that's not exactly right.\My physical body has long perished... I am what you might call a spectral form now.\Or rather, a weak ghost trying to atone for his sins of the past.\I watched over Nirvana for 400 years until someone appeared who would be able to destroy it.\And now...\W-What are you saying...? response:	What is this?
context: I am the only survivor.\Well, at this point, that's not exactly right.\My physical body has long perished... I am what you might call a spectral form now.\Or rather, a weak ghost trying to atone for his sins of the past.\I watched over Nirvana for 400 years until someone appeared who would be able to destroy it.\And now...\W-What are you saying...?\What is this? response:	Everyone?
context: Well, at this point, that's not exactly right.\My physical body has long perished... I am what you might call a spectral form now.\Or rather, a weak ghost trying to atone for his sins of the past.\I watched over Nirvana for 400 years until someone appeared who would be able to destroy it.\And now...\W-What are you saying...?\What is this?\Everyone? response:	All of you!
context: My physical body has long perished... I am what you might call a spectral form now.\Or rather, a weak ghost trying to atone for his sins of the past.\I watched over Nirvana for 400 years until someone appeared who would be able to destroy it.\And now...\W-What are you saying...?\What is this?\Everyone?\All of you! response:	Magna! Pepel!
context: Or rather, a weak ghost trying to atone for his sins of the past.\I watched over Nirvana for 400 years until someone appeared who would be able to destroy it.\And now...\W-What are you saying...?\What is this?\Everyone?\All of you!\Magna! Pepel! response:	What's going on here?
context: I watched over Nirvana for 400 years until someone appeared who would be able to destroy it.\And now...\W-What are you saying...?\What is this?\Everyone?\All of you!\Magna! Pepel!\What's going on here? response:	They're all disappearing!
context: And now...\W-What are you saying...?\What is this?\Everyone?\All of you!\Magna! Pepel!\What's going on here?\They're all disappearing! response:	No! Everyone!
context: W-What are you saying...?\What is this?\Everyone?\All of you!\Magna! Pepel!\What's going on here?\They're all disappearing!\No! Everyone! response:	I don't want you to disappear!
context: What is this?\Everyone?\All of you!\Magna! Pepel!\What's going on here?\They're all disappearing!\No! Everyone!\I don't want you to disappear! response:	I apologize for deceiving you...
context: Everyone?\All of you!\Magna! Pepel!\What's going on here?\They're all disappearing!\No! Everyone!\I don't want you to disappear!\I apologize for deceiving you... response:	All the members of the guild are illusions created by me.
context: All of you!\Magna! Pepel!\What's going on here?\They're all disappearing!\No! Everyone!\I don't want you to disappear!\I apologize for deceiving you...\All the members of the guild are illusions created by me. response:	Say what?!
context: Magna! Pepel!\What's going on here?\They're all disappearing!\No! Everyone!\I don't want you to disappear!\I apologize for deceiving you...\All the members of the guild are illusions created by me.\Say what?! response:	Illusions with their own personalities?
context: What's going on here?\They're all disappearing!\No! Everyone!\I don't want you to disappear!\I apologize for deceiving you...\All the members of the guild are illusions created by me.\Say what?!\Illusions with their own personalities? response:	What incredible magic power!
context: They're all disappearing!\No! Everyone!\I don't want you to disappear!\I apologize for deceiving you...\All the members of the guild are illusions created by me.\Say what?!\Illusions with their own personalities?\What incredible magic power! response:	7 years ago, a single boy came here.
context: No! Everyone!\I don't want you to disappear!\I apologize for deceiving you...\All the members of the guild are illusions created by me.\Say what?!\Illusions with their own personalities?\What incredible magic power!\7 years ago, a single boy came here. response:	Please, take care of this girl!
context: I don't want you to disappear!\I apologize for deceiving you...\All the members of the guild are illusions created by me.\Say what?!\Illusions with their own personalities?\What incredible magic power!\7 years ago, a single boy came here.\Please, take care of this girl! response:	I couldn't turn down the request of that boy and his fierce, honest eyes.
context: I apologize for deceiving you...\All the members of the guild are illusions created by me.\Say what?!\Illusions with their own personalities?\What incredible magic power!\7 years ago, a single boy came here.\Please, take care of this girl!\I couldn't turn down the request of that boy and his fierce, honest eyes. response:	Even though I had promised myself I would stay alone...
context: All the members of the guild are illusions created by me.\Say what?!\Illusions with their own personalities?\What incredible magic power!\7 years ago, a single boy came here.\Please, take care of this girl!\I couldn't turn down the request of that boy and his fierce, honest eyes.\Even though I had promised myself I would stay alone... response:	Mister, where am I?
context: Say what?!\Illusions with their own personalities?\What incredible magic power!\7 years ago, a single boy came here.\Please, take care of this girl!\I couldn't turn down the request of that boy and his fierce, honest eyes.\Even though I had promised myself I would stay alone...\Mister, where am I? response:	T-This is...
context: Illusions with their own personalities?\What incredible magic power!\7 years ago, a single boy came here.\Please, take care of this girl!\I couldn't turn down the request of that boy and his fierce, honest eyes.\Even though I had promised myself I would stay alone...\Mister, where am I?\T-This is... response:	Jellal?
context: What incredible magic power!\7 years ago, a single boy came here.\Please, take care of this girl!\I couldn't turn down the request of that boy and his fierce, honest eyes.\Even though I had promised myself I would stay alone...\Mister, where am I?\T-This is...\Jellal? response:	He said he was taking me to a guild...
context: 7 years ago, a single boy came here.\Please, take care of this girl!\I couldn't turn down the request of that boy and his fierce, honest eyes.\Even though I had promised myself I would stay alone...\Mister, where am I?\T-This is...\Jellal?\He said he was taking me to a guild... response:	T-This is a guild!
context: Please, take care of this girl!\I couldn't turn down the request of that boy and his fierce, honest eyes.\Even though I had promised myself I would stay alone...\Mister, where am I?\T-This is...\Jellal?\He said he was taking me to a guild...\T-This is a guild! response:	This is a Wizard's Guild!
context: I couldn't turn down the request of that boy and his fierce, honest eyes.\Even though I had promised myself I would stay alone...\Mister, where am I?\T-This is...\Jellal?\He said he was taking me to a guild...\T-This is a guild!\This is a Wizard's Guild! response:	Really?
context: Even though I had promised myself I would stay alone...\Mister, where am I?\T-This is...\Jellal?\He said he was taking me to a guild...\T-This is a guild!\This is a Wizard's Guild!\Really? response:	Nabula!
context: Mister, where am I?\T-This is...\Jellal?\He said he was taking me to a guild...\T-This is a guild!\This is a Wizard's Guild!\Really?\Nabula! response:	Try going outside!
context: T-This is...\Jellal?\He said he was taking me to a guild...\T-This is a guild!\This is a Wizard's Guild!\Really?\Nabula!\Try going outside! response:	You have friends waiting for you.
context: Jellal?\He said he was taking me to a guild...\T-This is a guild!\This is a Wizard's Guild!\Really?\Nabula!\Try going outside!\You have friends waiting for you. response:	And so I also created an illusory family.
context: He said he was taking me to a guild...\T-This is a guild!\This is a Wizard's Guild!\Really?\Nabula!\Try going outside!\You have friends waiting for you.\And so I also created an illusory family. response:	The guild was created all for Wendy?
context: T-This is a guild!\This is a Wizard's Guild!\Really?\Nabula!\Try going outside!\You have friends waiting for you.\And so I also created an illusory family.\The guild was created all for Wendy? response:	I don't wanna hear that!
context: This is a Wizard's Guild!\Really?\Nabula!\Try going outside!\You have friends waiting for you.\And so I also created an illusory family.\The guild was created all for Wendy?\I don't wanna hear that! response:	Bask, Naoki, don't you disappear too!
context: Really?\Nabula!\Try going outside!\You have friends waiting for you.\And so I also created an illusory family.\The guild was created all for Wendy?\I don't wanna hear that!\Bask, Naoki, don't you disappear too! response:	Wendy, Carla... You no longer need a foster family.
context: Nabula!\Try going outside!\You have friends waiting for you.\And so I also created an illusory family.\The guild was created all for Wendy?\I don't wanna hear that!\Bask, Naoki, don't you disappear too!\Wendy, Carla... You no longer need a foster family. response:	Don't you have real friends now?
context: Try going outside!\You have friends waiting for you.\And so I also created an illusory family.\The guild was created all for Wendy?\I don't wanna hear that!\Bask, Naoki, don't you disappear too!\Wendy, Carla... You no longer need a foster family.\Don't you have real friends now? response:	Your future... has only just begun.
context: You have friends waiting for you.\And so I also created an illusory family.\The guild was created all for Wendy?\I don't wanna hear that!\Bask, Naoki, don't you disappear too!\Wendy, Carla... You no longer need a foster family.\Don't you have real friends now?\Your future... has only just begun. response:	Master!
context: And so I also created an illusory family.\The guild was created all for Wendy?\I don't wanna hear that!\Bask, Naoki, don't you disappear too!\Wendy, Carla... You no longer need a foster family.\Don't you have real friends now?\Your future... has only just begun.\Master! response:	Everyone, truly, thank you.
context: The guild was created all for Wendy?\I don't wanna hear that!\Bask, Naoki, don't you disappear too!\Wendy, Carla... You no longer need a foster family.\Don't you have real friends now?\Your future... has only just begun.\Master!\Everyone, truly, thank you. response:	I leave Wendy and Carla in your hands.
context: I don't wanna hear that!\Bask, Naoki, don't you disappear too!\Wendy, Carla... You no longer need a foster family.\Don't you have real friends now?\Your future... has only just begun.\Master!\Everyone, truly, thank you.\I leave Wendy and Carla in your hands. response:	Master!
context: Bask, Naoki, don't you disappear too!\Wendy, Carla... You no longer need a foster family.\Don't you have real friends now?\Your future... has only just begun.\Master!\Everyone, truly, thank you.\I leave Wendy and Carla in your hands.\Master! response:	Bury the pain of losing your loved ones... into the arms of your friends.
context: Wendy, Carla... You no longer need a foster family.\Don't you have real friends now?\Your future... has only just begun.\Master!\Everyone, truly, thank you.\I leave Wendy and Carla in your hands.\Master!\Bury the pain of losing your loved ones... into the arms of your friends. response:	Come.
context: Don't you have real friends now?\Your future... has only just begun.\Master!\Everyone, truly, thank you.\I leave Wendy and Carla in your hands.\Master!\Bury the pain of losing your loved ones... into the arms of your friends.\Come. response:	To Fairy Tail.
context: Your future... has only just begun.\Master!\Everyone, truly, thank you.\I leave Wendy and Carla in your hands.\Master!\Bury the pain of losing your loved ones... into the arms of your friends.\Come.\To Fairy Tail. response:	It feels like it's been a while since we've been back to the guild.
context: Master!\Everyone, truly, thank you.\I leave Wendy and Carla in your hands.\Master!\Bury the pain of losing your loved ones... into the arms of your friends.\Come.\To Fairy Tail.\It feels like it's been a while since we've been back to the guild. response:	No kidding!
context: Everyone, truly, thank you.\I leave Wendy and Carla in your hands.\Master!\Bury the pain of losing your loved ones... into the arms of your friends.\Come.\To Fairy Tail.\It feels like it's been a while since we've been back to the guild.\No kidding! response:	We can finally take it easy!
context: I leave Wendy and Carla in your hands.\Master!\Bury the pain of losing your loved ones... into the arms of your friends.\Come.\To Fairy Tail.\It feels like it's been a while since we've been back to the guild.\No kidding!\We can finally take it easy! response:	Actually, it doesn't look like we can.
context: Master!\Bury the pain of losing your loved ones... into the arms of your friends.\Come.\To Fairy Tail.\It feels like it's been a while since we've been back to the guild.\No kidding!\We can finally take it easy!\Actually, it doesn't look like we can. response:	I heard there's a person that saw a dragon!
context: Bury the pain of losing your loved ones... into the arms of your friends.\Come.\To Fairy Tail.\It feels like it's been a while since we've been back to the guild.\No kidding!\We can finally take it easy!\Actually, it doesn't look like we can.\I heard there's a person that saw a dragon! response:	Seriously?!
context: Come.\To Fairy Tail.\It feels like it's been a while since we've been back to the guild.\No kidding!\We can finally take it easy!\Actually, it doesn't look like we can.\I heard there's a person that saw a dragon!\Seriously?! response:	Could that dragon be Igneel?
context: To Fairy Tail.\It feels like it's been a while since we've been back to the guild.\No kidding!\We can finally take it easy!\Actually, it doesn't look like we can.\I heard there's a person that saw a dragon!\Seriously?!\Could that dragon be Igneel? response:	Maybe it's the Dragon that Wendy and Carla are looking for!
context: It feels like it's been a while since we've been back to the guild.\No kidding!\We can finally take it easy!\Actually, it doesn't look like we can.\I heard there's a person that saw a dragon!\Seriously?!\Could that dragon be Igneel?\Maybe it's the Dragon that Wendy and Carla are looking for! response:	Next time: Call of the Dragon.
context: No kidding!\We can finally take it easy!\Actually, it doesn't look like we can.\I heard there's a person that saw a dragon!\Seriously?!\Could that dragon be Igneel?\Maybe it's the Dragon that Wendy and Carla are looking for!\Next time: Call of the Dragon. response:	Oh yeah... What was the name of the dragon they were looking for again?
context: We can finally take it easy!\Actually, it doesn't look like we can.\I heard there's a person that saw a dragon!\Seriously?!\Could that dragon be Igneel?\Maybe it's the Dragon that Wendy and Carla are looking for!\Next time: Call of the Dragon.\Oh yeah... What was the name of the dragon they were looking for again? response:	I'm pretty sure it's Wendine.
context: Actually, it doesn't look like we can.\I heard there's a person that saw a dragon!\Seriously?!\Could that dragon be Igneel?\Maybe it's the Dragon that Wendy and Carla are looking for!\Next time: Call of the Dragon.\Oh yeah... What was the name of the dragon they were looking for again?\I'm pretty sure it's Wendine. response:	Uh, I think you're mixed up.