context: It's not here either. response:	We may not be able to find it.
context: It's not here either.\We may not be able to find it. response:	Calm down.
context: It's not here either.\We may not be able to find it.\Calm down. response:	I know just what to do.
context: It's not here either.\We may not be able to find it.\Calm down.\I know just what to do. response:	Yes, this is New Compton waste disposal.
context: It's not here either.\We may not be able to find it.\Calm down.\I know just what to do.\Yes, this is New Compton waste disposal. response:	Hello.
context: It's not here either.\We may not be able to find it.\Calm down.\I know just what to do.\Yes, this is New Compton waste disposal.\Hello. response:	I accidentally put something really important in the garbage,
context: It's not here either.\We may not be able to find it.\Calm down.\I know just what to do.\Yes, this is New Compton waste disposal.\Hello.\I accidentally put something really important in the garbage, response:	and it just got picked up.
context: It's not here either.\We may not be able to find it.\Calm down.\I know just what to do.\Yes, this is New Compton waste disposal.\Hello.\I accidentally put something really important in the garbage,\and it just got picked up. response:	I'm sorry to hear that.
context: We may not be able to find it.\Calm down.\I know just what to do.\Yes, this is New Compton waste disposal.\Hello.\I accidentally put something really important in the garbage,\and it just got picked up.\I'm sorry to hear that. response:	Goodbye.
context: Calm down.\I know just what to do.\Yes, this is New Compton waste disposal.\Hello.\I accidentally put something really important in the garbage,\and it just got picked up.\I'm sorry to hear that.\Goodbye. response:	W-Wait!
context: I know just what to do.\Yes, this is New Compton waste disposal.\Hello.\I accidentally put something really important in the garbage,\and it just got picked up.\I'm sorry to hear that.\Goodbye.\W-Wait! response:	Is there something else?
context: Yes, this is New Compton waste disposal.\Hello.\I accidentally put something really important in the garbage,\and it just got picked up.\I'm sorry to hear that.\Goodbye.\W-Wait!\Is there something else? response:	I told you, it's really important!
context: Hello.\I accidentally put something really important in the garbage,\and it just got picked up.\I'm sorry to hear that.\Goodbye.\W-Wait!\Is there something else?\I told you, it's really important! response:	When your garbage is picked up, you lose all rights to it.
context: I accidentally put something really important in the garbage,\and it just got picked up.\I'm sorry to hear that.\Goodbye.\W-Wait!\Is there something else?\I told you, it's really important!\When your garbage is picked up, you lose all rights to it. response:	Goodbye.
context: and it just got picked up.\I'm sorry to hear that.\Goodbye.\W-Wait!\Is there something else?\I told you, it's really important!\When your garbage is picked up, you lose all rights to it.\Goodbye. response:	Wait, I said...
context: I'm sorry to hear that.\Goodbye.\W-Wait!\Is there something else?\I told you, it's really important!\When your garbage is picked up, you lose all rights to it.\Goodbye.\Wait, I said... response:	Um, uh... I know!
context: Goodbye.\W-Wait!\Is there something else?\I told you, it's really important!\When your garbage is picked up, you lose all rights to it.\Goodbye.\Wait, I said...\Um, uh... I know! response:	It's important evidence.
context: W-Wait!\Is there something else?\I told you, it's really important!\When your garbage is picked up, you lose all rights to it.\Goodbye.\Wait, I said...\Um, uh... I know!\It's important evidence. response:	I'm Cecil Epps, with the San-Teresa Metropolitan Police.
context: Is there something else?\I told you, it's really important!\When your garbage is picked up, you lose all rights to it.\Goodbye.\Wait, I said...\Um, uh... I know!\It's important evidence.\I'm Cecil Epps, with the San-Teresa Metropolitan Police. response:	I'm a deputy coroner.
context: I told you, it's really important!\When your garbage is picked up, you lose all rights to it.\Goodbye.\Wait, I said...\Um, uh... I know!\It's important evidence.\I'm Cecil Epps, with the San-Teresa Metropolitan Police.\I'm a deputy coroner. response:	Um... if this evidence is lost, th-the investigation will...
context: When your garbage is picked up, you lose all rights to it.\Goodbye.\Wait, I said...\Um, uh... I know!\It's important evidence.\I'm Cecil Epps, with the San-Teresa Metropolitan Police.\I'm a deputy coroner.\Um... if this evidence is lost, th-the investigation will... response:	Um... something really bad will happen to it! So cooperate with the police investigation!
context: Goodbye.\Wait, I said...\Um, uh... I know!\It's important evidence.\I'm Cecil Epps, with the San-Teresa Metropolitan Police.\I'm a deputy coroner.\Um... if this evidence is lost, th-the investigation will...\Um... something really bad will happen to it! So cooperate with the police investigation! response:	Please, grant me mercy!
context: Wait, I said...\Um, uh... I know!\It's important evidence.\I'm Cecil Epps, with the San-Teresa Metropolitan Police.\I'm a deputy coroner.\Um... if this evidence is lost, th-the investigation will...\Um... something really bad will happen to it! So cooperate with the police investigation!\Please, grant me mercy! response:	Grant me salvation!
context: Um, uh... I know!\It's important evidence.\I'm Cecil Epps, with the San-Teresa Metropolitan Police.\I'm a deputy coroner.\Um... if this evidence is lost, th-the investigation will...\Um... something really bad will happen to it! So cooperate with the police investigation!\Please, grant me mercy!\Grant me salvation! response:	O'Neill, I came here to ask you something!
context: It's important evidence.\I'm Cecil Epps, with the San-Teresa Metropolitan Police.\I'm a deputy coroner.\Um... if this evidence is lost, th-the investigation will...\Um... something really bad will happen to it! So cooperate with the police investigation!\Please, grant me mercy!\Grant me salvation!\O'Neill, I came here to ask you something! response:	Look at this. It's the tip you gave me.
context: I'm Cecil Epps, with the San-Teresa Metropolitan Police.\I'm a deputy coroner.\Um... if this evidence is lost, th-the investigation will...\Um... something really bad will happen to it! So cooperate with the police investigation!\Please, grant me mercy!\Grant me salvation!\O'Neill, I came here to ask you something!\Look at this. It's the tip you gave me. response:	I need to know more about the guy you said is working with the smuggler...
context: I'm a deputy coroner.\Um... if this evidence is lost, th-the investigation will...\Um... something really bad will happen to it! So cooperate with the police investigation!\Please, grant me mercy!\Grant me salvation!\O'Neill, I came here to ask you something!\Look at this. It's the tip you gave me.\I need to know more about the guy you said is working with the smuggler... response:	The patient is in pain. Stop it.
context: Um... if this evidence is lost, th-the investigation will...\Um... something really bad will happen to it! So cooperate with the police investigation!\Please, grant me mercy!\Grant me salvation!\O'Neill, I came here to ask you something!\Look at this. It's the tip you gave me.\I need to know more about the guy you said is working with the smuggler...\The patient is in pain. Stop it. response:	It's just a hangover.
context: Um... something really bad will happen to it! So cooperate with the police investigation!\Please, grant me mercy!\Grant me salvation!\O'Neill, I came here to ask you something!\Look at this. It's the tip you gave me.\I need to know more about the guy you said is working with the smuggler...\The patient is in pain. Stop it.\It's just a hangover. response:	Hey! Look at this!
context: Please, grant me mercy!\Grant me salvation!\O'Neill, I came here to ask you something!\Look at this. It's the tip you gave me.\I need to know more about the guy you said is working with the smuggler...\The patient is in pain. Stop it.\It's just a hangover.\Hey! Look at this! response:	Is this the guy who you saw with the smuggler?
context: Grant me salvation!\O'Neill, I came here to ask you something!\Look at this. It's the tip you gave me.\I need to know more about the guy you said is working with the smuggler...\The patient is in pain. Stop it.\It's just a hangover.\Hey! Look at this!\Is this the guy who you saw with the smuggler? response:	If I tell you, will I be able to go to heaven?
context: O'Neill, I came here to ask you something!\Look at this. It's the tip you gave me.\I need to know more about the guy you said is working with the smuggler...\The patient is in pain. Stop it.\It's just a hangover.\Hey! Look at this!\Is this the guy who you saw with the smuggler?\If I tell you, will I be able to go to heaven? response:	In first class?
context: Look at this. It's the tip you gave me.\I need to know more about the guy you said is working with the smuggler...\The patient is in pain. Stop it.\It's just a hangover.\Hey! Look at this!\Is this the guy who you saw with the smuggler?\If I tell you, will I be able to go to heaven?\In first class? response:	Yeah. With all the expensive wine and cognac you can drink!
context: I need to know more about the guy you said is working with the smuggler...\The patient is in pain. Stop it.\It's just a hangover.\Hey! Look at this!\Is this the guy who you saw with the smuggler?\If I tell you, will I be able to go to heaven?\In first class?\Yeah. With all the expensive wine and cognac you can drink! response:	I never want to drink another drop of alcohol!
context: The patient is in pain. Stop it.\It's just a hangover.\Hey! Look at this!\Is this the guy who you saw with the smuggler?\If I tell you, will I be able to go to heaven?\In first class?\Yeah. With all the expensive wine and cognac you can drink!\I never want to drink another drop of alcohol! response:	Answer me, you hungover asshole!
context: It's just a hangover.\Hey! Look at this!\Is this the guy who you saw with the smuggler?\If I tell you, will I be able to go to heaven?\In first class?\Yeah. With all the expensive wine and cognac you can drink!\I never want to drink another drop of alcohol!\Answer me, you hungover asshole! response:	Detective!
context: Hey! Look at this!\Is this the guy who you saw with the smuggler?\If I tell you, will I be able to go to heaven?\In first class?\Yeah. With all the expensive wine and cognac you can drink!\I never want to drink another drop of alcohol!\Answer me, you hungover asshole!\Detective! response:	He's hyperventilating!
context: Is this the guy who you saw with the smuggler?\If I tell you, will I be able to go to heaven?\In first class?\Yeah. With all the expensive wine and cognac you can drink!\I never want to drink another drop of alcohol!\Answer me, you hungover asshole!\Detective!\He's hyperventilating! response:	Mr. O'Neill!
context: If I tell you, will I be able to go to heaven?\In first class?\Yeah. With all the expensive wine and cognac you can drink!\I never want to drink another drop of alcohol!\Answer me, you hungover asshole!\Detective!\He's hyperventilating!\Mr. O'Neill! response:	Calm down, Mr. O'Neill! Everything will be fine!
context: In first class?\Yeah. With all the expensive wine and cognac you can drink!\I never want to drink another drop of alcohol!\Answer me, you hungover asshole!\Detective!\He's hyperventilating!\Mr. O'Neill!\Calm down, Mr. O'Neill! Everything will be fine! response:	Shit.
context: Yeah. With all the expensive wine and cognac you can drink!\I never want to drink another drop of alcohol!\Answer me, you hungover asshole!\Detective!\He's hyperventilating!\Mr. O'Neill!\Calm down, Mr. O'Neill! Everything will be fine!\Shit. response:	He's gone.
context: I never want to drink another drop of alcohol!\Answer me, you hungover asshole!\Detective!\He's hyperventilating!\Mr. O'Neill!\Calm down, Mr. O'Neill! Everything will be fine!\Shit.\He's gone. response:	Kenny, do you know the girl O'Neill went on a date with a few days ago?
context: Answer me, you hungover asshole!\Detective!\He's hyperventilating!\Mr. O'Neill!\Calm down, Mr. O'Neill! Everything will be fine!\Shit.\He's gone.\Kenny, do you know the girl O'Neill went on a date with a few days ago? response:	She may have seen the smuggler.
context: Detective!\He's hyperventilating!\Mr. O'Neill!\Calm down, Mr. O'Neill! Everything will be fine!\Shit.\He's gone.\Kenny, do you know the girl O'Neill went on a date with a few days ago?\She may have seen the smuggler. response:	That would be the SM queen you just saw.
context: He's hyperventilating!\Mr. O'Neill!\Calm down, Mr. O'Neill! Everything will be fine!\Shit.\He's gone.\Kenny, do you know the girl O'Neill went on a date with a few days ago?\She may have seen the smuggler.\That would be the SM queen you just saw. response:	The one in the kitchen.
context: Mr. O'Neill!\Calm down, Mr. O'Neill! Everything will be fine!\Shit.\He's gone.\Kenny, do you know the girl O'Neill went on a date with a few days ago?\She may have seen the smuggler.\That would be the SM queen you just saw.\The one in the kitchen. response:	She had her head stuck in the fridge, right?
context: Calm down, Mr. O'Neill! Everything will be fine!\Shit.\He's gone.\Kenny, do you know the girl O'Neill went on a date with a few days ago?\She may have seen the smuggler.\That would be the SM queen you just saw.\The one in the kitchen.\She had her head stuck in the fridge, right? response:	Did she?
context: Shit.\He's gone.\Kenny, do you know the girl O'Neill went on a date with a few days ago?\She may have seen the smuggler.\That would be the SM queen you just saw.\The one in the kitchen.\She had her head stuck in the fridge, right?\Did she? response:	My name is Cecil Epps.
context: He's gone.\Kenny, do you know the girl O'Neill went on a date with a few days ago?\She may have seen the smuggler.\That would be the SM queen you just saw.\The one in the kitchen.\She had her head stuck in the fridge, right?\Did she?\My name is Cecil Epps. response:	Well, it looks real to me.
context: Kenny, do you know the girl O'Neill went on a date with a few days ago?\She may have seen the smuggler.\That would be the SM queen you just saw.\The one in the kitchen.\She had her head stuck in the fridge, right?\Did she?\My name is Cecil Epps.\Well, it looks real to me. response:	Not that I've never seen one.
context: She may have seen the smuggler.\That would be the SM queen you just saw.\The one in the kitchen.\She had her head stuck in the fridge, right?\Did she?\My name is Cecil Epps.\Well, it looks real to me.\Not that I've never seen one. response:	So, what's your address, Miss Epps?
context: That would be the SM queen you just saw.\The one in the kitchen.\She had her head stuck in the fridge, right?\Did she?\My name is Cecil Epps.\Well, it looks real to me.\Not that I've never seen one.\So, what's your address, Miss Epps? response:	172 Caster Street.
context: The one in the kitchen.\She had her head stuck in the fridge, right?\Did she?\My name is Cecil Epps.\Well, it looks real to me.\Not that I've never seen one.\So, what's your address, Miss Epps?\172 Caster Street. response:	Hunter Waste Management handles that area, so...
context: She had her head stuck in the fridge, right?\Did she?\My name is Cecil Epps.\Well, it looks real to me.\Not that I've never seen one.\So, what's your address, Miss Epps?\172 Caster Street.\Hunter Waste Management handles that area, so... response:	It's truck number 3. Right over there.
context: Did she?\My name is Cecil Epps.\Well, it looks real to me.\Not that I've never seen one.\So, what's your address, Miss Epps?\172 Caster Street.\Hunter Waste Management handles that area, so...\It's truck number 3. Right over there. response:	In front of the WCT.
context: My name is Cecil Epps.\Well, it looks real to me.\Not that I've never seen one.\So, what's your address, Miss Epps?\172 Caster Street.\Hunter Waste Management handles that area, so...\It's truck number 3. Right over there.\In front of the WCT. response:	WCT?
context: Well, it looks real to me.\Not that I've never seen one.\So, what's your address, Miss Epps?\172 Caster Street.\Hunter Waste Management handles that area, so...\It's truck number 3. Right over there.\In front of the WCT.\WCT? response:	The waste disposal terminal.
context: Not that I've never seen one.\So, what's your address, Miss Epps?\172 Caster Street.\Hunter Waste Management handles that area, so...\It's truck number 3. Right over there.\In front of the WCT.\WCT?\The waste disposal terminal. response:	Everything we collect is dumped in there.
context: So, what's your address, Miss Epps?\172 Caster Street.\Hunter Waste Management handles that area, so...\It's truck number 3. Right over there.\In front of the WCT.\WCT?\The waste disposal terminal.\Everything we collect is dumped in there. response:	Oh, no!
context: 172 Caster Street.\Hunter Waste Management handles that area, so...\It's truck number 3. Right over there.\In front of the WCT.\WCT?\The waste disposal terminal.\Everything we collect is dumped in there.\Oh, no! response:	Wait! Stop! Stop!
context: Hunter Waste Management handles that area, so...\It's truck number 3. Right over there.\In front of the WCT.\WCT?\The waste disposal terminal.\Everything we collect is dumped in there.\Oh, no!\Wait! Stop! Stop! response:	Stop it! Stop it!
context: It's truck number 3. Right over there.\In front of the WCT.\WCT?\The waste disposal terminal.\Everything we collect is dumped in there.\Oh, no!\Wait! Stop! Stop!\Stop it! Stop it! response:	What?
context: In front of the WCT.\WCT?\The waste disposal terminal.\Everything we collect is dumped in there.\Oh, no!\Wait! Stop! Stop!\Stop it! Stop it!\What? response:	Oh, jeez!
context: WCT?\The waste disposal terminal.\Everything we collect is dumped in there.\Oh, no!\Wait! Stop! Stop!\Stop it! Stop it!\What?\Oh, jeez! response:	Tilarna?
context: The waste disposal terminal.\Everything we collect is dumped in there.\Oh, no!\Wait! Stop! Stop!\Stop it! Stop it!\What?\Oh, jeez!\Tilarna? response:	Chief, it's me. Matoba.
context: Everything we collect is dumped in there.\Oh, no!\Wait! Stop! Stop!\Stop it! Stop it!\What?\Oh, jeez!\Tilarna?\Chief, it's me. Matoba. response:	About Hellmandes with the CBP...
context: Oh, no!\Wait! Stop! Stop!\Stop it! Stop it!\What?\Oh, jeez!\Tilarna?\Chief, it's me. Matoba.\About Hellmandes with the CBP... response:	I just got another call from the man.
context: Wait! Stop! Stop!\Stop it! Stop it!\What?\Oh, jeez!\Tilarna?\Chief, it's me. Matoba.\About Hellmandes with the CBP...\I just got another call from the man. response:	So you did get in a fight with him.
context: Stop it! Stop it!\What?\Oh, jeez!\Tilarna?\Chief, it's me. Matoba.\About Hellmandes with the CBP...\I just got another call from the man.\So you did get in a fight with him. response:	Just now?
context: What?\Oh, jeez!\Tilarna?\Chief, it's me. Matoba.\About Hellmandes with the CBP...\I just got another call from the man.\So you did get in a fight with him.\Just now? response:	Something about you not picking up the phone, and whether or not you were at home.
context: Oh, jeez!\Tilarna?\Chief, it's me. Matoba.\About Hellmandes with the CBP...\I just got another call from the man.\So you did get in a fight with him.\Just now?\Something about you not picking up the phone, and whether or not you were at home. response:	Hey, are you listening, Matoba?
context: Tilarna?\Chief, it's me. Matoba.\About Hellmandes with the CBP...\I just got another call from the man.\So you did get in a fight with him.\Just now?\Something about you not picking up the phone, and whether or not you were at home.\Hey, are you listening, Matoba? response:	Which means...
context: Chief, it's me. Matoba.\About Hellmandes with the CBP...\I just got another call from the man.\So you did get in a fight with him.\Just now?\Something about you not picking up the phone, and whether or not you were at home.\Hey, are you listening, Matoba?\Which means... response:	Sorry, Chief! I'll call you back!
context: About Hellmandes with the CBP...\I just got another call from the man.\So you did get in a fight with him.\Just now?\Something about you not picking up the phone, and whether or not you were at home.\Hey, are you listening, Matoba?\Which means...\Sorry, Chief! I'll call you back! response:	Cecil?
context: I just got another call from the man.\So you did get in a fight with him.\Just now?\Something about you not picking up the phone, and whether or not you were at home.\Hey, are you listening, Matoba?\Which means...\Sorry, Chief! I'll call you back!\Cecil? response:	I'm sorry, Kei...
context: So you did get in a fight with him.\Just now?\Something about you not picking up the phone, and whether or not you were at home.\Hey, are you listening, Matoba?\Which means...\Sorry, Chief! I'll call you back!\Cecil?\I'm sorry, Kei... response:	We need to talk about Tilarna...
context: Just now?\Something about you not picking up the phone, and whether or not you were at home.\Hey, are you listening, Matoba?\Which means...\Sorry, Chief! I'll call you back!\Cecil?\I'm sorry, Kei...\We need to talk about Tilarna... response:	What happened?
context: Something about you not picking up the phone, and whether or not you were at home.\Hey, are you listening, Matoba?\Which means...\Sorry, Chief! I'll call you back!\Cecil?\I'm sorry, Kei...\We need to talk about Tilarna...\What happened? response:	So Tilarna and Kuroi switched bodies?
context: Hey, are you listening, Matoba?\Which means...\Sorry, Chief! I'll call you back!\Cecil?\I'm sorry, Kei...\We need to talk about Tilarna...\What happened?\So Tilarna and Kuroi switched bodies? response:	Okay. Magic, huh? I believe it.
context: Which means...\Sorry, Chief! I'll call you back!\Cecil?\I'm sorry, Kei...\We need to talk about Tilarna...\What happened?\So Tilarna and Kuroi switched bodies?\Okay. Magic, huh? I believe it. response:	So right now it's Tilarna, or rather Kuroi, who's at my house?
context: Sorry, Chief! I'll call you back!\Cecil?\I'm sorry, Kei...\We need to talk about Tilarna...\What happened?\So Tilarna and Kuroi switched bodies?\Okay. Magic, huh? I believe it.\So right now it's Tilarna, or rather Kuroi, who's at my house? response:	-That's dangerous. -Dangerous?
context: Cecil?\I'm sorry, Kei...\We need to talk about Tilarna...\What happened?\So Tilarna and Kuroi switched bodies?\Okay. Magic, huh? I believe it.\So right now it's Tilarna, or rather Kuroi, who's at my house?\-That's dangerous. -Dangerous? response:	I need to hurry. Cecil, I'll call you back.
context: I'm sorry, Kei...\We need to talk about Tilarna...\What happened?\So Tilarna and Kuroi switched bodies?\Okay. Magic, huh? I believe it.\So right now it's Tilarna, or rather Kuroi, who's at my house?\-That's dangerous. -Dangerous?\I need to hurry. Cecil, I'll call you back. response:	Wait, Kei!
context: We need to talk about Tilarna...\What happened?\So Tilarna and Kuroi switched bodies?\Okay. Magic, huh? I believe it.\So right now it's Tilarna, or rather Kuroi, who's at my house?\-That's dangerous. -Dangerous?\I need to hurry. Cecil, I'll call you back.\Wait, Kei! response:	Kuroi's body, here at the dump, is...
context: What happened?\So Tilarna and Kuroi switched bodies?\Okay. Magic, huh? I believe it.\So right now it's Tilarna, or rather Kuroi, who's at my house?\-That's dangerous. -Dangerous?\I need to hurry. Cecil, I'll call you back.\Wait, Kei!\Kuroi's body, here at the dump, is... response:	I tried to stop her, but...
context: So Tilarna and Kuroi switched bodies?\Okay. Magic, huh? I believe it.\So right now it's Tilarna, or rather Kuroi, who's at my house?\-That's dangerous. -Dangerous?\I need to hurry. Cecil, I'll call you back.\Wait, Kei!\Kuroi's body, here at the dump, is...\I tried to stop her, but... response:	Don't worry about that.
context: Okay. Magic, huh? I believe it.\So right now it's Tilarna, or rather Kuroi, who's at my house?\-That's dangerous. -Dangerous?\I need to hurry. Cecil, I'll call you back.\Wait, Kei!\Kuroi's body, here at the dump, is...\I tried to stop her, but...\Don't worry about that. response:	It's Tilarna, right? So I'm sure she's fine.
context: So right now it's Tilarna, or rather Kuroi, who's at my house?\-That's dangerous. -Dangerous?\I need to hurry. Cecil, I'll call you back.\Wait, Kei!\Kuroi's body, here at the dump, is...\I tried to stop her, but...\Don't worry about that.\It's Tilarna, right? So I'm sure she's fine. response:	Bye.
context: -That's dangerous. -Dangerous?\I need to hurry. Cecil, I'll call you back.\Wait, Kei!\Kuroi's body, here at the dump, is...\I tried to stop her, but...\Don't worry about that.\It's Tilarna, right? So I'm sure she's fine.\Bye. response:	I found it. There's the cat!
context: I need to hurry. Cecil, I'll call you back.\Wait, Kei!\Kuroi's body, here at the dump, is...\I tried to stop her, but...\Don't worry about that.\It's Tilarna, right? So I'm sure she's fine.\Bye.\I found it. There's the cat! response:	Tilarna!
context: Wait, Kei!\Kuroi's body, here at the dump, is...\I tried to stop her, but...\Don't worry about that.\It's Tilarna, right? So I'm sure she's fine.\Bye.\I found it. There's the cat!\Tilarna! response:	Smell it. The smell of latena.
context: Kuroi's body, here at the dump, is...\I tried to stop her, but...\Don't worry about that.\It's Tilarna, right? So I'm sure she's fine.\Bye.\I found it. There's the cat!\Tilarna!\Smell it. The smell of latena. response:	Don't use your nose. Use your heart.
context: I tried to stop her, but...\Don't worry about that.\It's Tilarna, right? So I'm sure she's fine.\Bye.\I found it. There's the cat!\Tilarna!\Smell it. The smell of latena.\Don't use your nose. Use your heart. response:	There it is!
context: Don't worry about that.\It's Tilarna, right? So I'm sure she's fine.\Bye.\I found it. There's the cat!\Tilarna!\Smell it. The smell of latena.\Don't use your nose. Use your heart.\There it is! response:	It's over...
context: It's Tilarna, right? So I'm sure she's fine.\Bye.\I found it. There's the cat!\Tilarna!\Smell it. The smell of latena.\Don't use your nose. Use your heart.\There it is!\It's over... response:	Damn it...
context: Bye.\I found it. There's the cat!\Tilarna!\Smell it. The smell of latena.\Don't use your nose. Use your heart.\There it is!\It's over...\Damn it... response:	Give me the damn crossbow!
context: I found it. There's the cat!\Tilarna!\Smell it. The smell of latena.\Don't use your nose. Use your heart.\There it is!\It's over...\Damn it...\Give me the damn crossbow! response:	My life is on the line here!
context: Tilarna!\Smell it. The smell of latena.\Don't use your nose. Use your heart.\There it is!\It's over...\Damn it...\Give me the damn crossbow!\My life is on the line here! response:	This is...
context: Smell it. The smell of latena.\Don't use your nose. Use your heart.\There it is!\It's over...\Damn it...\Give me the damn crossbow!\My life is on the line here!\This is... response:	Thank you, God!
context: Don't use your nose. Use your heart.\There it is!\It's over...\Damn it...\Give me the damn crossbow!\My life is on the line here!\This is...\Thank you, God! response:	Thank you, God! Thank you, God!
context: There it is!\It's over...\Damn it...\Give me the damn crossbow!\My life is on the line here!\This is...\Thank you, God!\Thank you, God! Thank you, God! response:	You can't get out of this by pretending you're crazy-
context: It's over...\Damn it...\Give me the damn crossbow!\My life is on the line here!\This is...\Thank you, God!\Thank you, God! Thank you, God!\You can't get out of this by pretending you're crazy- response:	Don't touch me.
context: Damn it...\Give me the damn crossbow!\My life is on the line here!\This is...\Thank you, God!\Thank you, God! Thank you, God!\You can't get out of this by pretending you're crazy-\Don't touch me. response:	What?
context: Give me the damn crossbow!\My life is on the line here!\This is...\Thank you, God!\Thank you, God! Thank you, God!\You can't get out of this by pretending you're crazy-\Don't touch me.\What? response:	You saw, didn't you?
context: My life is on the line here!\This is...\Thank you, God!\Thank you, God! Thank you, God!\You can't get out of this by pretending you're crazy-\Don't touch me.\What?\You saw, didn't you? response:	Saw what?
context: This is...\Thank you, God!\Thank you, God! Thank you, God!\You can't get out of this by pretending you're crazy-\Don't touch me.\What?\You saw, didn't you?\Saw what? response:	I don't know what's going on here, but you're in for a world of pain!
context: Thank you, God!\Thank you, God! Thank you, God!\You can't get out of this by pretending you're crazy-\Don't touch me.\What?\You saw, didn't you?\Saw what?\I don't know what's going on here, but you're in for a world of pain! response:	-D-Don't hurt me! -Shut up!
context: Thank you, God! Thank you, God!\You can't get out of this by pretending you're crazy-\Don't touch me.\What?\You saw, didn't you?\Saw what?\I don't know what's going on here, but you're in for a world of pain!\-D-Don't hurt me! -Shut up! response:	-I just wanted to make some money... -I don't care!
context: You can't get out of this by pretending you're crazy-\Don't touch me.\What?\You saw, didn't you?\Saw what?\I don't know what's going on here, but you're in for a world of pain!\-D-Don't hurt me! -Shut up!\-I just wanted to make some money... -I don't care! response:	Mercy!
context: Don't touch me.\What?\You saw, didn't you?\Saw what?\I don't know what's going on here, but you're in for a world of pain!\-D-Don't hurt me! -Shut up!\-I just wanted to make some money... -I don't care!\Mercy! response:	No mercy!
context: What?\You saw, didn't you?\Saw what?\I don't know what's going on here, but you're in for a world of pain!\-D-Don't hurt me! -Shut up!\-I just wanted to make some money... -I don't care!\Mercy!\No mercy! response:	Please don't...
context: You saw, didn't you?\Saw what?\I don't know what's going on here, but you're in for a world of pain!\-D-Don't hurt me! -Shut up!\-I just wanted to make some money... -I don't care!\Mercy!\No mercy!\Please don't... response:	You're going to die like a bug, with no dignity at all...
context: Saw what?\I don't know what's going on here, but you're in for a world of pain!\-D-Don't hurt me! -Shut up!\-I just wanted to make some money... -I don't care!\Mercy!\No mercy!\Please don't...\You're going to die like a bug, with no dignity at all... response:	Curses of Beyadah upon you!
context: I don't know what's going on here, but you're in for a world of pain!\-D-Don't hurt me! -Shut up!\-I just wanted to make some money... -I don't care!\Mercy!\No mercy!\Please don't...\You're going to die like a bug, with no dignity at all...\Curses of Beyadah upon you! response:	Hey, don't kill him!
context: -D-Don't hurt me! -Shut up!\-I just wanted to make some money... -I don't care!\Mercy!\No mercy!\Please don't...\You're going to die like a bug, with no dignity at all...\Curses of Beyadah upon you!\Hey, don't kill him! response:	That's you, right, Tilarna?
context: -I just wanted to make some money... -I don't care!\Mercy!\No mercy!\Please don't...\You're going to die like a bug, with no dignity at all...\Curses of Beyadah upon you!\Hey, don't kill him!\That's you, right, Tilarna? response:	You're back?
context: Mercy!\No mercy!\Please don't...\You're going to die like a bug, with no dignity at all...\Curses of Beyadah upon you!\Hey, don't kill him!\That's you, right, Tilarna?\You're back? response:	Kei?
context: No mercy!\Please don't...\You're going to die like a bug, with no dignity at all...\Curses of Beyadah upon you!\Hey, don't kill him!\That's you, right, Tilarna?\You're back?\Kei? response:	My life... my life...
context: Please don't...\You're going to die like a bug, with no dignity at all...\Curses of Beyadah upon you!\Hey, don't kill him!\That's you, right, Tilarna?\You're back?\Kei?\My life... my life... response:	What a mess.
context: You're going to die like a bug, with no dignity at all...\Curses of Beyadah upon you!\Hey, don't kill him!\That's you, right, Tilarna?\You're back?\Kei?\My life... my life...\What a mess. response:	Clean this up.
context: Curses of Beyadah upon you!\Hey, don't kill him!\That's you, right, Tilarna?\You're back?\Kei?\My life... my life...\What a mess.\Clean this up. response:	That weird crossbow only activated because you were careless, right?
context: Hey, don't kill him!\That's you, right, Tilarna?\You're back?\Kei?\My life... my life...\What a mess.\Clean this up.\That weird crossbow only activated because you were careless, right? response:	Shut up!
context: That's you, right, Tilarna?\You're back?\Kei?\My life... my life...\What a mess.\Clean this up.\That weird crossbow only activated because you were careless, right?\Shut up! response:	What's wrong with you?
context: You're back?\Kei?\My life... my life...\What a mess.\Clean this up.\That weird crossbow only activated because you were careless, right?\Shut up!\What's wrong with you? response:	This morning I was trying my best to get your help,
context: Kei?\My life... my life...\What a mess.\Clean this up.\That weird crossbow only activated because you were careless, right?\Shut up!\What's wrong with you?\This morning I was trying my best to get your help, response:	and you left without figuring out a thing!
context: My life... my life...\What a mess.\Clean this up.\That weird crossbow only activated because you were careless, right?\Shut up!\What's wrong with you?\This morning I was trying my best to get your help,\and you left without figuring out a thing! response:	How was I supposed to know you'd swapped bodies with Kuroi?
context: What a mess.\Clean this up.\That weird crossbow only activated because you were careless, right?\Shut up!\What's wrong with you?\This morning I was trying my best to get your help,\and you left without figuring out a thing!\How was I supposed to know you'd swapped bodies with Kuroi? response:	B-But...
context: Clean this up.\That weird crossbow only activated because you were careless, right?\Shut up!\What's wrong with you?\This morning I was trying my best to get your help,\and you left without figuring out a thing!\How was I supposed to know you'd swapped bodies with Kuroi?\B-But... response:	Having you all over me dressed like that first thing in the morning was freaking me out.
context: That weird crossbow only activated because you were careless, right?\Shut up!\What's wrong with you?\This morning I was trying my best to get your help,\and you left without figuring out a thing!\How was I supposed to know you'd swapped bodies with Kuroi?\B-But...\Having you all over me dressed like that first thing in the morning was freaking me out. response:	I wanted to get out of there.
context: Shut up!\What's wrong with you?\This morning I was trying my best to get your help,\and you left without figuring out a thing!\How was I supposed to know you'd swapped bodies with Kuroi?\B-But...\Having you all over me dressed like that first thing in the morning was freaking me out.\I wanted to get out of there. response:	It was freaking you out?
context: What's wrong with you?\This morning I was trying my best to get your help,\and you left without figuring out a thing!\How was I supposed to know you'd swapped bodies with Kuroi?\B-But...\Having you all over me dressed like that first thing in the morning was freaking me out.\I wanted to get out of there.\It was freaking you out? response:	Huh?
context: This morning I was trying my best to get your help,\and you left without figuring out a thing!\How was I supposed to know you'd swapped bodies with Kuroi?\B-But...\Having you all over me dressed like that first thing in the morning was freaking me out.\I wanted to get out of there.\It was freaking you out?\Huh? response:	No, nothing...
context: and you left without figuring out a thing!\How was I supposed to know you'd swapped bodies with Kuroi?\B-But...\Having you all over me dressed like that first thing in the morning was freaking me out.\I wanted to get out of there.\It was freaking you out?\Huh?\No, nothing... response:	So what happened to the crossbow?
context: How was I supposed to know you'd swapped bodies with Kuroi?\B-But...\Having you all over me dressed like that first thing in the morning was freaking me out.\I wanted to get out of there.\It was freaking you out?\Huh?\No, nothing...\So what happened to the crossbow? response:	It was destroyed. That's why I was able to go back, I think.
context: B-But...\Having you all over me dressed like that first thing in the morning was freaking me out.\I wanted to get out of there.\It was freaking you out?\Huh?\No, nothing...\So what happened to the crossbow?\It was destroyed. That's why I was able to go back, I think. response:	There's no way to know now, though.
context: Having you all over me dressed like that first thing in the morning was freaking me out.\I wanted to get out of there.\It was freaking you out?\Huh?\No, nothing...\So what happened to the crossbow?\It was destroyed. That's why I was able to go back, I think.\There's no way to know now, though. response:	I guess that's just how it goes.
context: I wanted to get out of there.\It was freaking you out?\Huh?\No, nothing...\So what happened to the crossbow?\It was destroyed. That's why I was able to go back, I think.\There's no way to know now, though.\I guess that's just how it goes. response:	I need to get better control of myself.
context: It was freaking you out?\Huh?\No, nothing...\So what happened to the crossbow?\It was destroyed. That's why I was able to go back, I think.\There's no way to know now, though.\I guess that's just how it goes.\I need to get better control of myself. response:	And thanks to you, I didn't even get to kill that man.
context: Huh?\No, nothing...\So what happened to the crossbow?\It was destroyed. That's why I was able to go back, I think.\There's no way to know now, though.\I guess that's just how it goes.\I need to get better control of myself.\And thanks to you, I didn't even get to kill that man. response:	If you did, it would be mur-
context: No, nothing...\So what happened to the crossbow?\It was destroyed. That's why I was able to go back, I think.\There's no way to know now, though.\I guess that's just how it goes.\I need to get better control of myself.\And thanks to you, I didn't even get to kill that man.\If you did, it would be mur- response:	Wait...
context: So what happened to the crossbow?\It was destroyed. That's why I was able to go back, I think.\There's no way to know now, though.\I guess that's just how it goes.\I need to get better control of myself.\And thanks to you, I didn't even get to kill that man.\If you did, it would be mur-\Wait... response:	Did he do something to you?
context: It was destroyed. That's why I was able to go back, I think.\There's no way to know now, though.\I guess that's just how it goes.\I need to get better control of myself.\And thanks to you, I didn't even get to kill that man.\If you did, it would be mur-\Wait...\Did he do something to you? response:	No! He definitely did not! Not a chance!
context: There's no way to know now, though.\I guess that's just how it goes.\I need to get better control of myself.\And thanks to you, I didn't even get to kill that man.\If you did, it would be mur-\Wait...\Did he do something to you?\No! He definitely did not! Not a chance! response:	He just saw me!
context: I guess that's just how it goes.\I need to get better control of myself.\And thanks to you, I didn't even get to kill that man.\If you did, it would be mur-\Wait...\Did he do something to you?\No! He definitely did not! Not a chance!\He just saw me! response:	Saw you?
context: I need to get better control of myself.\And thanks to you, I didn't even get to kill that man.\If you did, it would be mur-\Wait...\Did he do something to you?\No! He definitely did not! Not a chance!\He just saw me!\Saw you? response:	I-It's very important...
context: And thanks to you, I didn't even get to kill that man.\If you did, it would be mur-\Wait...\Did he do something to you?\No! He definitely did not! Not a chance!\He just saw me!\Saw you?\I-It's very important... response:	What a pain.
context: If you did, it would be mur-\Wait...\Did he do something to you?\No! He definitely did not! Not a chance!\He just saw me!\Saw you?\I-It's very important...\What a pain. response:	What's a pain?
context: Wait...\Did he do something to you?\No! He definitely did not! Not a chance!\He just saw me!\Saw you?\I-It's very important...\What a pain.\What's a pain? response:	Aren't you mad?
context: Did he do something to you?\No! He definitely did not! Not a chance!\He just saw me!\Saw you?\I-It's very important...\What a pain.\What's a pain?\Aren't you mad? response:	He saw my butt...
context: No! He definitely did not! Not a chance!\He just saw me!\Saw you?\I-It's very important...\What a pain.\What's a pain?\Aren't you mad?\He saw my butt... response:	No... Anyway, you should be madder!
context: He just saw me!\Saw you?\I-It's very important...\What a pain.\What's a pain?\Aren't you mad?\He saw my butt...\No... Anyway, you should be madder! response:	Why would I?
context: Saw you?\I-It's very important...\What a pain.\What's a pain?\Aren't you mad?\He saw my butt...\No... Anyway, you should be madder!\Why would I? response:	Shut up! Get a little mad, you rakebye!
context: I-It's very important...\What a pain.\What's a pain?\Aren't you mad?\He saw my butt...\No... Anyway, you should be madder!\Why would I?\Shut up! Get a little mad, you rakebye! response:	Wait a second.
context: What a pain.\What's a pain?\Aren't you mad?\He saw my butt...\No... Anyway, you should be madder!\Why would I?\Shut up! Get a little mad, you rakebye!\Wait a second. response:	I think I forgot something.
context: What's a pain?\Aren't you mad?\He saw my butt...\No... Anyway, you should be madder!\Why would I?\Shut up! Get a little mad, you rakebye!\Wait a second.\I think I forgot something. response:	Don't try and change the subject-
context: Aren't you mad?\He saw my butt...\No... Anyway, you should be madder!\Why would I?\Shut up! Get a little mad, you rakebye!\Wait a second.\I think I forgot something.\Don't try and change the subject- response:	Where are Kuroi and Cecil?
context: He saw my butt...\No... Anyway, you should be madder!\Why would I?\Shut up! Get a little mad, you rakebye!\Wait a second.\I think I forgot something.\Don't try and change the subject-\Where are Kuroi and Cecil? response:	I'm sorry, Tilarna...
context: No... Anyway, you should be madder!\Why would I?\Shut up! Get a little mad, you rakebye!\Wait a second.\I think I forgot something.\Don't try and change the subject-\Where are Kuroi and Cecil?\I'm sorry, Tilarna... response:	I couldn't help you!
context: Why would I?\Shut up! Get a little mad, you rakebye!\Wait a second.\I think I forgot something.\Don't try and change the subject-\Where are Kuroi and Cecil?\I'm sorry, Tilarna...\I couldn't help you! response:	Tilarna!
context: Shut up! Get a little mad, you rakebye!\Wait a second.\I think I forgot something.\Don't try and change the subject-\Where are Kuroi and Cecil?\I'm sorry, Tilarna...\I couldn't help you!\Tilarna! response:	Tilarna, I'm sorry!
context: Wait a second.\I think I forgot something.\Don't try and change the subject-\Where are Kuroi and Cecil?\I'm sorry, Tilarna...\I couldn't help you!\Tilarna!\Tilarna, I'm sorry! response:	I couldn't help you!
context: I think I forgot something.\Don't try and change the subject-\Where are Kuroi and Cecil?\I'm sorry, Tilarna...\I couldn't help you!\Tilarna!\Tilarna, I'm sorry!\I couldn't help you! response:	I don't know what to say to you!
context: Don't try and change the subject-\Where are Kuroi and Cecil?\I'm sorry, Tilarna...\I couldn't help you!\Tilarna!\Tilarna, I'm sorry!\I couldn't help you!\I don't know what to say to you! response:	Fifteen years ago, a hyperspace gate appeared in the middle of the Pacific.
context: Where are Kuroi and Cecil?\I'm sorry, Tilarna...\I couldn't help you!\Tilarna!\Tilarna, I'm sorry!\I couldn't help you!\I don't know what to say to you!\Fifteen years ago, a hyperspace gate appeared in the middle of the Pacific. response:	Beyond the gate lay a strange world filled with fairies and monsters.
context: I'm sorry, Tilarna...\I couldn't help you!\Tilarna!\Tilarna, I'm sorry!\I couldn't help you!\I don't know what to say to you!\Fifteen years ago, a hyperspace gate appeared in the middle of the Pacific.\Beyond the gate lay a strange world filled with fairies and monsters. response:	Kariaena Island. The city of San-Teresa.
context: I couldn't help you!\Tilarna!\Tilarna, I'm sorry!\I couldn't help you!\I don't know what to say to you!\Fifteen years ago, a hyperspace gate appeared in the middle of the Pacific.\Beyond the gate lay a strange world filled with fairies and monsters.\Kariaena Island. The city of San-Teresa. response:	This city is Earth's front door.
context: Tilarna!\Tilarna, I'm sorry!\I couldn't help you!\I don't know what to say to you!\Fifteen years ago, a hyperspace gate appeared in the middle of the Pacific.\Beyond the gate lay a strange world filled with fairies and monsters.\Kariaena Island. The city of San-Teresa.\This city is Earth's front door. response:	Over two million citizens from both worlds live here.
context: Tilarna, I'm sorry!\I couldn't help you!\I don't know what to say to you!\Fifteen years ago, a hyperspace gate appeared in the middle of the Pacific.\Beyond the gate lay a strange world filled with fairies and monsters.\Kariaena Island. The city of San-Teresa.\This city is Earth's front door.\Over two million citizens from both worlds live here. response:	A mixture of different races and diverse cultures, haves and have-nots...
context: I couldn't help you!\I don't know what to say to you!\Fifteen years ago, a hyperspace gate appeared in the middle of the Pacific.\Beyond the gate lay a strange world filled with fairies and monsters.\Kariaena Island. The city of San-Teresa.\This city is Earth's front door.\Over two million citizens from both worlds live here.\A mixture of different races and diverse cultures, haves and have-nots... response:	The world's newest city of dreams.
context: I don't know what to say to you!\Fifteen years ago, a hyperspace gate appeared in the middle of the Pacific.\Beyond the gate lay a strange world filled with fairies and monsters.\Kariaena Island. The city of San-Teresa.\This city is Earth's front door.\Over two million citizens from both worlds live here.\A mixture of different races and diverse cultures, haves and have-nots...\The world's newest city of dreams. response:	But in the shadows of all this chaos lurked countless crimes.
context: Fifteen years ago, a hyperspace gate appeared in the middle of the Pacific.\Beyond the gate lay a strange world filled with fairies and monsters.\Kariaena Island. The city of San-Teresa.\This city is Earth's front door.\Over two million citizens from both worlds live here.\A mixture of different races and diverse cultures, haves and have-nots...\The world's newest city of dreams.\But in the shadows of all this chaos lurked countless crimes. response:	Drugs. Prostitution.
context: Beyond the gate lay a strange world filled with fairies and monsters.\Kariaena Island. The city of San-Teresa.\This city is Earth's front door.\Over two million citizens from both worlds live here.\A mixture of different races and diverse cultures, haves and have-nots...\The world's newest city of dreams.\But in the shadows of all this chaos lurked countless crimes.\Drugs. Prostitution. response:	Weapons smuggling.
context: Kariaena Island. The city of San-Teresa.\This city is Earth's front door.\Over two million citizens from both worlds live here.\A mixture of different races and diverse cultures, haves and have-nots...\The world's newest city of dreams.\But in the shadows of all this chaos lurked countless crimes.\Drugs. Prostitution.\Weapons smuggling. response:	The San-Teresa Metropolitan Police maintained
context: This city is Earth's front door.\Over two million citizens from both worlds live here.\A mixture of different races and diverse cultures, haves and have-nots...\The world's newest city of dreams.\But in the shadows of all this chaos lurked countless crimes.\Drugs. Prostitution.\Weapons smuggling.\The San-Teresa Metropolitan Police maintained response:	a special unit to deal with these crimes.
context: Over two million citizens from both worlds live here.\A mixture of different races and diverse cultures, haves and have-nots...\The world's newest city of dreams.\But in the shadows of all this chaos lurked countless crimes.\Drugs. Prostitution.\Weapons smuggling.\The San-Teresa Metropolitan Police maintained\a special unit to deal with these crimes. response:	I think you overcooked it.
context: A mixture of different races and diverse cultures, haves and have-nots...\The world's newest city of dreams.\But in the shadows of all this chaos lurked countless crimes.\Drugs. Prostitution.\Weapons smuggling.\The San-Teresa Metropolitan Police maintained\a special unit to deal with these crimes.\I think you overcooked it. response:	Matoba, are you insulting the Zimmer family recipe?
context: The world's newest city of dreams.\But in the shadows of all this chaos lurked countless crimes.\Drugs. Prostitution.\Weapons smuggling.\The San-Teresa Metropolitan Police maintained\a special unit to deal with these crimes.\I think you overcooked it.\Matoba, are you insulting the Zimmer family recipe? response:	You're just burning it.
context: But in the shadows of all this chaos lurked countless crimes.\Drugs. Prostitution.\Weapons smuggling.\The San-Teresa Metropolitan Police maintained\a special unit to deal with these crimes.\I think you overcooked it.\Matoba, are you insulting the Zimmer family recipe?\You're just burning it. response:	Put it on a tray, lower the heat, and close the grill.
context: Drugs. Prostitution.\Weapons smuggling.\The San-Teresa Metropolitan Police maintained\a special unit to deal with these crimes.\I think you overcooked it.\Matoba, are you insulting the Zimmer family recipe?\You're just burning it.\Put it on a tray, lower the heat, and close the grill. response:	You need to get that hot air flowing over it.
context: Weapons smuggling.\The San-Teresa Metropolitan Police maintained\a special unit to deal with these crimes.\I think you overcooked it.\Matoba, are you insulting the Zimmer family recipe?\You're just burning it.\Put it on a tray, lower the heat, and close the grill.\You need to get that hot air flowing over it. response:	The meat looked so good, too.
context: The San-Teresa Metropolitan Police maintained\a special unit to deal with these crimes.\I think you overcooked it.\Matoba, are you insulting the Zimmer family recipe?\You're just burning it.\Put it on a tray, lower the heat, and close the grill.\You need to get that hot air flowing over it.\The meat looked so good, too. response:	Shut up!
context: a special unit to deal with these crimes.\I think you overcooked it.\Matoba, are you insulting the Zimmer family recipe?\You're just burning it.\Put it on a tray, lower the heat, and close the grill.\You need to get that hot air flowing over it.\The meat looked so good, too.\Shut up! response:	Whenever you talk about food or cars, you get all obsessed...
context: I think you overcooked it.\Matoba, are you insulting the Zimmer family recipe?\You're just burning it.\Put it on a tray, lower the heat, and close the grill.\You need to get that hot air flowing over it.\The meat looked so good, too.\Shut up!\Whenever you talk about food or cars, you get all obsessed... response:	You sound like a food snob!
context: Matoba, are you insulting the Zimmer family recipe?\You're just burning it.\Put it on a tray, lower the heat, and close the grill.\You need to get that hot air flowing over it.\The meat looked so good, too.\Shut up!\Whenever you talk about food or cars, you get all obsessed...\You sound like a food snob! response:	I'm not a snob!
context: You're just burning it.\Put it on a tray, lower the heat, and close the grill.\You need to get that hot air flowing over it.\The meat looked so good, too.\Shut up!\Whenever you talk about food or cars, you get all obsessed...\You sound like a food snob!\I'm not a snob! response:	Every snob says that!
context: Put it on a tray, lower the heat, and close the grill.\You need to get that hot air flowing over it.\The meat looked so good, too.\Shut up!\Whenever you talk about food or cars, you get all obsessed...\You sound like a food snob!\I'm not a snob!\Every snob says that! response:	And anyway, this is my home.
context: You need to get that hot air flowing over it.\The meat looked so good, too.\Shut up!\Whenever you talk about food or cars, you get all obsessed...\You sound like a food snob!\I'm not a snob!\Every snob says that!\And anyway, this is my home. response:	This food is under my jurisdiction!
context: The meat looked so good, too.\Shut up!\Whenever you talk about food or cars, you get all obsessed...\You sound like a food snob!\I'm not a snob!\Every snob says that!\And anyway, this is my home.\This food is under my jurisdiction! response:	Now quit bitching, go to the kitchen, and get me a beer!
context: Shut up!\Whenever you talk about food or cars, you get all obsessed...\You sound like a food snob!\I'm not a snob!\Every snob says that!\And anyway, this is my home.\This food is under my jurisdiction!\Now quit bitching, go to the kitchen, and get me a beer! response:	I'm the one who brought the meat you're ruining, and it was expensive!
context: Whenever you talk about food or cars, you get all obsessed...\You sound like a food snob!\I'm not a snob!\Every snob says that!\And anyway, this is my home.\This food is under my jurisdiction!\Now quit bitching, go to the kitchen, and get me a beer!\I'm the one who brought the meat you're ruining, and it was expensive! response:	Kei, you want to join us? The water feels great!
context: You sound like a food snob!\I'm not a snob!\Every snob says that!\And anyway, this is my home.\This food is under my jurisdiction!\Now quit bitching, go to the kitchen, and get me a beer!\I'm the one who brought the meat you're ruining, and it was expensive!\Kei, you want to join us? The water feels great! response:	Later.
context: I'm not a snob!\Every snob says that!\And anyway, this is my home.\This food is under my jurisdiction!\Now quit bitching, go to the kitchen, and get me a beer!\I'm the one who brought the meat you're ruining, and it was expensive!\Kei, you want to join us? The water feels great!\Later. response:	That's a shame.
context: Every snob says that!\And anyway, this is my home.\This food is under my jurisdiction!\Now quit bitching, go to the kitchen, and get me a beer!\I'm the one who brought the meat you're ruining, and it was expensive!\Kei, you want to join us? The water feels great!\Later.\That's a shame. response:	Ignore him. He's pretending to be too cool for it.
context: And anyway, this is my home.\This food is under my jurisdiction!\Now quit bitching, go to the kitchen, and get me a beer!\I'm the one who brought the meat you're ruining, and it was expensive!\Kei, you want to join us? The water feels great!\Later.\That's a shame.\Ignore him. He's pretending to be too cool for it. response:	What's wrong? What's wrong? What's wrong?
context: This food is under my jurisdiction!\Now quit bitching, go to the kitchen, and get me a beer!\I'm the one who brought the meat you're ruining, and it was expensive!\Kei, you want to join us? The water feels great!\Later.\That's a shame.\Ignore him. He's pretending to be too cool for it.\What's wrong? What's wrong? What's wrong? response:	Come on, tell your daddy!
context: Now quit bitching, go to the kitchen, and get me a beer!\I'm the one who brought the meat you're ruining, and it was expensive!\Kei, you want to join us? The water feels great!\Later.\That's a shame.\Ignore him. He's pretending to be too cool for it.\What's wrong? What's wrong? What's wrong?\Come on, tell your daddy! response:	Who took the towel off?
context: I'm the one who brought the meat you're ruining, and it was expensive!\Kei, you want to join us? The water feels great!\Later.\That's a shame.\Ignore him. He's pretending to be too cool for it.\What's wrong? What's wrong? What's wrong?\Come on, tell your daddy!\Who took the towel off? response:	Me. Was that a problem?
context: Kei, you want to join us? The water feels great!\Later.\That's a shame.\Ignore him. He's pretending to be too cool for it.\What's wrong? What's wrong? What's wrong?\Come on, tell your daddy!\Who took the towel off?\Me. Was that a problem? response:	I was using it as a cover.
context: Later.\That's a shame.\Ignore him. He's pretending to be too cool for it.\What's wrong? What's wrong? What's wrong?\Come on, tell your daddy!\Who took the towel off?\Me. Was that a problem?\I was using it as a cover. response:	You need to make it dark, or the clams won't spit out the salt.
context: That's a shame.\Ignore him. He's pretending to be too cool for it.\What's wrong? What's wrong? What's wrong?\Come on, tell your daddy!\Who took the towel off?\Me. Was that a problem?\I was using it as a cover.\You need to make it dark, or the clams won't spit out the salt. response:	They spit out the sand already, right?
context: Ignore him. He's pretending to be too cool for it.\What's wrong? What's wrong? What's wrong?\Come on, tell your daddy!\Who took the towel off?\Me. Was that a problem?\I was using it as a cover.\You need to make it dark, or the clams won't spit out the salt.\They spit out the sand already, right? response:	But not the salt.
context: What's wrong? What's wrong? What's wrong?\Come on, tell your daddy!\Who took the towel off?\Me. Was that a problem?\I was using it as a cover.\You need to make it dark, or the clams won't spit out the salt.\They spit out the sand already, right?\But not the salt. response:	Who cares? It's not a big deal.
context: Come on, tell your daddy!\Who took the towel off?\Me. Was that a problem?\I was using it as a cover.\You need to make it dark, or the clams won't spit out the salt.\They spit out the sand already, right?\But not the salt.\Who cares? It's not a big deal. response:	It is a big deal!
context: Who took the towel off?\Me. Was that a problem?\I was using it as a cover.\You need to make it dark, or the clams won't spit out the salt.\They spit out the sand already, right?\But not the salt.\Who cares? It's not a big deal.\It is a big deal! response:	These clams are filled with salt water.
context: Me. Was that a problem?\I was using it as a cover.\You need to make it dark, or the clams won't spit out the salt.\They spit out the sand already, right?\But not the salt.\Who cares? It's not a big deal.\It is a big deal!\These clams are filled with salt water. response:	You need them to spit it out or you can't eat them.
context: I was using it as a cover.\You need to make it dark, or the clams won't spit out the salt.\They spit out the sand already, right?\But not the salt.\Who cares? It's not a big deal.\It is a big deal!\These clams are filled with salt water.\You need them to spit it out or you can't eat them. response:	At least... don't put much salt in.
context: You need to make it dark, or the clams won't spit out the salt.\They spit out the sand already, right?\But not the salt.\Who cares? It's not a big deal.\It is a big deal!\These clams are filled with salt water.\You need them to spit it out or you can't eat them.\At least... don't put much salt in. response:	Or actually, don't put any in.
context: They spit out the sand already, right?\But not the salt.\Who cares? It's not a big deal.\It is a big deal!\These clams are filled with salt water.\You need them to spit it out or you can't eat them.\At least... don't put much salt in.\Or actually, don't put any in. response:	You always get really annoying about cooking, Kei.
context: But not the salt.\Who cares? It's not a big deal.\It is a big deal!\These clams are filled with salt water.\You need them to spit it out or you can't eat them.\At least... don't put much salt in.\Or actually, don't put any in.\You always get really annoying about cooking, Kei. response:	You really seem like a food snob.
context: Who cares? It's not a big deal.\It is a big deal!\These clams are filled with salt water.\You need them to spit it out or you can't eat them.\At least... don't put much salt in.\Or actually, don't put any in.\You always get really annoying about cooking, Kei.\You really seem like a food snob. response:	I don't want my son to end up like you.
context: It is a big deal!\These clams are filled with salt water.\You need them to spit it out or you can't eat them.\At least... don't put much salt in.\Or actually, don't put any in.\You always get really annoying about cooking, Kei.\You really seem like a food snob.\I don't want my son to end up like you. response:	I'm not a snob.
context: These clams are filled with salt water.\You need them to spit it out or you can't eat them.\At least... don't put much salt in.\Or actually, don't put any in.\You always get really annoying about cooking, Kei.\You really seem like a food snob.\I don't want my son to end up like you.\I'm not a snob. response:	All snobs say that.
context: You need them to spit it out or you can't eat them.\At least... don't put much salt in.\Or actually, don't put any in.\You always get really annoying about cooking, Kei.\You really seem like a food snob.\I don't want my son to end up like you.\I'm not a snob.\All snobs say that. response:	San-Teresa City. San-Teresa City...
context: At least... don't put much salt in.\Or actually, don't put any in.\You always get really annoying about cooking, Kei.\You really seem like a food snob.\I don't want my son to end up like you.\I'm not a snob.\All snobs say that.\San-Teresa City. San-Teresa City... response:	The mayoral election?
context: Or actually, don't put any in.\You always get really annoying about cooking, Kei.\You really seem like a food snob.\I don't want my son to end up like you.\I'm not a snob.\All snobs say that.\San-Teresa City. San-Teresa City...\The mayoral election? response:	It's a farce. There's nobody worth voting for.
context: You always get really annoying about cooking, Kei.\You really seem like a food snob.\I don't want my son to end up like you.\I'm not a snob.\All snobs say that.\San-Teresa City. San-Teresa City...\The mayoral election?\It's a farce. There's nobody worth voting for. response:	This Kahns guy is the best of the bunch.
context: You really seem like a food snob.\I don't want my son to end up like you.\I'm not a snob.\All snobs say that.\San-Teresa City. San-Teresa City...\The mayoral election?\It's a farce. There's nobody worth voting for.\This Kahns guy is the best of the bunch. response:	Nathan Kahns.
context: I don't want my son to end up like you.\I'm not a snob.\All snobs say that.\San-Teresa City. San-Teresa City...\The mayoral election?\It's a farce. There's nobody worth voting for.\This Kahns guy is the best of the bunch.\Nathan Kahns. response:	He was mayor of Seattle for two terms. City councilman here for two years.
context: I'm not a snob.\All snobs say that.\San-Teresa City. San-Teresa City...\The mayoral election?\It's a farce. There's nobody worth voting for.\This Kahns guy is the best of the bunch.\Nathan Kahns.\He was mayor of Seattle for two terms. City councilman here for two years. response:	He looks like a guy who no girl wants to date even though he's rich.
context: All snobs say that.\San-Teresa City. San-Teresa City...\The mayoral election?\It's a farce. There's nobody worth voting for.\This Kahns guy is the best of the bunch.\Nathan Kahns.\He was mayor of Seattle for two terms. City councilman here for two years.\He looks like a guy who no girl wants to date even though he's rich. response:	Maybe,
context: San-Teresa City. San-Teresa City...\The mayoral election?\It's a farce. There's nobody worth voting for.\This Kahns guy is the best of the bunch.\Nathan Kahns.\He was mayor of Seattle for two terms. City councilman here for two years.\He looks like a guy who no girl wants to date even though he's rich.\Maybe, response:	but he's had a lot of mayoral experience and knows what he's talking about.
context: The mayoral election?\It's a farce. There's nobody worth voting for.\This Kahns guy is the best of the bunch.\Nathan Kahns.\He was mayor of Seattle for two terms. City councilman here for two years.\He looks like a guy who no girl wants to date even though he's rich.\Maybe,\but he's had a lot of mayoral experience and knows what he's talking about. response:	And he's a lot better than the other two.
context: It's a farce. There's nobody worth voting for.\This Kahns guy is the best of the bunch.\Nathan Kahns.\He was mayor of Seattle for two terms. City councilman here for two years.\He looks like a guy who no girl wants to date even though he's rich.\Maybe,\but he's had a lot of mayoral experience and knows what he's talking about.\And he's a lot better than the other two. response:	My wife and I are voting for this Kahns guy.
context: This Kahns guy is the best of the bunch.\Nathan Kahns.\He was mayor of Seattle for two terms. City councilman here for two years.\He looks like a guy who no girl wants to date even though he's rich.\Maybe,\but he's had a lot of mayoral experience and knows what he's talking about.\And he's a lot better than the other two.\My wife and I are voting for this Kahns guy. response:	Mozeleemay is running too, huh?
context: Nathan Kahns.\He was mayor of Seattle for two terms. City councilman here for two years.\He looks like a guy who no girl wants to date even though he's rich.\Maybe,\but he's had a lot of mayoral experience and knows what he's talking about.\And he's a lot better than the other two.\My wife and I are voting for this Kahns guy.\Mozeleemay is running too, huh? response:	Yeah.
context: He was mayor of Seattle for two terms. City councilman here for two years.\He looks like a guy who no girl wants to date even though he's rich.\Maybe,\but he's had a lot of mayoral experience and knows what he's talking about.\And he's a lot better than the other two.\My wife and I are voting for this Kahns guy.\Mozeleemay is running too, huh?\Yeah. response:	I still can't believe that guy's running for mayor.
context: He looks like a guy who no girl wants to date even though he's rich.\Maybe,\but he's had a lot of mayoral experience and knows what he's talking about.\And he's a lot better than the other two.\My wife and I are voting for this Kahns guy.\Mozeleemay is running too, huh?\Yeah.\I still can't believe that guy's running for mayor. response:	There's also the far-right candidate Tourte, who says the aliens should go back into space.
context: Maybe,\but he's had a lot of mayoral experience and knows what he's talking about.\And he's a lot better than the other two.\My wife and I are voting for this Kahns guy.\Mozeleemay is running too, huh?\Yeah.\I still can't believe that guy's running for mayor.\There's also the far-right candidate Tourte, who says the aliens should go back into space. response:	What?
context: but he's had a lot of mayoral experience and knows what he's talking about.\And he's a lot better than the other two.\My wife and I are voting for this Kahns guy.\Mozeleemay is running too, huh?\Yeah.\I still can't believe that guy's running for mayor.\There's also the far-right candidate Tourte, who says the aliens should go back into space.\What? response:	Breaking news!
context: And he's a lot better than the other two.\My wife and I are voting for this Kahns guy.\Mozeleemay is running too, huh?\Yeah.\I still can't believe that guy's running for mayor.\There's also the far-right candidate Tourte, who says the aliens should go back into space.\What?\Breaking news! response:	-Mayoral candidate Kahns has just been shot! -Kahns was shot?
context: My wife and I are voting for this Kahns guy.\Mozeleemay is running too, huh?\Yeah.\I still can't believe that guy's running for mayor.\There's also the far-right candidate Tourte, who says the aliens should go back into space.\What?\Breaking news!\-Mayoral candidate Kahns has just been shot! -Kahns was shot? response:	Look over there! They just loaded him into an ambulance.
context: Mozeleemay is running too, huh?\Yeah.\I still can't believe that guy's running for mayor.\There's also the far-right candidate Tourte, who says the aliens should go back into space.\What?\Breaking news!\-Mayoral candidate Kahns has just been shot! -Kahns was shot?\Look over there! They just loaded him into an ambulance. response:	He's not responding to anything his team says to him...
context: Yeah.\I still can't believe that guy's running for mayor.\There's also the far-right candidate Tourte, who says the aliens should go back into space.\What?\Breaking news!\-Mayoral candidate Kahns has just been shot! -Kahns was shot?\Look over there! They just loaded him into an ambulance.\He's not responding to anything his team says to him... response:	Oh, God... I can't believe this is happening.
context: I still can't believe that guy's running for mayor.\There's also the far-right candidate Tourte, who says the aliens should go back into space.\What?\Breaking news!\-Mayoral candidate Kahns has just been shot! -Kahns was shot?\Look over there! They just loaded him into an ambulance.\He's not responding to anything his team says to him...\Oh, God... I can't believe this is happening. response:	Oh, God! Oh, God!
context: There's also the far-right candidate Tourte, who says the aliens should go back into space.\What?\Breaking news!\-Mayoral candidate Kahns has just been shot! -Kahns was shot?\Look over there! They just loaded him into an ambulance.\He's not responding to anything his team says to him...\Oh, God... I can't believe this is happening.\Oh, God! Oh, God! response:	The meat's done, Matoba.
context: What?\Breaking news!\-Mayoral candidate Kahns has just been shot! -Kahns was shot?\Look over there! They just loaded him into an ambulance.\He's not responding to anything his team says to him...\Oh, God... I can't believe this is happening.\Oh, God! Oh, God!\The meat's done, Matoba. response:	Now where's that beer?
context: Breaking news!\-Mayoral candidate Kahns has just been shot! -Kahns was shot?\Look over there! They just loaded him into an ambulance.\He's not responding to anything his team says to him...\Oh, God... I can't believe this is happening.\Oh, God! Oh, God!\The meat's done, Matoba.\Now where's that beer? response:	What's wrong?
context: -Mayoral candidate Kahns has just been shot! -Kahns was shot?\Look over there! They just loaded him into an ambulance.\He's not responding to anything his team says to him...\Oh, God... I can't believe this is happening.\Oh, God! Oh, God!\The meat's done, Matoba.\Now where's that beer?\What's wrong? response:	The news is saying...
context: Look over there! They just loaded him into an ambulance.\He's not responding to anything his team says to him...\Oh, God... I can't believe this is happening.\Oh, God! Oh, God!\The meat's done, Matoba.\Now where's that beer?\What's wrong?\The news is saying... response:	We're having an emergency briefing.
context: He's not responding to anything his team says to him...\Oh, God... I can't believe this is happening.\Oh, God! Oh, God!\The meat's done, Matoba.\Now where's that beer?\What's wrong?\The news is saying...\We're having an emergency briefing. response:	A candidate for mayor was shot.
context: Oh, God... I can't believe this is happening.\Oh, God! Oh, God!\The meat's done, Matoba.\Now where's that beer?\What's wrong?\The news is saying...\We're having an emergency briefing.\A candidate for mayor was shot. response:	The shooter is John Ennaji.
context: Oh, God! Oh, God!\The meat's done, Matoba.\Now where's that beer?\What's wrong?\The news is saying...\We're having an emergency briefing.\A candidate for mayor was shot.\The shooter is John Ennaji. response:	A male Semanian.
context: The meat's done, Matoba.\Now where's that beer?\What's wrong?\The news is saying...\We're having an emergency briefing.\A candidate for mayor was shot.\The shooter is John Ennaji.\A male Semanian. response:	32 in Earth years.
context: Now where's that beer?\What's wrong?\The news is saying...\We're having an emergency briefing.\A candidate for mayor was shot.\The shooter is John Ennaji.\A male Semanian.\32 in Earth years. response:	Single, works at a convenience store.
context: What's wrong?\The news is saying...\We're having an emergency briefing.\A candidate for mayor was shot.\The shooter is John Ennaji.\A male Semanian.\32 in Earth years.\Single, works at a convenience store. response:	No criminal record except for a few speeding tickets.
context: The news is saying...\We're having an emergency briefing.\A candidate for mayor was shot.\The shooter is John Ennaji.\A male Semanian.\32 in Earth years.\Single, works at a convenience store.\No criminal record except for a few speeding tickets. response:	Everybody who knows him says they can't believe it.
context: We're having an emergency briefing.\A candidate for mayor was shot.\The shooter is John Ennaji.\A male Semanian.\32 in Earth years.\Single, works at a convenience store.\No criminal record except for a few speeding tickets.\Everybody who knows him says they can't believe it. response:	No underworld connections, either.
context: A candidate for mayor was shot.\The shooter is John Ennaji.\A male Semanian.\32 in Earth years.\Single, works at a convenience store.\No criminal record except for a few speeding tickets.\Everybody who knows him says they can't believe it.\No underworld connections, either. response:	There's no role for the Special Vice Squad here, but...
context: The shooter is John Ennaji.\A male Semanian.\32 in Earth years.\Single, works at a convenience store.\No criminal record except for a few speeding tickets.\Everybody who knows him says they can't believe it.\No underworld connections, either.\There's no role for the Special Vice Squad here, but... response:	Is there a problem?
context: A male Semanian.\32 in Earth years.\Single, works at a convenience store.\No criminal record except for a few speeding tickets.\Everybody who knows him says they can't believe it.\No underworld connections, either.\There's no role for the Special Vice Squad here, but...\Is there a problem? response:	I read your report. About Rick Fury.
context: 32 in Earth years.\Single, works at a convenience store.\No criminal record except for a few speeding tickets.\Everybody who knows him says they can't believe it.\No underworld connections, either.\There's no role for the Special Vice Squad here, but...\Is there a problem?\I read your report. About Rick Fury. response:	Zelada?
context: Single, works at a convenience store.\No criminal record except for a few speeding tickets.\Everybody who knows him says they can't believe it.\No underworld connections, either.\There's no role for the Special Vice Squad here, but...\Is there a problem?\I read your report. About Rick Fury.\Zelada? response:	We never found his body.
context: No criminal record except for a few speeding tickets.\Everybody who knows him says they can't believe it.\No underworld connections, either.\There's no role for the Special Vice Squad here, but...\Is there a problem?\I read your report. About Rick Fury.\Zelada?\We never found his body. response:	It wouldn't surprise me at all if he was still alive.
context: Everybody who knows him says they can't believe it.\No underworld connections, either.\There's no role for the Special Vice Squad here, but...\Is there a problem?\I read your report. About Rick Fury.\Zelada?\We never found his body.\It wouldn't surprise me at all if he was still alive. response:	So is this what you're saying, Chief?
context: No underworld connections, either.\There's no role for the Special Vice Squad here, but...\Is there a problem?\I read your report. About Rick Fury.\Zelada?\We never found his body.\It wouldn't surprise me at all if he was still alive.\So is this what you're saying, Chief? response:	The shooter who killed Kahns was controlled with magic?
context: There's no role for the Special Vice Squad here, but...\Is there a problem?\I read your report. About Rick Fury.\Zelada?\We never found his body.\It wouldn't surprise me at all if he was still alive.\So is this what you're saying, Chief?\The shooter who killed Kahns was controlled with magic? response:	Don't just come out and say it.
context: Is there a problem?\I read your report. About Rick Fury.\Zelada?\We never found his body.\It wouldn't surprise me at all if he was still alive.\So is this what you're saying, Chief?\The shooter who killed Kahns was controlled with magic?\Don't just come out and say it. response:	We're just covering all the bases. Got it?
context: I read your report. About Rick Fury.\Zelada?\We never found his body.\It wouldn't surprise me at all if he was still alive.\So is this what you're saying, Chief?\The shooter who killed Kahns was controlled with magic?\Don't just come out and say it.\We're just covering all the bases. Got it? response:	I want you and Exedilica to head to the coroner's office and see what you find, now.
context: Zelada?\We never found his body.\It wouldn't surprise me at all if he was still alive.\So is this what you're saying, Chief?\The shooter who killed Kahns was controlled with magic?\Don't just come out and say it.\We're just covering all the bases. Got it?\I want you and Exedilica to head to the coroner's office and see what you find, now. response:	Now? Dressed like this?
context: We never found his body.\It wouldn't surprise me at all if he was still alive.\So is this what you're saying, Chief?\The shooter who killed Kahns was controlled with magic?\Don't just come out and say it.\We're just covering all the bases. Got it?\I want you and Exedilica to head to the coroner's office and see what you find, now.\Now? Dressed like this? response:	Yeah. Now.
context: It wouldn't surprise me at all if he was still alive.\So is this what you're saying, Chief?\The shooter who killed Kahns was controlled with magic?\Don't just come out and say it.\We're just covering all the bases. Got it?\I want you and Exedilica to head to the coroner's office and see what you find, now.\Now? Dressed like this?\Yeah. Now. response:	I thought it might have been another controlled corpse, too.
context: So is this what you're saying, Chief?\The shooter who killed Kahns was controlled with magic?\Don't just come out and say it.\We're just covering all the bases. Got it?\I want you and Exedilica to head to the coroner's office and see what you find, now.\Now? Dressed like this?\Yeah. Now.\I thought it might have been another controlled corpse, too. response:	I didn't expect Inspector Zimmer would pick up on it, though.
context: The shooter who killed Kahns was controlled with magic?\Don't just come out and say it.\We're just covering all the bases. Got it?\I want you and Exedilica to head to the coroner's office and see what you find, now.\Now? Dressed like this?\Yeah. Now.\I thought it might have been another controlled corpse, too.\I didn't expect Inspector Zimmer would pick up on it, though. response:	He surprises you with how smart he is sometimes.
context: Don't just come out and say it.\We're just covering all the bases. Got it?\I want you and Exedilica to head to the coroner's office and see what you find, now.\Now? Dressed like this?\Yeah. Now.\I thought it might have been another controlled corpse, too.\I didn't expect Inspector Zimmer would pick up on it, though.\He surprises you with how smart he is sometimes. response:	I just wanted to go home.
context: We're just covering all the bases. Got it?\I want you and Exedilica to head to the coroner's office and see what you find, now.\Now? Dressed like this?\Yeah. Now.\I thought it might have been another controlled corpse, too.\I didn't expect Inspector Zimmer would pick up on it, though.\He surprises you with how smart he is sometimes.\I just wanted to go home. response:	You don't want to catch the guy who was behind Kahns' death?
context: I want you and Exedilica to head to the coroner's office and see what you find, now.\Now? Dressed like this?\Yeah. Now.\I thought it might have been another controlled corpse, too.\I didn't expect Inspector Zimmer would pick up on it, though.\He surprises you with how smart he is sometimes.\I just wanted to go home.\You don't want to catch the guy who was behind Kahns' death? response:	I don't want to waste a valuable weekend avenging a politician.
context: Now? Dressed like this?\Yeah. Now.\I thought it might have been another controlled corpse, too.\I didn't expect Inspector Zimmer would pick up on it, though.\He surprises you with how smart he is sometimes.\I just wanted to go home.\You don't want to catch the guy who was behind Kahns' death?\I don't want to waste a valuable weekend avenging a politician. response:	Kei...
context: Yeah. Now.\I thought it might have been another controlled corpse, too.\I didn't expect Inspector Zimmer would pick up on it, though.\He surprises you with how smart he is sometimes.\I just wanted to go home.\You don't want to catch the guy who was behind Kahns' death?\I don't want to waste a valuable weekend avenging a politician.\Kei... response:	I was kidding.
context: I thought it might have been another controlled corpse, too.\I didn't expect Inspector Zimmer would pick up on it, though.\He surprises you with how smart he is sometimes.\I just wanted to go home.\You don't want to catch the guy who was behind Kahns' death?\I don't want to waste a valuable weekend avenging a politician.\Kei...\I was kidding. response:	I've found myself impressed by Earth's democracy.
context: I didn't expect Inspector Zimmer would pick up on it, though.\He surprises you with how smart he is sometimes.\I just wanted to go home.\You don't want to catch the guy who was behind Kahns' death?\I don't want to waste a valuable weekend avenging a politician.\Kei...\I was kidding.\I've found myself impressed by Earth's democracy. response:	I think a system that reflects the people's wishes in any way at all is a wonderful thing.
context: He surprises you with how smart he is sometimes.\I just wanted to go home.\You don't want to catch the guy who was behind Kahns' death?\I don't want to waste a valuable weekend avenging a politician.\Kei...\I was kidding.\I've found myself impressed by Earth's democracy.\I think a system that reflects the people's wishes in any way at all is a wonderful thing. response:	And this shooting is a declaration of war against that system.
context: I just wanted to go home.\You don't want to catch the guy who was behind Kahns' death?\I don't want to waste a valuable weekend avenging a politician.\Kei...\I was kidding.\I've found myself impressed by Earth's democracy.\I think a system that reflects the people's wishes in any way at all is a wonderful thing.\And this shooting is a declaration of war against that system. response:	That's a nice speech. Or it would be if you weren't wearing a swimsuit.
context: You don't want to catch the guy who was behind Kahns' death?\I don't want to waste a valuable weekend avenging a politician.\Kei...\I was kidding.\I've found myself impressed by Earth's democracy.\I think a system that reflects the people's wishes in any way at all is a wonderful thing.\And this shooting is a declaration of war against that system.\That's a nice speech. Or it would be if you weren't wearing a swimsuit. response:	Stop staring.
context: I don't want to waste a valuable weekend avenging a politician.\Kei...\I was kidding.\I've found myself impressed by Earth's democracy.\I think a system that reflects the people's wishes in any way at all is a wonderful thing.\And this shooting is a declaration of war against that system.\That's a nice speech. Or it would be if you weren't wearing a swimsuit.\Stop staring. response:	That's why I didn't want to do this.
context: Kei...\I was kidding.\I've found myself impressed by Earth's democracy.\I think a system that reflects the people's wishes in any way at all is a wonderful thing.\And this shooting is a declaration of war against that system.\That's a nice speech. Or it would be if you weren't wearing a swimsuit.\Stop staring.\That's why I didn't want to do this. response:	I don't understand... Are they mocking us?
context: I was kidding.\I've found myself impressed by Earth's democracy.\I think a system that reflects the people's wishes in any way at all is a wonderful thing.\And this shooting is a declaration of war against that system.\That's a nice speech. Or it would be if you weren't wearing a swimsuit.\Stop staring.\That's why I didn't want to do this.\I don't understand... Are they mocking us? response:	Forget it.
context: I've found myself impressed by Earth's democracy.\I think a system that reflects the people's wishes in any way at all is a wonderful thing.\And this shooting is a declaration of war against that system.\That's a nice speech. Or it would be if you weren't wearing a swimsuit.\Stop staring.\That's why I didn't want to do this.\I don't understand... Are they mocking us?\Forget it. response:	You in there, Cecil? I'm coming in.
context: I think a system that reflects the people's wishes in any way at all is a wonderful thing.\And this shooting is a declaration of war against that system.\That's a nice speech. Or it would be if you weren't wearing a swimsuit.\Stop staring.\That's why I didn't want to do this.\I don't understand... Are they mocking us?\Forget it.\You in there, Cecil? I'm coming in. response:	Kei? Wait!
context: And this shooting is a declaration of war against that system.\That's a nice speech. Or it would be if you weren't wearing a swimsuit.\Stop staring.\That's why I didn't want to do this.\I don't understand... Are they mocking us?\Forget it.\You in there, Cecil? I'm coming in.\Kei? Wait! response:	Who are you?
context: That's a nice speech. Or it would be if you weren't wearing a swimsuit.\Stop staring.\That's why I didn't want to do this.\I don't understand... Are they mocking us?\Forget it.\You in there, Cecil? I'm coming in.\Kei? Wait!\Who are you? response:	We'll be quick.
context: Stop staring.\That's why I didn't want to do this.\I don't understand... Are they mocking us?\Forget it.\You in there, Cecil? I'm coming in.\Kei? Wait!\Who are you?\We'll be quick. response:	Man, it sure is hot today.
context: That's why I didn't want to do this.\I don't understand... Are they mocking us?\Forget it.\You in there, Cecil? I'm coming in.\Kei? Wait!\Who are you?\We'll be quick.\Man, it sure is hot today. response:	The chief was right.
context: I don't understand... Are they mocking us?\Forget it.\You in there, Cecil? I'm coming in.\Kei? Wait!\Who are you?\We'll be quick.\Man, it sure is hot today.\The chief was right. response:	He was dead, and someone manipulated his body into doing the murder.
context: Forget it.\You in there, Cecil? I'm coming in.\Kei? Wait!\Who are you?\We'll be quick.\Man, it sure is hot today.\The chief was right.\He was dead, and someone manipulated his body into doing the murder. response:	Zelada?
context: You in there, Cecil? I'm coming in.\Kei? Wait!\Who are you?\We'll be quick.\Man, it sure is hot today.\The chief was right.\He was dead, and someone manipulated his body into doing the murder.\Zelada? response:	I can't be sure.
context: Kei? Wait!\Who are you?\We'll be quick.\Man, it sure is hot today.\The chief was right.\He was dead, and someone manipulated his body into doing the murder.\Zelada?\I can't be sure. response:	But this form of magic is particularly rare.
context: Who are you?\We'll be quick.\Man, it sure is hot today.\The chief was right.\He was dead, and someone manipulated his body into doing the murder.\Zelada?\I can't be sure.\But this form of magic is particularly rare. response:	What do we do now?
context: We'll be quick.\Man, it sure is hot today.\The chief was right.\He was dead, and someone manipulated his body into doing the murder.\Zelada?\I can't be sure.\But this form of magic is particularly rare.\What do we do now? response:	We tell Chief Zimmer first.
context: Man, it sure is hot today.\The chief was right.\He was dead, and someone manipulated his body into doing the murder.\Zelada?\I can't be sure.\But this form of magic is particularly rare.\What do we do now?\We tell Chief Zimmer first. response:	Damn alien.
context: The chief was right.\He was dead, and someone manipulated his body into doing the murder.\Zelada?\I can't be sure.\But this form of magic is particularly rare.\What do we do now?\We tell Chief Zimmer first.\Damn alien. response:	Hold up.
context: He was dead, and someone manipulated his body into doing the murder.\Zelada?\I can't be sure.\But this form of magic is particularly rare.\What do we do now?\We tell Chief Zimmer first.\Damn alien.\Hold up. response:	What did you just say?
context: Zelada?\I can't be sure.\But this form of magic is particularly rare.\What do we do now?\We tell Chief Zimmer first.\Damn alien.\Hold up.\What did you just say? response:	Nothing.
context: I can't be sure.\But this form of magic is particularly rare.\What do we do now?\We tell Chief Zimmer first.\Damn alien.\Hold up.\What did you just say?\Nothing. response:	Don't lie to me.
context: But this form of magic is particularly rare.\What do we do now?\We tell Chief Zimmer first.\Damn alien.\Hold up.\What did you just say?\Nothing.\Don't lie to me. response:	What did you just say when you saw her?
context: What do we do now?\We tell Chief Zimmer first.\Damn alien.\Hold up.\What did you just say?\Nothing.\Don't lie to me.\What did you just say when you saw her? response:	I don't know...
context: We tell Chief Zimmer first.\Damn alien.\Hold up.\What did you just say?\Nothing.\Don't lie to me.\What did you just say when you saw her?\I don't know... response:	I heard it.
context: Damn alien.\Hold up.\What did you just say?\Nothing.\Don't lie to me.\What did you just say when you saw her?\I don't know...\I heard it. response:	You called her a damn alien.
context: Hold up.\What did you just say?\Nothing.\Don't lie to me.\What did you just say when you saw her?\I don't know...\I heard it.\You called her a damn alien. response:	You insulted my partner.
context: What did you just say?\Nothing.\Don't lie to me.\What did you just say when you saw her?\I don't know...\I heard it.\You called her a damn alien.\You insulted my partner. response:	What made you think that was a good idea?
context: Nothing.\Don't lie to me.\What did you just say when you saw her?\I don't know...\I heard it.\You called her a damn alien.\You insulted my partner.\What made you think that was a good idea? response:	Officer Sanders... Sanders, Sanders, Officer Sanders...
context: Don't lie to me.\What did you just say when you saw her?\I don't know...\I heard it.\You called her a damn alien.\You insulted my partner.\What made you think that was a good idea?\Officer Sanders... Sanders, Sanders, Officer Sanders... response:	You want to tell me why you said that?
context: What did you just say when you saw her?\I don't know...\I heard it.\You called her a damn alien.\You insulted my partner.\What made you think that was a good idea?\Officer Sanders... Sanders, Sanders, Officer Sanders...\You want to tell me why you said that? response:	I'm sorry.
context: I don't know...\I heard it.\You called her a damn alien.\You insulted my partner.\What made you think that was a good idea?\Officer Sanders... Sanders, Sanders, Officer Sanders...\You want to tell me why you said that?\I'm sorry. response:	I asked you a question.
context: I heard it.\You called her a damn alien.\You insulted my partner.\What made you think that was a good idea?\Officer Sanders... Sanders, Sanders, Officer Sanders...\You want to tell me why you said that?\I'm sorry.\I asked you a question. response:	Um, please...
context: You called her a damn alien.\You insulted my partner.\What made you think that was a good idea?\Officer Sanders... Sanders, Sanders, Officer Sanders...\You want to tell me why you said that?\I'm sorry.\I asked you a question.\Um, please... response:	Kei, that's enough.
context: You insulted my partner.\What made you think that was a good idea?\Officer Sanders... Sanders, Sanders, Officer Sanders...\You want to tell me why you said that?\I'm sorry.\I asked you a question.\Um, please...\Kei, that's enough. response:	Officer Sanders, I told you to answer my question.
context: What made you think that was a good idea?\Officer Sanders... Sanders, Sanders, Officer Sanders...\You want to tell me why you said that?\I'm sorry.\I asked you a question.\Um, please...\Kei, that's enough.\Officer Sanders, I told you to answer my question. response:	Now, do it!
context: Officer Sanders... Sanders, Sanders, Officer Sanders...\You want to tell me why you said that?\I'm sorry.\I asked you a question.\Um, please...\Kei, that's enough.\Officer Sanders, I told you to answer my question.\Now, do it! response:	Please!
context: You want to tell me why you said that?\I'm sorry.\I asked you a question.\Um, please...\Kei, that's enough.\Officer Sanders, I told you to answer my question.\Now, do it!\Please! response:	Please forgive me...
context: I'm sorry.\I asked you a question.\Um, please...\Kei, that's enough.\Officer Sanders, I told you to answer my question.\Now, do it!\Please!\Please forgive me... response:	My family is conservative. We were voting for Kahns...
context: I asked you a question.\Um, please...\Kei, that's enough.\Officer Sanders, I told you to answer my question.\Now, do it!\Please!\Please forgive me...\My family is conservative. We were voting for Kahns... response:	And, um... after what happened today...
context: Um, please...\Kei, that's enough.\Officer Sanders, I told you to answer my question.\Now, do it!\Please!\Please forgive me...\My family is conservative. We were voting for Kahns...\And, um... after what happened today... response:	The killer was... from the other world...
context: Kei, that's enough.\Officer Sanders, I told you to answer my question.\Now, do it!\Please!\Please forgive me...\My family is conservative. We were voting for Kahns...\And, um... after what happened today...\The killer was... from the other world... response:	So you think she killed Kahns, then.
context: Officer Sanders, I told you to answer my question.\Now, do it!\Please!\Please forgive me...\My family is conservative. We were voting for Kahns...\And, um... after what happened today...\The killer was... from the other world...\So you think she killed Kahns, then. response:	No.
context: Now, do it!\Please!\Please forgive me...\My family is conservative. We were voting for Kahns...\And, um... after what happened today...\The killer was... from the other world...\So you think she killed Kahns, then.\No. response:	Then she killed your family, then.
context: Please!\Please forgive me...\My family is conservative. We were voting for Kahns...\And, um... after what happened today...\The killer was... from the other world...\So you think she killed Kahns, then.\No.\Then she killed your family, then. response:	No.
context: Please forgive me...\My family is conservative. We were voting for Kahns...\And, um... after what happened today...\The killer was... from the other world...\So you think she killed Kahns, then.\No.\Then she killed your family, then.\No. response:	Christ. Do you have a reason to insult her, then?
context: My family is conservative. We were voting for Kahns...\And, um... after what happened today...\The killer was... from the other world...\So you think she killed Kahns, then.\No.\Then she killed your family, then.\No.\Christ. Do you have a reason to insult her, then? response:	Who the hell do you think you are?
context: And, um... after what happened today...\The killer was... from the other world...\So you think she killed Kahns, then.\No.\Then she killed your family, then.\No.\Christ. Do you have a reason to insult her, then?\Who the hell do you think you are? response:	Do you act like this towards the citizens, too?
context: The killer was... from the other world...\So you think she killed Kahns, then.\No.\Then she killed your family, then.\No.\Christ. Do you have a reason to insult her, then?\Who the hell do you think you are?\Do you act like this towards the citizens, too? response:	Kei.
context: So you think she killed Kahns, then.\No.\Then she killed your family, then.\No.\Christ. Do you have a reason to insult her, then?\Who the hell do you think you are?\Do you act like this towards the citizens, too?\Kei. response:	That's enough. Let's go.
context: No.\Then she killed your family, then.\No.\Christ. Do you have a reason to insult her, then?\Who the hell do you think you are?\Do you act like this towards the citizens, too?\Kei.\That's enough. Let's go. response:	But...
context: Then she killed your family, then.\No.\Christ. Do you have a reason to insult her, then?\Who the hell do you think you are?\Do you act like this towards the citizens, too?\Kei.\That's enough. Let's go.\But... response:	It's fine. Let's go.
context: No.\Christ. Do you have a reason to insult her, then?\Who the hell do you think you are?\Do you act like this towards the citizens, too?\Kei.\That's enough. Let's go.\But...\It's fine. Let's go. response:	That was embarrassing.
context: Christ. Do you have a reason to insult her, then?\Who the hell do you think you are?\Do you act like this towards the citizens, too?\Kei.\That's enough. Let's go.\But...\It's fine. Let's go.\That was embarrassing. response:	I wish you wouldn't do that.
context: Who the hell do you think you are?\Do you act like this towards the citizens, too?\Kei.\That's enough. Let's go.\But...\It's fine. Let's go.\That was embarrassing.\I wish you wouldn't do that. response:	Sorry.
context: Do you act like this towards the citizens, too?\Kei.\That's enough. Let's go.\But...\It's fine. Let's go.\That was embarrassing.\I wish you wouldn't do that.\Sorry. response:	But thank you.
context: Kei.\That's enough. Let's go.\But...\It's fine. Let's go.\That was embarrassing.\I wish you wouldn't do that.\Sorry.\But thank you. response:	I didn't do it because I wanted a thank you.
context: That's enough. Let's go.\But...\It's fine. Let's go.\That was embarrassing.\I wish you wouldn't do that.\Sorry.\But thank you.\I didn't do it because I wanted a thank you. response:	He just made me mad.
context: But...\It's fine. Let's go.\That was embarrassing.\I wish you wouldn't do that.\Sorry.\But thank you.\I didn't do it because I wanted a thank you.\He just made me mad. response:	I thought you'd say that.
context: It's fine. Let's go.\That was embarrassing.\I wish you wouldn't do that.\Sorry.\But thank you.\I didn't do it because I wanted a thank you.\He just made me mad.\I thought you'd say that. response:	You call people aliens all the time, anyway.
context: That was embarrassing.\I wish you wouldn't do that.\Sorry.\But thank you.\I didn't do it because I wanted a thank you.\He just made me mad.\I thought you'd say that.\You call people aliens all the time, anyway. response:	When I do, it's...
context: I wish you wouldn't do that.\Sorry.\But thank you.\I didn't do it because I wanted a thank you.\He just made me mad.\I thought you'd say that.\You call people aliens all the time, anyway.\When I do, it's... response:	It's like a joke.
context: Sorry.\But thank you.\I didn't do it because I wanted a thank you.\He just made me mad.\I thought you'd say that.\You call people aliens all the time, anyway.\When I do, it's...\It's like a joke. response:	It's like when a gangster calls his girlfriend a bitch trying to look cool.
context: But thank you.\I didn't do it because I wanted a thank you.\He just made me mad.\I thought you'd say that.\You call people aliens all the time, anyway.\When I do, it's...\It's like a joke.\It's like when a gangster calls his girlfriend a bitch trying to look cool. response:	But if somebody else calls her a bitch, he gets mad. It's like that.
context: I didn't do it because I wanted a thank you.\He just made me mad.\I thought you'd say that.\You call people aliens all the time, anyway.\When I do, it's...\It's like a joke.\It's like when a gangster calls his girlfriend a bitch trying to look cool.\But if somebody else calls her a bitch, he gets mad. It's like that. response:	I'm not your woman.
context: He just made me mad.\I thought you'd say that.\You call people aliens all the time, anyway.\When I do, it's...\It's like a joke.\It's like when a gangster calls his girlfriend a bitch trying to look cool.\But if somebody else calls her a bitch, he gets mad. It's like that.\I'm not your woman. response:	Of course not. It was an example. Sheesh.
context: I thought you'd say that.\You call people aliens all the time, anyway.\When I do, it's...\It's like a joke.\It's like when a gangster calls his girlfriend a bitch trying to look cool.\But if somebody else calls her a bitch, he gets mad. It's like that.\I'm not your woman.\Of course not. It was an example. Sheesh. response:	Just forget it.
context: You call people aliens all the time, anyway.\When I do, it's...\It's like a joke.\It's like when a gangster calls his girlfriend a bitch trying to look cool.\But if somebody else calls her a bitch, he gets mad. It's like that.\I'm not your woman.\Of course not. It was an example. Sheesh.\Just forget it. response:	Okay, I'll let you off the hook for now.
context: When I do, it's...\It's like a joke.\It's like when a gangster calls his girlfriend a bitch trying to look cool.\But if somebody else calls her a bitch, he gets mad. It's like that.\I'm not your woman.\Of course not. It was an example. Sheesh.\Just forget it.\Okay, I'll let you off the hook for now. response:	Thank me later, doreany.
context: It's like a joke.\It's like when a gangster calls his girlfriend a bitch trying to look cool.\But if somebody else calls her a bitch, he gets mad. It's like that.\I'm not your woman.\Of course not. It was an example. Sheesh.\Just forget it.\Okay, I'll let you off the hook for now.\Thank me later, doreany. response:	Quiet, alien.
context: It's like when a gangster calls his girlfriend a bitch trying to look cool.\But if somebody else calls her a bitch, he gets mad. It's like that.\I'm not your woman.\Of course not. It was an example. Sheesh.\Just forget it.\Okay, I'll let you off the hook for now.\Thank me later, doreany.\Quiet, alien. response:	I see.
context: But if somebody else calls her a bitch, he gets mad. It's like that.\I'm not your woman.\Of course not. It was an example. Sheesh.\Just forget it.\Okay, I'll let you off the hook for now.\Thank me later, doreany.\Quiet, alien.\I see. response:	It's probably Zelada.
context: I'm not your woman.\Of course not. It was an example. Sheesh.\Just forget it.\Okay, I'll let you off the hook for now.\Thank me later, doreany.\Quiet, alien.\I see.\It's probably Zelada. response:	Inspector Zimmer, you were right.
context: Of course not. It was an example. Sheesh.\Just forget it.\Okay, I'll let you off the hook for now.\Thank me later, doreany.\Quiet, alien.\I see.\It's probably Zelada.\Inspector Zimmer, you were right. response:	That's a shame.
context: Just forget it.\Okay, I'll let you off the hook for now.\Thank me later, doreany.\Quiet, alien.\I see.\It's probably Zelada.\Inspector Zimmer, you were right.\That's a shame. response:	I was hoping I wasn't.
context: Okay, I'll let you off the hook for now.\Thank me later, doreany.\Quiet, alien.\I see.\It's probably Zelada.\Inspector Zimmer, you were right.\That's a shame.\I was hoping I wasn't. response:	Why?
context: Thank me later, doreany.\Quiet, alien.\I see.\It's probably Zelada.\Inspector Zimmer, you were right.\That's a shame.\I was hoping I wasn't.\Why? response:	Because now I get to go to every department involved and tell them,
context: Quiet, alien.\I see.\It's probably Zelada.\Inspector Zimmer, you were right.\That's a shame.\I was hoping I wasn't.\Why?\Because now I get to go to every department involved and tell them, response:	Watch out for wizards.
context: I see.\It's probably Zelada.\Inspector Zimmer, you were right.\That's a shame.\I was hoping I wasn't.\Why?\Because now I get to go to every department involved and tell them,\Watch out for wizards. response:	That's rough.
context: It's probably Zelada.\Inspector Zimmer, you were right.\That's a shame.\I was hoping I wasn't.\Why?\Because now I get to go to every department involved and tell them,\Watch out for wizards.\That's rough. response:	A Semanian shot an Earth mayoral candidate.
context: Inspector Zimmer, you were right.\That's a shame.\I was hoping I wasn't.\Why?\Because now I get to go to every department involved and tell them,\Watch out for wizards.\That's rough.\A Semanian shot an Earth mayoral candidate. response:	This is going to be a pain.
context: That's a shame.\I was hoping I wasn't.\Why?\Because now I get to go to every department involved and tell them,\Watch out for wizards.\That's rough.\A Semanian shot an Earth mayoral candidate.\This is going to be a pain. response:	How?
context: I was hoping I wasn't.\Why?\Because now I get to go to every department involved and tell them,\Watch out for wizards.\That's rough.\A Semanian shot an Earth mayoral candidate.\This is going to be a pain.\How? response:	Ethnic strife.
context: Why?\Because now I get to go to every department involved and tell them,\Watch out for wizards.\That's rough.\A Semanian shot an Earth mayoral candidate.\This is going to be a pain.\How?\Ethnic strife. response:	Just like you saw earlier.
context: Because now I get to go to every department involved and tell them,\Watch out for wizards.\That's rough.\A Semanian shot an Earth mayoral candidate.\This is going to be a pain.\How?\Ethnic strife.\Just like you saw earlier. response:	You know what I mean, right?
context: Watch out for wizards.\That's rough.\A Semanian shot an Earth mayoral candidate.\This is going to be a pain.\How?\Ethnic strife.\Just like you saw earlier.\You know what I mean, right? response:	Even if Zelada, a Semanian, is behind it,
context: That's rough.\A Semanian shot an Earth mayoral candidate.\This is going to be a pain.\How?\Ethnic strife.\Just like you saw earlier.\You know what I mean, right?\Even if Zelada, a Semanian, is behind it, response:	we need to figure out the truth as fast as possible.
context: A Semanian shot an Earth mayoral candidate.\This is going to be a pain.\How?\Ethnic strife.\Just like you saw earlier.\You know what I mean, right?\Even if Zelada, a Semanian, is behind it,\we need to figure out the truth as fast as possible. response:	But how do we find the guy?
context: This is going to be a pain.\How?\Ethnic strife.\Just like you saw earlier.\You know what I mean, right?\Even if Zelada, a Semanian, is behind it,\we need to figure out the truth as fast as possible.\But how do we find the guy? response:	It's not like you can catch a wizard on a security camera.
context: How?\Ethnic strife.\Just like you saw earlier.\You know what I mean, right?\Even if Zelada, a Semanian, is behind it,\we need to figure out the truth as fast as possible.\But how do we find the guy?\It's not like you can catch a wizard on a security camera. response:	How about we go back to the basics of investigating?
context: Ethnic strife.\Just like you saw earlier.\You know what I mean, right?\Even if Zelada, a Semanian, is behind it,\we need to figure out the truth as fast as possible.\But how do we find the guy?\It's not like you can catch a wizard on a security camera.\How about we go back to the basics of investigating? response:	What do you mean by basics?
context: Just like you saw earlier.\You know what I mean, right?\Even if Zelada, a Semanian, is behind it,\we need to figure out the truth as fast as possible.\But how do we find the guy?\It's not like you can catch a wizard on a security camera.\How about we go back to the basics of investigating?\What do you mean by basics? response:	Motive.
context: You know what I mean, right?\Even if Zelada, a Semanian, is behind it,\we need to figure out the truth as fast as possible.\But how do we find the guy?\It's not like you can catch a wizard on a security camera.\How about we go back to the basics of investigating?\What do you mean by basics?\Motive. response:	Who gains by Kahns' death?
context: Even if Zelada, a Semanian, is behind it,\we need to figure out the truth as fast as possible.\But how do we find the guy?\It's not like you can catch a wizard on a security camera.\How about we go back to the basics of investigating?\What do you mean by basics?\Motive.\Who gains by Kahns' death? response:	Next time Next time on COP CRAFT.