context: Today I promised to play with Saikawa in the park. response:	I see. Have fun.
context: Today I promised to play with Saikawa in the park.\I see. Have fun. response:	Mm.
context: Today I promised to play with Saikawa in the park.\I see. Have fun.\Mm. response:	Do you have any plans for today, Miss Kobayashi?
context: Today I promised to play with Saikawa in the park.\I see. Have fun.\Mm.\Do you have any plans for today, Miss Kobayashi? response:	I guess I'd like to spend my day off relaxing at home for once.
context: Today I promised to play with Saikawa in the park.\I see. Have fun.\Mm.\Do you have any plans for today, Miss Kobayashi?\I guess I'd like to spend my day off relaxing at home for once. response:	Understood!
context: Today I promised to play with Saikawa in the park.\I see. Have fun.\Mm.\Do you have any plans for today, Miss Kobayashi?\I guess I'd like to spend my day off relaxing at home for once.\Understood! response:	I'll give it my utmost best as your maid to ensure you can relax.
context: Today I promised to play with Saikawa in the park.\I see. Have fun.\Mm.\Do you have any plans for today, Miss Kobayashi?\I guess I'd like to spend my day off relaxing at home for once.\Understood!\I'll give it my utmost best as your maid to ensure you can relax. response:	Well, just leaving me alone is fine.
context: Today I promised to play with Saikawa in the park.\I see. Have fun.\Mm.\Do you have any plans for today, Miss Kobayashi?\I guess I'd like to spend my day off relaxing at home for once.\Understood!\I'll give it my utmost best as your maid to ensure you can relax.\Well, just leaving me alone is fine. response:	Kanna!
context: I see. Have fun.\Mm.\Do you have any plans for today, Miss Kobayashi?\I guess I'd like to spend my day off relaxing at home for once.\Understood!\I'll give it my utmost best as your maid to ensure you can relax.\Well, just leaving me alone is fine.\Kanna! response:	Take care.
context: Mm.\Do you have any plans for today, Miss Kobayashi?\I guess I'd like to spend my day off relaxing at home for once.\Understood!\I'll give it my utmost best as your maid to ensure you can relax.\Well, just leaving me alone is fine.\Kanna!\Take care. response:	Yeah.
context: Do you have any plans for today, Miss Kobayashi?\I guess I'd like to spend my day off relaxing at home for once.\Understood!\I'll give it my utmost best as your maid to ensure you can relax.\Well, just leaving me alone is fine.\Kanna!\Take care.\Yeah. response:	I hope the sun comes out today.
context: I guess I'd like to spend my day off relaxing at home for once.\Understood!\I'll give it my utmost best as your maid to ensure you can relax.\Well, just leaving me alone is fine.\Kanna!\Take care.\Yeah.\I hope the sun comes out today. response:	Cute.
context: Understood!\I'll give it my utmost best as your maid to ensure you can relax.\Well, just leaving me alone is fine.\Kanna!\Take care.\Yeah.\I hope the sun comes out today.\Cute. response:	Shepherd's purse, huh?
context: I'll give it my utmost best as your maid to ensure you can relax.\Well, just leaving me alone is fine.\Kanna!\Take care.\Yeah.\I hope the sun comes out today.\Cute.\Shepherd's purse, huh? response:	Flower Language Dictionary
context: Well, just leaving me alone is fine.\Kanna!\Take care.\Yeah.\I hope the sun comes out today.\Cute.\Shepherd's purse, huh?\Flower Language Dictionary response:	Flower language?
context: Kanna!\Take care.\Yeah.\I hope the sun comes out today.\Cute.\Shepherd's purse, huh?\Flower Language Dictionary\Flower language? response:	Yes. It's a book about the language of flowers.
context: Take care.\Yeah.\I hope the sun comes out today.\Cute.\Shepherd's purse, huh?\Flower Language Dictionary\Flower language?\Yes. It's a book about the language of flowers. response:	Georgie lent it to me.
context: Yeah.\I hope the sun comes out today.\Cute.\Shepherd's purse, huh?\Flower Language Dictionary\Flower language?\Yes. It's a book about the language of flowers.\Georgie lent it to me. response:	It's interesting.
context: I hope the sun comes out today.\Cute.\Shepherd's purse, huh?\Flower Language Dictionary\Flower language?\Yes. It's a book about the language of flowers.\Georgie lent it to me.\It's interesting. response:	Saikawa.
context: Cute.\Shepherd's purse, huh?\Flower Language Dictionary\Flower language?\Yes. It's a book about the language of flowers.\Georgie lent it to me.\It's interesting.\Saikawa. response:	The meaning of shepherd's purse is...
context: Shepherd's purse, huh?\Flower Language Dictionary\Flower language?\Yes. It's a book about the language of flowers.\Georgie lent it to me.\It's interesting.\Saikawa.\The meaning of shepherd's purse is... response:	There!
context: Flower Language Dictionary\Flower language?\Yes. It's a book about the language of flowers.\Georgie lent it to me.\It's interesting.\Saikawa.\The meaning of shepherd's purse is...\There! response:	Shepherd's Purse Flower Meaning: I'll offer everything to you. Brassicaaceae Family, Capsella Genus, Annual.
context: Flower language?\Yes. It's a book about the language of flowers.\Georgie lent it to me.\It's interesting.\Saikawa.\The meaning of shepherd's purse is...\There!\Shepherd's Purse Flower Meaning: I'll offer everything to you. Brassicaaceae Family, Capsella Genus, Annual. response:	I'll offer everything to you?!
context: Yes. It's a book about the language of flowers.\Georgie lent it to me.\It's interesting.\Saikawa.\The meaning of shepherd's purse is...\There!\Shepherd's Purse Flower Meaning: I'll offer everything to you. Brassicaaceae Family, Capsella Genus, Annual.\I'll offer everything to you?! response:	My everything for you, Kanna-san!
context: Georgie lent it to me.\It's interesting.\Saikawa.\The meaning of shepherd's purse is...\There!\Shepherd's Purse Flower Meaning: I'll offer everything to you. Brassicaaceae Family, Capsella Genus, Annual.\I'll offer everything to you?!\My everything for you, Kanna-san! response:	My everything?
context: It's interesting.\Saikawa.\The meaning of shepherd's purse is...\There!\Shepherd's Purse Flower Meaning: I'll offer everything to you. Brassicaaceae Family, Capsella Genus, Annual.\I'll offer everything to you?!\My everything for you, Kanna-san!\My everything? response:	Here you go, Miss Kobayashi.
context: Saikawa.\The meaning of shepherd's purse is...\There!\Shepherd's Purse Flower Meaning: I'll offer everything to you. Brassicaaceae Family, Capsella Genus, Annual.\I'll offer everything to you?!\My everything for you, Kanna-san!\My everything?\Here you go, Miss Kobayashi. response:	Yeah, thanks.
context: The meaning of shepherd's purse is...\There!\Shepherd's Purse Flower Meaning: I'll offer everything to you. Brassicaaceae Family, Capsella Genus, Annual.\I'll offer everything to you?!\My everything for you, Kanna-san!\My everything?\Here you go, Miss Kobayashi.\Yeah, thanks. response:	How is it?
context: There!\Shepherd's Purse Flower Meaning: I'll offer everything to you. Brassicaaceae Family, Capsella Genus, Annual.\I'll offer everything to you?!\My everything for you, Kanna-san!\My everything?\Here you go, Miss Kobayashi.\Yeah, thanks.\How is it? response:	Oh, it's good.
context: Shepherd's Purse Flower Meaning: I'll offer everything to you. Brassicaaceae Family, Capsella Genus, Annual.\I'll offer everything to you?!\My everything for you, Kanna-san!\My everything?\Here you go, Miss Kobayashi.\Yeah, thanks.\How is it?\Oh, it's good. response:	I've been trying to change the temperature and such,
context: I'll offer everything to you?!\My everything for you, Kanna-san!\My everything?\Here you go, Miss Kobayashi.\Yeah, thanks.\How is it?\Oh, it's good.\I've been trying to change the temperature and such, response:	depending on how you're feeling.
context: My everything for you, Kanna-san!\My everything?\Here you go, Miss Kobayashi.\Yeah, thanks.\How is it?\Oh, it's good.\I've been trying to change the temperature and such,\depending on how you're feeling. response:	You dragons are amazing.
context: My everything?\Here you go, Miss Kobayashi.\Yeah, thanks.\How is it?\Oh, it's good.\I've been trying to change the temperature and such,\depending on how you're feeling.\You dragons are amazing. response:	It's not because I'm a dragon.
context: Here you go, Miss Kobayashi.\Yeah, thanks.\How is it?\Oh, it's good.\I've been trying to change the temperature and such,\depending on how you're feeling.\You dragons are amazing.\It's not because I'm a dragon. response:	It's because I'm me.
context: Yeah, thanks.\How is it?\Oh, it's good.\I've been trying to change the temperature and such,\depending on how you're feeling.\You dragons are amazing.\It's not because I'm a dragon.\It's because I'm me. response:	Well, I should go shopping soon.
context: How is it?\Oh, it's good.\I've been trying to change the temperature and such,\depending on how you're feeling.\You dragons are amazing.\It's not because I'm a dragon.\It's because I'm me.\Well, I should go shopping soon. response:	What should I make for tonight's dinner?
context: Oh, it's good.\I've been trying to change the temperature and such,\depending on how you're feeling.\You dragons are amazing.\It's not because I'm a dragon.\It's because I'm me.\Well, I should go shopping soon.\What should I make for tonight's dinner? response:	Omurice.
context: I've been trying to change the temperature and such,\depending on how you're feeling.\You dragons are amazing.\It's not because I'm a dragon.\It's because I'm me.\Well, I should go shopping soon.\What should I make for tonight's dinner?\Omurice. response:	Sounds good!
context: depending on how you're feeling.\You dragons are amazing.\It's not because I'm a dragon.\It's because I'm me.\Well, I should go shopping soon.\What should I make for tonight's dinner?\Omurice.\Sounds good! response:	Let's go with that, then.
context: You dragons are amazing.\It's not because I'm a dragon.\It's because I'm me.\Well, I should go shopping soon.\What should I make for tonight's dinner?\Omurice.\Sounds good!\Let's go with that, then. response:	Make us proper ones today, please.
context: It's not because I'm a dragon.\It's because I'm me.\Well, I should go shopping soon.\What should I make for tonight's dinner?\Omurice.\Sounds good!\Let's go with that, then.\Make us proper ones today, please. response:	Leave it to me!
context: It's because I'm me.\Well, I should go shopping soon.\What should I make for tonight's dinner?\Omurice.\Sounds good!\Let's go with that, then.\Make us proper ones today, please.\Leave it to me! response:	I'm heading out.
context: Well, I should go shopping soon.\What should I make for tonight's dinner?\Omurice.\Sounds good!\Let's go with that, then.\Make us proper ones today, please.\Leave it to me!\I'm heading out. response:	Okay.
context: What should I make for tonight's dinner?\Omurice.\Sounds good!\Let's go with that, then.\Make us proper ones today, please.\Leave it to me!\I'm heading out.\Okay. response:	Omurice, omurice!
context: Omurice.\Sounds good!\Let's go with that, then.\Make us proper ones today, please.\Leave it to me!\I'm heading out.\Okay.\Omurice, omurice! response:	LED Light Campaign On Now
context: Sounds good!\Let's go with that, then.\Make us proper ones today, please.\Leave it to me!\I'm heading out.\Okay.\Omurice, omurice!\LED Light Campaign On Now response:	Their lifespan is short!
context: Let's go with that, then.\Make us proper ones today, please.\Leave it to me!\I'm heading out.\Okay.\Omurice, omurice!\LED Light Campaign On Now\Their lifespan is short! response:	Yes. For example, the house mouse only lives for a year to a year and a half.
context: Make us proper ones today, please.\Leave it to me!\I'm heading out.\Okay.\Omurice, omurice!\LED Light Campaign On Now\Their lifespan is short!\Yes. For example, the house mouse only lives for a year to a year and a half. response:	House Mouse
context: Leave it to me!\I'm heading out.\Okay.\Omurice, omurice!\LED Light Campaign On Now\Their lifespan is short!\Yes. For example, the house mouse only lives for a year to a year and a half.\House Mouse response:	Lifespan
context: I'm heading out.\Okay.\Omurice, omurice!\LED Light Campaign On Now\Their lifespan is short!\Yes. For example, the house mouse only lives for a year to a year and a half.\House Mouse\Lifespan response:	Human
context: Okay.\Omurice, omurice!\LED Light Campaign On Now\Their lifespan is short!\Yes. For example, the house mouse only lives for a year to a year and a half.\House Mouse\Lifespan\Human response:	Ah, how sad!
context: Omurice, omurice!\LED Light Campaign On Now\Their lifespan is short!\Yes. For example, the house mouse only lives for a year to a year and a half.\House Mouse\Lifespan\Human\Ah, how sad! response:	That's not so.
context: LED Light Campaign On Now\Their lifespan is short!\Yes. For example, the house mouse only lives for a year to a year and a half.\House Mouse\Lifespan\Human\Ah, how sad!\That's not so. response:	Every living creature has its own perception of time,
context: Their lifespan is short!\Yes. For example, the house mouse only lives for a year to a year and a half.\House Mouse\Lifespan\Human\Ah, how sad!\That's not so.\Every living creature has its own perception of time, response:	and applying human standards to them is mistaken.
context: Yes. For example, the house mouse only lives for a year to a year and a half.\House Mouse\Lifespan\Human\Ah, how sad!\That's not so.\Every living creature has its own perception of time,\and applying human standards to them is mistaken. response:	How long are you planning to keep doing this?
context: House Mouse\Lifespan\Human\Ah, how sad!\That's not so.\Every living creature has its own perception of time,\and applying human standards to them is mistaken.\How long are you planning to keep doing this? response:	Are you me?
context: Lifespan\Human\Ah, how sad!\That's not so.\Every living creature has its own perception of time,\and applying human standards to them is mistaken.\How long are you planning to keep doing this?\Are you me? response:	That's right.
context: Human\Ah, how sad!\That's not so.\Every living creature has its own perception of time,\and applying human standards to them is mistaken.\How long are you planning to keep doing this?\Are you me?\That's right. response:	I'm the doubt within you.
context: Ah, how sad!\That's not so.\Every living creature has its own perception of time,\and applying human standards to them is mistaken.\How long are you planning to keep doing this?\Are you me?\That's right.\I'm the doubt within you. response:	Don't avert your eyes.
context: That's not so.\Every living creature has its own perception of time,\and applying human standards to them is mistaken.\How long are you planning to keep doing this?\Are you me?\That's right.\I'm the doubt within you.\Don't avert your eyes. response:	Don't deceive yourself.
context: Every living creature has its own perception of time,\and applying human standards to them is mistaken.\How long are you planning to keep doing this?\Are you me?\That's right.\I'm the doubt within you.\Don't avert your eyes.\Don't deceive yourself. response:	And with that...
context: and applying human standards to them is mistaken.\How long are you planning to keep doing this?\Are you me?\That's right.\I'm the doubt within you.\Don't avert your eyes.\Don't deceive yourself.\And with that... response:	I ask you. How long are you planning to keep doing this?
context: How long are you planning to keep doing this?\Are you me?\That's right.\I'm the doubt within you.\Don't avert your eyes.\Don't deceive yourself.\And with that...\I ask you. How long are you planning to keep doing this? response:	I just want to enjoy this time I have now,
context: Are you me?\That's right.\I'm the doubt within you.\Don't avert your eyes.\Don't deceive yourself.\And with that...\I ask you. How long are you planning to keep doing this?\I just want to enjoy this time I have now, response:	and spend time with Miss Kobayashi, that's all...
context: That's right.\I'm the doubt within you.\Don't avert your eyes.\Don't deceive yourself.\And with that...\I ask you. How long are you planning to keep doing this?\I just want to enjoy this time I have now,\and spend time with Miss Kobayashi, that's all... response:	How long?
context: I'm the doubt within you.\Don't avert your eyes.\Don't deceive yourself.\And with that...\I ask you. How long are you planning to keep doing this?\I just want to enjoy this time I have now,\and spend time with Miss Kobayashi, that's all...\How long? response:	You understand, don't you?
context: Don't avert your eyes.\Don't deceive yourself.\And with that...\I ask you. How long are you planning to keep doing this?\I just want to enjoy this time I have now,\and spend time with Miss Kobayashi, that's all...\How long?\You understand, don't you? response:	One day you will have to go back.
context: Don't deceive yourself.\And with that...\I ask you. How long are you planning to keep doing this?\I just want to enjoy this time I have now,\and spend time with Miss Kobayashi, that's all...\How long?\You understand, don't you?\One day you will have to go back. response:	I won't go back.
context: And with that...\I ask you. How long are you planning to keep doing this?\I just want to enjoy this time I have now,\and spend time with Miss Kobayashi, that's all...\How long?\You understand, don't you?\One day you will have to go back.\I won't go back. response:	I don't intend to go back.
context: I ask you. How long are you planning to keep doing this?\I just want to enjoy this time I have now,\and spend time with Miss Kobayashi, that's all...\How long?\You understand, don't you?\One day you will have to go back.\I won't go back.\I don't intend to go back. response:	Because I'm Miss Kobayashi's maid.
context: I just want to enjoy this time I have now,\and spend time with Miss Kobayashi, that's all...\How long?\You understand, don't you?\One day you will have to go back.\I won't go back.\I don't intend to go back.\Because I'm Miss Kobayashi's maid. response:	You're not. You're a dragon!
context: and spend time with Miss Kobayashi, that's all...\How long?\You understand, don't you?\One day you will have to go back.\I won't go back.\I don't intend to go back.\Because I'm Miss Kobayashi's maid.\You're not. You're a dragon! response:	What will you do if you have a reason to return?
context: How long?\You understand, don't you?\One day you will have to go back.\I won't go back.\I don't intend to go back.\Because I'm Miss Kobayashi's maid.\You're not. You're a dragon!\What will you do if you have a reason to return? response:	If the war back there worsens?
context: You understand, don't you?\One day you will have to go back.\I won't go back.\I don't intend to go back.\Because I'm Miss Kobayashi's maid.\You're not. You're a dragon!\What will you do if you have a reason to return?\If the war back there worsens? response:	If you long for battle?
context: One day you will have to go back.\I won't go back.\I don't intend to go back.\Because I'm Miss Kobayashi's maid.\You're not. You're a dragon!\What will you do if you have a reason to return?\If the war back there worsens?\If you long for battle? response:	If Miss Kobayashi were to...
context: I won't go back.\I don't intend to go back.\Because I'm Miss Kobayashi's maid.\You're not. You're a dragon!\What will you do if you have a reason to return?\If the war back there worsens?\If you long for battle?\If Miss Kobayashi were to... response:	Die
context: I don't intend to go back.\Because I'm Miss Kobayashi's maid.\You're not. You're a dragon!\What will you do if you have a reason to return?\If the war back there worsens?\If you long for battle?\If Miss Kobayashi were to...\Die response:	Miss Kobayashi... The place I belong...
context: Because I'm Miss Kobayashi's maid.\You're not. You're a dragon!\What will you do if you have a reason to return?\If the war back there worsens?\If you long for battle?\If Miss Kobayashi were to...\Die\Miss Kobayashi... The place I belong... response:	Father?
context: You're not. You're a dragon!\What will you do if you have a reason to return?\If the war back there worsens?\If you long for battle?\If Miss Kobayashi were to...\Die\Miss Kobayashi... The place I belong...\Father? response:	You understand why I'm here, yes?
context: What will you do if you have a reason to return?\If the war back there worsens?\If you long for battle?\If Miss Kobayashi were to...\Die\Miss Kobayashi... The place I belong...\Father?\You understand why I'm here, yes? response:	You're coming home with me.
context: If the war back there worsens?\If you long for battle?\If Miss Kobayashi were to...\Die\Miss Kobayashi... The place I belong...\Father?\You understand why I'm here, yes?\You're coming home with me. response:	Tohru, this isn't where you belong.
context: If you long for battle?\If Miss Kobayashi were to...\Die\Miss Kobayashi... The place I belong...\Father?\You understand why I'm here, yes?\You're coming home with me.\Tohru, this isn't where you belong. response:	Lady Tohru!
context: If Miss Kobayashi were to...\Die\Miss Kobayashi... The place I belong...\Father?\You understand why I'm here, yes?\You're coming home with me.\Tohru, this isn't where you belong.\Lady Tohru! response:	Yeah.
context: Die\Miss Kobayashi... The place I belong...\Father?\You understand why I'm here, yes?\You're coming home with me.\Tohru, this isn't where you belong.\Lady Tohru!\Yeah. response:	Tohru's still not back yet, huh.
context: Miss Kobayashi... The place I belong...\Father?\You understand why I'm here, yes?\You're coming home with me.\Tohru, this isn't where you belong.\Lady Tohru!\Yeah.\Tohru's still not back yet, huh. response:	Just how far did she go to shop?
context: Father?\You understand why I'm here, yes?\You're coming home with me.\Tohru, this isn't where you belong.\Lady Tohru!\Yeah.\Tohru's still not back yet, huh.\Just how far did she go to shop? response:	Lady Tohru went home.
context: You understand why I'm here, yes?\You're coming home with me.\Tohru, this isn't where you belong.\Lady Tohru!\Yeah.\Tohru's still not back yet, huh.\Just how far did she go to shop?\Lady Tohru went home. response:	No, she's not
context: You're coming home with me.\Tohru, this isn't where you belong.\Lady Tohru!\Yeah.\Tohru's still not back yet, huh.\Just how far did she go to shop?\Lady Tohru went home.\No, she's not response:	She went home.
context: Tohru, this isn't where you belong.\Lady Tohru!\Yeah.\Tohru's still not back yet, huh.\Just how far did she go to shop?\Lady Tohru went home.\No, she's not\She went home. response:	Huh?
context: Lady Tohru!\Yeah.\Tohru's still not back yet, huh.\Just how far did she go to shop?\Lady Tohru went home.\No, she's not\She went home.\Huh? response:	To the other world.
context: Yeah.\Tohru's still not back yet, huh.\Just how far did she go to shop?\Lady Tohru went home.\No, she's not\She went home.\Huh?\To the other world. response:	I think the Emperor of Demise, Lady Tohru's father, came to pick her up.
context: Tohru's still not back yet, huh.\Just how far did she go to shop?\Lady Tohru went home.\No, she's not\She went home.\Huh?\To the other world.\I think the Emperor of Demise, Lady Tohru's father, came to pick her up. response:	What do you mean?
context: Just how far did she go to shop?\Lady Tohru went home.\No, she's not\She went home.\Huh?\To the other world.\I think the Emperor of Demise, Lady Tohru's father, came to pick her up.\What do you mean? response:	I don't think she'll come back to this world anymore.
context: Lady Tohru went home.\No, she's not\She went home.\Huh?\To the other world.\I think the Emperor of Demise, Lady Tohru's father, came to pick her up.\What do you mean?\I don't think she'll come back to this world anymore. response:	Huh?
context: No, she's not\She went home.\Huh?\To the other world.\I think the Emperor of Demise, Lady Tohru's father, came to pick her up.\What do you mean?\I don't think she'll come back to this world anymore.\Huh? response:	She can't go against the Emperor of Demise.
context: She went home.\Huh?\To the other world.\I think the Emperor of Demise, Lady Tohru's father, came to pick her up.\What do you mean?\I don't think she'll come back to this world anymore.\Huh?\She can't go against the Emperor of Demise. response:	I see.
context: Huh?\To the other world.\I think the Emperor of Demise, Lady Tohru's father, came to pick her up.\What do you mean?\I don't think she'll come back to this world anymore.\Huh?\She can't go against the Emperor of Demise.\I see. response:	Seriously?
context: To the other world.\I think the Emperor of Demise, Lady Tohru's father, came to pick her up.\What do you mean?\I don't think she'll come back to this world anymore.\Huh?\She can't go against the Emperor of Demise.\I see.\Seriously? response:	Episode 13
context: I think the Emperor of Demise, Lady Tohru's father, came to pick her up.\What do you mean?\I don't think she'll come back to this world anymore.\Huh?\She can't go against the Emperor of Demise.\I see.\Seriously?\Episode 13 response:	Emperor of Demise Arrives! (It Was the Final Episode Before We Knew It)
context: What do you mean?\I don't think she'll come back to this world anymore.\Huh?\She can't go against the Emperor of Demise.\I see.\Seriously?\Episode 13\Emperor of Demise Arrives! (It Was the Final Episode Before We Knew It) response:	Crap!
context: I don't think she'll come back to this world anymore.\Huh?\She can't go against the Emperor of Demise.\I see.\Seriously?\Episode 13\Emperor of Demise Arrives! (It Was the Final Episode Before We Knew It)\Crap! response:	Kanna-chan, wake up!
context: Huh?\She can't go against the Emperor of Demise.\I see.\Seriously?\Episode 13\Emperor of Demise Arrives! (It Was the Final Episode Before We Knew It)\Crap!\Kanna-chan, wake up! response:	You'll be late!
context: She can't go against the Emperor of Demise.\I see.\Seriously?\Episode 13\Emperor of Demise Arrives! (It Was the Final Episode Before We Knew It)\Crap!\Kanna-chan, wake up!\You'll be late! response:	Shoot, shoot.
context: I see.\Seriously?\Episode 13\Emperor of Demise Arrives! (It Was the Final Episode Before We Knew It)\Crap!\Kanna-chan, wake up!\You'll be late!\Shoot, shoot. response:	I totally forgot!
context: Seriously?\Episode 13\Emperor of Demise Arrives! (It Was the Final Episode Before We Knew It)\Crap!\Kanna-chan, wake up!\You'll be late!\Shoot, shoot.\I totally forgot! response:	Hot!
context: Episode 13\Emperor of Demise Arrives! (It Was the Final Episode Before We Knew It)\Crap!\Kanna-chan, wake up!\You'll be late!\Shoot, shoot.\I totally forgot!\Hot! response:	Oh, man...
context: Emperor of Demise Arrives! (It Was the Final Episode Before We Knew It)\Crap!\Kanna-chan, wake up!\You'll be late!\Shoot, shoot.\I totally forgot!\Hot!\Oh, man... response:	I'm sorry, Kanna-chan.
context: Crap!\Kanna-chan, wake up!\You'll be late!\Shoot, shoot.\I totally forgot!\Hot!\Oh, man...\I'm sorry, Kanna-chan. response:	It's okay.
context: Kanna-chan, wake up!\You'll be late!\Shoot, shoot.\I totally forgot!\Hot!\Oh, man...\I'm sorry, Kanna-chan.\It's okay. response:	Kobayashi-san.
context: You'll be late!\Shoot, shoot.\I totally forgot!\Hot!\Oh, man...\I'm sorry, Kanna-chan.\It's okay.\Kobayashi-san. response:	Kobayashi-san.
context: Shoot, shoot.\I totally forgot!\Hot!\Oh, man...\I'm sorry, Kanna-chan.\It's okay.\Kobayashi-san.\Kobayashi-san. response:	Kobayashi-san?
context: I totally forgot!\Hot!\Oh, man...\I'm sorry, Kanna-chan.\It's okay.\Kobayashi-san.\Kobayashi-san.\Kobayashi-san? response:	Huh?
context: Hot!\Oh, man...\I'm sorry, Kanna-chan.\It's okay.\Kobayashi-san.\Kobayashi-san.\Kobayashi-san?\Huh? response:	Oh, Yamashita-kun.
context: Oh, man...\I'm sorry, Kanna-chan.\It's okay.\Kobayashi-san.\Kobayashi-san.\Kobayashi-san?\Huh?\Oh, Yamashita-kun. response:	About those revisions...
context: I'm sorry, Kanna-chan.\It's okay.\Kobayashi-san.\Kobayashi-san.\Kobayashi-san?\Huh?\Oh, Yamashita-kun.\About those revisions... response:	Yeah, I'll take care of them.
context: It's okay.\Kobayashi-san.\Kobayashi-san.\Kobayashi-san?\Huh?\Oh, Yamashita-kun.\About those revisions...\Yeah, I'll take care of them. response:	Sorry.
context: Kobayashi-san.\Kobayashi-san.\Kobayashi-san?\Huh?\Oh, Yamashita-kun.\About those revisions...\Yeah, I'll take care of them.\Sorry. response:	Kobayashi-san, did something happen?
context: Kobayashi-san.\Kobayashi-san?\Huh?\Oh, Yamashita-kun.\About those revisions...\Yeah, I'll take care of them.\Sorry.\Kobayashi-san, did something happen? response:	Tohru went home.
context: Kobayashi-san?\Huh?\Oh, Yamashita-kun.\About those revisions...\Yeah, I'll take care of them.\Sorry.\Kobayashi-san, did something happen?\Tohru went home. response:	To the other world.
context: Huh?\Oh, Yamashita-kun.\About those revisions...\Yeah, I'll take care of them.\Sorry.\Kobayashi-san, did something happen?\Tohru went home.\To the other world. response:	I see.
context: Oh, Yamashita-kun.\About those revisions...\Yeah, I'll take care of them.\Sorry.\Kobayashi-san, did something happen?\Tohru went home.\To the other world.\I see. response:	Yeah.
context: About those revisions...\Yeah, I'll take care of them.\Sorry.\Kobayashi-san, did something happen?\Tohru went home.\To the other world.\I see.\Yeah. response:	I'm home.
context: Yeah, I'll take care of them.\Sorry.\Kobayashi-san, did something happen?\Tohru went home.\To the other world.\I see.\Yeah.\I'm home. response:	Sorry I'm late.
context: Sorry.\Kobayashi-san, did something happen?\Tohru went home.\To the other world.\I see.\Yeah.\I'm home.\Sorry I'm late. response:	Let's have dinner.
context: Kobayashi-san, did something happen?\Tohru went home.\To the other world.\I see.\Yeah.\I'm home.\Sorry I'm late.\Let's have dinner. response:	Yeah.
context: Tohru went home.\To the other world.\I see.\Yeah.\I'm home.\Sorry I'm late.\Let's have dinner.\Yeah. response:	Burnable Trash
context: To the other world.\I see.\Yeah.\I'm home.\Sorry I'm late.\Let's have dinner.\Yeah.\Burnable Trash response:	Time Set
context: I see.\Yeah.\I'm home.\Sorry I'm late.\Let's have dinner.\Yeah.\Burnable Trash\Time Set response:	Are you all right?
context: Yeah.\I'm home.\Sorry I'm late.\Let's have dinner.\Yeah.\Burnable Trash\Time Set\Are you all right? response:	How so?
context: I'm home.\Sorry I'm late.\Let's have dinner.\Yeah.\Burnable Trash\Time Set\Are you all right?\How so? response:	Staying this late, pulling overtime.
context: Sorry I'm late.\Let's have dinner.\Yeah.\Burnable Trash\Time Set\Are you all right?\How so?\Staying this late, pulling overtime. response:	Kanna-chan's staying at Saikawa-san's place tonight.
context: Let's have dinner.\Yeah.\Burnable Trash\Time Set\Are you all right?\How so?\Staying this late, pulling overtime.\Kanna-chan's staying at Saikawa-san's place tonight. response:	I see.
context: Yeah.\Burnable Trash\Time Set\Are you all right?\How so?\Staying this late, pulling overtime.\Kanna-chan's staying at Saikawa-san's place tonight.\I see. response:	Want to go for drinks after we're done?
context: Burnable Trash\Time Set\Are you all right?\How so?\Staying this late, pulling overtime.\Kanna-chan's staying at Saikawa-san's place tonight.\I see.\Want to go for drinks after we're done? response:	I'll pass tonight.
context: Time Set\Are you all right?\How so?\Staying this late, pulling overtime.\Kanna-chan's staying at Saikawa-san's place tonight.\I see.\Want to go for drinks after we're done?\I'll pass tonight. response:	All right.
context: Are you all right?\How so?\Staying this late, pulling overtime.\Kanna-chan's staying at Saikawa-san's place tonight.\I see.\Want to go for drinks after we're done?\I'll pass tonight.\All right. response:	Next time, then.
context: How so?\Staying this late, pulling overtime.\Kanna-chan's staying at Saikawa-san's place tonight.\I see.\Want to go for drinks after we're done?\I'll pass tonight.\All right.\Next time, then. response:	Yeah.
context: Staying this late, pulling overtime.\Kanna-chan's staying at Saikawa-san's place tonight.\I see.\Want to go for drinks after we're done?\I'll pass tonight.\All right.\Next time, then.\Yeah. response:	Well, Kanna-sama, young lady, good night.
context: Kanna-chan's staying at Saikawa-san's place tonight.\I see.\Want to go for drinks after we're done?\I'll pass tonight.\All right.\Next time, then.\Yeah.\Well, Kanna-sama, young lady, good night. response:	Good night.
context: I see.\Want to go for drinks after we're done?\I'll pass tonight.\All right.\Next time, then.\Yeah.\Well, Kanna-sama, young lady, good night.\Good night. response:	Wh-What's the matter, Kanna-san?
context: Want to go for drinks after we're done?\I'll pass tonight.\All right.\Next time, then.\Yeah.\Well, Kanna-sama, young lady, good night.\Good night.\Wh-What's the matter, Kanna-san? response:	Tohru.
context: I'll pass tonight.\All right.\Next time, then.\Yeah.\Well, Kanna-sama, young lady, good night.\Good night.\Wh-What's the matter, Kanna-san?\Tohru. response:	Hades7: Well, time for me to drop off.
context: All right.\Next time, then.\Yeah.\Well, Kanna-sama, young lady, good night.\Good night.\Wh-What's the matter, Kanna-san?\Tohru.\Hades7: Well, time for me to drop off. response:	Ebony Holy Knight: Oh, me, too.
context: Next time, then.\Yeah.\Well, Kanna-sama, young lady, good night.\Good night.\Wh-What's the matter, Kanna-san?\Tohru.\Hades7: Well, time for me to drop off.\Ebony Holy Knight: Oh, me, too. response:	Ebony Holy Knight: Ooyama-san, good night.
context: Yeah.\Well, Kanna-sama, young lady, good night.\Good night.\Wh-What's the matter, Kanna-san?\Tohru.\Hades7: Well, time for me to drop off.\Ebony Holy Knight: Oh, me, too.\Ebony Holy Knight: Ooyama-san, good night. response:	Crystalite: Pulling another all-nighter?
context: Well, Kanna-sama, young lady, good night.\Good night.\Wh-What's the matter, Kanna-san?\Tohru.\Hades7: Well, time for me to drop off.\Ebony Holy Knight: Oh, me, too.\Ebony Holy Knight: Ooyama-san, good night.\Crystalite: Pulling another all-nighter? response:	Crystalite: That's crazy. Later.
context: Good night.\Wh-What's the matter, Kanna-san?\Tohru.\Hades7: Well, time for me to drop off.\Ebony Holy Knight: Oh, me, too.\Ebony Holy Knight: Ooyama-san, good night.\Crystalite: Pulling another all-nighter?\Crystalite: That's crazy. Later. response:	I'm home.
context: Wh-What's the matter, Kanna-san?\Tohru.\Hades7: Well, time for me to drop off.\Ebony Holy Knight: Oh, me, too.\Ebony Holy Knight: Ooyama-san, good night.\Crystalite: Pulling another all-nighter?\Crystalite: That's crazy. Later.\I'm home. response:	I should've told her the omurice was good,
context: Tohru.\Hades7: Well, time for me to drop off.\Ebony Holy Knight: Oh, me, too.\Ebony Holy Knight: Ooyama-san, good night.\Crystalite: Pulling another all-nighter?\Crystalite: That's crazy. Later.\I'm home.\I should've told her the omurice was good, response:	if things were going to turn out like this.
context: Hades7: Well, time for me to drop off.\Ebony Holy Knight: Oh, me, too.\Ebony Holy Knight: Ooyama-san, good night.\Crystalite: Pulling another all-nighter?\Crystalite: That's crazy. Later.\I'm home.\I should've told her the omurice was good,\if things were going to turn out like this. response:	Miss Kobayashi, it's me!
context: Ebony Holy Knight: Oh, me, too.\Ebony Holy Knight: Ooyama-san, good night.\Crystalite: Pulling another all-nighter?\Crystalite: That's crazy. Later.\I'm home.\I should've told her the omurice was good,\if things were going to turn out like this.\Miss Kobayashi, it's me! response:	Me, Tohru!
context: Ebony Holy Knight: Ooyama-san, good night.\Crystalite: Pulling another all-nighter?\Crystalite: That's crazy. Later.\I'm home.\I should've told her the omurice was good,\if things were going to turn out like this.\Miss Kobayashi, it's me!\Me, Tohru! response:	Tohru?
context: Crystalite: Pulling another all-nighter?\Crystalite: That's crazy. Later.\I'm home.\I should've told her the omurice was good,\if things were going to turn out like this.\Miss Kobayashi, it's me!\Me, Tohru!\Tohru? response:	I'm home, Miss Kobayashi!
context: Crystalite: That's crazy. Later.\I'm home.\I should've told her the omurice was good,\if things were going to turn out like this.\Miss Kobayashi, it's me!\Me, Tohru!\Tohru?\I'm home, Miss Kobayashi! response:	Oh, I can't fit inside in this form.
context: I'm home.\I should've told her the omurice was good,\if things were going to turn out like this.\Miss Kobayashi, it's me!\Me, Tohru!\Tohru?\I'm home, Miss Kobayashi!\Oh, I can't fit inside in this form. response:	Why?
context: I should've told her the omurice was good,\if things were going to turn out like this.\Miss Kobayashi, it's me!\Me, Tohru!\Tohru?\I'm home, Miss Kobayashi!\Oh, I can't fit inside in this form.\Why? response:	Huh?
context: if things were going to turn out like this.\Miss Kobayashi, it's me!\Me, Tohru!\Tohru?\I'm home, Miss Kobayashi!\Oh, I can't fit inside in this form.\Why?\Huh? response:	I thought you went home.
context: Miss Kobayashi, it's me!\Me, Tohru!\Tohru?\I'm home, Miss Kobayashi!\Oh, I can't fit inside in this form.\Why?\Huh?\I thought you went home. response:	To the other world.
context: Me, Tohru!\Tohru?\I'm home, Miss Kobayashi!\Oh, I can't fit inside in this form.\Why?\Huh?\I thought you went home.\To the other world. response:	Yes.
context: Tohru?\I'm home, Miss Kobayashi!\Oh, I can't fit inside in this form.\Why?\Huh?\I thought you went home.\To the other world.\Yes. response:	But I came back.
context: I'm home, Miss Kobayashi!\Oh, I can't fit inside in this form.\Why?\Huh?\I thought you went home.\To the other world.\Yes.\But I came back. response:	This is kind of awkward.
context: Oh, I can't fit inside in this form.\Why?\Huh?\I thought you went home.\To the other world.\Yes.\But I came back.\This is kind of awkward. response:	Yeah.
context: Why?\Huh?\I thought you went home.\To the other world.\Yes.\But I came back.\This is kind of awkward.\Yeah. response:	I'm home, Miss Kobayashi.
context: Huh?\I thought you went home.\To the other world.\Yes.\But I came back.\This is kind of awkward.\Yeah.\I'm home, Miss Kobayashi. response:	What?
context: I thought you went home.\To the other world.\Yes.\But I came back.\This is kind of awkward.\Yeah.\I'm home, Miss Kobayashi.\What? response:	Tohru.
context: To the other world.\Yes.\But I came back.\This is kind of awkward.\Yeah.\I'm home, Miss Kobayashi.\What?\Tohru. response:	Father.
context: Yes.\But I came back.\This is kind of awkward.\Yeah.\I'm home, Miss Kobayashi.\What?\Tohru.\Father. response:	This is Tohru's...
context: But I came back.\This is kind of awkward.\Yeah.\I'm home, Miss Kobayashi.\What?\Tohru.\Father.\This is Tohru's... response:	Why did you come back without permission?
context: This is kind of awkward.\Yeah.\I'm home, Miss Kobayashi.\What?\Tohru.\Father.\This is Tohru's...\Why did you come back without permission? response:	Because I want to be here.
context: Yeah.\I'm home, Miss Kobayashi.\What?\Tohru.\Father.\This is Tohru's...\Why did you come back without permission?\Because I want to be here. response:	Please!
context: I'm home, Miss Kobayashi.\What?\Tohru.\Father.\This is Tohru's...\Why did you come back without permission?\Because I want to be here.\Please! response:	No.
context: What?\Tohru.\Father.\This is Tohru's...\Why did you come back without permission?\Because I want to be here.\Please!\No. response:	I told you. We're forbidden from interfering in this world.
context: Tohru.\Father.\This is Tohru's...\Why did you come back without permission?\Because I want to be here.\Please!\No.\I told you. We're forbidden from interfering in this world. response:	You're coming home with me.
context: Father.\This is Tohru's...\Why did you come back without permission?\Because I want to be here.\Please!\No.\I told you. We're forbidden from interfering in this world.\You're coming home with me. response:	I don't want to!
context: This is Tohru's...\Why did you come back without permission?\Because I want to be here.\Please!\No.\I told you. We're forbidden from interfering in this world.\You're coming home with me.\I don't want to! response:	What you want doesn't matter.
context: Why did you come back without permission?\Because I want to be here.\Please!\No.\I told you. We're forbidden from interfering in this world.\You're coming home with me.\I don't want to!\What you want doesn't matter. response:	You understand. You can't be in this world.
context: Because I want to be here.\Please!\No.\I told you. We're forbidden from interfering in this world.\You're coming home with me.\I don't want to!\What you want doesn't matter.\You understand. You can't be in this world. response:	You can't throw the world into chaos over your whims.
context: Please!\No.\I told you. We're forbidden from interfering in this world.\You're coming home with me.\I don't want to!\What you want doesn't matter.\You understand. You can't be in this world.\You can't throw the world into chaos over your whims. response:	I want to be here.
context: No.\I told you. We're forbidden from interfering in this world.\You're coming home with me.\I don't want to!\What you want doesn't matter.\You understand. You can't be in this world.\You can't throw the world into chaos over your whims.\I want to be here. response:	Because this is where I belong.
context: I told you. We're forbidden from interfering in this world.\You're coming home with me.\I don't want to!\What you want doesn't matter.\You understand. You can't be in this world.\You can't throw the world into chaos over your whims.\I want to be here.\Because this is where I belong. response:	You would live a quiet life as a human?
context: You're coming home with me.\I don't want to!\What you want doesn't matter.\You understand. You can't be in this world.\You can't throw the world into chaos over your whims.\I want to be here.\Because this is where I belong.\You would live a quiet life as a human? response:	One day you'll fray apart.
context: I don't want to!\What you want doesn't matter.\You understand. You can't be in this world.\You can't throw the world into chaos over your whims.\I want to be here.\Because this is where I belong.\You would live a quiet life as a human?\One day you'll fray apart. response:	You've sensed that, haven't you?
context: What you want doesn't matter.\You understand. You can't be in this world.\You can't throw the world into chaos over your whims.\I want to be here.\Because this is where I belong.\You would live a quiet life as a human?\One day you'll fray apart.\You've sensed that, haven't you? response:	Come back, Tohru.
context: You understand. You can't be in this world.\You can't throw the world into chaos over your whims.\I want to be here.\Because this is where I belong.\You would live a quiet life as a human?\One day you'll fray apart.\You've sensed that, haven't you?\Come back, Tohru. response:	Before you get hurt.
context: You can't throw the world into chaos over your whims.\I want to be here.\Because this is where I belong.\You would live a quiet life as a human?\One day you'll fray apart.\You've sensed that, haven't you?\Come back, Tohru.\Before you get hurt. response:	Is it okay if I speak up?
context: I want to be here.\Because this is where I belong.\You would live a quiet life as a human?\One day you'll fray apart.\You've sensed that, haven't you?\Come back, Tohru.\Before you get hurt.\Is it okay if I speak up? response:	That was a mean way of phrasing it.
context: Because this is where I belong.\You would live a quiet life as a human?\One day you'll fray apart.\You've sensed that, haven't you?\Come back, Tohru.\Before you get hurt.\Is it okay if I speak up?\That was a mean way of phrasing it. response:	But it's not nice to butt in between a parent and child.
context: You would live a quiet life as a human?\One day you'll fray apart.\You've sensed that, haven't you?\Come back, Tohru.\Before you get hurt.\Is it okay if I speak up?\That was a mean way of phrasing it.\But it's not nice to butt in between a parent and child. response:	I should probably respect Tohru's decision.
context: One day you'll fray apart.\You've sensed that, haven't you?\Come back, Tohru.\Before you get hurt.\Is it okay if I speak up?\That was a mean way of phrasing it.\But it's not nice to butt in between a parent and child.\I should probably respect Tohru's decision. response:	I don't want to!
context: You've sensed that, haven't you?\Come back, Tohru.\Before you get hurt.\Is it okay if I speak up?\That was a mean way of phrasing it.\But it's not nice to butt in between a parent and child.\I should probably respect Tohru's decision.\I don't want to! response:	Umm...
context: Come back, Tohru.\Before you get hurt.\Is it okay if I speak up?\That was a mean way of phrasing it.\But it's not nice to butt in between a parent and child.\I should probably respect Tohru's decision.\I don't want to!\Umm... response:	Miss Kobayashi!
context: Before you get hurt.\Is it okay if I speak up?\That was a mean way of phrasing it.\But it's not nice to butt in between a parent and child.\I should probably respect Tohru's decision.\I don't want to!\Umm...\Miss Kobayashi! response:	Choose your words carefully.
context: Is it okay if I speak up?\That was a mean way of phrasing it.\But it's not nice to butt in between a parent and child.\I should probably respect Tohru's decision.\I don't want to!\Umm...\Miss Kobayashi!\Choose your words carefully. response:	You might be the one eliminated, depending on what you say.
context: That was a mean way of phrasing it.\But it's not nice to butt in between a parent and child.\I should probably respect Tohru's decision.\I don't want to!\Umm...\Miss Kobayashi!\Choose your words carefully.\You might be the one eliminated, depending on what you say. response:	I'm home, Miss Kobayashi.
context: But it's not nice to butt in between a parent and child.\I should probably respect Tohru's decision.\I don't want to!\Umm...\Miss Kobayashi!\Choose your words carefully.\You might be the one eliminated, depending on what you say.\I'm home, Miss Kobayashi. response:	What is it?
context: I should probably respect Tohru's decision.\I don't want to!\Umm...\Miss Kobayashi!\Choose your words carefully.\You might be the one eliminated, depending on what you say.\I'm home, Miss Kobayashi.\What is it? response:	Tohru said she doesn't want to go back!
context: I don't want to!\Umm...\Miss Kobayashi!\Choose your words carefully.\You might be the one eliminated, depending on what you say.\I'm home, Miss Kobayashi.\What is it?\Tohru said she doesn't want to go back! response:	You...!
context: Umm...\Miss Kobayashi!\Choose your words carefully.\You might be the one eliminated, depending on what you say.\I'm home, Miss Kobayashi.\What is it?\Tohru said she doesn't want to go back!\You...! response:	You can't interfere in this world, right?
context: Miss Kobayashi!\Choose your words carefully.\You might be the one eliminated, depending on what you say.\I'm home, Miss Kobayashi.\What is it?\Tohru said she doesn't want to go back!\You...!\You can't interfere in this world, right? response:	Then you can't kill me.
context: Choose your words carefully.\You might be the one eliminated, depending on what you say.\I'm home, Miss Kobayashi.\What is it?\Tohru said she doesn't want to go back!\You...!\You can't interfere in this world, right?\Then you can't kill me. response:	But I can leave you just shy of death.
context: You might be the one eliminated, depending on what you say.\I'm home, Miss Kobayashi.\What is it?\Tohru said she doesn't want to go back!\You...!\You can't interfere in this world, right?\Then you can't kill me.\But I can leave you just shy of death. response:	That won't change how I feel!
context: I'm home, Miss Kobayashi.\What is it?\Tohru said she doesn't want to go back!\You...!\You can't interfere in this world, right?\Then you can't kill me.\But I can leave you just shy of death.\That won't change how I feel! response:	We must obey the rules of the world.
context: What is it?\Tohru said she doesn't want to go back!\You...!\You can't interfere in this world, right?\Then you can't kill me.\But I can leave you just shy of death.\That won't change how I feel!\We must obey the rules of the world. response:	If the dragons charged with defending order are found to be in this world,
context: Tohru said she doesn't want to go back!\You...!\You can't interfere in this world, right?\Then you can't kill me.\But I can leave you just shy of death.\That won't change how I feel!\We must obey the rules of the world.\If the dragons charged with defending order are found to be in this world, response:	others will be influenced by that and make their way here.
context: You...!\You can't interfere in this world, right?\Then you can't kill me.\But I can leave you just shy of death.\That won't change how I feel!\We must obey the rules of the world.\If the dragons charged with defending order are found to be in this world,\others will be influenced by that and make their way here. response:	Things may be fine now, but eventually some will plot an invasion.
context: You can't interfere in this world, right?\Then you can't kill me.\But I can leave you just shy of death.\That won't change how I feel!\We must obey the rules of the world.\If the dragons charged with defending order are found to be in this world,\others will be influenced by that and make their way here.\Things may be fine now, but eventually some will plot an invasion. response:	What then?
context: Then you can't kill me.\But I can leave you just shy of death.\That won't change how I feel!\We must obey the rules of the world.\If the dragons charged with defending order are found to be in this world,\others will be influenced by that and make their way here.\Things may be fine now, but eventually some will plot an invasion.\What then? response:	That wouldn't be Tohru's fault.
context: But I can leave you just shy of death.\That won't change how I feel!\We must obey the rules of the world.\If the dragons charged with defending order are found to be in this world,\others will be influenced by that and make their way here.\Things may be fine now, but eventually some will plot an invasion.\What then?\That wouldn't be Tohru's fault. response:	You're just twisting this into her responsibility!
context: That won't change how I feel!\We must obey the rules of the world.\If the dragons charged with defending order are found to be in this world,\others will be influenced by that and make their way here.\Things may be fine now, but eventually some will plot an invasion.\What then?\That wouldn't be Tohru's fault.\You're just twisting this into her responsibility! response:	It's a possibility.
context: We must obey the rules of the world.\If the dragons charged with defending order are found to be in this world,\others will be influenced by that and make their way here.\Things may be fine now, but eventually some will plot an invasion.\What then?\That wouldn't be Tohru's fault.\You're just twisting this into her responsibility!\It's a possibility. response:	Who cares?!
context: If the dragons charged with defending order are found to be in this world,\others will be influenced by that and make their way here.\Things may be fine now, but eventually some will plot an invasion.\What then?\That wouldn't be Tohru's fault.\You're just twisting this into her responsibility!\It's a possibility.\Who cares?! response:	Why are you so fixated on Tohru?
context: others will be influenced by that and make their way here.\Things may be fine now, but eventually some will plot an invasion.\What then?\That wouldn't be Tohru's fault.\You're just twisting this into her responsibility!\It's a possibility.\Who cares?!\Why are you so fixated on Tohru? response:	Don't tell me you like Tohru?
context: Things may be fine now, but eventually some will plot an invasion.\What then?\That wouldn't be Tohru's fault.\You're just twisting this into her responsibility!\It's a possibility.\Who cares?!\Why are you so fixated on Tohru?\Don't tell me you like Tohru? response:	I can't believe a human like you would.
context: What then?\That wouldn't be Tohru's fault.\You're just twisting this into her responsibility!\It's a possibility.\Who cares?!\Why are you so fixated on Tohru?\Don't tell me you like Tohru?\I can't believe a human like you would. response:	Really?
context: That wouldn't be Tohru's fault.\You're just twisting this into her responsibility!\It's a possibility.\Who cares?!\Why are you so fixated on Tohru?\Don't tell me you like Tohru?\I can't believe a human like you would.\Really? response:	Tohru's a great girl!
context: You're just twisting this into her responsibility!\It's a possibility.\Who cares?!\Why are you so fixated on Tohru?\Don't tell me you like Tohru?\I can't believe a human like you would.\Really?\Tohru's a great girl! response:	I know that.
context: It's a possibility.\Who cares?!\Why are you so fixated on Tohru?\Don't tell me you like Tohru?\I can't believe a human like you would.\Really?\Tohru's a great girl!\I know that. response:	She's bright and cheerful,
context: Who cares?!\Why are you so fixated on Tohru?\Don't tell me you like Tohru?\I can't believe a human like you would.\Really?\Tohru's a great girl!\I know that.\She's bright and cheerful, response:	and sometimes she feels down, but she hides it with a laugh.
context: Why are you so fixated on Tohru?\Don't tell me you like Tohru?\I can't believe a human like you would.\Really?\Tohru's a great girl!\I know that.\She's bright and cheerful,\and sometimes she feels down, but she hides it with a laugh. response:	And to top it off, she's a maid!
context: Don't tell me you like Tohru?\I can't believe a human like you would.\Really?\Tohru's a great girl!\I know that.\She's bright and cheerful,\and sometimes she feels down, but she hides it with a laugh.\And to top it off, she's a maid! response:	Do you get it?
context: I can't believe a human like you would.\Really?\Tohru's a great girl!\I know that.\She's bright and cheerful,\and sometimes she feels down, but she hides it with a laugh.\And to top it off, she's a maid!\Do you get it? response:	Don't take my maid away!
context: Really?\Tohru's a great girl!\I know that.\She's bright and cheerful,\and sometimes she feels down, but she hides it with a laugh.\And to top it off, she's a maid!\Do you get it?\Don't take my maid away! response:	She's mine!
context: Tohru's a great girl!\I know that.\She's bright and cheerful,\and sometimes she feels down, but she hides it with a laugh.\And to top it off, she's a maid!\Do you get it?\Don't take my maid away!\She's mine! response:	You overstep
context: I know that.\She's bright and cheerful,\and sometimes she feels down, but she hides it with a laugh.\And to top it off, she's a maid!\Do you get it?\Don't take my maid away!\She's mine!\You overstep response:	I see.
context: She's bright and cheerful,\and sometimes she feels down, but she hides it with a laugh.\And to top it off, she's a maid!\Do you get it?\Don't take my maid away!\She's mine!\You overstep\I see. response:	In that case, this space is too small.
context: and sometimes she feels down, but she hides it with a laugh.\And to top it off, she's a maid!\Do you get it?\Don't take my maid away!\She's mine!\You overstep\I see.\In that case, this space is too small. response:	Tohru.
context: And to top it off, she's a maid!\Do you get it?\Don't take my maid away!\She's mine!\You overstep\I see.\In that case, this space is too small.\Tohru. response:	This is a first.
context: Do you get it?\Don't take my maid away!\She's mine!\You overstep\I see.\In that case, this space is too small.\Tohru.\This is a first. response:	You rebelling against me.
context: Don't take my maid away!\She's mine!\You overstep\I see.\In that case, this space is too small.\Tohru.\This is a first.\You rebelling against me. response:	I'll decide where I belong on my own.
context: She's mine!\You overstep\I see.\In that case, this space is too small.\Tohru.\This is a first.\You rebelling against me.\I'll decide where I belong on my own. response:	Hmph.
context: You overstep\I see.\In that case, this space is too small.\Tohru.\This is a first.\You rebelling against me.\I'll decide where I belong on my own.\Hmph. response:	I respect you, Father.
context: I see.\In that case, this space is too small.\Tohru.\This is a first.\You rebelling against me.\I'll decide where I belong on my own.\Hmph.\I respect you, Father. response:	I admire you.
context: In that case, this space is too small.\Tohru.\This is a first.\You rebelling against me.\I'll decide where I belong on my own.\Hmph.\I respect you, Father.\I admire you. response:	But that's as a dragon.
context: Tohru.\This is a first.\You rebelling against me.\I'll decide where I belong on my own.\Hmph.\I respect you, Father.\I admire you.\But that's as a dragon. response:	Miss Kobayashi is my...
context: This is a first.\You rebelling against me.\I'll decide where I belong on my own.\Hmph.\I respect you, Father.\I admire you.\But that's as a dragon.\Miss Kobayashi is my... response:	my...
context: You rebelling against me.\I'll decide where I belong on my own.\Hmph.\I respect you, Father.\I admire you.\But that's as a dragon.\Miss Kobayashi is my...\my... response:	my light!
context: I'll decide where I belong on my own.\Hmph.\I respect you, Father.\I admire you.\But that's as a dragon.\Miss Kobayashi is my...\my...\my light! response:	You know nothing.
context: Hmph.\I respect you, Father.\I admire you.\But that's as a dragon.\Miss Kobayashi is my...\my...\my light!\You know nothing. response:	In that case...!
context: I respect you, Father.\I admire you.\But that's as a dragon.\Miss Kobayashi is my...\my...\my light!\You know nothing.\In that case...! response:	If you defy me, I won't show mercy.
context: I admire you.\But that's as a dragon.\Miss Kobayashi is my...\my...\my light!\You know nothing.\In that case...!\If you defy me, I won't show mercy. response:	Come home, stupid daughter.
context: But that's as a dragon.\Miss Kobayashi is my...\my...\my light!\You know nothing.\In that case...!\If you defy me, I won't show mercy.\Come home, stupid daughter. response:	I won't go back!
context: Miss Kobayashi is my...\my...\my light!\You know nothing.\In that case...!\If you defy me, I won't show mercy.\Come home, stupid daughter.\I won't go back! response:	I won't allow it!
context: my...\my light!\You know nothing.\In that case...!\If you defy me, I won't show mercy.\Come home, stupid daughter.\I won't go back!\I won't allow it! response:	Not with a human!
context: my light!\You know nothing.\In that case...!\If you defy me, I won't show mercy.\Come home, stupid daughter.\I won't go back!\I won't allow it!\Not with a human! response:	Miss Kobayashi's special!
context: You know nothing.\In that case...!\If you defy me, I won't show mercy.\Come home, stupid daughter.\I won't go back!\I won't allow it!\Not with a human!\Miss Kobayashi's special! response:	There!
context: In that case...!\If you defy me, I won't show mercy.\Come home, stupid daughter.\I won't go back!\I won't allow it!\Not with a human!\Miss Kobayashi's special!\There! response:	This is your last chance. Come home.
context: If you defy me, I won't show mercy.\Come home, stupid daughter.\I won't go back!\I won't allow it!\Not with a human!\Miss Kobayashi's special!\There!\This is your last chance. Come home. response:	I won't go back!
context: Come home, stupid daughter.\I won't go back!\I won't allow it!\Not with a human!\Miss Kobayashi's special!\There!\This is your last chance. Come home.\I won't go back! response:	You hardhead!
context: I won't go back!\I won't allow it!\Not with a human!\Miss Kobayashi's special!\There!\This is your last chance. Come home.\I won't go back!\You hardhead! response:	Wait, wait, wait!
context: I won't allow it!\Not with a human!\Miss Kobayashi's special!\There!\This is your last chance. Come home.\I won't go back!\You hardhead!\Wait, wait, wait! response:	Kanna? Miss Kobayashi?
context: Not with a human!\Miss Kobayashi's special!\There!\This is your last chance. Come home.\I won't go back!\You hardhead!\Wait, wait, wait!\Kanna? Miss Kobayashi? response:	Why are you two fighting?!
context: Miss Kobayashi's special!\There!\This is your last chance. Come home.\I won't go back!\You hardhead!\Wait, wait, wait!\Kanna? Miss Kobayashi?\Why are you two fighting?! response:	Stay out of this, human.
context: There!\This is your last chance. Come home.\I won't go back!\You hardhead!\Wait, wait, wait!\Kanna? Miss Kobayashi?\Why are you two fighting?!\Stay out of this, human. response:	I'm sorry, Miss Kobayashi, but could you step back for a bit?
context: This is your last chance. Come home.\I won't go back!\You hardhead!\Wait, wait, wait!\Kanna? Miss Kobayashi?\Why are you two fighting?!\Stay out of this, human.\I'm sorry, Miss Kobayashi, but could you step back for a bit? response:	Why are you dragons like this?
context: I won't go back!\You hardhead!\Wait, wait, wait!\Kanna? Miss Kobayashi?\Why are you two fighting?!\Stay out of this, human.\I'm sorry, Miss Kobayashi, but could you step back for a bit?\Why are you dragons like this? response:	You'll never get anywhere if you can't compromise.
context: You hardhead!\Wait, wait, wait!\Kanna? Miss Kobayashi?\Why are you two fighting?!\Stay out of this, human.\I'm sorry, Miss Kobayashi, but could you step back for a bit?\Why are you dragons like this?\You'll never get anywhere if you can't compromise. response:	What are you getting at?
context: Wait, wait, wait!\Kanna? Miss Kobayashi?\Why are you two fighting?!\Stay out of this, human.\I'm sorry, Miss Kobayashi, but could you step back for a bit?\Why are you dragons like this?\You'll never get anywhere if you can't compromise.\What are you getting at? response:	You're being extreme!
context: Kanna? Miss Kobayashi?\Why are you two fighting?!\Stay out of this, human.\I'm sorry, Miss Kobayashi, but could you step back for a bit?\Why are you dragons like this?\You'll never get anywhere if you can't compromise.\What are you getting at?\You're being extreme! response:	I can never understand that.
context: Why are you two fighting?!\Stay out of this, human.\I'm sorry, Miss Kobayashi, but could you step back for a bit?\Why are you dragons like this?\You'll never get anywhere if you can't compromise.\What are you getting at?\You're being extreme!\I can never understand that. response:	Of course. Humans could never understand us.
context: Stay out of this, human.\I'm sorry, Miss Kobayashi, but could you step back for a bit?\Why are you dragons like this?\You'll never get anywhere if you can't compromise.\What are you getting at?\You're being extreme!\I can never understand that.\Of course. Humans could never understand us. response:	Not so.
context: I'm sorry, Miss Kobayashi, but could you step back for a bit?\Why are you dragons like this?\You'll never get anywhere if you can't compromise.\What are you getting at?\You're being extreme!\I can never understand that.\Of course. Humans could never understand us.\Not so. response:	Hmm?
context: Why are you dragons like this?\You'll never get anywhere if you can't compromise.\What are you getting at?\You're being extreme!\I can never understand that.\Of course. Humans could never understand us.\Not so.\Hmm? response:	Knowing you're different is only the start.
context: You'll never get anywhere if you can't compromise.\What are you getting at?\You're being extreme!\I can never understand that.\Of course. Humans could never understand us.\Not so.\Hmm?\Knowing you're different is only the start. response:	You grow closer or more distant,
context: What are you getting at?\You're being extreme!\I can never understand that.\Of course. Humans could never understand us.\Not so.\Hmm?\Knowing you're different is only the start.\You grow closer or more distant, response:	again and again, while realizing those differences.
context: You're being extreme!\I can never understand that.\Of course. Humans could never understand us.\Not so.\Hmm?\Knowing you're different is only the start.\You grow closer or more distant,\again and again, while realizing those differences. response:	And then you start finding the aspects you like.
context: I can never understand that.\Of course. Humans could never understand us.\Not so.\Hmm?\Knowing you're different is only the start.\You grow closer or more distant,\again and again, while realizing those differences.\And then you start finding the aspects you like. response:	You can even build respect.
context: Of course. Humans could never understand us.\Not so.\Hmm?\Knowing you're different is only the start.\You grow closer or more distant,\again and again, while realizing those differences.\And then you start finding the aspects you like.\You can even build respect. response:	Respect?
context: Not so.\Hmm?\Knowing you're different is only the start.\You grow closer or more distant,\again and again, while realizing those differences.\And then you start finding the aspects you like.\You can even build respect.\Respect? response:	Then you can forge both trust and bonds.
context: Hmm?\Knowing you're different is only the start.\You grow closer or more distant,\again and again, while realizing those differences.\And then you start finding the aspects you like.\You can even build respect.\Respect?\Then you can forge both trust and bonds. response:	Do you genuinely believe you can live alongside her?
context: Knowing you're different is only the start.\You grow closer or more distant,\again and again, while realizing those differences.\And then you start finding the aspects you like.\You can even build respect.\Respect?\Then you can forge both trust and bonds.\Do you genuinely believe you can live alongside her? response:	You're wrong!
context: You grow closer or more distant,\again and again, while realizing those differences.\And then you start finding the aspects you like.\You can even build respect.\Respect?\Then you can forge both trust and bonds.\Do you genuinely believe you can live alongside her?\You're wrong! response:	We've already been doing that for a long time.
context: again and again, while realizing those differences.\And then you start finding the aspects you like.\You can even build respect.\Respect?\Then you can forge both trust and bonds.\Do you genuinely believe you can live alongside her?\You're wrong!\We've already been doing that for a long time. response:	It's about whether or not you believe it can last.
context: And then you start finding the aspects you like.\You can even build respect.\Respect?\Then you can forge both trust and bonds.\Do you genuinely believe you can live alongside her?\You're wrong!\We've already been doing that for a long time.\It's about whether or not you believe it can last. response:	I believed it would.
context: You can even build respect.\Respect?\Then you can forge both trust and bonds.\Do you genuinely believe you can live alongside her?\You're wrong!\We've already been doing that for a long time.\It's about whether or not you believe it can last.\I believed it would. response:	What about you?
context: Respect?\Then you can forge both trust and bonds.\Do you genuinely believe you can live alongside her?\You're wrong!\We've already been doing that for a long time.\It's about whether or not you believe it can last.\I believed it would.\What about you? response:	Try having faith in your daughter!
context: Then you can forge both trust and bonds.\Do you genuinely believe you can live alongside her?\You're wrong!\We've already been doing that for a long time.\It's about whether or not you believe it can last.\I believed it would.\What about you?\Try having faith in your daughter! response:	I won't approve.
context: Do you genuinely believe you can live alongside her?\You're wrong!\We've already been doing that for a long time.\It's about whether or not you believe it can last.\I believed it would.\What about you?\Try having faith in your daughter!\I won't approve. response:	Not with something like a human who doesn't even have the lifespan to live alongside her.
context: You're wrong!\We've already been doing that for a long time.\It's about whether or not you believe it can last.\I believed it would.\What about you?\Try having faith in your daughter!\I won't approve.\Not with something like a human who doesn't even have the lifespan to live alongside her. response:	Tohru. My foolish daughter.
context: We've already been doing that for a long time.\It's about whether or not you believe it can last.\I believed it would.\What about you?\Try having faith in your daughter!\I won't approve.\Not with something like a human who doesn't even have the lifespan to live alongside her.\Tohru. My foolish daughter. response:	Sorry for being selfish.
context: It's about whether or not you believe it can last.\I believed it would.\What about you?\Try having faith in your daughter!\I won't approve.\Not with something like a human who doesn't even have the lifespan to live alongside her.\Tohru. My foolish daughter.\Sorry for being selfish. response:	What should I give you?
context: I believed it would.\What about you?\Try having faith in your daughter!\I won't approve.\Not with something like a human who doesn't even have the lifespan to live alongside her.\Tohru. My foolish daughter.\Sorry for being selfish.\What should I give you? response:	Everything. I'll give you everything!
context: What about you?\Try having faith in your daughter!\I won't approve.\Not with something like a human who doesn't even have the lifespan to live alongside her.\Tohru. My foolish daughter.\Sorry for being selfish.\What should I give you?\Everything. I'll give you everything! response:	I don't need that much.
context: Try having faith in your daughter!\I won't approve.\Not with something like a human who doesn't even have the lifespan to live alongside her.\Tohru. My foolish daughter.\Sorry for being selfish.\What should I give you?\Everything. I'll give you everything!\I don't need that much. response:	Good morning, Tohru.
context: I won't approve.\Not with something like a human who doesn't even have the lifespan to live alongside her.\Tohru. My foolish daughter.\Sorry for being selfish.\What should I give you?\Everything. I'll give you everything!\I don't need that much.\Good morning, Tohru. response:	Good morning, Miss Kobayashi.
context: Not with something like a human who doesn't even have the lifespan to live alongside her.\Tohru. My foolish daughter.\Sorry for being selfish.\What should I give you?\Everything. I'll give you everything!\I don't need that much.\Good morning, Tohru.\Good morning, Miss Kobayashi. response:	Good morning, Lady Tohru.
context: Tohru. My foolish daughter.\Sorry for being selfish.\What should I give you?\Everything. I'll give you everything!\I don't need that much.\Good morning, Tohru.\Good morning, Miss Kobayashi.\Good morning, Lady Tohru. response:	Morning, Kanna.
context: Sorry for being selfish.\What should I give you?\Everything. I'll give you everything!\I don't need that much.\Good morning, Tohru.\Good morning, Miss Kobayashi.\Good morning, Lady Tohru.\Morning, Kanna. response:	Okay, I'm heading out.
context: What should I give you?\Everything. I'll give you everything!\I don't need that much.\Good morning, Tohru.\Good morning, Miss Kobayashi.\Good morning, Lady Tohru.\Morning, Kanna.\Okay, I'm heading out. response:	We're out of conditioner.
context: Everything. I'll give you everything!\I don't need that much.\Good morning, Tohru.\Good morning, Miss Kobayashi.\Good morning, Lady Tohru.\Morning, Kanna.\Okay, I'm heading out.\We're out of conditioner. response:	Okay, I'll buy some.
context: I don't need that much.\Good morning, Tohru.\Good morning, Miss Kobayashi.\Good morning, Lady Tohru.\Morning, Kanna.\Okay, I'm heading out.\We're out of conditioner.\Okay, I'll buy some. response:	Also...
context: Good morning, Tohru.\Good morning, Miss Kobayashi.\Good morning, Lady Tohru.\Morning, Kanna.\Okay, I'm heading out.\We're out of conditioner.\Okay, I'll buy some.\Also... response:	8 o'clock, right?
context: Good morning, Miss Kobayashi.\Good morning, Lady Tohru.\Morning, Kanna.\Okay, I'm heading out.\We're out of conditioner.\Okay, I'll buy some.\Also...\8 o'clock, right? response:	I know.
context: Good morning, Lady Tohru.\Morning, Kanna.\Okay, I'm heading out.\We're out of conditioner.\Okay, I'll buy some.\Also...\8 o'clock, right?\I know. response:	Kanna-san said she was coming over to play again today.
context: Morning, Kanna.\Okay, I'm heading out.\We're out of conditioner.\Okay, I'll buy some.\Also...\8 o'clock, right?\I know.\Kanna-san said she was coming over to play again today. response:	In that case, I'll prepare chocolates.
context: Okay, I'm heading out.\We're out of conditioner.\Okay, I'll buy some.\Also...\8 o'clock, right?\I know.\Kanna-san said she was coming over to play again today.\In that case, I'll prepare chocolates. response:	Chocolates?
context: We're out of conditioner.\Okay, I'll buy some.\Also...\8 o'clock, right?\I know.\Kanna-san said she was coming over to play again today.\In that case, I'll prepare chocolates.\Chocolates? response:	Take care, Shouta.
context: Okay, I'll buy some.\Also...\8 o'clock, right?\I know.\Kanna-san said she was coming over to play again today.\In that case, I'll prepare chocolates.\Chocolates?\Take care, Shouta. response:	Stop it!
context: Also...\8 o'clock, right?\I know.\Kanna-san said she was coming over to play again today.\In that case, I'll prepare chocolates.\Chocolates?\Take care, Shouta.\Stop it! response:	Try our new waffles!
context: 8 o'clock, right?\I know.\Kanna-san said she was coming over to play again today.\In that case, I'll prepare chocolates.\Chocolates?\Take care, Shouta.\Stop it!\Try our new waffles! response:	Thank you very much.
context: I know.\Kanna-san said she was coming over to play again today.\In that case, I'll prepare chocolates.\Chocolates?\Take care, Shouta.\Stop it!\Try our new waffles!\Thank you very much. response:	Tohru.
context: Kanna-san said she was coming over to play again today.\In that case, I'll prepare chocolates.\Chocolates?\Take care, Shouta.\Stop it!\Try our new waffles!\Thank you very much.\Tohru. response:	Yes?
context: In that case, I'll prepare chocolates.\Chocolates?\Take care, Shouta.\Stop it!\Try our new waffles!\Thank you very much.\Tohru.\Yes? response:	I'm thinking of going home for the first time in a while.
context: Chocolates?\Take care, Shouta.\Stop it!\Try our new waffles!\Thank you very much.\Tohru.\Yes?\I'm thinking of going home for the first time in a while. response:	Oh, sounds nice.
context: Take care, Shouta.\Stop it!\Try our new waffles!\Thank you very much.\Tohru.\Yes?\I'm thinking of going home for the first time in a while.\Oh, sounds nice. response:	Please, you should go.
context: Stop it!\Try our new waffles!\Thank you very much.\Tohru.\Yes?\I'm thinking of going home for the first time in a while.\Oh, sounds nice.\Please, you should go. response:	Will you come with me?
context: Try our new waffles!\Thank you very much.\Tohru.\Yes?\I'm thinking of going home for the first time in a while.\Oh, sounds nice.\Please, you should go.\Will you come with me? response:	I'll never be able to grow old with Miss Kobayashi.
context: Thank you very much.\Tohru.\Yes?\I'm thinking of going home for the first time in a while.\Oh, sounds nice.\Please, you should go.\Will you come with me?\I'll never be able to grow old with Miss Kobayashi. response:	One day, the time will come when we have to part.
context: Tohru.\Yes?\I'm thinking of going home for the first time in a while.\Oh, sounds nice.\Please, you should go.\Will you come with me?\I'll never be able to grow old with Miss Kobayashi.\One day, the time will come when we have to part. response:	Even so, I would never think I was better off not meeting her.
context: Yes?\I'm thinking of going home for the first time in a while.\Oh, sounds nice.\Please, you should go.\Will you come with me?\I'll never be able to grow old with Miss Kobayashi.\One day, the time will come when we have to part.\Even so, I would never think I was better off not meeting her. response:	I just want to treasure this time we have.
context: I'm thinking of going home for the first time in a while.\Oh, sounds nice.\Please, you should go.\Will you come with me?\I'll never be able to grow old with Miss Kobayashi.\One day, the time will come when we have to part.\Even so, I would never think I was better off not meeting her.\I just want to treasure this time we have. response:	I'm home.