context: Ilulu. response:	Ilulu.
context: Ilulu.\Ilulu. response:	Were you playing with humans again?
context: Ilulu.\Ilulu.\Were you playing with humans again? response:	Yeah.
context: Ilulu.\Ilulu.\Were you playing with humans again?\Yeah. response:	Humans are nice, so I love them!
context: Ilulu.\Ilulu.\Were you playing with humans again?\Yeah.\Humans are nice, so I love them! response:	I see.
context: Ilulu.\Ilulu.\Were you playing with humans again?\Yeah.\Humans are nice, so I love them!\I see. response:	Perhaps it is time we consider coexisting, then.
context: Ilulu.\Ilulu.\Were you playing with humans again?\Yeah.\Humans are nice, so I love them!\I see.\Perhaps it is time we consider coexisting, then. response:	Bad news!
context: Ilulu.\Ilulu.\Were you playing with humans again?\Yeah.\Humans are nice, so I love them!\I see.\Perhaps it is time we consider coexisting, then.\Bad news! response:	The humans are attacking the dragon village!
context: Ilulu.\Were you playing with humans again?\Yeah.\Humans are nice, so I love them!\I see.\Perhaps it is time we consider coexisting, then.\Bad news!\The humans are attacking the dragon village! response:	This always happens when we stay quiet.
context: Were you playing with humans again?\Yeah.\Humans are nice, so I love them!\I see.\Perhaps it is time we consider coexisting, then.\Bad news!\The humans are attacking the dragon village!\This always happens when we stay quiet. response:	Damn humans!
context: Yeah.\Humans are nice, so I love them!\I see.\Perhaps it is time we consider coexisting, then.\Bad news!\The humans are attacking the dragon village!\This always happens when we stay quiet.\Damn humans! response:	They will pay!
context: Humans are nice, so I love them!\I see.\Perhaps it is time we consider coexisting, then.\Bad news!\The humans are attacking the dragon village!\This always happens when we stay quiet.\Damn humans!\They will pay! response:	Where's Mom and Dad?
context: I see.\Perhaps it is time we consider coexisting, then.\Bad news!\The humans are attacking the dragon village!\This always happens when we stay quiet.\Damn humans!\They will pay!\Where's Mom and Dad? response:	I'm sorry, dear.
context: Perhaps it is time we consider coexisting, then.\Bad news!\The humans are attacking the dragon village!\This always happens when we stay quiet.\Damn humans!\They will pay!\Where's Mom and Dad?\I'm sorry, dear. response:	Does this mean I can't play with humans anymore?
context: Bad news!\The humans are attacking the dragon village!\This always happens when we stay quiet.\Damn humans!\They will pay!\Where's Mom and Dad?\I'm sorry, dear.\Does this mean I can't play with humans anymore? response:	Of course it does!
context: The humans are attacking the dragon village!\This always happens when we stay quiet.\Damn humans!\They will pay!\Where's Mom and Dad?\I'm sorry, dear.\Does this mean I can't play with humans anymore?\Of course it does! response:	The humans are the ones who took your parents from you!
context: This always happens when we stay quiet.\Damn humans!\They will pay!\Where's Mom and Dad?\I'm sorry, dear.\Does this mean I can't play with humans anymore?\Of course it does!\The humans are the ones who took your parents from you! response:	Humans are our enemy!
context: Damn humans!\They will pay!\Where's Mom and Dad?\I'm sorry, dear.\Does this mean I can't play with humans anymore?\Of course it does!\The humans are the ones who took your parents from you!\Humans are our enemy! response:	There will never be understanding between us!
context: They will pay!\Where's Mom and Dad?\I'm sorry, dear.\Does this mean I can't play with humans anymore?\Of course it does!\The humans are the ones who took your parents from you!\Humans are our enemy!\There will never be understanding between us! response:	Good.
context: Where's Mom and Dad?\I'm sorry, dear.\Does this mean I can't play with humans anymore?\Of course it does!\The humans are the ones who took your parents from you!\Humans are our enemy!\There will never be understanding between us!\Good. response:	Everyone's asleep.
context: I'm sorry, dear.\Does this mean I can't play with humans anymore?\Of course it does!\The humans are the ones who took your parents from you!\Humans are our enemy!\There will never be understanding between us!\Good.\Everyone's asleep. response:	I can't believe the first one I'd see aside from my father's would be my own...
context: Does this mean I can't play with humans anymore?\Of course it does!\The humans are the ones who took your parents from you!\Humans are our enemy!\There will never be understanding between us!\Good.\Everyone's asleep.\I can't believe the first one I'd see aside from my father's would be my own... response:	Jeez, please say something if you're going to be late.
context: Of course it does!\The humans are the ones who took your parents from you!\Humans are our enemy!\There will never be understanding between us!\Good.\Everyone's asleep.\I can't believe the first one I'd see aside from my father's would be my own...\Jeez, please say something if you're going to be late. response:	Oh, yeah. Sorry.
context: The humans are the ones who took your parents from you!\Humans are our enemy!\There will never be understanding between us!\Good.\Everyone's asleep.\I can't believe the first one I'd see aside from my father's would be my own...\Jeez, please say something if you're going to be late.\Oh, yeah. Sorry. response:	What's the matter, Miss Kobayashi?
context: Humans are our enemy!\There will never be understanding between us!\Good.\Everyone's asleep.\I can't believe the first one I'd see aside from my father's would be my own...\Jeez, please say something if you're going to be late.\Oh, yeah. Sorry.\What's the matter, Miss Kobayashi? response:	Your face is bright red.
context: There will never be understanding between us!\Good.\Everyone's asleep.\I can't believe the first one I'd see aside from my father's would be my own...\Jeez, please say something if you're going to be late.\Oh, yeah. Sorry.\What's the matter, Miss Kobayashi?\Your face is bright red. response:	Huh?
context: Good.\Everyone's asleep.\I can't believe the first one I'd see aside from my father's would be my own...\Jeez, please say something if you're going to be late.\Oh, yeah. Sorry.\What's the matter, Miss Kobayashi?\Your face is bright red.\Huh? response:	Do you have a cold?
context: Everyone's asleep.\I can't believe the first one I'd see aside from my father's would be my own...\Jeez, please say something if you're going to be late.\Oh, yeah. Sorry.\What's the matter, Miss Kobayashi?\Your face is bright red.\Huh?\Do you have a cold? response:	I-I'm fine!
context: I can't believe the first one I'd see aside from my father's would be my own...\Jeez, please say something if you're going to be late.\Oh, yeah. Sorry.\What's the matter, Miss Kobayashi?\Your face is bright red.\Huh?\Do you have a cold?\I-I'm fine! response:	Huh? Why?!
context: Jeez, please say something if you're going to be late.\Oh, yeah. Sorry.\What's the matter, Miss Kobayashi?\Your face is bright red.\Huh?\Do you have a cold?\I-I'm fine!\Huh? Why?! response:	Why is my heart racing because Tohru looks like this?!
context: Oh, yeah. Sorry.\What's the matter, Miss Kobayashi?\Your face is bright red.\Huh?\Do you have a cold?\I-I'm fine!\Huh? Why?!\Why is my heart racing because Tohru looks like this?! response:	Does this mean I'm lusting after Tohru?
context: What's the matter, Miss Kobayashi?\Your face is bright red.\Huh?\Do you have a cold?\I-I'm fine!\Huh? Why?!\Why is my heart racing because Tohru looks like this?!\Does this mean I'm lusting after Tohru? response:	Just put your clothes on.
context: Your face is bright red.\Huh?\Do you have a cold?\I-I'm fine!\Huh? Why?!\Why is my heart racing because Tohru looks like this?!\Does this mean I'm lusting after Tohru?\Just put your clothes on. response:	Okay.
context: Huh?\Do you have a cold?\I-I'm fine!\Huh? Why?!\Why is my heart racing because Tohru looks like this?!\Does this mean I'm lusting after Tohru?\Just put your clothes on.\Okay. response:	Kobayashi,
context: Do you have a cold?\I-I'm fine!\Huh? Why?!\Why is my heart racing because Tohru looks like this?!\Does this mean I'm lusting after Tohru?\Just put your clothes on.\Okay.\Kobayashi, response:	now that you've become a man,
context: I-I'm fine!\Huh? Why?!\Why is my heart racing because Tohru looks like this?!\Does this mean I'm lusting after Tohru?\Just put your clothes on.\Okay.\Kobayashi,\now that you've become a man, response:	you'll show your true colors in no time!
context: Huh? Why?!\Why is my heart racing because Tohru looks like this?!\Does this mean I'm lusting after Tohru?\Just put your clothes on.\Okay.\Kobayashi,\now that you've become a man,\you'll show your true colors in no time! response:	Now, show me!
context: Why is my heart racing because Tohru looks like this?!\Does this mean I'm lusting after Tohru?\Just put your clothes on.\Okay.\Kobayashi,\now that you've become a man,\you'll show your true colors in no time!\Now, show me! response:	Show me how shallow humans are!
context: Does this mean I'm lusting after Tohru?\Just put your clothes on.\Okay.\Kobayashi,\now that you've become a man,\you'll show your true colors in no time!\Now, show me!\Show me how shallow humans are! response:	I bet that's what she's thinking.
context: Just put your clothes on.\Okay.\Kobayashi,\now that you've become a man,\you'll show your true colors in no time!\Now, show me!\Show me how shallow humans are!\I bet that's what she's thinking. response:	I'm betting Ilulu used magic to turn me into a guy.
context: Okay.\Kobayashi,\now that you've become a man,\you'll show your true colors in no time!\Now, show me!\Show me how shallow humans are!\I bet that's what she's thinking.\I'm betting Ilulu used magic to turn me into a guy. response:	I just hope I go back to normal with time.
context: Kobayashi,\now that you've become a man,\you'll show your true colors in no time!\Now, show me!\Show me how shallow humans are!\I bet that's what she's thinking.\I'm betting Ilulu used magic to turn me into a guy.\I just hope I go back to normal with time. response:	I don't know what Ilulu hopes to get out of me,
context: now that you've become a man,\you'll show your true colors in no time!\Now, show me!\Show me how shallow humans are!\I bet that's what she's thinking.\I'm betting Ilulu used magic to turn me into a guy.\I just hope I go back to normal with time.\I don't know what Ilulu hopes to get out of me, response:	but I need to keep a clear head.
context: you'll show your true colors in no time!\Now, show me!\Show me how shallow humans are!\I bet that's what she's thinking.\I'm betting Ilulu used magic to turn me into a guy.\I just hope I go back to normal with time.\I don't know what Ilulu hopes to get out of me,\but I need to keep a clear head. response:	K-Kanna-chan?!
context: Now, show me!\Show me how shallow humans are!\I bet that's what she's thinking.\I'm betting Ilulu used magic to turn me into a guy.\I just hope I go back to normal with time.\I don't know what Ilulu hopes to get out of me,\but I need to keep a clear head.\K-Kanna-chan?! response:	Good morning, Kobayashi.
context: Show me how shallow humans are!\I bet that's what she's thinking.\I'm betting Ilulu used magic to turn me into a guy.\I just hope I go back to normal with time.\I don't know what Ilulu hopes to get out of me,\but I need to keep a clear head.\K-Kanna-chan?!\Good morning, Kobayashi. response:	What's wrong?
context: I bet that's what she's thinking.\I'm betting Ilulu used magic to turn me into a guy.\I just hope I go back to normal with time.\I don't know what Ilulu hopes to get out of me,\but I need to keep a clear head.\K-Kanna-chan?!\Good morning, Kobayashi.\What's wrong? response:	I thought you'd be cold in the morning.
context: I'm betting Ilulu used magic to turn me into a guy.\I just hope I go back to normal with time.\I don't know what Ilulu hopes to get out of me,\but I need to keep a clear head.\K-Kanna-chan?!\Good morning, Kobayashi.\What's wrong?\I thought you'd be cold in the morning. response:	I-I'm awake already, okay?
context: I just hope I go back to normal with time.\I don't know what Ilulu hopes to get out of me,\but I need to keep a clear head.\K-Kanna-chan?!\Good morning, Kobayashi.\What's wrong?\I thought you'd be cold in the morning.\I-I'm awake already, okay? response:	At this point, I have no idea what might happen.
context: I don't know what Ilulu hopes to get out of me,\but I need to keep a clear head.\K-Kanna-chan?!\Good morning, Kobayashi.\What's wrong?\I thought you'd be cold in the morning.\I-I'm awake already, okay?\At this point, I have no idea what might happen. response:	I'll need to keep some distance from the others.
context: but I need to keep a clear head.\K-Kanna-chan?!\Good morning, Kobayashi.\What's wrong?\I thought you'd be cold in the morning.\I-I'm awake already, okay?\At this point, I have no idea what might happen.\I'll need to keep some distance from the others. response:	I wonder if Tohru could fix this.
context: K-Kanna-chan?!\Good morning, Kobayashi.\What's wrong?\I thought you'd be cold in the morning.\I-I'm awake already, okay?\At this point, I have no idea what might happen.\I'll need to keep some distance from the others.\I wonder if Tohru could fix this. response:	Huh?! Miss Kobayashi's become a male?!
context: Good morning, Kobayashi.\What's wrong?\I thought you'd be cold in the morning.\I-I'm awake already, okay?\At this point, I have no idea what might happen.\I'll need to keep some distance from the others.\I wonder if Tohru could fix this.\Huh?! Miss Kobayashi's become a male?! response:	Let's do it, then!
context: What's wrong?\I thought you'd be cold in the morning.\I-I'm awake already, okay?\At this point, I have no idea what might happen.\I'll need to keep some distance from the others.\I wonder if Tohru could fix this.\Huh?! Miss Kobayashi's become a male?!\Let's do it, then! response:	Let's get on with preserving our species!
context: I thought you'd be cold in the morning.\I-I'm awake already, okay?\At this point, I have no idea what might happen.\I'll need to keep some distance from the others.\I wonder if Tohru could fix this.\Huh?! Miss Kobayashi's become a male?!\Let's do it, then!\Let's get on with preserving our species! response:	That's dangerous.
context: I-I'm awake already, okay?\At this point, I have no idea what might happen.\I'll need to keep some distance from the others.\I wonder if Tohru could fix this.\Huh?! Miss Kobayashi's become a male?!\Let's do it, then!\Let's get on with preserving our species!\That's dangerous. response:	Okay, let's ride the canoe to adventure!
context: At this point, I have no idea what might happen.\I'll need to keep some distance from the others.\I wonder if Tohru could fix this.\Huh?! Miss Kobayashi's become a male?!\Let's do it, then!\Let's get on with preserving our species!\That's dangerous.\Okay, let's ride the canoe to adventure! response:	What are you watching?
context: I'll need to keep some distance from the others.\I wonder if Tohru could fix this.\Huh?! Miss Kobayashi's become a male?!\Let's do it, then!\Let's get on with preserving our species!\That's dangerous.\Okay, let's ride the canoe to adventure!\What are you watching? response:	Everyone watching at home come along with us, too!
context: I wonder if Tohru could fix this.\Huh?! Miss Kobayashi's become a male?!\Let's do it, then!\Let's get on with preserving our species!\That's dangerous.\Okay, let's ride the canoe to adventure!\What are you watching?\Everyone watching at home come along with us, too! response:	Clinky Clang.
context: Huh?! Miss Kobayashi's become a male?!\Let's do it, then!\Let's get on with preserving our species!\That's dangerous.\Okay, let's ride the canoe to adventure!\What are you watching?\Everyone watching at home come along with us, too!\Clinky Clang. response:	Oh!
context: Let's do it, then!\Let's get on with preserving our species!\That's dangerous.\Okay, let's ride the canoe to adventure!\What are you watching?\Everyone watching at home come along with us, too!\Clinky Clang.\Oh! response:	Are you all ready?
context: Let's get on with preserving our species!\That's dangerous.\Okay, let's ride the canoe to adventure!\What are you watching?\Everyone watching at home come along with us, too!\Clinky Clang.\Oh!\Are you all ready? response:	Let's go!
context: That's dangerous.\Okay, let's ride the canoe to adventure!\What are you watching?\Everyone watching at home come along with us, too!\Clinky Clang.\Oh!\Are you all ready?\Let's go! response:	Go!
context: Okay, let's ride the canoe to adventure!\What are you watching?\Everyone watching at home come along with us, too!\Clinky Clang.\Oh!\Are you all ready?\Let's go!\Go! response:	Oh!
context: What are you watching?\Everyone watching at home come along with us, too!\Clinky Clang.\Oh!\Are you all ready?\Let's go!\Go!\Oh! response:	Oh?
context: Everyone watching at home come along with us, too!\Clinky Clang.\Oh!\Are you all ready?\Let's go!\Go!\Oh!\Oh? response:	Now, paddle, paddle!
context: Clinky Clang.\Oh!\Are you all ready?\Let's go!\Go!\Oh!\Oh?\Now, paddle, paddle! response:	Yeah!
context: Oh!\Are you all ready?\Let's go!\Go!\Oh!\Oh?\Now, paddle, paddle!\Yeah! response:	It's a waterfall! Everyone, huddle up!
context: Are you all ready?\Let's go!\Go!\Oh!\Oh?\Now, paddle, paddle!\Yeah!\It's a waterfall! Everyone, huddle up! response:	This is normal between women.
context: Let's go!\Go!\Oh!\Oh?\Now, paddle, paddle!\Yeah!\It's a waterfall! Everyone, huddle up!\This is normal between women. response:	I-I can take it.
context: Go!\Oh!\Oh?\Now, paddle, paddle!\Yeah!\It's a waterfall! Everyone, huddle up!\This is normal between women.\I-I can take it. response:	I won't be controlled by some crazy instincts.
context: Oh!\Oh?\Now, paddle, paddle!\Yeah!\It's a waterfall! Everyone, huddle up!\This is normal between women.\I-I can take it.\I won't be controlled by some crazy instincts. response:	Miss Kobayashi!
context: Oh?\Now, paddle, paddle!\Yeah!\It's a waterfall! Everyone, huddle up!\This is normal between women.\I-I can take it.\I won't be controlled by some crazy instincts.\Miss Kobayashi! response:	Don't hug me for no reason!
context: Now, paddle, paddle!\Yeah!\It's a waterfall! Everyone, huddle up!\This is normal between women.\I-I can take it.\I won't be controlled by some crazy instincts.\Miss Kobayashi!\Don't hug me for no reason! response:	Kobayashi!
context: Yeah!\It's a waterfall! Everyone, huddle up!\This is normal between women.\I-I can take it.\I won't be controlled by some crazy instincts.\Miss Kobayashi!\Don't hug me for no reason!\Kobayashi! response:	Don't frolic on me!
context: It's a waterfall! Everyone, huddle up!\This is normal between women.\I-I can take it.\I won't be controlled by some crazy instincts.\Miss Kobayashi!\Don't hug me for no reason!\Kobayashi!\Don't frolic on me! response:	Miss Kobayashi!
context: This is normal between women.\I-I can take it.\I won't be controlled by some crazy instincts.\Miss Kobayashi!\Don't hug me for no reason!\Kobayashi!\Don't frolic on me!\Miss Kobayashi! response:	I said, don't hug me for no reason!
context: I-I can take it.\I won't be controlled by some crazy instincts.\Miss Kobayashi!\Don't hug me for no reason!\Kobayashi!\Don't frolic on me!\Miss Kobayashi!\I said, don't hug me for no reason! response:	Miss Kobayashi!
context: I won't be controlled by some crazy instincts.\Miss Kobayashi!\Don't hug me for no reason!\Kobayashi!\Don't frolic on me!\Miss Kobayashi!\I said, don't hug me for no reason!\Miss Kobayashi! response:	No!
context: Miss Kobayashi!\Don't hug me for no reason!\Kobayashi!\Don't frolic on me!\Miss Kobayashi!\I said, don't hug me for no reason!\Miss Kobayashi!\No! response:	Was her contact always this intense?
context: Don't hug me for no reason!\Kobayashi!\Don't frolic on me!\Miss Kobayashi!\I said, don't hug me for no reason!\Miss Kobayashi!\No!\Was her contact always this intense? response:	Phew.
context: Kobayashi!\Don't frolic on me!\Miss Kobayashi!\I said, don't hug me for no reason!\Miss Kobayashi!\No!\Was her contact always this intense?\Phew. response:	Thank goodness, it's gotten smaller.
context: Don't frolic on me!\Miss Kobayashi!\I said, don't hug me for no reason!\Miss Kobayashi!\No!\Was her contact always this intense?\Phew.\Thank goodness, it's gotten smaller. response:	I knew Ilulu had to be weakened after her battle with Tohru.
context: Miss Kobayashi!\I said, don't hug me for no reason!\Miss Kobayashi!\No!\Was her contact always this intense?\Phew.\Thank goodness, it's gotten smaller.\I knew Ilulu had to be weakened after her battle with Tohru. response:	The factions of dragons from Tohru's world...
context: I said, don't hug me for no reason!\Miss Kobayashi!\No!\Was her contact always this intense?\Phew.\Thank goodness, it's gotten smaller.\I knew Ilulu had to be weakened after her battle with Tohru.\The factions of dragons from Tohru's world... response:	The chaos faction, right?
context: Miss Kobayashi!\No!\Was her contact always this intense?\Phew.\Thank goodness, it's gotten smaller.\I knew Ilulu had to be weakened after her battle with Tohru.\The factions of dragons from Tohru's world...\The chaos faction, right? response:	They hate humans and teach their children the same.
context: No!\Was her contact always this intense?\Phew.\Thank goodness, it's gotten smaller.\I knew Ilulu had to be weakened after her battle with Tohru.\The factions of dragons from Tohru's world...\The chaos faction, right?\They hate humans and teach their children the same. response:	Ilulu was raised that way,
context: Was her contact always this intense?\Phew.\Thank goodness, it's gotten smaller.\I knew Ilulu had to be weakened after her battle with Tohru.\The factions of dragons from Tohru's world...\The chaos faction, right?\They hate humans and teach their children the same.\Ilulu was raised that way, response:	so she lives that way
context: Phew.\Thank goodness, it's gotten smaller.\I knew Ilulu had to be weakened after her battle with Tohru.\The factions of dragons from Tohru's world...\The chaos faction, right?\They hate humans and teach their children the same.\Ilulu was raised that way,\so she lives that way response:	and thinks like that, too.
context: Thank goodness, it's gotten smaller.\I knew Ilulu had to be weakened after her battle with Tohru.\The factions of dragons from Tohru's world...\The chaos faction, right?\They hate humans and teach their children the same.\Ilulu was raised that way,\so she lives that way\and thinks like that, too. response:	Miss Kobayashi! Miss Kobayashi!
context: I knew Ilulu had to be weakened after her battle with Tohru.\The factions of dragons from Tohru's world...\The chaos faction, right?\They hate humans and teach their children the same.\Ilulu was raised that way,\so she lives that way\and thinks like that, too.\Miss Kobayashi! Miss Kobayashi! response:	Kanna's asleep, so how about some evening liquor?
context: The factions of dragons from Tohru's world...\The chaos faction, right?\They hate humans and teach their children the same.\Ilulu was raised that way,\so she lives that way\and thinks like that, too.\Miss Kobayashi! Miss Kobayashi!\Kanna's asleep, so how about some evening liquor? response:	Mmm.
context: The chaos faction, right?\They hate humans and teach their children the same.\Ilulu was raised that way,\so she lives that way\and thinks like that, too.\Miss Kobayashi! Miss Kobayashi!\Kanna's asleep, so how about some evening liquor?\Mmm. response:	It's good.
context: They hate humans and teach their children the same.\Ilulu was raised that way,\so she lives that way\and thinks like that, too.\Miss Kobayashi! Miss Kobayashi!\Kanna's asleep, so how about some evening liquor?\Mmm.\It's good. response:	I'm done thinking about it today.
context: Ilulu was raised that way,\so she lives that way\and thinks like that, too.\Miss Kobayashi! Miss Kobayashi!\Kanna's asleep, so how about some evening liquor?\Mmm.\It's good.\I'm done thinking about it today. response:	Huh? This happened before, too.
context: so she lives that way\and thinks like that, too.\Miss Kobayashi! Miss Kobayashi!\Kanna's asleep, so how about some evening liquor?\Mmm.\It's good.\I'm done thinking about it today.\Huh? This happened before, too. response:	The love potion?!
context: and thinks like that, too.\Miss Kobayashi! Miss Kobayashi!\Kanna's asleep, so how about some evening liquor?\Mmm.\It's good.\I'm done thinking about it today.\Huh? This happened before, too.\The love potion?! response:	I noticed partway through.
context: Miss Kobayashi! Miss Kobayashi!\Kanna's asleep, so how about some evening liquor?\Mmm.\It's good.\I'm done thinking about it today.\Huh? This happened before, too.\The love potion?!\I noticed partway through. response:	Right now, you...
context: Kanna's asleep, so how about some evening liquor?\Mmm.\It's good.\I'm done thinking about it today.\Huh? This happened before, too.\The love potion?!\I noticed partway through.\Right now, you... response:	have one of those!
context: Mmm.\It's good.\I'm done thinking about it today.\Huh? This happened before, too.\The love potion?!\I noticed partway through.\Right now, you...\have one of those! response:	Ilulu must have gotten to you, huh?
context: It's good.\I'm done thinking about it today.\Huh? This happened before, too.\The love potion?!\I noticed partway through.\Right now, you...\have one of those!\Ilulu must have gotten to you, huh? response:	Poor Miss Kobayashi.
context: I'm done thinking about it today.\Huh? This happened before, too.\The love potion?!\I noticed partway through.\Right now, you...\have one of those!\Ilulu must have gotten to you, huh?\Poor Miss Kobayashi. response:	I'll fix you right up.
context: Huh? This happened before, too.\The love potion?!\I noticed partway through.\Right now, you...\have one of those!\Ilulu must have gotten to you, huh?\Poor Miss Kobayashi.\I'll fix you right up. response:	But before that!
context: The love potion?!\I noticed partway through.\Right now, you...\have one of those!\Ilulu must have gotten to you, huh?\Poor Miss Kobayashi.\I'll fix you right up.\But before that! response:	I'll seize my opportunity!
context: I noticed partway through.\Right now, you...\have one of those!\Ilulu must have gotten to you, huh?\Poor Miss Kobayashi.\I'll fix you right up.\But before that!\I'll seize my opportunity! response:	Now that our hearts are united, that just leaves our bodies.
context: Right now, you...\have one of those!\Ilulu must have gotten to you, huh?\Poor Miss Kobayashi.\I'll fix you right up.\But before that!\I'll seize my opportunity!\Now that our hearts are united, that just leaves our bodies. response:	Now, Miss Kobayashi, give it all to me.
context: have one of those!\Ilulu must have gotten to you, huh?\Poor Miss Kobayashi.\I'll fix you right up.\But before that!\I'll seize my opportunity!\Now that our hearts are united, that just leaves our bodies.\Now, Miss Kobayashi, give it all to me. response:	Why are you completely turned off?!
context: Ilulu must have gotten to you, huh?\Poor Miss Kobayashi.\I'll fix you right up.\But before that!\I'll seize my opportunity!\Now that our hearts are united, that just leaves our bodies.\Now, Miss Kobayashi, give it all to me.\Why are you completely turned off?! response:	You took off your maid outfit.
context: Poor Miss Kobayashi.\I'll fix you right up.\But before that!\I'll seize my opportunity!\Now that our hearts are united, that just leaves our bodies.\Now, Miss Kobayashi, give it all to me.\Why are you completely turned off?!\You took off your maid outfit. response:	How could you?
context: I'll fix you right up.\But before that!\I'll seize my opportunity!\Now that our hearts are united, that just leaves our bodies.\Now, Miss Kobayashi, give it all to me.\Why are you completely turned off?!\You took off your maid outfit.\How could you? response:	Huh?
context: But before that!\I'll seize my opportunity!\Now that our hearts are united, that just leaves our bodies.\Now, Miss Kobayashi, give it all to me.\Why are you completely turned off?!\You took off your maid outfit.\How could you?\Huh? response:	Tohru, I'm going to tell you all the things that make a maid great
context: I'll seize my opportunity!\Now that our hearts are united, that just leaves our bodies.\Now, Miss Kobayashi, give it all to me.\Why are you completely turned off?!\You took off your maid outfit.\How could you?\Huh?\Tohru, I'm going to tell you all the things that make a maid great response:	from the male perspective.
context: Now that our hearts are united, that just leaves our bodies.\Now, Miss Kobayashi, give it all to me.\Why are you completely turned off?!\You took off your maid outfit.\How could you?\Huh?\Tohru, I'm going to tell you all the things that make a maid great\from the male perspective. response:	Good.
context: Now, Miss Kobayashi, give it all to me.\Why are you completely turned off?!\You took off your maid outfit.\How could you?\Huh?\Tohru, I'm going to tell you all the things that make a maid great\from the male perspective.\Good. response:	I made it through that.
context: Why are you completely turned off?!\You took off your maid outfit.\How could you?\Huh?\Tohru, I'm going to tell you all the things that make a maid great\from the male perspective.\Good.\I made it through that. response:	What will you do next, Ilulu?
context: You took off your maid outfit.\How could you?\Huh?\Tohru, I'm going to tell you all the things that make a maid great\from the male perspective.\Good.\I made it through that.\What will you do next, Ilulu? response:	It's displayed nicely, Miss.
context: How could you?\Huh?\Tohru, I'm going to tell you all the things that make a maid great\from the male perspective.\Good.\I made it through that.\What will you do next, Ilulu?\It's displayed nicely, Miss. response:	Something's not right, though.
context: Huh?\Tohru, I'm going to tell you all the things that make a maid great\from the male perspective.\Good.\I made it through that.\What will you do next, Ilulu?\It's displayed nicely, Miss.\Something's not right, though. response:	That does it!
context: Tohru, I'm going to tell you all the things that make a maid great\from the male perspective.\Good.\I made it through that.\What will you do next, Ilulu?\It's displayed nicely, Miss.\Something's not right, though.\That does it! response:	I see!
context: from the male perspective.\Good.\I made it through that.\What will you do next, Ilulu?\It's displayed nicely, Miss.\Something's not right, though.\That does it!\I see! response:	Episode 2
context: Good.\I made it through that.\What will you do next, Ilulu?\It's displayed nicely, Miss.\Something's not right, though.\That does it!\I see!\Episode 2 response:	Hot Guy Kobayashi! (In Many Senses)
context: I made it through that.\What will you do next, Ilulu?\It's displayed nicely, Miss.\Something's not right, though.\That does it!\I see!\Episode 2\Hot Guy Kobayashi! (In Many Senses) response:	Stop. Don't run.
context: What will you do next, Ilulu?\It's displayed nicely, Miss.\Something's not right, though.\That does it!\I see!\Episode 2\Hot Guy Kobayashi! (In Many Senses)\Stop. Don't run. response:	You followed me here, harmony bastard?!
context: It's displayed nicely, Miss.\Something's not right, though.\That does it!\I see!\Episode 2\Hot Guy Kobayashi! (In Many Senses)\Stop. Don't run.\You followed me here, harmony bastard?! response:	I'm Cremene of the dragon-slaying camp.
context: Something's not right, though.\That does it!\I see!\Episode 2\Hot Guy Kobayashi! (In Many Senses)\Stop. Don't run.\You followed me here, harmony bastard?!\I'm Cremene of the dragon-slaying camp. response:	Give my name to the judge in the underworld after you die.
context: That does it!\I see!\Episode 2\Hot Guy Kobayashi! (In Many Senses)\Stop. Don't run.\You followed me here, harmony bastard?!\I'm Cremene of the dragon-slaying camp.\Give my name to the judge in the underworld after you die. response:	I want the credit.
context: I see!\Episode 2\Hot Guy Kobayashi! (In Many Senses)\Stop. Don't run.\You followed me here, harmony bastard?!\I'm Cremene of the dragon-slaying camp.\Give my name to the judge in the underworld after you die.\I want the credit. response:	Now...
context: Episode 2\Hot Guy Kobayashi! (In Many Senses)\Stop. Don't run.\You followed me here, harmony bastard?!\I'm Cremene of the dragon-slaying camp.\Give my name to the judge in the underworld after you die.\I want the credit.\Now... response:	Ilulu always appears when I'm alone,
context: Hot Guy Kobayashi! (In Many Senses)\Stop. Don't run.\You followed me here, harmony bastard?!\I'm Cremene of the dragon-slaying camp.\Give my name to the judge in the underworld after you die.\I want the credit.\Now...\Ilulu always appears when I'm alone, response:	so maybe I can see her if I wait here?
context: Stop. Don't run.\You followed me here, harmony bastard?!\I'm Cremene of the dragon-slaying camp.\Give my name to the judge in the underworld after you die.\I want the credit.\Now...\Ilulu always appears when I'm alone,\so maybe I can see her if I wait here? response:	I wonder why I'm
context: You followed me here, harmony bastard?!\I'm Cremene of the dragon-slaying camp.\Give my name to the judge in the underworld after you die.\I want the credit.\Now...\Ilulu always appears when I'm alone,\so maybe I can see her if I wait here?\I wonder why I'm response:	focusing on Ilulu so much?
context: I'm Cremene of the dragon-slaying camp.\Give my name to the judge in the underworld after you die.\I want the credit.\Now...\Ilulu always appears when I'm alone,\so maybe I can see her if I wait here?\I wonder why I'm\focusing on Ilulu so much? response:	Maybe it's because I feel like we could get along?
context: Give my name to the judge in the underworld after you die.\I want the credit.\Now...\Ilulu always appears when I'm alone,\so maybe I can see her if I wait here?\I wonder why I'm\focusing on Ilulu so much?\Maybe it's because I feel like we could get along? response:	All the others I've met from another world
context: I want the credit.\Now...\Ilulu always appears when I'm alone,\so maybe I can see her if I wait here?\I wonder why I'm\focusing on Ilulu so much?\Maybe it's because I feel like we could get along?\All the others I've met from another world response:	have been friendly.
context: Now...\Ilulu always appears when I'm alone,\so maybe I can see her if I wait here?\I wonder why I'm\focusing on Ilulu so much?\Maybe it's because I feel like we could get along?\All the others I've met from another world\have been friendly. response:	They all have this air of having lived through conflict and its resulting tragedy,
context: Ilulu always appears when I'm alone,\so maybe I can see her if I wait here?\I wonder why I'm\focusing on Ilulu so much?\Maybe it's because I feel like we could get along?\All the others I've met from another world\have been friendly.\They all have this air of having lived through conflict and its resulting tragedy, response:	yet they're still able to interact with people
context: so maybe I can see her if I wait here?\I wonder why I'm\focusing on Ilulu so much?\Maybe it's because I feel like we could get along?\All the others I've met from another world\have been friendly.\They all have this air of having lived through conflict and its resulting tragedy,\yet they're still able to interact with people response:	because they know that's not everything.
context: I wonder why I'm\focusing on Ilulu so much?\Maybe it's because I feel like we could get along?\All the others I've met from another world\have been friendly.\They all have this air of having lived through conflict and its resulting tragedy,\yet they're still able to interact with people\because they know that's not everything. response:	Because they're willing to believe there's more than just strife.
context: focusing on Ilulu so much?\Maybe it's because I feel like we could get along?\All the others I've met from another world\have been friendly.\They all have this air of having lived through conflict and its resulting tragedy,\yet they're still able to interact with people\because they know that's not everything.\Because they're willing to believe there's more than just strife. response:	That's the Tohru I believe in.
context: Maybe it's because I feel like we could get along?\All the others I've met from another world\have been friendly.\They all have this air of having lived through conflict and its resulting tragedy,\yet they're still able to interact with people\because they know that's not everything.\Because they're willing to believe there's more than just strife.\That's the Tohru I believe in. response:	Which is why I want her to reconcile
context: All the others I've met from another world\have been friendly.\They all have this air of having lived through conflict and its resulting tragedy,\yet they're still able to interact with people\because they know that's not everything.\Because they're willing to believe there's more than just strife.\That's the Tohru I believe in.\Which is why I want her to reconcile response:	with Ilulu.
context: have been friendly.\They all have this air of having lived through conflict and its resulting tragedy,\yet they're still able to interact with people\because they know that's not everything.\Because they're willing to believe there's more than just strife.\That's the Tohru I believe in.\Which is why I want her to reconcile\with Ilulu. response:	Ilulu's not showing up.
context: They all have this air of having lived through conflict and its resulting tragedy,\yet they're still able to interact with people\because they know that's not everything.\Because they're willing to believe there's more than just strife.\That's the Tohru I believe in.\Which is why I want her to reconcile\with Ilulu.\Ilulu's not showing up. response:	Maybe she's over here, where there's less foot traffic?
context: yet they're still able to interact with people\because they know that's not everything.\Because they're willing to believe there's more than just strife.\That's the Tohru I believe in.\Which is why I want her to reconcile\with Ilulu.\Ilulu's not showing up.\Maybe she's over here, where there's less foot traffic? response:	Ilulu?!
context: because they know that's not everything.\Because they're willing to believe there's more than just strife.\That's the Tohru I believe in.\Which is why I want her to reconcile\with Ilulu.\Ilulu's not showing up.\Maybe she's over here, where there's less foot traffic?\Ilulu?! response:	You're injured?
context: Because they're willing to believe there's more than just strife.\That's the Tohru I believe in.\Which is why I want her to reconcile\with Ilulu.\Ilulu's not showing up.\Maybe she's over here, where there's less foot traffic?\Ilulu?!\You're injured? response:	You've seen us?
context: That's the Tohru I believe in.\Which is why I want her to reconcile\with Ilulu.\Ilulu's not showing up.\Maybe she's over here, where there's less foot traffic?\Ilulu?!\You're injured?\You've seen us? response:	Human of this world, I have come to destroy that vile beast from another world.
context: Which is why I want her to reconcile\with Ilulu.\Ilulu's not showing up.\Maybe she's over here, where there's less foot traffic?\Ilulu?!\You're injured?\You've seen us?\Human of this world, I have come to destroy that vile beast from another world. response:	Leave here at once,
context: with Ilulu.\Ilulu's not showing up.\Maybe she's over here, where there's less foot traffic?\Ilulu?!\You're injured?\You've seen us?\Human of this world, I have come to destroy that vile beast from another world.\Leave here at once, response:	and forget you were ever here.
context: Ilulu's not showing up.\Maybe she's over here, where there's less foot traffic?\Ilulu?!\You're injured?\You've seen us?\Human of this world, I have come to destroy that vile beast from another world.\Leave here at once,\and forget you were ever here. response:	Who is this guy?
context: Maybe she's over here, where there's less foot traffic?\Ilulu?!\You're injured?\You've seen us?\Human of this world, I have come to destroy that vile beast from another world.\Leave here at once,\and forget you were ever here.\Who is this guy? response:	Do you mean you're here to kill Ilulu?
context: Ilulu?!\You're injured?\You've seen us?\Human of this world, I have come to destroy that vile beast from another world.\Leave here at once,\and forget you were ever here.\Who is this guy?\Do you mean you're here to kill Ilulu? response:	You're saying you're an adult that's trying to kill a child?
context: You're injured?\You've seen us?\Human of this world, I have come to destroy that vile beast from another world.\Leave here at once,\and forget you were ever here.\Who is this guy?\Do you mean you're here to kill Ilulu?\You're saying you're an adult that's trying to kill a child? response:	I am.
context: You've seen us?\Human of this world, I have come to destroy that vile beast from another world.\Leave here at once,\and forget you were ever here.\Who is this guy?\Do you mean you're here to kill Ilulu?\You're saying you're an adult that's trying to kill a child?\I am. response:	That creature is chaos.
context: Human of this world, I have come to destroy that vile beast from another world.\Leave here at once,\and forget you were ever here.\Who is this guy?\Do you mean you're here to kill Ilulu?\You're saying you're an adult that's trying to kill a child?\I am.\That creature is chaos. response:	An evil dragon that will bring naught but harm to humans.
context: Leave here at once,\and forget you were ever here.\Who is this guy?\Do you mean you're here to kill Ilulu?\You're saying you're an adult that's trying to kill a child?\I am.\That creature is chaos.\An evil dragon that will bring naught but harm to humans. response:	In that case...
context: and forget you were ever here.\Who is this guy?\Do you mean you're here to kill Ilulu?\You're saying you're an adult that's trying to kill a child?\I am.\That creature is chaos.\An evil dragon that will bring naught but harm to humans.\In that case... response:	What is that unpleasant blare?!
context: Who is this guy?\Do you mean you're here to kill Ilulu?\You're saying you're an adult that's trying to kill a child?\I am.\That creature is chaos.\An evil dragon that will bring naught but harm to humans.\In that case...\What is that unpleasant blare?! response:	Hey! Keep it down!
context: Do you mean you're here to kill Ilulu?\You're saying you're an adult that's trying to kill a child?\I am.\That creature is chaos.\An evil dragon that will bring naught but harm to humans.\In that case...\What is that unpleasant blare?!\Hey! Keep it down! response:	All right!
context: You're saying you're an adult that's trying to kill a child?\I am.\That creature is chaos.\An evil dragon that will bring naught but harm to humans.\In that case...\What is that unpleasant blare?!\Hey! Keep it down!\All right! response:	Security Buzzer Power!
context: I am.\That creature is chaos.\An evil dragon that will bring naught but harm to humans.\In that case...\What is that unpleasant blare?!\Hey! Keep it down!\All right!\Security Buzzer Power! response:	You're damn heavy!
context: That creature is chaos.\An evil dragon that will bring naught but harm to humans.\In that case...\What is that unpleasant blare?!\Hey! Keep it down!\All right!\Security Buzzer Power!\You're damn heavy! response:	They ran away?
context: An evil dragon that will bring naught but harm to humans.\In that case...\What is that unpleasant blare?!\Hey! Keep it down!\All right!\Security Buzzer Power!\You're damn heavy!\They ran away? response:	Why would a human...?
context: In that case...\What is that unpleasant blare?!\Hey! Keep it down!\All right!\Security Buzzer Power!\You're damn heavy!\They ran away?\Why would a human...? response:	Oh, coming to?
context: What is that unpleasant blare?!\Hey! Keep it down!\All right!\Security Buzzer Power!\You're damn heavy!\They ran away?\Why would a human...?\Oh, coming to? response:	You okay?
context: Hey! Keep it down!\All right!\Security Buzzer Power!\You're damn heavy!\They ran away?\Why would a human...?\Oh, coming to?\You okay? response:	It looks like your wound healed up right away, though.
context: All right!\Security Buzzer Power!\You're damn heavy!\They ran away?\Why would a human...?\Oh, coming to?\You okay?\It looks like your wound healed up right away, though. response:	Why did you save me?
context: Security Buzzer Power!\You're damn heavy!\They ran away?\Why would a human...?\Oh, coming to?\You okay?\It looks like your wound healed up right away, though.\Why did you save me? response:	Can we say we're safe yet?
context: You're damn heavy!\They ran away?\Why would a human...?\Oh, coming to?\You okay?\It looks like your wound healed up right away, though.\Why did you save me?\Can we say we're safe yet? response:	I'm sure that guy's still after you, right?
context: They ran away?\Why would a human...?\Oh, coming to?\You okay?\It looks like your wound healed up right away, though.\Why did you save me?\Can we say we're safe yet?\I'm sure that guy's still after you, right? response:	It doesn't matter.
context: Why would a human...?\Oh, coming to?\You okay?\It looks like your wound healed up right away, though.\Why did you save me?\Can we say we're safe yet?\I'm sure that guy's still after you, right?\It doesn't matter. response:	Huh?
context: Oh, coming to?\You okay?\It looks like your wound healed up right away, though.\Why did you save me?\Can we say we're safe yet?\I'm sure that guy's still after you, right?\It doesn't matter.\Huh? response:	If I'm defeated in battle, then that's just my fate.
context: You okay?\It looks like your wound healed up right away, though.\Why did you save me?\Can we say we're safe yet?\I'm sure that guy's still after you, right?\It doesn't matter.\Huh?\If I'm defeated in battle, then that's just my fate. response:	Wouldn't me saving you be fate, too, then?
context: It looks like your wound healed up right away, though.\Why did you save me?\Can we say we're safe yet?\I'm sure that guy's still after you, right?\It doesn't matter.\Huh?\If I'm defeated in battle, then that's just my fate.\Wouldn't me saving you be fate, too, then? response:	Hey, Ilulu.
context: Why did you save me?\Can we say we're safe yet?\I'm sure that guy's still after you, right?\It doesn't matter.\Huh?\If I'm defeated in battle, then that's just my fate.\Wouldn't me saving you be fate, too, then?\Hey, Ilulu. response:	Is there something you want to tell me?
context: Can we say we're safe yet?\I'm sure that guy's still after you, right?\It doesn't matter.\Huh?\If I'm defeated in battle, then that's just my fate.\Wouldn't me saving you be fate, too, then?\Hey, Ilulu.\Is there something you want to tell me? response:	The way you mess with me
context: I'm sure that guy's still after you, right?\It doesn't matter.\Huh?\If I'm defeated in battle, then that's just my fate.\Wouldn't me saving you be fate, too, then?\Hey, Ilulu.\Is there something you want to tell me?\The way you mess with me response:	kind of suggests there is.
context: It doesn't matter.\Huh?\If I'm defeated in battle, then that's just my fate.\Wouldn't me saving you be fate, too, then?\Hey, Ilulu.\Is there something you want to tell me?\The way you mess with me\kind of suggests there is. response:	can't accept dragons coexisting with humans.
context: Huh?\If I'm defeated in battle, then that's just my fate.\Wouldn't me saving you be fate, too, then?\Hey, Ilulu.\Is there something you want to tell me?\The way you mess with me\kind of suggests there is.\can't accept dragons coexisting with humans. response:	There's no way they can get along with humans.
context: If I'm defeated in battle, then that's just my fate.\Wouldn't me saving you be fate, too, then?\Hey, Ilulu.\Is there something you want to tell me?\The way you mess with me\kind of suggests there is.\can't accept dragons coexisting with humans.\There's no way they can get along with humans. response:	You told me that before.
context: Wouldn't me saving you be fate, too, then?\Hey, Ilulu.\Is there something you want to tell me?\The way you mess with me\kind of suggests there is.\can't accept dragons coexisting with humans.\There's no way they can get along with humans.\You told me that before. response:	Because if they can get along...
context: Hey, Ilulu.\Is there something you want to tell me?\The way you mess with me\kind of suggests there is.\can't accept dragons coexisting with humans.\There's no way they can get along with humans.\You told me that before.\Because if they can get along... response:	then why did I spend all this time...
context: Is there something you want to tell me?\The way you mess with me\kind of suggests there is.\can't accept dragons coexisting with humans.\There's no way they can get along with humans.\You told me that before.\Because if they can get along...\then why did I spend all this time... response:	Dragons are superior beings, so associating with humans is shameful.
context: The way you mess with me\kind of suggests there is.\can't accept dragons coexisting with humans.\There's no way they can get along with humans.\You told me that before.\Because if they can get along...\then why did I spend all this time...\Dragons are superior beings, so associating with humans is shameful. response:	I really...
context: kind of suggests there is.\can't accept dragons coexisting with humans.\There's no way they can get along with humans.\You told me that before.\Because if they can get along...\then why did I spend all this time...\Dragons are superior beings, so associating with humans is shameful.\I really... response:	There were all kinds of tragedies.
context: can't accept dragons coexisting with humans.\There's no way they can get along with humans.\You told me that before.\Because if they can get along...\then why did I spend all this time...\Dragons are superior beings, so associating with humans is shameful.\I really...\There were all kinds of tragedies. response:	Harmony is impossible.
context: There's no way they can get along with humans.\You told me that before.\Because if they can get along...\then why did I spend all this time...\Dragons are superior beings, so associating with humans is shameful.\I really...\There were all kinds of tragedies.\Harmony is impossible. response:	I really, well...
context: You told me that before.\Because if they can get along...\then why did I spend all this time...\Dragons are superior beings, so associating with humans is shameful.\I really...\There were all kinds of tragedies.\Harmony is impossible.\I really, well... response:	Humans are our enemy!
context: Because if they can get along...\then why did I spend all this time...\Dragons are superior beings, so associating with humans is shameful.\I really...\There were all kinds of tragedies.\Harmony is impossible.\I really, well...\Humans are our enemy! response:	I wanted...
context: then why did I spend all this time...\Dragons are superior beings, so associating with humans is shameful.\I really...\There were all kinds of tragedies.\Harmony is impossible.\I really, well...\Humans are our enemy!\I wanted... response:	I wanted to...
context: Dragons are superior beings, so associating with humans is shameful.\I really...\There were all kinds of tragedies.\Harmony is impossible.\I really, well...\Humans are our enemy!\I wanted...\I wanted to... response:	I really...
context: I really...\There were all kinds of tragedies.\Harmony is impossible.\I really, well...\Humans are our enemy!\I wanted...\I wanted to...\I really... response:	wanted to play with them more!
context: There were all kinds of tragedies.\Harmony is impossible.\I really, well...\Humans are our enemy!\I wanted...\I wanted to...\I really...\wanted to play with them more! response:	No one would let me.
context: Harmony is impossible.\I really, well...\Humans are our enemy!\I wanted...\I wanted to...\I really...\wanted to play with them more!\No one would let me. response:	That girl and that boy did nothing wrong, and yet...
context: I really, well...\Humans are our enemy!\I wanted...\I wanted to...\I really...\wanted to play with them more!\No one would let me.\That girl and that boy did nothing wrong, and yet... response:	I see.
context: Humans are our enemy!\I wanted...\I wanted to...\I really...\wanted to play with them more!\No one would let me.\That girl and that boy did nothing wrong, and yet...\I see. response:	Then, hey,
context: I wanted...\I wanted to...\I really...\wanted to play with them more!\No one would let me.\That girl and that boy did nothing wrong, and yet...\I see.\Then, hey, response:	let's play together next time.
context: I wanted to...\I really...\wanted to play with them more!\No one would let me.\That girl and that boy did nothing wrong, and yet...\I see.\Then, hey,\let's play together next time. response:	We do all kinds of things, you know.
context: I really...\wanted to play with them more!\No one would let me.\That girl and that boy did nothing wrong, and yet...\I see.\Then, hey,\let's play together next time.\We do all kinds of things, you know. response:	We play dodgeball, go to Comiket, go to hot springs, and so on.
context: wanted to play with them more!\No one would let me.\That girl and that boy did nothing wrong, and yet...\I see.\Then, hey,\let's play together next time.\We do all kinds of things, you know.\We play dodgeball, go to Comiket, go to hot springs, and so on. response:	Though, you'll have to lay off the kind of play that turns into battles.
context: No one would let me.\That girl and that boy did nothing wrong, and yet...\I see.\Then, hey,\let's play together next time.\We do all kinds of things, you know.\We play dodgeball, go to Comiket, go to hot springs, and so on.\Though, you'll have to lay off the kind of play that turns into battles. response:	Y-You're trying to trick me!
context: That girl and that boy did nothing wrong, and yet...\I see.\Then, hey,\let's play together next time.\We do all kinds of things, you know.\We play dodgeball, go to Comiket, go to hot springs, and so on.\Though, you'll have to lay off the kind of play that turns into battles.\Y-You're trying to trick me! response:	You're trying to win me over by saying nice things!
context: I see.\Then, hey,\let's play together next time.\We do all kinds of things, you know.\We play dodgeball, go to Comiket, go to hot springs, and so on.\Though, you'll have to lay off the kind of play that turns into battles.\Y-You're trying to trick me!\You're trying to win me over by saying nice things! response:	Yeah, I am.
context: Then, hey,\let's play together next time.\We do all kinds of things, you know.\We play dodgeball, go to Comiket, go to hot springs, and so on.\Though, you'll have to lay off the kind of play that turns into battles.\Y-You're trying to trick me!\You're trying to win me over by saying nice things!\Yeah, I am. response:	Huh?
context: let's play together next time.\We do all kinds of things, you know.\We play dodgeball, go to Comiket, go to hot springs, and so on.\Though, you'll have to lay off the kind of play that turns into battles.\Y-You're trying to trick me!\You're trying to win me over by saying nice things!\Yeah, I am.\Huh? response:	I'm trying to tame a fierce, evil dragon of chaos
context: We do all kinds of things, you know.\We play dodgeball, go to Comiket, go to hot springs, and so on.\Though, you'll have to lay off the kind of play that turns into battles.\Y-You're trying to trick me!\You're trying to win me over by saying nice things!\Yeah, I am.\Huh?\I'm trying to tame a fierce, evil dragon of chaos response:	with sweet words to render her harmless.
context: We play dodgeball, go to Comiket, go to hot springs, and so on.\Though, you'll have to lay off the kind of play that turns into battles.\Y-You're trying to trick me!\You're trying to win me over by saying nice things!\Yeah, I am.\Huh?\I'm trying to tame a fierce, evil dragon of chaos\with sweet words to render her harmless. response:	Will you believe what you've been taught?
context: Though, you'll have to lay off the kind of play that turns into battles.\Y-You're trying to trick me!\You're trying to win me over by saying nice things!\Yeah, I am.\Huh?\I'm trying to tame a fierce, evil dragon of chaos\with sweet words to render her harmless.\Will you believe what you've been taught? response:	Or would you care to be tricked by me?
context: Y-You're trying to trick me!\You're trying to win me over by saying nice things!\Yeah, I am.\Huh?\I'm trying to tame a fierce, evil dragon of chaos\with sweet words to render her harmless.\Will you believe what you've been taught?\Or would you care to be tricked by me? response:	That's enough.
context: You're trying to win me over by saying nice things!\Yeah, I am.\Huh?\I'm trying to tame a fierce, evil dragon of chaos\with sweet words to render her harmless.\Will you believe what you've been taught?\Or would you care to be tricked by me?\That's enough. response:	I can't believe you and the human were working together.
context: Yeah, I am.\Huh?\I'm trying to tame a fierce, evil dragon of chaos\with sweet words to render her harmless.\Will you believe what you've been taught?\Or would you care to be tricked by me?\That's enough.\I can't believe you and the human were working together. response:	I'll exterminate you, too!
context: Huh?\I'm trying to tame a fierce, evil dragon of chaos\with sweet words to render her harmless.\Will you believe what you've been taught?\Or would you care to be tricked by me?\That's enough.\I can't believe you and the human were working together.\I'll exterminate you, too! response:	Can you do that?
context: I'm trying to tame a fierce, evil dragon of chaos\with sweet words to render her harmless.\Will you believe what you've been taught?\Or would you care to be tricked by me?\That's enough.\I can't believe you and the human were working together.\I'll exterminate you, too!\Can you do that? response:	You have rules to follow, don't you?
context: with sweet words to render her harmless.\Will you believe what you've been taught?\Or would you care to be tricked by me?\That's enough.\I can't believe you and the human were working together.\I'll exterminate you, too!\Can you do that?\You have rules to follow, don't you? response:	Those rules are only on paper.
context: Will you believe what you've been taught?\Or would you care to be tricked by me?\That's enough.\I can't believe you and the human were working together.\I'll exterminate you, too!\Can you do that?\You have rules to follow, don't you?\Those rules are only on paper. response:	They're rules between dragons, so they don't apply to humans.
context: Or would you care to be tricked by me?\That's enough.\I can't believe you and the human were working together.\I'll exterminate you, too!\Can you do that?\You have rules to follow, don't you?\Those rules are only on paper.\They're rules between dragons, so they don't apply to humans. response:	He's making Tohru's father seem genuinely nice.
context: That's enough.\I can't believe you and the human were working together.\I'll exterminate you, too!\Can you do that?\You have rules to follow, don't you?\Those rules are only on paper.\They're rules between dragons, so they don't apply to humans.\He's making Tohru's father seem genuinely nice. response:	But...
context: I can't believe you and the human were working together.\I'll exterminate you, too!\Can you do that?\You have rules to follow, don't you?\Those rules are only on paper.\They're rules between dragons, so they don't apply to humans.\He's making Tohru's father seem genuinely nice.\But... response:	Don't underestimate humans.
context: I'll exterminate you, too!\Can you do that?\You have rules to follow, don't you?\Those rules are only on paper.\They're rules between dragons, so they don't apply to humans.\He's making Tohru's father seem genuinely nice.\But...\Don't underestimate humans. response:	A human who would try to protect a dragon?
context: Can you do that?\You have rules to follow, don't you?\Those rules are only on paper.\They're rules between dragons, so they don't apply to humans.\He's making Tohru's father seem genuinely nice.\But...\Don't underestimate humans.\A human who would try to protect a dragon? response:	Hmph!
context: You have rules to follow, don't you?\Those rules are only on paper.\They're rules between dragons, so they don't apply to humans.\He's making Tohru's father seem genuinely nice.\But...\Don't underestimate humans.\A human who would try to protect a dragon?\Hmph! response:	Kobayashi!
context: Those rules are only on paper.\They're rules between dragons, so they don't apply to humans.\He's making Tohru's father seem genuinely nice.\But...\Don't underestimate humans.\A human who would try to protect a dragon?\Hmph!\Kobayashi! response:	Ow!
context: They're rules between dragons, so they don't apply to humans.\He's making Tohru's father seem genuinely nice.\But...\Don't underestimate humans.\A human who would try to protect a dragon?\Hmph!\Kobayashi!\Ow! response:	That super hurts.
context: He's making Tohru's father seem genuinely nice.\But...\Don't underestimate humans.\A human who would try to protect a dragon?\Hmph!\Kobayashi!\Ow!\That super hurts. response:	You're late.
context: But...\Don't underestimate humans.\A human who would try to protect a dragon?\Hmph!\Kobayashi!\Ow!\That super hurts.\You're late. response:	You?!
context: Don't underestimate humans.\A human who would try to protect a dragon?\Hmph!\Kobayashi!\Ow!\That super hurts.\You're late.\You?! response:	How are you here?!
context: A human who would try to protect a dragon?\Hmph!\Kobayashi!\Ow!\That super hurts.\You're late.\You?!\How are you here?! response:	How dare you hurt Miss Kobayashi!
context: Hmph!\Kobayashi!\Ow!\That super hurts.\You're late.\You?!\How are you here?!\How dare you hurt Miss Kobayashi! response:	E-Even if you're here, I just need to call in reinforcements!
context: Kobayashi!\Ow!\That super hurts.\You're late.\You?!\How are you here?!\How dare you hurt Miss Kobayashi!\E-Even if you're here, I just need to call in reinforcements! response:	I'll summon Lady Elma at on
context: Ow!\That super hurts.\You're late.\You?!\How are you here?!\How dare you hurt Miss Kobayashi!\E-Even if you're here, I just need to call in reinforcements!\I'll summon Lady Elma at on response:	Choose the right words to plead for your life
context: That super hurts.\You're late.\You?!\How are you here?!\How dare you hurt Miss Kobayashi!\E-Even if you're here, I just need to call in reinforcements!\I'll summon Lady Elma at on\Choose the right words to plead for your life response:	and I'll let you have your soul back after breaking your body.
context: You're late.\You?!\How are you here?!\How dare you hurt Miss Kobayashi!\E-Even if you're here, I just need to call in reinforcements!\I'll summon Lady Elma at on\Choose the right words to plead for your life\and I'll let you have your soul back after breaking your body. response:	Now,
context: You?!\How are you here?!\How dare you hurt Miss Kobayashi!\E-Even if you're here, I just need to call in reinforcements!\I'll summon Lady Elma at on\Choose the right words to plead for your life\and I'll let you have your soul back after breaking your body.\Now, response:	beg for your life!
context: How are you here?!\How dare you hurt Miss Kobayashi!\E-Even if you're here, I just need to call in reinforcements!\I'll summon Lady Elma at on\Choose the right words to plead for your life\and I'll let you have your soul back after breaking your body.\Now,\beg for your life! response:	D-Did you kill him?
context: How dare you hurt Miss Kobayashi!\E-Even if you're here, I just need to call in reinforcements!\I'll summon Lady Elma at on\Choose the right words to plead for your life\and I'll let you have your soul back after breaking your body.\Now,\beg for your life!\D-Did you kill him? response:	No, I just erased his memories of this world
context: E-Even if you're here, I just need to call in reinforcements!\I'll summon Lady Elma at on\Choose the right words to plead for your life\and I'll let you have your soul back after breaking your body.\Now,\beg for your life!\D-Did you kill him?\No, I just erased his memories of this world response:	and sent him back from where he came.
context: I'll summon Lady Elma at on\Choose the right words to plead for your life\and I'll let you have your soul back after breaking your body.\Now,\beg for your life!\D-Did you kill him?\No, I just erased his memories of this world\and sent him back from where he came. response:	After punishing him a bit.
context: Choose the right words to plead for your life\and I'll let you have your soul back after breaking your body.\Now,\beg for your life!\D-Did you kill him?\No, I just erased his memories of this world\and sent him back from where he came.\After punishing him a bit. response:	Horn
context: and I'll let you have your soul back after breaking your body.\Now,\beg for your life!\D-Did you kill him?\No, I just erased his memories of this world\and sent him back from where he came.\After punishing him a bit.\Horn response:	I see.
context: Now,\beg for your life!\D-Did you kill him?\No, I just erased his memories of this world\and sent him back from where he came.\After punishing him a bit.\Horn\I see. response:	Thank goodness.
context: beg for your life!\D-Did you kill him?\No, I just erased his memories of this world\and sent him back from where he came.\After punishing him a bit.\Horn\I see.\Thank goodness. response:	Now Ilulu can...
context: D-Did you kill him?\No, I just erased his memories of this world\and sent him back from where he came.\After punishing him a bit.\Horn\I see.\Thank goodness.\Now Ilulu can... response:	Huh? Now that I'm relieved, I feel...
context: No, I just erased his memories of this world\and sent him back from where he came.\After punishing him a bit.\Horn\I see.\Thank goodness.\Now Ilulu can...\Huh? Now that I'm relieved, I feel... response:	Miss Kobayashi?!
context: and sent him back from where he came.\After punishing him a bit.\Horn\I see.\Thank goodness.\Now Ilulu can...\Huh? Now that I'm relieved, I feel...\Miss Kobayashi?! response:	Please hang in there!
context: After punishing him a bit.\Horn\I see.\Thank goodness.\Now Ilulu can...\Huh? Now that I'm relieved, I feel...\Miss Kobayashi?!\Please hang in there! response:	Dragon saliva can stop bleeding!
context: Horn\I see.\Thank goodness.\Now Ilulu can...\Huh? Now that I'm relieved, I feel...\Miss Kobayashi?!\Please hang in there!\Dragon saliva can stop bleeding! response:	You just want to lick her, don't you?!
context: I see.\Thank goodness.\Now Ilulu can...\Huh? Now that I'm relieved, I feel...\Miss Kobayashi?!\Please hang in there!\Dragon saliva can stop bleeding!\You just want to lick her, don't you?! response:	Here I come, Miss Kobayashi! Lick, lick, lick, lick!
context: Thank goodness.\Now Ilulu can...\Huh? Now that I'm relieved, I feel...\Miss Kobayashi?!\Please hang in there!\Dragon saliva can stop bleeding!\You just want to lick her, don't you?!\Here I come, Miss Kobayashi! Lick, lick, lick, lick! response:	Man, your tongue is long!
context: Now Ilulu can...\Huh? Now that I'm relieved, I feel...\Miss Kobayashi?!\Please hang in there!\Dragon saliva can stop bleeding!\You just want to lick her, don't you?!\Here I come, Miss Kobayashi! Lick, lick, lick, lick!\Man, your tongue is long! response:	A functional member of society
context: Huh? Now that I'm relieved, I feel...\Miss Kobayashi?!\Please hang in there!\Dragon saliva can stop bleeding!\You just want to lick her, don't you?!\Here I come, Miss Kobayashi! Lick, lick, lick, lick!\Man, your tongue is long!\A functional member of society response:	is someone who diligently obeys the rules
context: Miss Kobayashi?!\Please hang in there!\Dragon saliva can stop bleeding!\You just want to lick her, don't you?!\Here I come, Miss Kobayashi! Lick, lick, lick, lick!\Man, your tongue is long!\A functional member of society\is someone who diligently obeys the rules response:	and prioritizes their company over their private life.
context: Please hang in there!\Dragon saliva can stop bleeding!\You just want to lick her, don't you?!\Here I come, Miss Kobayashi! Lick, lick, lick, lick!\Man, your tongue is long!\A functional member of society\is someone who diligently obeys the rules\and prioritizes their company over their private life. response:	I believed that's just how it is.
context: Dragon saliva can stop bleeding!\You just want to lick her, don't you?!\Here I come, Miss Kobayashi! Lick, lick, lick, lick!\Man, your tongue is long!\A functional member of society\is someone who diligently obeys the rules\and prioritizes their company over their private life.\I believed that's just how it is. response:	Because I was taught that it's my duty to fill my role as a functional member of society.
context: You just want to lick her, don't you?!\Here I come, Miss Kobayashi! Lick, lick, lick, lick!\Man, your tongue is long!\A functional member of society\is someone who diligently obeys the rules\and prioritizes their company over their private life.\I believed that's just how it is.\Because I was taught that it's my duty to fill my role as a functional member of society. response:	Then, the next thing I knew, I no longer had any friends in my private life.
context: Here I come, Miss Kobayashi! Lick, lick, lick, lick!\Man, your tongue is long!\A functional member of society\is someone who diligently obeys the rules\and prioritizes their company over their private life.\I believed that's just how it is.\Because I was taught that it's my duty to fill my role as a functional member of society.\Then, the next thing I knew, I no longer had any friends in my private life. response:	That was when I met Tohru and managed to change.
context: Man, your tongue is long!\A functional member of society\is someone who diligently obeys the rules\and prioritizes their company over their private life.\I believed that's just how it is.\Because I was taught that it's my duty to fill my role as a functional member of society.\Then, the next thing I knew, I no longer had any friends in my private life.\That was when I met Tohru and managed to change. response:	So, maybe,
context: A functional member of society\is someone who diligently obeys the rules\and prioritizes their company over their private life.\I believed that's just how it is.\Because I was taught that it's my duty to fill my role as a functional member of society.\Then, the next thing I knew, I no longer had any friends in my private life.\That was when I met Tohru and managed to change.\So, maybe, response:	I was seeing my old self in Ilulu.
context: is someone who diligently obeys the rules\and prioritizes their company over their private life.\I believed that's just how it is.\Because I was taught that it's my duty to fill my role as a functional member of society.\Then, the next thing I knew, I no longer had any friends in my private life.\That was when I met Tohru and managed to change.\So, maybe,\I was seeing my old self in Ilulu. response:	Ah.
context: and prioritizes their company over their private life.\I believed that's just how it is.\Because I was taught that it's my duty to fill my role as a functional member of society.\Then, the next thing I knew, I no longer had any friends in my private life.\That was when I met Tohru and managed to change.\So, maybe,\I was seeing my old self in Ilulu.\Ah. response:	Miss Kobayashi?
context: I believed that's just how it is.\Because I was taught that it's my duty to fill my role as a functional member of society.\Then, the next thing I knew, I no longer had any friends in my private life.\That was when I met Tohru and managed to change.\So, maybe,\I was seeing my old self in Ilulu.\Ah.\Miss Kobayashi? response:	Stay with me!
context: Because I was taught that it's my duty to fill my role as a functional member of society.\Then, the next thing I knew, I no longer had any friends in my private life.\That was when I met Tohru and managed to change.\So, maybe,\I was seeing my old self in Ilulu.\Ah.\Miss Kobayashi?\Stay with me! response:	You're okay.
context: Then, the next thing I knew, I no longer had any friends in my private life.\That was when I met Tohru and managed to change.\So, maybe,\I was seeing my old self in Ilulu.\Ah.\Miss Kobayashi?\Stay with me!\You're okay. response:	Tohru.
context: That was when I met Tohru and managed to change.\So, maybe,\I was seeing my old self in Ilulu.\Ah.\Miss Kobayashi?\Stay with me!\You're okay.\Tohru. response:	Kanna-chan.
context: So, maybe,\I was seeing my old self in Ilulu.\Ah.\Miss Kobayashi?\Stay with me!\You're okay.\Tohru.\Kanna-chan. response:	Is this our home?
context: I was seeing my old self in Ilulu.\Ah.\Miss Kobayashi?\Stay with me!\You're okay.\Tohru.\Kanna-chan.\Is this our home? response:	Yes!
context: Ah.\Miss Kobayashi?\Stay with me!\You're okay.\Tohru.\Kanna-chan.\Is this our home?\Yes! response:	I healed your wounds, as well!
context: Miss Kobayashi?\Stay with me!\You're okay.\Tohru.\Kanna-chan.\Is this our home?\Yes!\I healed your wounds, as well! response:	Where's Ilulu?
context: Stay with me!\You're okay.\Tohru.\Kanna-chan.\Is this our home?\Yes!\I healed your wounds, as well!\Where's Ilulu? response:	Right there.
context: You're okay.\Tohru.\Kanna-chan.\Is this our home?\Yes!\I healed your wounds, as well!\Where's Ilulu?\Right there. response:	This girl wouldn't even try to leave your side.
context: Tohru.\Kanna-chan.\Is this our home?\Yes!\I healed your wounds, as well!\Where's Ilulu?\Right there.\This girl wouldn't even try to leave your side. response:	Even if she's finally noticed what makes you so great, it's too late!
context: Kanna-chan.\Is this our home?\Yes!\I healed your wounds, as well!\Where's Ilulu?\Right there.\This girl wouldn't even try to leave your side.\Even if she's finally noticed what makes you so great, it's too late! response:	Kobayashi!
context: Is this our home?\Yes!\I healed your wounds, as well!\Where's Ilulu?\Right there.\This girl wouldn't even try to leave your side.\Even if she's finally noticed what makes you so great, it's too late!\Kobayashi! response:	Can I let you trick me?
context: Yes!\I healed your wounds, as well!\Where's Ilulu?\Right there.\This girl wouldn't even try to leave your side.\Even if she's finally noticed what makes you so great, it's too late!\Kobayashi!\Can I let you trick me? response:	Yeah, of course.
context: I healed your wounds, as well!\Where's Ilulu?\Right there.\This girl wouldn't even try to leave your side.\Even if she's finally noticed what makes you so great, it's too late!\Kobayashi!\Can I let you trick me?\Yeah, of course. response:	Good morning.
context: Where's Ilulu?\Right there.\This girl wouldn't even try to leave your side.\Even if she's finally noticed what makes you so great, it's too late!\Kobayashi!\Can I let you trick me?\Yeah, of course.\Good morning. response:	El NiNo Miki is here to share today's national weather.
context: Right there.\This girl wouldn't even try to leave your side.\Even if she's finally noticed what makes you so great, it's too late!\Kobayashi!\Can I let you trick me?\Yeah, of course.\Good morning.\El NiNo Miki is here to share today's national weather. response:	Today, large regions will be seeing sunshine.
context: This girl wouldn't even try to leave your side.\Even if she's finally noticed what makes you so great, it's too late!\Kobayashi!\Can I let you trick me?\Yeah, of course.\Good morning.\El NiNo Miki is here to share today's national weather.\Today, large regions will be seeing sunshine. response:	Will she be fine without making her claws and tail disappear?
context: Even if she's finally noticed what makes you so great, it's too late!\Kobayashi!\Can I let you trick me?\Yeah, of course.\Good morning.\El NiNo Miki is here to share today's national weather.\Today, large regions will be seeing sunshine.\Will she be fine without making her claws and tail disappear? response:	We're under a high pressure system, so it's calm skies over a wide region.
context: Kobayashi!\Can I let you trick me?\Yeah, of course.\Good morning.\El NiNo Miki is here to share today's national weather.\Today, large regions will be seeing sunshine.\Will she be fine without making her claws and tail disappear?\We're under a high pressure system, so it's calm skies over a wide region. response:	And if she could make her breasts a normal size.
context: Can I let you trick me?\Yeah, of course.\Good morning.\El NiNo Miki is here to share today's national weather.\Today, large regions will be seeing sunshine.\Will she be fine without making her claws and tail disappear?\We're under a high pressure system, so it's calm skies over a wide region.\And if she could make her breasts a normal size. response:	You can rest assured and hang your laundry out today.
context: Yeah, of course.\Good morning.\El NiNo Miki is here to share today's national weather.\Today, large regions will be seeing sunshine.\Will she be fine without making her claws and tail disappear?\We're under a high pressure system, so it's calm skies over a wide region.\And if she could make her breasts a normal size.\You can rest assured and hang your laundry out today. response:	Ilulu is already pushing herself as it is at that size.
context: Good morning.\El NiNo Miki is here to share today's national weather.\Today, large regions will be seeing sunshine.\Will she be fine without making her claws and tail disappear?\We're under a high pressure system, so it's calm skies over a wide region.\And if she could make her breasts a normal size.\You can rest assured and hang your laundry out today.\Ilulu is already pushing herself as it is at that size. response:	The cherry blossoms are starting to bloom as well.
context: El NiNo Miki is here to share today's national weather.\Today, large regions will be seeing sunshine.\Will she be fine without making her claws and tail disappear?\We're under a high pressure system, so it's calm skies over a wide region.\And if she could make her breasts a normal size.\You can rest assured and hang your laundry out today.\Ilulu is already pushing herself as it is at that size.\The cherry blossoms are starting to bloom as well. response:	If she wasn't pushing herself, her breasts would be even bigger.
context: Today, large regions will be seeing sunshine.\Will she be fine without making her claws and tail disappear?\We're under a high pressure system, so it's calm skies over a wide region.\And if she could make her breasts a normal size.\You can rest assured and hang your laundry out today.\Ilulu is already pushing herself as it is at that size.\The cherry blossoms are starting to bloom as well.\If she wasn't pushing herself, her breasts would be even bigger. response:	They're only just blooming, but there aren't many caterpillars at this time!
context: Will she be fine without making her claws and tail disappear?\We're under a high pressure system, so it's calm skies over a wide region.\And if she could make her breasts a normal size.\You can rest assured and hang your laundry out today.\Ilulu is already pushing herself as it is at that size.\The cherry blossoms are starting to bloom as well.\If she wasn't pushing herself, her breasts would be even bigger.\They're only just blooming, but there aren't many caterpillars at this time! response:	Oh, she could probably make her claws and tail disappear if she tried.
context: We're under a high pressure system, so it's calm skies over a wide region.\And if she could make her breasts a normal size.\You can rest assured and hang your laundry out today.\Ilulu is already pushing herself as it is at that size.\The cherry blossoms are starting to bloom as well.\If she wasn't pushing herself, her breasts would be even bigger.\They're only just blooming, but there aren't many caterpillars at this time!\Oh, she could probably make her claws and tail disappear if she tried. response:	So, how about giving an early flower viewing a try right now?
context: And if she could make her breasts a normal size.\You can rest assured and hang your laundry out today.\Ilulu is already pushing herself as it is at that size.\The cherry blossoms are starting to bloom as well.\If she wasn't pushing herself, her breasts would be even bigger.\They're only just blooming, but there aren't many caterpillars at this time!\Oh, she could probably make her claws and tail disappear if she tried.\So, how about giving an early flower viewing a try right now? response:	Huh? What do you mean she can't reduce her breasts?
context: You can rest assured and hang your laundry out today.\Ilulu is already pushing herself as it is at that size.\The cherry blossoms are starting to bloom as well.\If she wasn't pushing herself, her breasts would be even bigger.\They're only just blooming, but there aren't many caterpillars at this time!\Oh, she could probably make her claws and tail disappear if she tried.\So, how about giving an early flower viewing a try right now?\Huh? What do you mean she can't reduce her breasts? response:	Give me about 5 of that!
context: Ilulu is already pushing herself as it is at that size.\The cherry blossoms are starting to bloom as well.\If she wasn't pushing herself, her breasts would be even bigger.\They're only just blooming, but there aren't many caterpillars at this time!\Oh, she could probably make her claws and tail disappear if she tried.\So, how about giving an early flower viewing a try right now?\Huh? What do you mean she can't reduce her breasts?\Give me about 5 of that! response:	Mornings and evenings will be chilly in many locations.
context: The cherry blossoms are starting to bloom as well.\If she wasn't pushing herself, her breasts would be even bigger.\They're only just blooming, but there aren't many caterpillars at this time!\Oh, she could probably make her claws and tail disappear if she tried.\So, how about giving an early flower viewing a try right now?\Huh? What do you mean she can't reduce her breasts?\Give me about 5 of that!\Mornings and evenings will be chilly in many locations. response:	Kobayashi, Kobayashi.
context: If she wasn't pushing herself, her breasts would be even bigger.\They're only just blooming, but there aren't many caterpillars at this time!\Oh, she could probably make her claws and tail disappear if she tried.\So, how about giving an early flower viewing a try right now?\Huh? What do you mean she can't reduce her breasts?\Give me about 5 of that!\Mornings and evenings will be chilly in many locations.\Kobayashi, Kobayashi. response:	What's the matter?
context: They're only just blooming, but there aren't many caterpillars at this time!\Oh, she could probably make her claws and tail disappear if she tried.\So, how about giving an early flower viewing a try right now?\Huh? What do you mean she can't reduce her breasts?\Give me about 5 of that!\Mornings and evenings will be chilly in many locations.\Kobayashi, Kobayashi.\What's the matter? response:	This is where excrement goes, right?
context: Oh, she could probably make her claws and tail disappear if she tried.\So, how about giving an early flower viewing a try right now?\Huh? What do you mean she can't reduce her breasts?\Give me about 5 of that!\Mornings and evenings will be chilly in many locations.\Kobayashi, Kobayashi.\What's the matter?\This is where excrement goes, right? response:	How does it work?
context: So, how about giving an early flower viewing a try right now?\Huh? What do you mean she can't reduce her breasts?\Give me about 5 of that!\Mornings and evenings will be chilly in many locations.\Kobayashi, Kobayashi.\What's the matter?\This is where excrement goes, right?\How does it work? response:	I have to start from there?
context: Huh? What do you mean she can't reduce her breasts?\Give me about 5 of that!\Mornings and evenings will be chilly in many locations.\Kobayashi, Kobayashi.\What's the matter?\This is where excrement goes, right?\How does it work?\I have to start from there? response:	Yeah, you sit on there.
context: Give me about 5 of that!\Mornings and evenings will be chilly in many locations.\Kobayashi, Kobayashi.\What's the matter?\This is where excrement goes, right?\How does it work?\I have to start from there?\Yeah, you sit on there. response:	Just like that.
context: Mornings and evenings will be chilly in many locations.\Kobayashi, Kobayashi.\What's the matter?\This is where excrement goes, right?\How does it work?\I have to start from there?\Yeah, you sit on there.\Just like that. response:	I got it.
context: Kobayashi, Kobayashi.\What's the matter?\This is where excrement goes, right?\How does it work?\I have to start from there?\Yeah, you sit on there.\Just like that.\I got it. response:	We'll have to teach her all kinds of things.
context: What's the matter?\This is where excrement goes, right?\How does it work?\I have to start from there?\Yeah, you sit on there.\Just like that.\I got it.\We'll have to teach her all kinds of things. response:	If only I had a talented maid at times like these.
context: This is where excrement goes, right?\How does it work?\I have to start from there?\Yeah, you sit on there.\Just like that.\I got it.\We'll have to teach her all kinds of things.\If only I had a talented maid at times like these. response:	I'd see them in a whole new light.
context: How does it work?\I have to start from there?\Yeah, you sit on there.\Just like that.\I got it.\We'll have to teach her all kinds of things.\If only I had a talented maid at times like these.\I'd see them in a whole new light. response:	Sorry. Just while I'm away at work.
context: I have to start from there?\Yeah, you sit on there.\Just like that.\I got it.\We'll have to teach her all kinds of things.\If only I had a talented maid at times like these.\I'd see them in a whole new light.\Sorry. Just while I'm away at work. response:	It's fine.
context: Yeah, you sit on there.\Just like that.\I got it.\We'll have to teach her all kinds of things.\If only I had a talented maid at times like these.\I'd see them in a whole new light.\Sorry. Just while I'm away at work.\It's fine. response:	You and I have a special, eternal bond, after all!
context: Just like that.\I got it.\We'll have to teach her all kinds of things.\If only I had a talented maid at times like these.\I'd see them in a whole new light.\Sorry. Just while I'm away at work.\It's fine.\You and I have a special, eternal bond, after all! response:	Don't add eternal on there so casually.
context: I got it.\We'll have to teach her all kinds of things.\If only I had a talented maid at times like these.\I'd see them in a whole new light.\Sorry. Just while I'm away at work.\It's fine.\You and I have a special, eternal bond, after all!\Don't add eternal on there so casually. response:	Have a good day.
context: We'll have to teach her all kinds of things.\If only I had a talented maid at times like these.\I'd see them in a whole new light.\Sorry. Just while I'm away at work.\It's fine.\You and I have a special, eternal bond, after all!\Don't add eternal on there so casually.\Have a good day. response:	Have you been working those muscles?
context: If only I had a talented maid at times like these.\I'd see them in a whole new light.\Sorry. Just while I'm away at work.\It's fine.\You and I have a special, eternal bond, after all!\Don't add eternal on there so casually.\Have a good day.\Have you been working those muscles? response:	Now...
context: I'd see them in a whole new light.\Sorry. Just while I'm away at work.\It's fine.\You and I have a special, eternal bond, after all!\Don't add eternal on there so casually.\Have a good day.\Have you been working those muscles?\Now... response:	When you don't work out they'll degrade and it can hasten your body's aging.
context: Sorry. Just while I'm away at work.\It's fine.\You and I have a special, eternal bond, after all!\Don't add eternal on there so casually.\Have a good day.\Have you been working those muscles?\Now...\When you don't work out they'll degrade and it can hasten your body's aging. response:	We were just trying to kill each other the other day.
context: It's fine.\You and I have a special, eternal bond, after all!\Don't add eternal on there so casually.\Have a good day.\Have you been working those muscles?\Now...\When you don't work out they'll degrade and it can hasten your body's aging.\We were just trying to kill each other the other day. response:	There's no way Tohru would forgive a traitor.
context: You and I have a special, eternal bond, after all!\Don't add eternal on there so casually.\Have a good day.\Have you been working those muscles?\Now...\When you don't work out they'll degrade and it can hasten your body's aging.\We were just trying to kill each other the other day.\There's no way Tohru would forgive a traitor. response:	She'll eliminate me.
context: Don't add eternal on there so casually.\Have a good day.\Have you been working those muscles?\Now...\When you don't work out they'll degrade and it can hasten your body's aging.\We were just trying to kill each other the other day.\There's no way Tohru would forgive a traitor.\She'll eliminate me. response:	But I want to know more about Kobayashi before that.
context: Have a good day.\Have you been working those muscles?\Now...\When you don't work out they'll degrade and it can hasten your body's aging.\We were just trying to kill each other the other day.\There's no way Tohru would forgive a traitor.\She'll eliminate me.\But I want to know more about Kobayashi before that. response:	I won't go down easily.
context: Have you been working those muscles?\Now...\When you don't work out they'll degrade and it can hasten your body's aging.\We were just trying to kill each other the other day.\There's no way Tohru would forgive a traitor.\She'll eliminate me.\But I want to know more about Kobayashi before that.\I won't go down easily. response:	Don't fight!
context: Now...\When you don't work out they'll degrade and it can hasten your body's aging.\We were just trying to kill each other the other day.\There's no way Tohru would forgive a traitor.\She'll eliminate me.\But I want to know more about Kobayashi before that.\I won't go down easily.\Don't fight! response:	Here.
context: When you don't work out they'll degrade and it can hasten your body's aging.\We were just trying to kill each other the other day.\There's no way Tohru would forgive a traitor.\She'll eliminate me.\But I want to know more about Kobayashi before that.\I won't go down easily.\Don't fight!\Here. response:	Living as a Human Manual
context: We were just trying to kill each other the other day.\There's no way Tohru would forgive a traitor.\She'll eliminate me.\But I want to know more about Kobayashi before that.\I won't go down easily.\Don't fight!\Here.\Living as a Human Manual response:	Kobayashi Tohru
context: There's no way Tohru would forgive a traitor.\She'll eliminate me.\But I want to know more about Kobayashi before that.\I won't go down easily.\Don't fight!\Here.\Living as a Human Manual\Kobayashi Tohru response:	It's the manual I wrote on how to live as a human.
context: She'll eliminate me.\But I want to know more about Kobayashi before that.\I won't go down easily.\Don't fight!\Here.\Living as a Human Manual\Kobayashi Tohru\It's the manual I wrote on how to live as a human. response:	Now, change your claws into human hands.
context: But I want to know more about Kobayashi before that.\I won't go down easily.\Don't fight!\Here.\Living as a Human Manual\Kobayashi Tohru\It's the manual I wrote on how to live as a human.\Now, change your claws into human hands. response:	Wha?
context: I won't go down easily.\Don't fight!\Here.\Living as a Human Manual\Kobayashi Tohru\It's the manual I wrote on how to live as a human.\Now, change your claws into human hands.\Wha? response:	Why are you laughing at yourself?!
context: Don't fight!\Here.\Living as a Human Manual\Kobayashi Tohru\It's the manual I wrote on how to live as a human.\Now, change your claws into human hands.\Wha?\Why are you laughing at yourself?! response:	Do you suck at making hands?
context: Here.\Living as a Human Manual\Kobayashi Tohru\It's the manual I wrote on how to live as a human.\Now, change your claws into human hands.\Wha?\Why are you laughing at yourself?!\Do you suck at making hands? response:	I can't transform them well.
context: Living as a Human Manual\Kobayashi Tohru\It's the manual I wrote on how to live as a human.\Now, change your claws into human hands.\Wha?\Why are you laughing at yourself?!\Do you suck at making hands?\I can't transform them well. response:	I'll read it like this.
context: Kobayashi Tohru\It's the manual I wrote on how to live as a human.\Now, change your claws into human hands.\Wha?\Why are you laughing at yourself?!\Do you suck at making hands?\I can't transform them well.\I'll read it like this. response:	Oh, you can hold it with those hands?
context: It's the manual I wrote on how to live as a human.\Now, change your claws into human hands.\Wha?\Why are you laughing at yourself?!\Do you suck at making hands?\I can't transform them well.\I'll read it like this.\Oh, you can hold it with those hands? response:	They come with tiny hands.
context: Now, change your claws into human hands.\Wha?\Why are you laughing at yourself?!\Do you suck at making hands?\I can't transform them well.\I'll read it like this.\Oh, you can hold it with those hands?\They come with tiny hands. response:	Creepy!
context: Wha?\Why are you laughing at yourself?!\Do you suck at making hands?\I can't transform them well.\I'll read it like this.\Oh, you can hold it with those hands?\They come with tiny hands.\Creepy! response:	Greetings.
context: Why are you laughing at yourself?!\Do you suck at making hands?\I can't transform them well.\I'll read it like this.\Oh, you can hold it with those hands?\They come with tiny hands.\Creepy!\Greetings. response:	Humans establish communication with greetings.
context: Do you suck at making hands?\I can't transform them well.\I'll read it like this.\Oh, you can hold it with those hands?\They come with tiny hands.\Creepy!\Greetings.\Humans establish communication with greetings. response:	For now just repeat whatever greeting one says to you.
context: I can't transform them well.\I'll read it like this.\Oh, you can hold it with those hands?\They come with tiny hands.\Creepy!\Greetings.\Humans establish communication with greetings.\For now just repeat whatever greeting one says to you. response:	Food.
context: I'll read it like this.\Oh, you can hold it with those hands?\They come with tiny hands.\Creepy!\Greetings.\Humans establish communication with greetings.\For now just repeat whatever greeting one says to you.\Food. response:	Humans can mostly eat anything, but they stubbornly won't eat dragon meat.
context: Oh, you can hold it with those hands?\They come with tiny hands.\Creepy!\Greetings.\Humans establish communication with greetings.\For now just repeat whatever greeting one says to you.\Food.\Humans can mostly eat anything, but they stubbornly won't eat dragon meat. response:	Currently seeking ways to get them to eat it.
context: They come with tiny hands.\Creepy!\Greetings.\Humans establish communication with greetings.\For now just repeat whatever greeting one says to you.\Food.\Humans can mostly eat anything, but they stubbornly won't eat dragon meat.\Currently seeking ways to get them to eat it. response:	Mating
context: Creepy!\Greetings.\Humans establish communication with greetings.\For now just repeat whatever greeting one says to you.\Food.\Humans can mostly eat anything, but they stubbornly won't eat dragon meat.\Currently seeking ways to get them to eat it.\Mating response:	I want to do it.
context: Greetings.\Humans establish communication with greetings.\For now just repeat whatever greeting one says to you.\Food.\Humans can mostly eat anything, but they stubbornly won't eat dragon meat.\Currently seeking ways to get them to eat it.\Mating\I want to do it. response:	The stuff in here is biased!
context: Humans establish communication with greetings.\For now just repeat whatever greeting one says to you.\Food.\Humans can mostly eat anything, but they stubbornly won't eat dragon meat.\Currently seeking ways to get them to eat it.\Mating\I want to do it.\The stuff in here is biased! response:	It's the truth for me.
context: For now just repeat whatever greeting one says to you.\Food.\Humans can mostly eat anything, but they stubbornly won't eat dragon meat.\Currently seeking ways to get them to eat it.\Mating\I want to do it.\The stuff in here is biased!\It's the truth for me. response:	Clothing.
context: Food.\Humans can mostly eat anything, but they stubbornly won't eat dragon meat.\Currently seeking ways to get them to eat it.\Mating\I want to do it.\The stuff in here is biased!\It's the truth for me.\Clothing. response:	Wearing clothing as similar as possible to what other humans wear will keep you from standing out.
context: Humans can mostly eat anything, but they stubbornly won't eat dragon meat.\Currently seeking ways to get them to eat it.\Mating\I want to do it.\The stuff in here is biased!\It's the truth for me.\Clothing.\Wearing clothing as similar as possible to what other humans wear will keep you from standing out. response:	Hmm?
context: Currently seeking ways to get them to eat it.\Mating\I want to do it.\The stuff in here is biased!\It's the truth for me.\Clothing.\Wearing clothing as similar as possible to what other humans wear will keep you from standing out.\Hmm? response:	Aren't you going against this a bit?
context: Mating\I want to do it.\The stuff in here is biased!\It's the truth for me.\Clothing.\Wearing clothing as similar as possible to what other humans wear will keep you from standing out.\Hmm?\Aren't you going against this a bit? response:	Conspicuous
context: I want to do it.\The stuff in here is biased!\It's the truth for me.\Clothing.\Wearing clothing as similar as possible to what other humans wear will keep you from standing out.\Hmm?\Aren't you going against this a bit?\Conspicuous response:	Yah!
context: The stuff in here is biased!\It's the truth for me.\Clothing.\Wearing clothing as similar as possible to what other humans wear will keep you from standing out.\Hmm?\Aren't you going against this a bit?\Conspicuous\Yah! response:	Fine.
context: It's the truth for me.\Clothing.\Wearing clothing as similar as possible to what other humans wear will keep you from standing out.\Hmm?\Aren't you going against this a bit?\Conspicuous\Yah!\Fine. response:	I'll wear human clothing, too.
context: Clothing.\Wearing clothing as similar as possible to what other humans wear will keep you from standing out.\Hmm?\Aren't you going against this a bit?\Conspicuous\Yah!\Fine.\I'll wear human clothing, too. response:	We don't have your size.
context: Wearing clothing as similar as possible to what other humans wear will keep you from standing out.\Hmm?\Aren't you going against this a bit?\Conspicuous\Yah!\Fine.\I'll wear human clothing, too.\We don't have your size. response:	There are Kanna's clothes, right?
context: Hmm?\Aren't you going against this a bit?\Conspicuous\Yah!\Fine.\I'll wear human clothing, too.\We don't have your size.\There are Kanna's clothes, right? response:	The size won't fit!
context: Aren't you going against this a bit?\Conspicuous\Yah!\Fine.\I'll wear human clothing, too.\We don't have your size.\There are Kanna's clothes, right?\The size won't fit! response:	See, it fit.
context: Conspicuous\Yah!\Fine.\I'll wear human clothing, too.\We don't have your size.\There are Kanna's clothes, right?\The size won't fit!\See, it fit. response:	What did I just tell you?
context: Yah!\Fine.\I'll wear human clothing, too.\We don't have your size.\There are Kanna's clothes, right?\The size won't fit!\See, it fit.\What did I just tell you? response:	Why don't you transform your scales like I do?
context: Fine.\I'll wear human clothing, too.\We don't have your size.\There are Kanna's clothes, right?\The size won't fit!\See, it fit.\What did I just tell you?\Why don't you transform your scales like I do? response:	I don't have the skill to do that.
context: I'll wear human clothing, too.\We don't have your size.\There are Kanna's clothes, right?\The size won't fit!\See, it fit.\What did I just tell you?\Why don't you transform your scales like I do?\I don't have the skill to do that. response:	I'll lend you my clothes, then.
context: We don't have your size.\There are Kanna's clothes, right?\The size won't fit!\See, it fit.\What did I just tell you?\Why don't you transform your scales like I do?\I don't have the skill to do that.\I'll lend you my clothes, then. response:	What are you planning to do from now on?
context: There are Kanna's clothes, right?\The size won't fit!\See, it fit.\What did I just tell you?\Why don't you transform your scales like I do?\I don't have the skill to do that.\I'll lend you my clothes, then.\What are you planning to do from now on? response:	What will I do?
context: The size won't fit!\See, it fit.\What did I just tell you?\Why don't you transform your scales like I do?\I don't have the skill to do that.\I'll lend you my clothes, then.\What are you planning to do from now on?\What will I do? response:	What do you want to do?
context: See, it fit.\What did I just tell you?\Why don't you transform your scales like I do?\I don't have the skill to do that.\I'll lend you my clothes, then.\What are you planning to do from now on?\What will I do?\What do you want to do? response:	There's something, isn't there?
context: What did I just tell you?\Why don't you transform your scales like I do?\I don't have the skill to do that.\I'll lend you my clothes, then.\What are you planning to do from now on?\What will I do?\What do you want to do?\There's something, isn't there? response:	Something I want to do?
context: Why don't you transform your scales like I do?\I don't have the skill to do that.\I'll lend you my clothes, then.\What are you planning to do from now on?\What will I do?\What do you want to do?\There's something, isn't there?\Something I want to do? response:	I'll think on it.
context: I don't have the skill to do that.\I'll lend you my clothes, then.\What are you planning to do from now on?\What will I do?\What do you want to do?\There's something, isn't there?\Something I want to do?\I'll think on it. response:	That so?
context: I'll lend you my clothes, then.\What are you planning to do from now on?\What will I do?\What do you want to do?\There's something, isn't there?\Something I want to do?\I'll think on it.\That so? response:	Yeah.
context: What are you planning to do from now on?\What will I do?\What do you want to do?\There's something, isn't there?\Something I want to do?\I'll think on it.\That so?\Yeah. response:	You couldn't fully say that polite phrase there.
context: What will I do?\What do you want to do?\There's something, isn't there?\Something I want to do?\I'll think on it.\That so?\Yeah.\You couldn't fully say that polite phrase there. response:	This might come as a surprise,
context: What do you want to do?\There's something, isn't there?\Something I want to do?\I'll think on it.\That so?\Yeah.\You couldn't fully say that polite phrase there.\This might come as a surprise, response:	but I don't take kindly to you being here!
context: There's something, isn't there?\Something I want to do?\I'll think on it.\That so?\Yeah.\You couldn't fully say that polite phrase there.\This might come as a surprise,\but I don't take kindly to you being here! response:	That's not a surprise.
context: Something I want to do?\I'll think on it.\That so?\Yeah.\You couldn't fully say that polite phrase there.\This might come as a surprise,\but I don't take kindly to you being here!\That's not a surprise. response:	After all, think about how you showed up!
context: I'll think on it.\That so?\Yeah.\You couldn't fully say that polite phrase there.\This might come as a surprise,\but I don't take kindly to you being here!\That's not a surprise.\After all, think about how you showed up! response:	You were like a bloodthirsty berserker.
context: That so?\Yeah.\You couldn't fully say that polite phrase there.\This might come as a surprise,\but I don't take kindly to you being here!\That's not a surprise.\After all, think about how you showed up!\You were like a bloodthirsty berserker. response:	No, that was because fighting you seemed like fun.
context: Yeah.\You couldn't fully say that polite phrase there.\This might come as a surprise,\but I don't take kindly to you being here!\That's not a surprise.\After all, think about how you showed up!\You were like a bloodthirsty berserker.\No, that was because fighting you seemed like fun. response:	Wait, I looked like that?!
context: You couldn't fully say that polite phrase there.\This might come as a surprise,\but I don't take kindly to you being here!\That's not a surprise.\After all, think about how you showed up!\You were like a bloodthirsty berserker.\No, that was because fighting you seemed like fun.\Wait, I looked like that?! response:	Please figure out what you want to do quickly.
context: This might come as a surprise,\but I don't take kindly to you being here!\That's not a surprise.\After all, think about how you showed up!\You were like a bloodthirsty berserker.\No, that was because fighting you seemed like fun.\Wait, I looked like that?!\Please figure out what you want to do quickly. response:	They say those who don't work don't eat.
context: but I don't take kindly to you being here!\That's not a surprise.\After all, think about how you showed up!\You were like a bloodthirsty berserker.\No, that was because fighting you seemed like fun.\Wait, I looked like that?!\Please figure out what you want to do quickly.\They say those who don't work don't eat. response:	What about Kanna?
context: That's not a surprise.\After all, think about how you showed up!\You were like a bloodthirsty berserker.\No, that was because fighting you seemed like fun.\Wait, I looked like that?!\Please figure out what you want to do quickly.\They say those who don't work don't eat.\What about Kanna? response:	Kanna has her job as an elementary school student.
context: After all, think about how you showed up!\You were like a bloodthirsty berserker.\No, that was because fighting you seemed like fun.\Wait, I looked like that?!\Please figure out what you want to do quickly.\They say those who don't work don't eat.\What about Kanna?\Kanna has her job as an elementary school student. response:	Then I'll be an elementary school student, too.
context: You were like a bloodthirsty berserker.\No, that was because fighting you seemed like fun.\Wait, I looked like that?!\Please figure out what you want to do quickly.\They say those who don't work don't eat.\What about Kanna?\Kanna has her job as an elementary school student.\Then I'll be an elementary school student, too. response:	You have to be a child for that.
context: No, that was because fighting you seemed like fun.\Wait, I looked like that?!\Please figure out what you want to do quickly.\They say those who don't work don't eat.\What about Kanna?\Kanna has her job as an elementary school student.\Then I'll be an elementary school student, too.\You have to be a child for that. response:	You're about the same age as me, aren't you?
context: Wait, I looked like that?!\Please figure out what you want to do quickly.\They say those who don't work don't eat.\What about Kanna?\Kanna has her job as an elementary school student.\Then I'll be an elementary school student, too.\You have to be a child for that.\You're about the same age as me, aren't you? response:	I see.
context: Please figure out what you want to do quickly.\They say those who don't work don't eat.\What about Kanna?\Kanna has her job as an elementary school student.\Then I'll be an elementary school student, too.\You have to be a child for that.\You're about the same age as me, aren't you?\I see. response:	At least think it over.
context: They say those who don't work don't eat.\What about Kanna?\Kanna has her job as an elementary school student.\Then I'll be an elementary school student, too.\You have to be a child for that.\You're about the same age as me, aren't you?\I see.\At least think it over. response:	I'm home.
context: What about Kanna?\Kanna has her job as an elementary school student.\Then I'll be an elementary school student, too.\You have to be a child for that.\You're about the same age as me, aren't you?\I see.\At least think it over.\I'm home. response:	What's Ilulu doing?
context: Kanna has her job as an elementary school student.\Then I'll be an elementary school student, too.\You have to be a child for that.\You're about the same age as me, aren't you?\I see.\At least think it over.\I'm home.\What's Ilulu doing? response:	Thinking about what she wants to do.
context: Then I'll be an elementary school student, too.\You have to be a child for that.\You're about the same age as me, aren't you?\I see.\At least think it over.\I'm home.\What's Ilulu doing?\Thinking about what she wants to do. response:	Hmm...
context: You have to be a child for that.\You're about the same age as me, aren't you?\I see.\At least think it over.\I'm home.\What's Ilulu doing?\Thinking about what she wants to do.\Hmm... response:	I hope you find something.
context: You're about the same age as me, aren't you?\I see.\At least think it over.\I'm home.\What's Ilulu doing?\Thinking about what she wants to do.\Hmm...\I hope you find something. response:	What is it?
context: I see.\At least think it over.\I'm home.\What's Ilulu doing?\Thinking about what she wants to do.\Hmm...\I hope you find something.\What is it? response:	I figured out what I want to do for now.
context: At least think it over.\I'm home.\What's Ilulu doing?\Thinking about what she wants to do.\Hmm...\I hope you find something.\What is it?\I figured out what I want to do for now. response:	Oh, what's that?
context: I'm home.\What's Ilulu doing?\Thinking about what she wants to do.\Hmm...\I hope you find something.\What is it?\I figured out what I want to do for now.\Oh, what's that? response:	I want to make babies with you.
context: What's Ilulu doing?\Thinking about what she wants to do.\Hmm...\I hope you find something.\What is it?\I figured out what I want to do for now.\Oh, what's that?\I want to make babies with you. response:	Huh?
context: Thinking about what she wants to do.\Hmm...\I hope you find something.\What is it?\I figured out what I want to do for now.\Oh, what's that?\I want to make babies with you.\Huh? response:	Huh?
context: Hmm...\I hope you find something.\What is it?\I figured out what I want to do for now.\Oh, what's that?\I want to make babies with you.\Huh?\Huh? response:	When I thought about it,
context: I hope you find something.\What is it?\I figured out what I want to do for now.\Oh, what's that?\I want to make babies with you.\Huh?\Huh?\When I thought about it, response:	I am at an age where I could have and raise children.
context: What is it?\I figured out what I want to do for now.\Oh, what's that?\I want to make babies with you.\Huh?\Huh?\When I thought about it,\I am at an age where I could have and raise children. response:	I want you to fill the loneliness from my lack of family.
context: I figured out what I want to do for now.\Oh, what's that?\I want to make babies with you.\Huh?\Huh?\When I thought about it,\I am at an age where I could have and raise children.\I want you to fill the loneliness from my lack of family. response:	Kobayashi, have sex with me!
context: Oh, what's that?\I want to make babies with you.\Huh?\Huh?\When I thought about it,\I am at an age where I could have and raise children.\I want you to fill the loneliness from my lack of family.\Kobayashi, have sex with me! response:	No way!
context: I want to make babies with you.\Huh?\Huh?\When I thought about it,\I am at an age where I could have and raise children.\I want you to fill the loneliness from my lack of family.\Kobayashi, have sex with me!\No way! response:	That's just no, no, no, no!
context: Huh?\Huh?\When I thought about it,\I am at an age where I could have and raise children.\I want you to fill the loneliness from my lack of family.\Kobayashi, have sex with me!\No way!\That's just no, no, no, no! response:	Not happening!
context: Huh?\When I thought about it,\I am at an age where I could have and raise children.\I want you to fill the loneliness from my lack of family.\Kobayashi, have sex with me!\No way!\That's just no, no, no, no!\Not happening! response:	I'm a woman, anyway.
context: When I thought about it,\I am at an age where I could have and raise children.\I want you to fill the loneliness from my lack of family.\Kobayashi, have sex with me!\No way!\That's just no, no, no, no!\Not happening!\I'm a woman, anyway. response:	I can give you a thing again!
context: I am at an age where I could have and raise children.\I want you to fill the loneliness from my lack of family.\Kobayashi, have sex with me!\No way!\That's just no, no, no, no!\Not happening!\I'm a woman, anyway.\I can give you a thing again! response:	No, you won't!
context: I want you to fill the loneliness from my lack of family.\Kobayashi, have sex with me!\No way!\That's just no, no, no, no!\Not happening!\I'm a woman, anyway.\I can give you a thing again!\No, you won't! response:	If you do that, then I'm doing her!
context: Kobayashi, have sex with me!\No way!\That's just no, no, no, no!\Not happening!\I'm a woman, anyway.\I can give you a thing again!\No, you won't!\If you do that, then I'm doing her! response:	Vulgar.
context: No way!\That's just no, no, no, no!\Not happening!\I'm a woman, anyway.\I can give you a thing again!\No, you won't!\If you do that, then I'm doing her!\Vulgar. response:	Right?
context: That's just no, no, no, no!\Not happening!\I'm a woman, anyway.\I can give you a thing again!\No, you won't!\If you do that, then I'm doing her!\Vulgar.\Right? response:	Absolutely not, got it?!
context: Not happening!\I'm a woman, anyway.\I can give you a thing again!\No, you won't!\If you do that, then I'm doing her!\Vulgar.\Right?\Absolutely not, got it?! response:	I'm not really holding onto my chastity for a reason, but I'm not giving it to you all.
context: I'm a woman, anyway.\I can give you a thing again!\No, you won't!\If you do that, then I'm doing her!\Vulgar.\Right?\Absolutely not, got it?!\I'm not really holding onto my chastity for a reason, but I'm not giving it to you all. response:	Oh!
context: I can give you a thing again!\No, you won't!\If you do that, then I'm doing her!\Vulgar.\Right?\Absolutely not, got it?!\I'm not really holding onto my chastity for a reason, but I'm not giving it to you all.\Oh! response:	That's for Ilulu.
context: No, you won't!\If you do that, then I'm doing her!\Vulgar.\Right?\Absolutely not, got it?!\I'm not really holding onto my chastity for a reason, but I'm not giving it to you all.\Oh!\That's for Ilulu. response:	Next Episode Preview
context: If you do that, then I'm doing her!\Vulgar.\Right?\Absolutely not, got it?!\I'm not really holding onto my chastity for a reason, but I'm not giving it to you all.\Oh!\That's for Ilulu.\Next Episode Preview response:	Where should we have Ilulu sleep?
context: Vulgar.\Right?\Absolutely not, got it?!\I'm not really holding onto my chastity for a reason, but I'm not giving it to you all.\Oh!\That's for Ilulu.\Next Episode Preview\Where should we have Ilulu sleep? response:	We don't have space for another bed.
context: Right?\Absolutely not, got it?!\I'm not really holding onto my chastity for a reason, but I'm not giving it to you all.\Oh!\That's for Ilulu.\Next Episode Preview\Where should we have Ilulu sleep?\We don't have space for another bed. response:	What about here?
context: Absolutely not, got it?!\I'm not really holding onto my chastity for a reason, but I'm not giving it to you all.\Oh!\That's for Ilulu.\Next Episode Preview\Where should we have Ilulu sleep?\We don't have space for another bed.\What about here? response:	The closet?
context: I'm not really holding onto my chastity for a reason, but I'm not giving it to you all.\Oh!\That's for Ilulu.\Next Episode Preview\Where should we have Ilulu sleep?\We don't have space for another bed.\What about here?\The closet? response:	It's calming.
context: Oh!\That's for Ilulu.\Next Episode Preview\Where should we have Ilulu sleep?\We don't have space for another bed.\What about here?\The closet?\It's calming. response:	If you're okay with it, that works.
context: That's for Ilulu.\Next Episode Preview\Where should we have Ilulu sleep?\We don't have space for another bed.\What about here?\The closet?\It's calming.\If you're okay with it, that works. response:	Yeah, I like it.
context: Next Episode Preview\Where should we have Ilulu sleep?\We don't have space for another bed.\What about here?\The closet?\It's calming.\If you're okay with it, that works.\Yeah, I like it. response:	Episode 3
context: Where should we have Ilulu sleep?\We don't have space for another bed.\What about here?\The closet?\It's calming.\If you're okay with it, that works.\Yeah, I like it.\Episode 3 response:	Extracurricular Actives (Of Course They're Not Normal)
context: We don't have space for another bed.\What about here?\The closet?\It's calming.\If you're okay with it, that works.\Yeah, I like it.\Episode 3\Extracurricular Actives (Of Course They're Not Normal) response:	This Week's Who's Rotten?
context: What about here?\The closet?\It's calming.\If you're okay with it, that works.\Yeah, I like it.\Episode 3\Extracurricular Actives (Of Course They're Not Normal)\This Week's Who's Rotten? response:	Cancer
context: The closet?\It's calming.\If you're okay with it, that works.\Yeah, I like it.\Episode 3\Extracurricular Actives (Of Course They're Not Normal)\This Week's Who's Rotten?\Cancer response:	You Might Get Caught In An Unexpected Event
context: It's calming.\If you're okay with it, that works.\Yeah, I like it.\Episode 3\Extracurricular Actives (Of Course They're Not Normal)\This Week's Who's Rotten?\Cancer\You Might Get Caught In An Unexpected Event response:	Lucky Advice
context: If you're okay with it, that works.\Yeah, I like it.\Episode 3\Extracurricular Actives (Of Course They're Not Normal)\This Week's Who's Rotten?\Cancer\You Might Get Caught In An Unexpected Event\Lucky Advice response:	Astrology is meaningless, anyway.
context: Yeah, I like it.\Episode 3\Extracurricular Actives (Of Course They're Not Normal)\This Week's Who's Rotten?\Cancer\You Might Get Caught In An Unexpected Event\Lucky Advice\Astrology is meaningless, anyway. response:	Don't completely reject it
context: Episode 3\Extracurricular Actives (Of Course They're Not Normal)\This Week's Who's Rotten?\Cancer\You Might Get Caught In An Unexpected Event\Lucky Advice\Astrology is meaningless, anyway.\Don't completely reject it response:	This Week's Who's Rotten?
context: Extracurricular Actives (Of Course They're Not Normal)\This Week's Who's Rotten?\Cancer\You Might Get Caught In An Unexpected Event\Lucky Advice\Astrology is meaningless, anyway.\Don't completely reject it\This Week's Who's Rotten? response:	Cancer.