context: Right, that's all for today's class. response:	Remember, you'll be studying for college exams next year,
context: Right, that's all for today's class.\Remember, you'll be studying for college exams next year, response:	Katagiri High School
context: Right, that's all for today's class.\Remember, you'll be studying for college exams next year,\Katagiri High School response:	Remember, you'll be studying for college exams next year,
context: Right, that's all for today's class.\Remember, you'll be studying for college exams next year,\Katagiri High School\Remember, you'll be studying for college exams next year, response:	so you won't get to enjoy your next summer vacation.
context: Right, that's all for today's class.\Remember, you'll be studying for college exams next year,\Katagiri High School\Remember, you'll be studying for college exams next year,\so you won't get to enjoy your next summer vacation. response:	Go out and enjoy the pool or the beach while you still can.
context: Right, that's all for today's class.\Remember, you'll be studying for college exams next year,\Katagiri High School\Remember, you'll be studying for college exams next year,\so you won't get to enjoy your next summer vacation.\Go out and enjoy the pool or the beach while you still can. response:	I'd be happy to go with you.
context: Right, that's all for today's class.\Remember, you'll be studying for college exams next year,\Katagiri High School\Remember, you'll be studying for college exams next year,\so you won't get to enjoy your next summer vacation.\Go out and enjoy the pool or the beach while you still can.\I'd be happy to go with you. response:	What? Why the hell would we invite a teacher to come with us?
context: Right, that's all for today's class.\Remember, you'll be studying for college exams next year,\Katagiri High School\Remember, you'll be studying for college exams next year,\so you won't get to enjoy your next summer vacation.\Go out and enjoy the pool or the beach while you still can.\I'd be happy to go with you.\What? Why the hell would we invite a teacher to come with us? response:	Oh, please, Ishikawa!
context: Remember, you'll be studying for college exams next year,\Katagiri High School\Remember, you'll be studying for college exams next year,\so you won't get to enjoy your next summer vacation.\Go out and enjoy the pool or the beach while you still can.\I'd be happy to go with you.\What? Why the hell would we invite a teacher to come with us?\Oh, please, Ishikawa! response:	There's no point in going to the pool or beach with a bunch of guys.
context: Katagiri High School\Remember, you'll be studying for college exams next year,\so you won't get to enjoy your next summer vacation.\Go out and enjoy the pool or the beach while you still can.\I'd be happy to go with you.\What? Why the hell would we invite a teacher to come with us?\Oh, please, Ishikawa!\There's no point in going to the pool or beach with a bunch of guys. response:	Oh, right.
context: Remember, you'll be studying for college exams next year,\so you won't get to enjoy your next summer vacation.\Go out and enjoy the pool or the beach while you still can.\I'd be happy to go with you.\What? Why the hell would we invite a teacher to come with us?\Oh, please, Ishikawa!\There's no point in going to the pool or beach with a bunch of guys.\Oh, right. response:	God, they're so dumb.
context: so you won't get to enjoy your next summer vacation.\Go out and enjoy the pool or the beach while you still can.\I'd be happy to go with you.\What? Why the hell would we invite a teacher to come with us?\Oh, please, Ishikawa!\There's no point in going to the pool or beach with a bunch of guys.\Oh, right.\God, they're so dumb. response:	Yasuda's pretty hot, but he keeps opening his dumb mouth.
context: Go out and enjoy the pool or the beach while you still can.\I'd be happy to go with you.\What? Why the hell would we invite a teacher to come with us?\Oh, please, Ishikawa!\There's no point in going to the pool or beach with a bunch of guys.\Oh, right.\God, they're so dumb.\Yasuda's pretty hot, but he keeps opening his dumb mouth. response:	He's a good teacher, too.
context: I'd be happy to go with you.\What? Why the hell would we invite a teacher to come with us?\Oh, please, Ishikawa!\There's no point in going to the pool or beach with a bunch of guys.\Oh, right.\God, they're so dumb.\Yasuda's pretty hot, but he keeps opening his dumb mouth.\He's a good teacher, too. response:	Ugh, just ignore him.
context: What? Why the hell would we invite a teacher to come with us?\Oh, please, Ishikawa!\There's no point in going to the pool or beach with a bunch of guys.\Oh, right.\God, they're so dumb.\Yasuda's pretty hot, but he keeps opening his dumb mouth.\He's a good teacher, too.\Ugh, just ignore him. response:	Why? Did something happen between you and Yasuda-sensei, Hori?
context: Oh, please, Ishikawa!\There's no point in going to the pool or beach with a bunch of guys.\Oh, right.\God, they're so dumb.\Yasuda's pretty hot, but he keeps opening his dumb mouth.\He's a good teacher, too.\Ugh, just ignore him.\Why? Did something happen between you and Yasuda-sensei, Hori? response:	Yeah, this morning.
context: There's no point in going to the pool or beach with a bunch of guys.\Oh, right.\God, they're so dumb.\Yasuda's pretty hot, but he keeps opening his dumb mouth.\He's a good teacher, too.\Ugh, just ignore him.\Why? Did something happen between you and Yasuda-sensei, Hori?\Yeah, this morning. response:	Hori! Keep your chin up, okay?
context: Oh, right.\God, they're so dumb.\Yasuda's pretty hot, but he keeps opening his dumb mouth.\He's a good teacher, too.\Ugh, just ignore him.\Why? Did something happen between you and Yasuda-sensei, Hori?\Yeah, this morning.\Hori! Keep your chin up, okay? response:	What? Why?
context: God, they're so dumb.\Yasuda's pretty hot, but he keeps opening his dumb mouth.\He's a good teacher, too.\Ugh, just ignore him.\Why? Did something happen between you and Yasuda-sensei, Hori?\Yeah, this morning.\Hori! Keep your chin up, okay?\What? Why? response:	Here's a little-known fact about me: I love flat-chested girls!
context: Yasuda's pretty hot, but he keeps opening his dumb mouth.\He's a good teacher, too.\Ugh, just ignore him.\Why? Did something happen between you and Yasuda-sensei, Hori?\Yeah, this morning.\Hori! Keep your chin up, okay?\What? Why?\Here's a little-known fact about me: I love flat-chested girls! response:	So have a little self-confidence!
context: He's a good teacher, too.\Ugh, just ignore him.\Why? Did something happen between you and Yasuda-sensei, Hori?\Yeah, this morning.\Hori! Keep your chin up, okay?\What? Why?\Here's a little-known fact about me: I love flat-chested girls!\So have a little self-confidence! response:	That's how he tried to cheer me up.
context: Ugh, just ignore him.\Why? Did something happen between you and Yasuda-sensei, Hori?\Yeah, this morning.\Hori! Keep your chin up, okay?\What? Why?\Here's a little-known fact about me: I love flat-chested girls!\So have a little self-confidence!\That's how he tried to cheer me up. response:	Sorry. I have no idea what he was trying to do there.
context: Why? Did something happen between you and Yasuda-sensei, Hori?\Yeah, this morning.\Hori! Keep your chin up, okay?\What? Why?\Here's a little-known fact about me: I love flat-chested girls!\So have a little self-confidence!\That's how he tried to cheer me up.\Sorry. I have no idea what he was trying to do there. response:	Oh, hey, Hori!
context: Yeah, this morning.\Hori! Keep your chin up, okay?\What? Why?\Here's a little-known fact about me: I love flat-chested girls!\So have a little self-confidence!\That's how he tried to cheer me up.\Sorry. I have no idea what he was trying to do there.\Oh, hey, Hori! response:	A guy from another school asked me for your number.
context: Hori! Keep your chin up, okay?\What? Why?\Here's a little-known fact about me: I love flat-chested girls!\So have a little self-confidence!\That's how he tried to cheer me up.\Sorry. I have no idea what he was trying to do there.\Oh, hey, Hori!\A guy from another school asked me for your number. response:	Can I give it to him?
context: What? Why?\Here's a little-known fact about me: I love flat-chested girls!\So have a little self-confidence!\That's how he tried to cheer me up.\Sorry. I have no idea what he was trying to do there.\Oh, hey, Hori!\A guy from another school asked me for your number.\Can I give it to him? response:	He didn't have the guts to ask me himself, so no. Turn him down.
context: Here's a little-known fact about me: I love flat-chested girls!\So have a little self-confidence!\That's how he tried to cheer me up.\Sorry. I have no idea what he was trying to do there.\Oh, hey, Hori!\A guy from another school asked me for your number.\Can I give it to him?\He didn't have the guts to ask me himself, so no. Turn him down. response:	Aww, again?
context: So have a little self-confidence!\That's how he tried to cheer me up.\Sorry. I have no idea what he was trying to do there.\Oh, hey, Hori!\A guy from another school asked me for your number.\Can I give it to him?\He didn't have the guts to ask me himself, so no. Turn him down.\Aww, again? response:	Yo, wanna hit up karaoke on our way home?
context: That's how he tried to cheer me up.\Sorry. I have no idea what he was trying to do there.\Oh, hey, Hori!\A guy from another school asked me for your number.\Can I give it to him?\He didn't have the guts to ask me himself, so no. Turn him down.\Aww, again?\Yo, wanna hit up karaoke on our way home? response:	Karaoke?
context: Sorry. I have no idea what he was trying to do there.\Oh, hey, Hori!\A guy from another school asked me for your number.\Can I give it to him?\He didn't have the guts to ask me himself, so no. Turn him down.\Aww, again?\Yo, wanna hit up karaoke on our way home?\Karaoke? response:	I got these coupons that expire today.
context: Oh, hey, Hori!\A guy from another school asked me for your number.\Can I give it to him?\He didn't have the guts to ask me himself, so no. Turn him down.\Aww, again?\Yo, wanna hit up karaoke on our way home?\Karaoke?\I got these coupons that expire today. response:	Half off two hours! That's a sweet deal!
context: A guy from another school asked me for your number.\Can I give it to him?\He didn't have the guts to ask me himself, so no. Turn him down.\Aww, again?\Yo, wanna hit up karaoke on our way home?\Karaoke?\I got these coupons that expire today.\Half off two hours! That's a sweet deal! response:	Wanna go, Hori?
context: Can I give it to him?\He didn't have the guts to ask me himself, so no. Turn him down.\Aww, again?\Yo, wanna hit up karaoke on our way home?\Karaoke?\I got these coupons that expire today.\Half off two hours! That's a sweet deal!\Wanna go, Hori? response:	C'mon!
context: He didn't have the guts to ask me himself, so no. Turn him down.\Aww, again?\Yo, wanna hit up karaoke on our way home?\Karaoke?\I got these coupons that expire today.\Half off two hours! That's a sweet deal!\Wanna go, Hori?\C'mon! response:	Sorry, I gotta pass.
context: Aww, again?\Yo, wanna hit up karaoke on our way home?\Karaoke?\I got these coupons that expire today.\Half off two hours! That's a sweet deal!\Wanna go, Hori?\C'mon!\Sorry, I gotta pass. response:	You always pass!
context: Yo, wanna hit up karaoke on our way home?\Karaoke?\I got these coupons that expire today.\Half off two hours! That's a sweet deal!\Wanna go, Hori?\C'mon!\Sorry, I gotta pass.\You always pass! response:	I'm really sorry!
context: Karaoke?\I got these coupons that expire today.\Half off two hours! That's a sweet deal!\Wanna go, Hori?\C'mon!\Sorry, I gotta pass.\You always pass!\I'm really sorry! response:	Hori-san.
context: I got these coupons that expire today.\Half off two hours! That's a sweet deal!\Wanna go, Hori?\C'mon!\Sorry, I gotta pass.\You always pass!\I'm really sorry!\Hori-san. response:	Huh?
context: Half off two hours! That's a sweet deal!\Wanna go, Hori?\C'mon!\Sorry, I gotta pass.\You always pass!\I'm really sorry!\Hori-san.\Huh? response:	You dropped your phone.
context: Wanna go, Hori?\C'mon!\Sorry, I gotta pass.\You always pass!\I'm really sorry!\Hori-san.\Huh?\You dropped your phone. response:	Oh, thanks.
context: C'mon!\Sorry, I gotta pass.\You always pass!\I'm really sorry!\Hori-san.\Huh?\You dropped your phone.\Oh, thanks. response:	God, Miyamura sounds so gloomy. Same as always, I guess.
context: Sorry, I gotta pass.\You always pass!\I'm really sorry!\Hori-san.\Huh?\You dropped your phone.\Oh, thanks.\God, Miyamura sounds so gloomy. Same as always, I guess. response:	I bet he's a total otaku.
context: You always pass!\I'm really sorry!\Hori-san.\Huh?\You dropped your phone.\Oh, thanks.\God, Miyamura sounds so gloomy. Same as always, I guess.\I bet he's a total otaku. response:	Oh, I like this angle!
context: I'm really sorry!\Hori-san.\Huh?\You dropped your phone.\Oh, thanks.\God, Miyamura sounds so gloomy. Same as always, I guess.\I bet he's a total otaku.\Oh, I like this angle! response:	The so moe! kind?
context: Hori-san.\Huh?\You dropped your phone.\Oh, thanks.\God, Miyamura sounds so gloomy. Same as always, I guess.\I bet he's a total otaku.\Oh, I like this angle!\The so moe! kind? response:	Oh, yeah, totally!
context: Huh?\You dropped your phone.\Oh, thanks.\God, Miyamura sounds so gloomy. Same as always, I guess.\I bet he's a total otaku.\Oh, I like this angle!\The so moe! kind?\Oh, yeah, totally! response:	What's he really like, Toru?
context: You dropped your phone.\Oh, thanks.\God, Miyamura sounds so gloomy. Same as always, I guess.\I bet he's a total otaku.\Oh, I like this angle!\The so moe! kind?\Oh, yeah, totally!\What's he really like, Toru? response:	Don't really know.
context: Oh, thanks.\God, Miyamura sounds so gloomy. Same as always, I guess.\I bet he's a total otaku.\Oh, I like this angle!\The so moe! kind?\Oh, yeah, totally!\What's he really like, Toru?\Don't really know. response:	Doesn't seem like he has any friends we could ask, either.
context: God, Miyamura sounds so gloomy. Same as always, I guess.\I bet he's a total otaku.\Oh, I like this angle!\The so moe! kind?\Oh, yeah, totally!\What's he really like, Toru?\Don't really know.\Doesn't seem like he has any friends we could ask, either. response:	Sorry, gotta run!
context: I bet he's a total otaku.\Oh, I like this angle!\The so moe! kind?\Oh, yeah, totally!\What's he really like, Toru?\Don't really know.\Doesn't seem like he has any friends we could ask, either.\Sorry, gotta run! response:	Hori's always in a hurry to get home.
context: Oh, I like this angle!\The so moe! kind?\Oh, yeah, totally!\What's he really like, Toru?\Don't really know.\Doesn't seem like he has any friends we could ask, either.\Sorry, gotta run!\Hori's always in a hurry to get home. response:	It's probably because she's got a boyfriend or something.
context: The so moe! kind?\Oh, yeah, totally!\What's he really like, Toru?\Don't really know.\Doesn't seem like he has any friends we could ask, either.\Sorry, gotta run!\Hori's always in a hurry to get home.\It's probably because she's got a boyfriend or something. response:	A boyfriend?!
context: Oh, yeah, totally!\What's he really like, Toru?\Don't really know.\Doesn't seem like he has any friends we could ask, either.\Sorry, gotta run!\Hori's always in a hurry to get home.\It's probably because she's got a boyfriend or something.\A boyfriend?! response:	I mean, she's pretty and popular. I wouldn't be surprised.
context: What's he really like, Toru?\Don't really know.\Doesn't seem like he has any friends we could ask, either.\Sorry, gotta run!\Hori's always in a hurry to get home.\It's probably because she's got a boyfriend or something.\A boyfriend?!\I mean, she's pretty and popular. I wouldn't be surprised. response:	Okay!
context: Don't really know.\Doesn't seem like he has any friends we could ask, either.\Sorry, gotta run!\Hori's always in a hurry to get home.\It's probably because she's got a boyfriend or something.\A boyfriend?!\I mean, she's pretty and popular. I wouldn't be surprised.\Okay! response:	Hey, Mom.
context: Doesn't seem like he has any friends we could ask, either.\Sorry, gotta run!\Hori's always in a hurry to get home.\It's probably because she's got a boyfriend or something.\A boyfriend?!\I mean, she's pretty and popular. I wouldn't be surprised.\Okay!\Hey, Mom. response:	Got it, I'll handle dinner.
context: Sorry, gotta run!\Hori's always in a hurry to get home.\It's probably because she's got a boyfriend or something.\A boyfriend?!\I mean, she's pretty and popular. I wouldn't be surprised.\Okay!\Hey, Mom.\Got it, I'll handle dinner. response:	I know, no getting out of overtime.
context: Hori's always in a hurry to get home.\It's probably because she's got a boyfriend or something.\A boyfriend?!\I mean, she's pretty and popular. I wouldn't be surprised.\Okay!\Hey, Mom.\Got it, I'll handle dinner.\I know, no getting out of overtime. response:	Bye.
context: It's probably because she's got a boyfriend or something.\A boyfriend?!\I mean, she's pretty and popular. I wouldn't be surprised.\Okay!\Hey, Mom.\Got it, I'll handle dinner.\I know, no getting out of overtime.\Bye. response:	I'd better get going...
context: A boyfriend?!\I mean, she's pretty and popular. I wouldn't be surprised.\Okay!\Hey, Mom.\Got it, I'll handle dinner.\I know, no getting out of overtime.\Bye.\I'd better get going... response:	Lion Room
context: I mean, she's pretty and popular. I wouldn't be surprised.\Okay!\Hey, Mom.\Got it, I'll handle dinner.\I know, no getting out of overtime.\Bye.\I'd better get going...\Lion Room response:	Sota!
context: Okay!\Hey, Mom.\Got it, I'll handle dinner.\I know, no getting out of overtime.\Bye.\I'd better get going...\Lion Room\Sota! response:	Big sis!
context: Hey, Mom.\Got it, I'll handle dinner.\I know, no getting out of overtime.\Bye.\I'd better get going...\Lion Room\Sota!\Big sis! response:	There you are!
context: Got it, I'll handle dinner.\I know, no getting out of overtime.\Bye.\I'd better get going...\Lion Room\Sota!\Big sis!\There you are! response:	Karaoke
context: I know, no getting out of overtime.\Bye.\I'd better get going...\Lion Room\Sota!\Big sis!\There you are!\Karaoke response:	Karaoke
context: Bye.\I'd better get going...\Lion Room\Sota!\Big sis!\There you are!\Karaoke\Karaoke response:	I know, right?
context: I'd better get going...\Lion Room\Sota!\Big sis!\There you are!\Karaoke\Karaoke\I know, right? response:	I know, right?
context: Lion Room\Sota!\Big sis!\There you are!\Karaoke\Karaoke\I know, right?\I know, right? response:	Wanna hit up that store we saw in that fashion mag?
context: Sota!\Big sis!\There you are!\Karaoke\Karaoke\I know, right?\I know, right?\Wanna hit up that store we saw in that fashion mag? response:	Wait, like, now?!
context: Big sis!\There you are!\Karaoke\Karaoke\I know, right?\I know, right?\Wanna hit up that store we saw in that fashion mag?\Wait, like, now?! response:	Yeah, let's go!
context: There you are!\Karaoke\Karaoke\I know, right?\I know, right?\Wanna hit up that store we saw in that fashion mag?\Wait, like, now?!\Yeah, let's go! response:	Let's have hamburg steak for dinner tonight.
context: Karaoke\Karaoke\I know, right?\I know, right?\Wanna hit up that store we saw in that fashion mag?\Wait, like, now?!\Yeah, let's go!\Let's have hamburg steak for dinner tonight. response:	Yay!
context: Karaoke\I know, right?\I know, right?\Wanna hit up that store we saw in that fashion mag?\Wait, like, now?!\Yeah, let's go!\Let's have hamburg steak for dinner tonight.\Yay! response:	Horimiya
context: I know, right?\I know, right?\Wanna hit up that store we saw in that fashion mag?\Wait, like, now?!\Yeah, let's go!\Let's have hamburg steak for dinner tonight.\Yay!\Horimiya response:	A Tiny Happenstance
context: I know, right?\Wanna hit up that store we saw in that fashion mag?\Wait, like, now?!\Yeah, let's go!\Let's have hamburg steak for dinner tonight.\Yay!\Horimiya\A Tiny Happenstance response:	A Tiny Happenstance
context: Wanna hit up that store we saw in that fashion mag?\Wait, like, now?!\Yeah, let's go!\Let's have hamburg steak for dinner tonight.\Yay!\Horimiya\A Tiny Happenstance\A Tiny Happenstance response:	Overtime and working on her day off...
context: Wait, like, now?!\Yeah, let's go!\Let's have hamburg steak for dinner tonight.\Yay!\Horimiya\A Tiny Happenstance\A Tiny Happenstance\Overtime and working on her day off... response:	Overtime and working on her day off...
context: Yeah, let's go!\Let's have hamburg steak for dinner tonight.\Yay!\Horimiya\A Tiny Happenstance\A Tiny Happenstance\Overtime and working on her day off...\Overtime and working on her day off... response:	I really wish she'd learn to say no to people...
context: Let's have hamburg steak for dinner tonight.\Yay!\Horimiya\A Tiny Happenstance\A Tiny Happenstance\Overtime and working on her day off...\Overtime and working on her day off...\I really wish she'd learn to say no to people... response:	Big sis!
context: Yay!\Horimiya\A Tiny Happenstance\A Tiny Happenstance\Overtime and working on her day off...\Overtime and working on her day off...\I really wish she'd learn to say no to people...\Big sis! response:	What's wrong?
context: Horimiya\A Tiny Happenstance\A Tiny Happenstance\Overtime and working on her day off...\Overtime and working on her day off...\I really wish she'd learn to say no to people...\Big sis!\What's wrong? response:	Bleed
context: A Tiny Happenstance\A Tiny Happenstance\Overtime and working on her day off...\Overtime and working on her day off...\I really wish she'd learn to say no to people...\Big sis!\What's wrong?\Bleed response:	Sota! What happened?!
context: A Tiny Happenstance\Overtime and working on her day off...\Overtime and working on her day off...\I really wish she'd learn to say no to people...\Big sis!\What's wrong?\Bleed\Sota! What happened?! response:	I fell down.
context: Overtime and working on her day off...\Overtime and working on her day off...\I really wish she'd learn to say no to people...\Big sis!\What's wrong?\Bleed\Sota! What happened?!\I fell down. response:	Aww. Where's your handkerchief, buddy?
context: Overtime and working on her day off...\I really wish she'd learn to say no to people...\Big sis!\What's wrong?\Bleed\Sota! What happened?!\I fell down.\Aww. Where's your handkerchief, buddy? response:	U-Uhh...
context: I really wish she'd learn to say no to people...\Big sis!\What's wrong?\Bleed\Sota! What happened?!\I fell down.\Aww. Where's your handkerchief, buddy?\U-Uhh... response:	Huh?!
context: Big sis!\What's wrong?\Bleed\Sota! What happened?!\I fell down.\Aww. Where's your handkerchief, buddy?\U-Uhh...\Huh?! response:	I think he's okay now, so I'm gonna go.
context: What's wrong?\Bleed\Sota! What happened?!\I fell down.\Aww. Where's your handkerchief, buddy?\U-Uhh...\Huh?!\I think he's okay now, so I'm gonna go. response:	I was totally ignoring him!
context: Bleed\Sota! What happened?!\I fell down.\Aww. Where's your handkerchief, buddy?\U-Uhh...\Huh?!\I think he's okay now, so I'm gonna go.\I was totally ignoring him! response:	U-Uhh, I'm so sorry you had to take care of him...
context: Sota! What happened?!\I fell down.\Aww. Where's your handkerchief, buddy?\U-Uhh...\Huh?!\I think he's okay now, so I'm gonna go.\I was totally ignoring him!\U-Uhh, I'm so sorry you had to take care of him... response:	It's okay.
context: I fell down.\Aww. Where's your handkerchief, buddy?\U-Uhh...\Huh?!\I think he's okay now, so I'm gonna go.\I was totally ignoring him!\U-Uhh, I'm so sorry you had to take care of him...\It's okay. response:	I'm gonna go, then.
context: Aww. Where's your handkerchief, buddy?\U-Uhh...\Huh?!\I think he's okay now, so I'm gonna go.\I was totally ignoring him!\U-Uhh, I'm so sorry you had to take care of him...\It's okay.\I'm gonna go, then. response:	Sota?
context: U-Uhh...\Huh?!\I think he's okay now, so I'm gonna go.\I was totally ignoring him!\U-Uhh, I'm so sorry you had to take care of him...\It's okay.\I'm gonna go, then.\Sota? response:	Uh, umm...
context: Huh?!\I think he's okay now, so I'm gonna go.\I was totally ignoring him!\U-Uhh, I'm so sorry you had to take care of him...\It's okay.\I'm gonna go, then.\Sota?\Uh, umm... response:	Umm, if you're not in a hurry, why don't you come in for a few?
context: I think he's okay now, so I'm gonna go.\I was totally ignoring him!\U-Uhh, I'm so sorry you had to take care of him...\It's okay.\I'm gonna go, then.\Sota?\Uh, umm...\Umm, if you're not in a hurry, why don't you come in for a few? response:	O-Okay, but...
context: I was totally ignoring him!\U-Uhh, I'm so sorry you had to take care of him...\It's okay.\I'm gonna go, then.\Sota?\Uh, umm...\Umm, if you're not in a hurry, why don't you come in for a few?\O-Okay, but... response:	Please. I have to thank you for taking care of him.
context: U-Uhh, I'm so sorry you had to take care of him...\It's okay.\I'm gonna go, then.\Sota?\Uh, umm...\Umm, if you're not in a hurry, why don't you come in for a few?\O-Okay, but...\Please. I have to thank you for taking care of him. response:	He got scared by a dog and fell down.
context: It's okay.\I'm gonna go, then.\Sota?\Uh, umm...\Umm, if you're not in a hurry, why don't you come in for a few?\O-Okay, but...\Please. I have to thank you for taking care of him.\He got scared by a dog and fell down. response:	Thank you for going so far out of your way.
context: I'm gonna go, then.\Sota?\Uh, umm...\Umm, if you're not in a hurry, why don't you come in for a few?\O-Okay, but...\Please. I have to thank you for taking care of him.\He got scared by a dog and fell down.\Thank you for going so far out of your way. response:	Oh, no, thank you for treating me.
context: Sota?\Uh, umm...\Umm, if you're not in a hurry, why don't you come in for a few?\O-Okay, but...\Please. I have to thank you for taking care of him.\He got scared by a dog and fell down.\Thank you for going so far out of your way.\Oh, no, thank you for treating me. response:	Hey, is your coffee really bitter?
context: Uh, umm...\Umm, if you're not in a hurry, why don't you come in for a few?\O-Okay, but...\Please. I have to thank you for taking care of him.\He got scared by a dog and fell down.\Thank you for going so far out of your way.\Oh, no, thank you for treating me.\Hey, is your coffee really bitter? response:	It sure is.
context: Umm, if you're not in a hurry, why don't you come in for a few?\O-Okay, but...\Please. I have to thank you for taking care of him.\He got scared by a dog and fell down.\Thank you for going so far out of your way.\Oh, no, thank you for treating me.\Hey, is your coffee really bitter?\It sure is. response:	He's a good kid. Introduced himself and everything.
context: O-Okay, but...\Please. I have to thank you for taking care of him.\He got scared by a dog and fell down.\Thank you for going so far out of your way.\Oh, no, thank you for treating me.\Hey, is your coffee really bitter?\It sure is.\He's a good kid. Introduced himself and everything. response:	O-Oh, thank you. He's a real handful most of the time, I swear.
context: Please. I have to thank you for taking care of him.\He got scared by a dog and fell down.\Thank you for going so far out of your way.\Oh, no, thank you for treating me.\Hey, is your coffee really bitter?\It sure is.\He's a good kid. Introduced himself and everything.\O-Oh, thank you. He's a real handful most of the time, I swear. response:	Still, I'm really impressed that you take care of all the housework.
context: He got scared by a dog and fell down.\Thank you for going so far out of your way.\Oh, no, thank you for treating me.\Hey, is your coffee really bitter?\It sure is.\He's a good kid. Introduced himself and everything.\O-Oh, thank you. He's a real handful most of the time, I swear.\Still, I'm really impressed that you take care of all the housework. response:	I never expected that from you, Hori-san.
context: Thank you for going so far out of your way.\Oh, no, thank you for treating me.\Hey, is your coffee really bitter?\It sure is.\He's a good kid. Introduced himself and everything.\O-Oh, thank you. He's a real handful most of the time, I swear.\Still, I'm really impressed that you take care of all the housework.\I never expected that from you, Hori-san. response:	Oh, no...
context: Oh, no, thank you for treating me.\Hey, is your coffee really bitter?\It sure is.\He's a good kid. Introduced himself and everything.\O-Oh, thank you. He's a real handful most of the time, I swear.\Still, I'm really impressed that you take care of all the housework.\I never expected that from you, Hori-san.\Oh, no... response:	You are Hori-san, right? In Class 1?
context: Hey, is your coffee really bitter?\It sure is.\He's a good kid. Introduced himself and everything.\O-Oh, thank you. He's a real handful most of the time, I swear.\Still, I'm really impressed that you take care of all the housework.\I never expected that from you, Hori-san.\Oh, no...\You are Hori-san, right? In Class 1? response:	Y-Yeah, that's me,
context: It sure is.\He's a good kid. Introduced himself and everything.\O-Oh, thank you. He's a real handful most of the time, I swear.\Still, I'm really impressed that you take care of all the housework.\I never expected that from you, Hori-san.\Oh, no...\You are Hori-san, right? In Class 1?\Y-Yeah, that's me, response:	but wait, you go to my school?!
context: He's a good kid. Introduced himself and everything.\O-Oh, thank you. He's a real handful most of the time, I swear.\Still, I'm really impressed that you take care of all the housework.\I never expected that from you, Hori-san.\Oh, no...\You are Hori-san, right? In Class 1?\Y-Yeah, that's me,\but wait, you go to my school?! response:	Huh? What are you talking about?
context: O-Oh, thank you. He's a real handful most of the time, I swear.\Still, I'm really impressed that you take care of all the housework.\I never expected that from you, Hori-san.\Oh, no...\You are Hori-san, right? In Class 1?\Y-Yeah, that's me,\but wait, you go to my school?!\Huh? What are you talking about? response:	I'm in your class. Miyamura?
context: Still, I'm really impressed that you take care of all the housework.\I never expected that from you, Hori-san.\Oh, no...\You are Hori-san, right? In Class 1?\Y-Yeah, that's me,\but wait, you go to my school?!\Huh? What are you talking about?\I'm in your class. Miyamura? response:	Wait... What?!
context: I never expected that from you, Hori-san.\Oh, no...\You are Hori-san, right? In Class 1?\Y-Yeah, that's me,\but wait, you go to my school?!\Huh? What are you talking about?\I'm in your class. Miyamura?\Wait... What?! response:	That can't be the same person!
context: Oh, no...\You are Hori-san, right? In Class 1?\Y-Yeah, that's me,\but wait, you go to my school?!\Huh? What are you talking about?\I'm in your class. Miyamura?\Wait... What?!\That can't be the same person! response:	I still don't believe it.
context: You are Hori-san, right? In Class 1?\Y-Yeah, that's me,\but wait, you go to my school?!\Huh? What are you talking about?\I'm in your class. Miyamura?\Wait... What?!\That can't be the same person!\I still don't believe it. response:	Hori, you're making the weirdest face right now. You okay?
context: Y-Yeah, that's me,\but wait, you go to my school?!\Huh? What are you talking about?\I'm in your class. Miyamura?\Wait... What?!\That can't be the same person!\I still don't believe it.\Hori, you're making the weirdest face right now. You okay? response:	Yeah, it's nothing.
context: but wait, you go to my school?!\Huh? What are you talking about?\I'm in your class. Miyamura?\Wait... What?!\That can't be the same person!\I still don't believe it.\Hori, you're making the weirdest face right now. You okay?\Yeah, it's nothing. response:	You sure?
context: Huh? What are you talking about?\I'm in your class. Miyamura?\Wait... What?!\That can't be the same person!\I still don't believe it.\Hori, you're making the weirdest face right now. You okay?\Yeah, it's nothing.\You sure? response:	Huh? Hori?
context: I'm in your class. Miyamura?\Wait... What?!\That can't be the same person!\I still don't believe it.\Hori, you're making the weirdest face right now. You okay?\Yeah, it's nothing.\You sure?\Huh? Hori? response:	Miyamura, can I have a sec?
context: Wait... What?!\That can't be the same person!\I still don't believe it.\Hori, you're making the weirdest face right now. You okay?\Yeah, it's nothing.\You sure?\Huh? Hori?\Miyamura, can I have a sec? response:	Huh? You want me to come over again?
context: That can't be the same person!\I still don't believe it.\Hori, you're making the weirdest face right now. You okay?\Yeah, it's nothing.\You sure?\Huh? Hori?\Miyamura, can I have a sec?\Huh? You want me to come over again? response:	N-Not me! My little brother!
context: I still don't believe it.\Hori, you're making the weirdest face right now. You okay?\Yeah, it's nothing.\You sure?\Huh? Hori?\Miyamura, can I have a sec?\Huh? You want me to come over again?\N-Not me! My little brother! response:	Sota wants'that cool dude' to come play with him.
context: Hori, you're making the weirdest face right now. You okay?\Yeah, it's nothing.\You sure?\Huh? Hori?\Miyamura, can I have a sec?\Huh? You want me to come over again?\N-Not me! My little brother!\Sota wants'that cool dude' to come play with him. response:	Really? Then I'll pick up a picture book for him or something.
context: Yeah, it's nothing.\You sure?\Huh? Hori?\Miyamura, can I have a sec?\Huh? You want me to come over again?\N-Not me! My little brother!\Sota wants'that cool dude' to come play with him.\Really? Then I'll pick up a picture book for him or something. response:	It's fine. You don't have to go out of your way or anything.
context: You sure?\Huh? Hori?\Miyamura, can I have a sec?\Huh? You want me to come over again?\N-Not me! My little brother!\Sota wants'that cool dude' to come play with him.\Really? Then I'll pick up a picture book for him or something.\It's fine. You don't have to go out of your way or anything. response:	Whew, okay. Sota'll be really thrilled.
context: Huh? Hori?\Miyamura, can I have a sec?\Huh? You want me to come over again?\N-Not me! My little brother!\Sota wants'that cool dude' to come play with him.\Really? Then I'll pick up a picture book for him or something.\It's fine. You don't have to go out of your way or anything.\Whew, okay. Sota'll be really thrilled. response:	This is a surprise.
context: Miyamura, can I have a sec?\Huh? You want me to come over again?\N-Not me! My little brother!\Sota wants'that cool dude' to come play with him.\Really? Then I'll pick up a picture book for him or something.\It's fine. You don't have to go out of your way or anything.\Whew, okay. Sota'll be really thrilled.\This is a surprise. response:	What is?
context: Huh? You want me to come over again?\N-Not me! My little brother!\Sota wants'that cool dude' to come play with him.\Really? Then I'll pick up a picture book for him or something.\It's fine. You don't have to go out of your way or anything.\Whew, okay. Sota'll be really thrilled.\This is a surprise.\What is? response:	You talking to me.
context: N-Not me! My little brother!\Sota wants'that cool dude' to come play with him.\Really? Then I'll pick up a picture book for him or something.\It's fine. You don't have to go out of your way or anything.\Whew, okay. Sota'll be really thrilled.\This is a surprise.\What is?\You talking to me. response:	I thought for sure after yesterday,
context: Sota wants'that cool dude' to come play with him.\Really? Then I'll pick up a picture book for him or something.\It's fine. You don't have to go out of your way or anything.\Whew, okay. Sota'll be really thrilled.\This is a surprise.\What is?\You talking to me.\I thought for sure after yesterday, response:	you'd just avoid being around me.
context: Really? Then I'll pick up a picture book for him or something.\It's fine. You don't have to go out of your way or anything.\Whew, okay. Sota'll be really thrilled.\This is a surprise.\What is?\You talking to me.\I thought for sure after yesterday,\you'd just avoid being around me. response:	Why would I do that?
context: It's fine. You don't have to go out of your way or anything.\Whew, okay. Sota'll be really thrilled.\This is a surprise.\What is?\You talking to me.\I thought for sure after yesterday,\you'd just avoid being around me.\Why would I do that? response:	I mean, yeah, it was a little awkward and freaked me out a bit.
context: Whew, okay. Sota'll be really thrilled.\This is a surprise.\What is?\You talking to me.\I thought for sure after yesterday,\you'd just avoid being around me.\Why would I do that?\I mean, yeah, it was a little awkward and freaked me out a bit. response:	You're so not like that here at school.
context: This is a surprise.\What is?\You talking to me.\I thought for sure after yesterday,\you'd just avoid being around me.\Why would I do that?\I mean, yeah, it was a little awkward and freaked me out a bit.\You're so not like that here at school. response:	But I'm kinda in the same boat,
context: What is?\You talking to me.\I thought for sure after yesterday,\you'd just avoid being around me.\Why would I do that?\I mean, yeah, it was a little awkward and freaked me out a bit.\You're so not like that here at school.\But I'm kinda in the same boat, response:	so I don't really have a reason to avoid you or any...
context: You talking to me.\I thought for sure after yesterday,\you'd just avoid being around me.\Why would I do that?\I mean, yeah, it was a little awkward and freaked me out a bit.\You're so not like that here at school.\But I'm kinda in the same boat,\so I don't really have a reason to avoid you or any... response:	Why're you blushing?
context: I thought for sure after yesterday,\you'd just avoid being around me.\Why would I do that?\I mean, yeah, it was a little awkward and freaked me out a bit.\You're so not like that here at school.\But I'm kinda in the same boat,\so I don't really have a reason to avoid you or any...\Why're you blushing? response:	Uh, I guess I'm just not used to hearing this stuff...
context: you'd just avoid being around me.\Why would I do that?\I mean, yeah, it was a little awkward and freaked me out a bit.\You're so not like that here at school.\But I'm kinda in the same boat,\so I don't really have a reason to avoid you or any...\Why're you blushing?\Uh, I guess I'm just not used to hearing this stuff... response:	It's kinda weird.
context: Why would I do that?\I mean, yeah, it was a little awkward and freaked me out a bit.\You're so not like that here at school.\But I'm kinda in the same boat,\so I don't really have a reason to avoid you or any...\Why're you blushing?\Uh, I guess I'm just not used to hearing this stuff...\It's kinda weird. response:	But thanks.
context: I mean, yeah, it was a little awkward and freaked me out a bit.\You're so not like that here at school.\But I'm kinda in the same boat,\so I don't really have a reason to avoid you or any...\Why're you blushing?\Uh, I guess I'm just not used to hearing this stuff...\It's kinda weird.\But thanks. response:	What?
context: You're so not like that here at school.\But I'm kinda in the same boat,\so I don't really have a reason to avoid you or any...\Why're you blushing?\Uh, I guess I'm just not used to hearing this stuff...\It's kinda weird.\But thanks.\What? response:	You've got a nice smile.
context: But I'm kinda in the same boat,\so I don't really have a reason to avoid you or any...\Why're you blushing?\Uh, I guess I'm just not used to hearing this stuff...\It's kinda weird.\But thanks.\What?\You've got a nice smile. response:	Huh?!
context: so I don't really have a reason to avoid you or any...\Why're you blushing?\Uh, I guess I'm just not used to hearing this stuff...\It's kinda weird.\But thanks.\What?\You've got a nice smile.\Huh?! response:	You should wear your hair up more often.
context: Why're you blushing?\Uh, I guess I'm just not used to hearing this stuff...\It's kinda weird.\But thanks.\What?\You've got a nice smile.\Huh?!\You should wear your hair up more often. response:	And lose the glasses, too.
context: Uh, I guess I'm just not used to hearing this stuff...\It's kinda weird.\But thanks.\What?\You've got a nice smile.\Huh?!\You should wear your hair up more often.\And lose the glasses, too. response:	I could, but then they'd see I have piercings.
context: It's kinda weird.\But thanks.\What?\You've got a nice smile.\Huh?!\You should wear your hair up more often.\And lose the glasses, too.\I could, but then they'd see I have piercings. response:	You've got a lot, too. How many?
context: But thanks.\What?\You've got a nice smile.\Huh?!\You should wear your hair up more often.\And lose the glasses, too.\I could, but then they'd see I have piercings.\You've got a lot, too. How many? response:	Nine, I think. Four on each ear and one on my lip.
context: What?\You've got a nice smile.\Huh?!\You should wear your hair up more often.\And lose the glasses, too.\I could, but then they'd see I have piercings.\You've got a lot, too. How many?\Nine, I think. Four on each ear and one on my lip. response:	That's way too many piercings.
context: You've got a nice smile.\Huh?!\You should wear your hair up more often.\And lose the glasses, too.\I could, but then they'd see I have piercings.\You've got a lot, too. How many?\Nine, I think. Four on each ear and one on my lip.\That's way too many piercings. response:	My mom said the same thing.
context: Huh?!\You should wear your hair up more often.\And lose the glasses, too.\I could, but then they'd see I have piercings.\You've got a lot, too. How many?\Nine, I think. Four on each ear and one on my lip.\That's way too many piercings.\My mom said the same thing. response:	I like manga, but I'm not into all that moe stuff.
context: You should wear your hair up more often.\And lose the glasses, too.\I could, but then they'd see I have piercings.\You've got a lot, too. How many?\Nine, I think. Four on each ear and one on my lip.\That's way too many piercings.\My mom said the same thing.\I like manga, but I'm not into all that moe stuff. response:	He's not an otaku.
context: And lose the glasses, too.\I could, but then they'd see I have piercings.\You've got a lot, too. How many?\Nine, I think. Four on each ear and one on my lip.\That's way too many piercings.\My mom said the same thing.\I like manga, but I'm not into all that moe stuff.\He's not an otaku. response:	I brought some cake!
context: I could, but then they'd see I have piercings.\You've got a lot, too. How many?\Nine, I think. Four on each ear and one on my lip.\That's way too many piercings.\My mom said the same thing.\I like manga, but I'm not into all that moe stuff.\He's not an otaku.\I brought some cake! response:	His family runs a cake shop.
context: You've got a lot, too. How many?\Nine, I think. Four on each ear and one on my lip.\That's way too many piercings.\My mom said the same thing.\I like manga, but I'm not into all that moe stuff.\He's not an otaku.\I brought some cake!\His family runs a cake shop. response:	Yeah, it hurt a lot when I did it.
context: Nine, I think. Four on each ear and one on my lip.\That's way too many piercings.\My mom said the same thing.\I like manga, but I'm not into all that moe stuff.\He's not an otaku.\I brought some cake!\His family runs a cake shop.\Yeah, it hurt a lot when I did it. response:	He pierced himself with a safety pin back in middle school.
context: That's way too many piercings.\My mom said the same thing.\I like manga, but I'm not into all that moe stuff.\He's not an otaku.\I brought some cake!\His family runs a cake shop.\Yeah, it hurt a lot when I did it.\He pierced himself with a safety pin back in middle school. response:	And...
context: My mom said the same thing.\I like manga, but I'm not into all that moe stuff.\He's not an otaku.\I brought some cake!\His family runs a cake shop.\Yeah, it hurt a lot when I did it.\He pierced himself with a safety pin back in middle school.\And... response:	Oof...
context: I like manga, but I'm not into all that moe stuff.\He's not an otaku.\I brought some cake!\His family runs a cake shop.\Yeah, it hurt a lot when I did it.\He pierced himself with a safety pin back in middle school.\And...\Oof... response:	He's not a very good student.
context: He's not an otaku.\I brought some cake!\His family runs a cake shop.\Yeah, it hurt a lot when I did it.\He pierced himself with a safety pin back in middle school.\And...\Oof...\He's not a very good student. response:	You're incredible, Hori-san! You've got almost straight A's!
context: I brought some cake!\His family runs a cake shop.\Yeah, it hurt a lot when I did it.\He pierced himself with a safety pin back in middle school.\And...\Oof...\He's not a very good student.\You're incredible, Hori-san! You've got almost straight A's! response:	It's nothing special.
context: His family runs a cake shop.\Yeah, it hurt a lot when I did it.\He pierced himself with a safety pin back in middle school.\And...\Oof...\He's not a very good student.\You're incredible, Hori-san! You've got almost straight A's!\It's nothing special. response:	Aren't quiet guys with glasses supposed to be smart?
context: Yeah, it hurt a lot when I did it.\He pierced himself with a safety pin back in middle school.\And...\Oof...\He's not a very good student.\You're incredible, Hori-san! You've got almost straight A's!\It's nothing special.\Aren't quiet guys with glasses supposed to be smart? response:	Is that how it works?
context: He pierced himself with a safety pin back in middle school.\And...\Oof...\He's not a very good student.\You're incredible, Hori-san! You've got almost straight A's!\It's nothing special.\Aren't quiet guys with glasses supposed to be smart?\Is that how it works? response:	This Week's Sales
context: And...\Oof...\He's not a very good student.\You're incredible, Hori-san! You've got almost straight A's!\It's nothing special.\Aren't quiet guys with glasses supposed to be smart?\Is that how it works?\This Week's Sales response:	This Week's Sales
context: Oof...\He's not a very good student.\You're incredible, Hori-san! You've got almost straight A's!\It's nothing special.\Aren't quiet guys with glasses supposed to be smart?\Is that how it works?\This Week's Sales\This Week's Sales response:	It's times like these when I realize
context: He's not a very good student.\You're incredible, Hori-san! You've got almost straight A's!\It's nothing special.\Aren't quiet guys with glasses supposed to be smart?\Is that how it works?\This Week's Sales\This Week's Sales\It's times like these when I realize response:	This Week's Sales
context: You're incredible, Hori-san! You've got almost straight A's!\It's nothing special.\Aren't quiet guys with glasses supposed to be smart?\Is that how it works?\This Week's Sales\This Week's Sales\It's times like these when I realize\This Week's Sales response:	that my initial impression of him was totally off the mark.
context: It's nothing special.\Aren't quiet guys with glasses supposed to be smart?\Is that how it works?\This Week's Sales\This Week's Sales\It's times like these when I realize\This Week's Sales\that my initial impression of him was totally off the mark. response:	that my initial impression of him was totally off the mark.
context: Aren't quiet guys with glasses supposed to be smart?\Is that how it works?\This Week's Sales\This Week's Sales\It's times like these when I realize\This Week's Sales\that my initial impression of him was totally off the mark.\that my initial impression of him was totally off the mark. response:	What's that? An ad for the supermarket?
context: Is that how it works?\This Week's Sales\This Week's Sales\It's times like these when I realize\This Week's Sales\that my initial impression of him was totally off the mark.\that my initial impression of him was totally off the mark.\What's that? An ad for the supermarket? response:	Yeah.
context: This Week's Sales\This Week's Sales\It's times like these when I realize\This Week's Sales\that my initial impression of him was totally off the mark.\that my initial impression of him was totally off the mark.\What's that? An ad for the supermarket?\Yeah. response:	Eggs are on sale tomo-
context: This Week's Sales\It's times like these when I realize\This Week's Sales\that my initial impression of him was totally off the mark.\that my initial impression of him was totally off the mark.\What's that? An ad for the supermarket?\Yeah.\Eggs are on sale tomo- response:	His lower eyelashes are really long.
context: It's times like these when I realize\This Week's Sales\that my initial impression of him was totally off the mark.\that my initial impression of him was totally off the mark.\What's that? An ad for the supermarket?\Yeah.\Eggs are on sale tomo-\His lower eyelashes are really long. response:	Hori-san?
context: This Week's Sales\that my initial impression of him was totally off the mark.\that my initial impression of him was totally off the mark.\What's that? An ad for the supermarket?\Yeah.\Eggs are on sale tomo-\His lower eyelashes are really long.\Hori-san? response:	Oh, uh!
context: that my initial impression of him was totally off the mark.\that my initial impression of him was totally off the mark.\What's that? An ad for the supermarket?\Yeah.\Eggs are on sale tomo-\His lower eyelashes are really long.\Hori-san?\Oh, uh! response:	There's a limited-time sale on eggs tomorrow with no purchase limit.
context: that my initial impression of him was totally off the mark.\What's that? An ad for the supermarket?\Yeah.\Eggs are on sale tomo-\His lower eyelashes are really long.\Hori-san?\Oh, uh!\There's a limited-time sale on eggs tomorrow with no purchase limit. response:	But it says only until 4 PM.
context: What's that? An ad for the supermarket?\Yeah.\Eggs are on sale tomo-\His lower eyelashes are really long.\Hori-san?\Oh, uh!\There's a limited-time sale on eggs tomorrow with no purchase limit.\But it says only until 4 PM. response:	Yeah, but it'll be fine.
context: Yeah.\Eggs are on sale tomo-\His lower eyelashes are really long.\Hori-san?\Oh, uh!\There's a limited-time sale on eggs tomorrow with no purchase limit.\But it says only until 4 PM.\Yeah, but it'll be fine. response:	As long as there's no emergency committee meeting or anything,
context: Eggs are on sale tomo-\His lower eyelashes are really long.\Hori-san?\Oh, uh!\There's a limited-time sale on eggs tomorrow with no purchase limit.\But it says only until 4 PM.\Yeah, but it'll be fine.\As long as there's no emergency committee meeting or anything, response:	I'll be able to buy a whole truckload of eggs on my way home!
context: His lower eyelashes are really long.\Hori-san?\Oh, uh!\There's a limited-time sale on eggs tomorrow with no purchase limit.\But it says only until 4 PM.\Yeah, but it'll be fine.\As long as there's no emergency committee meeting or anything,\I'll be able to buy a whole truckload of eggs on my way home! response:	All committee members,
context: Hori-san?\Oh, uh!\There's a limited-time sale on eggs tomorrow with no purchase limit.\But it says only until 4 PM.\Yeah, but it'll be fine.\As long as there's no emergency committee meeting or anything,\I'll be able to buy a whole truckload of eggs on my way home!\All committee members, response:	please report to the AV room after homeroom.
context: Oh, uh!\There's a limited-time sale on eggs tomorrow with no purchase limit.\But it says only until 4 PM.\Yeah, but it'll be fine.\As long as there's no emergency committee meeting or anything,\I'll be able to buy a whole truckload of eggs on my way home!\All committee members,\please report to the AV room after homeroom. response:	What great timing...
context: There's a limited-time sale on eggs tomorrow with no purchase limit.\But it says only until 4 PM.\Yeah, but it'll be fine.\As long as there's no emergency committee meeting or anything,\I'll be able to buy a whole truckload of eggs on my way home!\All committee members,\please report to the AV room after homeroom.\What great timing... response:	But I'm not giving up...
context: But it says only until 4 PM.\Yeah, but it'll be fine.\As long as there's no emergency committee meeting or anything,\I'll be able to buy a whole truckload of eggs on my way home!\All committee members,\please report to the AV room after homeroom.\What great timing...\But I'm not giving up... response:	Oh, Hori-s...
context: Yeah, but it'll be fine.\As long as there's no emergency committee meeting or anything,\I'll be able to buy a whole truckload of eggs on my way home!\All committee members,\please report to the AV room after homeroom.\What great timing...\But I'm not giving up...\Oh, Hori-s... response:	Coming over today, right? Get me those eggs asap
context: As long as there's no emergency committee meeting or anything,\I'll be able to buy a whole truckload of eggs on my way home!\All committee members,\please report to the AV room after homeroom.\What great timing...\But I'm not giving up...\Oh, Hori-s...\Coming over today, right? Get me those eggs asap response:	I'm supposed to buy them now?!
context: I'll be able to buy a whole truckload of eggs on my way home!\All committee members,\please report to the AV room after homeroom.\What great timing...\But I'm not giving up...\Oh, Hori-s...\Coming over today, right? Get me those eggs asap\I'm supposed to buy them now?! response:	And I have to run in this heat?!
context: All committee members,\please report to the AV room after homeroom.\What great timing...\But I'm not giving up...\Oh, Hori-s...\Coming over today, right? Get me those eggs asap\I'm supposed to buy them now?!\And I have to run in this heat?! response:	Twenty minutes left!
context: please report to the AV room after homeroom.\What great timing...\But I'm not giving up...\Oh, Hori-s...\Coming over today, right? Get me those eggs asap\I'm supposed to buy them now?!\And I have to run in this heat?!\Twenty minutes left! response:	I'll take the shortcut!
context: What great timing...\But I'm not giving up...\Oh, Hori-s...\Coming over today, right? Get me those eggs asap\I'm supposed to buy them now?!\And I have to run in this heat?!\Twenty minutes left!\I'll take the shortcut! response:	Sorry, it's egg time!
context: But I'm not giving up...\Oh, Hori-s...\Coming over today, right? Get me those eggs asap\I'm supposed to buy them now?!\And I have to run in this heat?!\Twenty minutes left!\I'll take the shortcut!\Sorry, it's egg time! response:	Wait, what?!
context: Oh, Hori-s...\Coming over today, right? Get me those eggs asap\I'm supposed to buy them now?!\And I have to run in this heat?!\Twenty minutes left!\I'll take the shortcut!\Sorry, it's egg time!\Wait, what?! response:	Egg time?
context: Coming over today, right? Get me those eggs asap\I'm supposed to buy them now?!\And I have to run in this heat?!\Twenty minutes left!\I'll take the shortcut!\Sorry, it's egg time!\Wait, what?!\Egg time? response:	Man, thanks a ton!
context: I'm supposed to buy them now?!\And I have to run in this heat?!\Twenty minutes left!\I'll take the shortcut!\Sorry, it's egg time!\Wait, what?!\Egg time?\Man, thanks a ton! response:	Those rabid housewives were scary... No more sales for me...
context: And I have to run in this heat?!\Twenty minutes left!\I'll take the shortcut!\Sorry, it's egg time!\Wait, what?!\Egg time?\Man, thanks a ton!\Those rabid housewives were scary... No more sales for me... response:	Oh, yeah, uh, I ran into someone on my way there.
context: Twenty minutes left!\I'll take the shortcut!\Sorry, it's egg time!\Wait, what?!\Egg time?\Man, thanks a ton!\Those rabid housewives were scary... No more sales for me...\Oh, yeah, uh, I ran into someone on my way there. response:	What? Who?! Where?!
context: I'll take the shortcut!\Sorry, it's egg time!\Wait, what?!\Egg time?\Man, thanks a ton!\Those rabid housewives were scary... No more sales for me...\Oh, yeah, uh, I ran into someone on my way there.\What? Who?! Where?! response:	That Yuki girl you hang out with.
context: Sorry, it's egg time!\Wait, what?!\Egg time?\Man, thanks a ton!\Those rabid housewives were scary... No more sales for me...\Oh, yeah, uh, I ran into someone on my way there.\What? Who?! Where?!\That Yuki girl you hang out with. response:	Oh.
context: Wait, what?!\Egg time?\Man, thanks a ton!\Those rabid housewives were scary... No more sales for me...\Oh, yeah, uh, I ran into someone on my way there.\What? Who?! Where?!\That Yuki girl you hang out with.\Oh. response:	You ran into her dressed like this?
context: Egg time?\Man, thanks a ton!\Those rabid housewives were scary... No more sales for me...\Oh, yeah, uh, I ran into someone on my way there.\What? Who?! Where?!\That Yuki girl you hang out with.\Oh.\You ran into her dressed like this? response:	Yeah, but I don't think she knew it was me.
context: Man, thanks a ton!\Those rabid housewives were scary... No more sales for me...\Oh, yeah, uh, I ran into someone on my way there.\What? Who?! Where?!\That Yuki girl you hang out with.\Oh.\You ran into her dressed like this?\Yeah, but I don't think she knew it was me. response:	Oh, huh.
context: Those rabid housewives were scary... No more sales for me...\Oh, yeah, uh, I ran into someone on my way there.\What? Who?! Where?!\That Yuki girl you hang out with.\Oh.\You ran into her dressed like this?\Yeah, but I don't think she knew it was me.\Oh, huh. response:	Let's dig in!
context: Oh, yeah, uh, I ran into someone on my way there.\What? Who?! Where?!\That Yuki girl you hang out with.\Oh.\You ran into her dressed like this?\Yeah, but I don't think she knew it was me.\Oh, huh.\Let's dig in! response:	Look out, don't spill.
context: What? Who?! Where?!\That Yuki girl you hang out with.\Oh.\You ran into her dressed like this?\Yeah, but I don't think she knew it was me.\Oh, huh.\Let's dig in!\Look out, don't spill. response:	Okay.
context: That Yuki girl you hang out with.\Oh.\You ran into her dressed like this?\Yeah, but I don't think she knew it was me.\Oh, huh.\Let's dig in!\Look out, don't spill.\Okay. response:	I kinda don't want anyone else to see you like this, Miyamura.
context: Oh.\You ran into her dressed like this?\Yeah, but I don't think she knew it was me.\Oh, huh.\Let's dig in!\Look out, don't spill.\Okay.\I kinda don't want anyone else to see you like this, Miyamura. response:	Sorry, never mind! Forget I said that.
context: You ran into her dressed like this?\Yeah, but I don't think she knew it was me.\Oh, huh.\Let's dig in!\Look out, don't spill.\Okay.\I kinda don't want anyone else to see you like this, Miyamura.\Sorry, never mind! Forget I said that. response:	I forgot to get out drinks. Is barley tea okay?
context: Yeah, but I don't think she knew it was me.\Oh, huh.\Let's dig in!\Look out, don't spill.\Okay.\I kinda don't want anyone else to see you like this, Miyamura.\Sorry, never mind! Forget I said that.\I forgot to get out drinks. Is barley tea okay? response:	Are you gonna eat?
context: Oh, huh.\Let's dig in!\Look out, don't spill.\Okay.\I kinda don't want anyone else to see you like this, Miyamura.\Sorry, never mind! Forget I said that.\I forgot to get out drinks. Is barley tea okay?\Are you gonna eat? response:	Hori-san, I...
context: Let's dig in!\Look out, don't spill.\Okay.\I kinda don't want anyone else to see you like this, Miyamura.\Sorry, never mind! Forget I said that.\I forgot to get out drinks. Is barley tea okay?\Are you gonna eat?\Hori-san, I... response:	When I get to see you like this,
context: Look out, don't spill.\Okay.\I kinda don't want anyone else to see you like this, Miyamura.\Sorry, never mind! Forget I said that.\I forgot to get out drinks. Is barley tea okay?\Are you gonna eat?\Hori-san, I...\When I get to see you like this, response:	cooking dinner, or getting mad and yelling really loud...
context: Okay.\I kinda don't want anyone else to see you like this, Miyamura.\Sorry, never mind! Forget I said that.\I forgot to get out drinks. Is barley tea okay?\Are you gonna eat?\Hori-san, I...\When I get to see you like this,\cooking dinner, or getting mad and yelling really loud... response:	Like, the fact that you don't care what your hair looks like at home,
context: I kinda don't want anyone else to see you like this, Miyamura.\Sorry, never mind! Forget I said that.\I forgot to get out drinks. Is barley tea okay?\Are you gonna eat?\Hori-san, I...\When I get to see you like this,\cooking dinner, or getting mad and yelling really loud...\Like, the fact that you don't care what your hair looks like at home, response:	or the way you're kinda brawny, in a good way-
context: Sorry, never mind! Forget I said that.\I forgot to get out drinks. Is barley tea okay?\Are you gonna eat?\Hori-san, I...\When I get to see you like this,\cooking dinner, or getting mad and yelling really loud...\Like, the fact that you don't care what your hair looks like at home,\or the way you're kinda brawny, in a good way- response:	That's enough!
context: I forgot to get out drinks. Is barley tea okay?\Are you gonna eat?\Hori-san, I...\When I get to see you like this,\cooking dinner, or getting mad and yelling really loud...\Like, the fact that you don't care what your hair looks like at home,\or the way you're kinda brawny, in a good way-\That's enough! response:	I don't want anyone else to see this side of you, either.
context: Are you gonna eat?\Hori-san, I...\When I get to see you like this,\cooking dinner, or getting mad and yelling really loud...\Like, the fact that you don't care what your hair looks like at home,\or the way you're kinda brawny, in a good way-\That's enough!\I don't want anyone else to see this side of you, either. response:	Neither do I.
context: Hori-san, I...\When I get to see you like this,\cooking dinner, or getting mad and yelling really loud...\Like, the fact that you don't care what your hair looks like at home,\or the way you're kinda brawny, in a good way-\That's enough!\I don't want anyone else to see this side of you, either.\Neither do I. response:	It kinda feels like this moment belongs to me and only me.
context: When I get to see you like this,\cooking dinner, or getting mad and yelling really loud...\Like, the fact that you don't care what your hair looks like at home,\or the way you're kinda brawny, in a good way-\That's enough!\I don't want anyone else to see this side of you, either.\Neither do I.\It kinda feels like this moment belongs to me and only me. response:	Don't say stuff like that, you dummy!
context: cooking dinner, or getting mad and yelling really loud...\Like, the fact that you don't care what your hair looks like at home,\or the way you're kinda brawny, in a good way-\That's enough!\I don't want anyone else to see this side of you, either.\Neither do I.\It kinda feels like this moment belongs to me and only me.\Don't say stuff like that, you dummy! response:	Can I have some, too, please?
context: Like, the fact that you don't care what your hair looks like at home,\or the way you're kinda brawny, in a good way-\That's enough!\I don't want anyone else to see this side of you, either.\Neither do I.\It kinda feels like this moment belongs to me and only me.\Don't say stuff like that, you dummy!\Can I have some, too, please? response:	Thanks!
context: or the way you're kinda brawny, in a good way-\That's enough!\I don't want anyone else to see this side of you, either.\Neither do I.\It kinda feels like this moment belongs to me and only me.\Don't say stuff like that, you dummy!\Can I have some, too, please?\Thanks! response:	Ugh, how can he say something that cringey with a straight face?!
context: That's enough!\I don't want anyone else to see this side of you, either.\Neither do I.\It kinda feels like this moment belongs to me and only me.\Don't say stuff like that, you dummy!\Can I have some, too, please?\Thanks!\Ugh, how can he say something that cringey with a straight face?! response:	Does he not realize? Is he that dumb?!
context: I don't want anyone else to see this side of you, either.\Neither do I.\It kinda feels like this moment belongs to me and only me.\Don't say stuff like that, you dummy!\Can I have some, too, please?\Thanks!\Ugh, how can he say something that cringey with a straight face?!\Does he not realize? Is he that dumb?! response:	-You dummy. You're such a dummy! You big dummy!
context: Neither do I.\It kinda feels like this moment belongs to me and only me.\Don't say stuff like that, you dummy!\Can I have some, too, please?\Thanks!\Ugh, how can he say something that cringey with a straight face?!\Does he not realize? Is he that dumb?!\-You dummy. You're such a dummy! You big dummy! response:	-I'm a dummy...? -You dummy. You're such a dummy! You big dummy!
context: It kinda feels like this moment belongs to me and only me.\Don't say stuff like that, you dummy!\Can I have some, too, please?\Thanks!\Ugh, how can he say something that cringey with a straight face?!\Does he not realize? Is he that dumb?!\-You dummy. You're such a dummy! You big dummy!\-I'm a dummy...? -You dummy. You're such a dummy! You big dummy! response:	-You dummy! Dummy, dummy, dummy!
context: Don't say stuff like that, you dummy!\Can I have some, too, please?\Thanks!\Ugh, how can he say something that cringey with a straight face?!\Does he not realize? Is he that dumb?!\-You dummy. You're such a dummy! You big dummy!\-I'm a dummy...? -You dummy. You're such a dummy! You big dummy!\-You dummy! Dummy, dummy, dummy! response:	-My sister can't stop saying dummy after she says it once. Watch. -You dummy! Dummy, dummy, dummy!
context: Can I have some, too, please?\Thanks!\Ugh, how can he say something that cringey with a straight face?!\Does he not realize? Is he that dumb?!\-You dummy. You're such a dummy! You big dummy!\-I'm a dummy...? -You dummy. You're such a dummy! You big dummy!\-You dummy! Dummy, dummy, dummy!\-My sister can't stop saying dummy after she says it once. Watch. -You dummy! Dummy, dummy, dummy! response:	-Really? -You dummy! Dummy, dummy, dummy!
context: Thanks!\Ugh, how can he say something that cringey with a straight face?!\Does he not realize? Is he that dumb?!\-You dummy. You're such a dummy! You big dummy!\-I'm a dummy...? -You dummy. You're such a dummy! You big dummy!\-You dummy! Dummy, dummy, dummy!\-My sister can't stop saying dummy after she says it once. Watch. -You dummy! Dummy, dummy, dummy!\-Really? -You dummy! Dummy, dummy, dummy! response:	Dummy, dummy, dummy!
context: Ugh, how can he say something that cringey with a straight face?!\Does he not realize? Is he that dumb?!\-You dummy. You're such a dummy! You big dummy!\-I'm a dummy...? -You dummy. You're such a dummy! You big dummy!\-You dummy! Dummy, dummy, dummy!\-My sister can't stop saying dummy after she says it once. Watch. -You dummy! Dummy, dummy, dummy!\-Really? -You dummy! Dummy, dummy, dummy!\Dummy, dummy, dummy! response:	You're right!
context: Does he not realize? Is he that dumb?!\-You dummy. You're such a dummy! You big dummy!\-I'm a dummy...? -You dummy. You're such a dummy! You big dummy!\-You dummy! Dummy, dummy, dummy!\-My sister can't stop saying dummy after she says it once. Watch. -You dummy! Dummy, dummy, dummy!\-Really? -You dummy! Dummy, dummy, dummy!\Dummy, dummy, dummy!\You're right! response:	Why're you laughing?!
context: -You dummy. You're such a dummy! You big dummy!\-I'm a dummy...? -You dummy. You're such a dummy! You big dummy!\-You dummy! Dummy, dummy, dummy!\-My sister can't stop saying dummy after she says it once. Watch. -You dummy! Dummy, dummy, dummy!\-Really? -You dummy! Dummy, dummy, dummy!\Dummy, dummy, dummy!\You're right!\Why're you laughing?! response:	Everyone has a side of them they don't want anyone to know about.
context: -I'm a dummy...? -You dummy. You're such a dummy! You big dummy!\-You dummy! Dummy, dummy, dummy!\-My sister can't stop saying dummy after she says it once. Watch. -You dummy! Dummy, dummy, dummy!\-Really? -You dummy! Dummy, dummy, dummy!\Dummy, dummy, dummy!\You're right!\Why're you laughing?!\Everyone has a side of them they don't want anyone to know about. response:	It's not that I don't like the way you are at school,
context: -You dummy! Dummy, dummy, dummy!\-My sister can't stop saying dummy after she says it once. Watch. -You dummy! Dummy, dummy, dummy!\-Really? -You dummy! Dummy, dummy, dummy!\Dummy, dummy, dummy!\You're right!\Why're you laughing?!\Everyone has a side of them they don't want anyone to know about.\It's not that I don't like the way you are at school, response:	I like this side of you that gets mad and dresses plain at home.
context: -My sister can't stop saying dummy after she says it once. Watch. -You dummy! Dummy, dummy, dummy!\-Really? -You dummy! Dummy, dummy, dummy!\Dummy, dummy, dummy!\You're right!\Why're you laughing?!\Everyone has a side of them they don't want anyone to know about.\It's not that I don't like the way you are at school,\I like this side of you that gets mad and dresses plain at home. response:	I think you're way cuter like this.
context: -Really? -You dummy! Dummy, dummy, dummy!\Dummy, dummy, dummy!\You're right!\Why're you laughing?!\Everyone has a side of them they don't want anyone to know about.\It's not that I don't like the way you are at school,\I like this side of you that gets mad and dresses plain at home.\I think you're way cuter like this. response:	The two of us ended up sharing this secret self time with each other.
context: Dummy, dummy, dummy!\You're right!\Why're you laughing?!\Everyone has a side of them they don't want anyone to know about.\It's not that I don't like the way you are at school,\I like this side of you that gets mad and dresses plain at home.\I think you're way cuter like this.\The two of us ended up sharing this secret self time with each other. response:	Ugh, whatever, you big dummy.
context: You're right!\Why're you laughing?!\Everyone has a side of them they don't want anyone to know about.\It's not that I don't like the way you are at school,\I like this side of you that gets mad and dresses plain at home.\I think you're way cuter like this.\The two of us ended up sharing this secret self time with each other.\Ugh, whatever, you big dummy. response:	It's only gonna get hotter from here on out.
context: Why're you laughing?!\Everyone has a side of them they don't want anyone to know about.\It's not that I don't like the way you are at school,\I like this side of you that gets mad and dresses plain at home.\I think you're way cuter like this.\The two of us ended up sharing this secret self time with each other.\Ugh, whatever, you big dummy.\It's only gonna get hotter from here on out. response:	Yep.
context: Everyone has a side of them they don't want anyone to know about.\It's not that I don't like the way you are at school,\I like this side of you that gets mad and dresses plain at home.\I think you're way cuter like this.\The two of us ended up sharing this secret self time with each other.\Ugh, whatever, you big dummy.\It's only gonna get hotter from here on out.\Yep. response:	Wearing this jacket all the time's gonna be torture.
context: It's not that I don't like the way you are at school,\I like this side of you that gets mad and dresses plain at home.\I think you're way cuter like this.\The two of us ended up sharing this secret self time with each other.\Ugh, whatever, you big dummy.\It's only gonna get hotter from here on out.\Yep.\Wearing this jacket all the time's gonna be torture. response:	Yeah, but at least...
context: I like this side of you that gets mad and dresses plain at home.\I think you're way cuter like this.\The two of us ended up sharing this secret self time with each other.\Ugh, whatever, you big dummy.\It's only gonna get hotter from here on out.\Yep.\Wearing this jacket all the time's gonna be torture.\Yeah, but at least... response:	Hori-san, I'm in trouble! We're gonna be swimming in P.E.!
context: I think you're way cuter like this.\The two of us ended up sharing this secret self time with each other.\Ugh, whatever, you big dummy.\It's only gonna get hotter from here on out.\Yep.\Wearing this jacket all the time's gonna be torture.\Yeah, but at least...\Hori-san, I'm in trouble! We're gonna be swimming in P.E.! response:	I'm screwed!
context: The two of us ended up sharing this secret self time with each other.\Ugh, whatever, you big dummy.\It's only gonna get hotter from here on out.\Yep.\Wearing this jacket all the time's gonna be torture.\Yeah, but at least...\Hori-san, I'm in trouble! We're gonna be swimming in P.E.!\I'm screwed! response:	Oh, yeah, you're right.
context: Ugh, whatever, you big dummy.\It's only gonna get hotter from here on out.\Yep.\Wearing this jacket all the time's gonna be torture.\Yeah, but at least...\Hori-san, I'm in trouble! We're gonna be swimming in P.E.!\I'm screwed!\Oh, yeah, you're right. response:	What's wrong with swimming? Better than making us run a marathon.
context: It's only gonna get hotter from here on out.\Yep.\Wearing this jacket all the time's gonna be torture.\Yeah, but at least...\Hori-san, I'm in trouble! We're gonna be swimming in P.E.!\I'm screwed!\Oh, yeah, you're right.\What's wrong with swimming? Better than making us run a marathon. response:	Swimming is way worse! They're gonna see everything!
context: Yep.\Wearing this jacket all the time's gonna be torture.\Yeah, but at least...\Hori-san, I'm in trouble! We're gonna be swimming in P.E.!\I'm screwed!\Oh, yeah, you're right.\What's wrong with swimming? Better than making us run a marathon.\Swimming is way worse! They're gonna see everything! response:	What do you mean, everythi -
context: Wearing this jacket all the time's gonna be torture.\Yeah, but at least...\Hori-san, I'm in trouble! We're gonna be swimming in P.E.!\I'm screwed!\Oh, yeah, you're right.\What's wrong with swimming? Better than making us run a marathon.\Swimming is way worse! They're gonna see everything!\What do you mean, everythi - response:	What do I do about these?!
context: Yeah, but at least...\Hori-san, I'm in trouble! We're gonna be swimming in P.E.!\I'm screwed!\Oh, yeah, you're right.\What's wrong with swimming? Better than making us run a marathon.\Swimming is way worse! They're gonna see everything!\What do you mean, everythi -\What do I do about these?! response:	Sometimes I'm not sure if you're incredibly bold
context: Hori-san, I'm in trouble! We're gonna be swimming in P.E.!\I'm screwed!\Oh, yeah, you're right.\What's wrong with swimming? Better than making us run a marathon.\Swimming is way worse! They're gonna see everything!\What do you mean, everythi -\What do I do about these?!\Sometimes I'm not sure if you're incredibly bold response:	or incredibly stupid.
context: I'm screwed!\Oh, yeah, you're right.\What's wrong with swimming? Better than making us run a marathon.\Swimming is way worse! They're gonna see everything!\What do you mean, everythi -\What do I do about these?!\Sometimes I'm not sure if you're incredibly bold\or incredibly stupid. response:	Yeah, for real...
context: Oh, yeah, you're right.\What's wrong with swimming? Better than making us run a marathon.\Swimming is way worse! They're gonna see everything!\What do you mean, everythi -\What do I do about these?!\Sometimes I'm not sure if you're incredibly bold\or incredibly stupid.\Yeah, for real... response:	But what if we do have to run a marathon? I have to wear my jacket!
context: What's wrong with swimming? Better than making us run a marathon.\Swimming is way worse! They're gonna see everything!\What do you mean, everythi -\What do I do about these?!\Sometimes I'm not sure if you're incredibly bold\or incredibly stupid.\Yeah, for real...\But what if we do have to run a marathon? I have to wear my jacket! response:	I'll die of heatstroke!
context: Swimming is way worse! They're gonna see everything!\What do you mean, everythi -\What do I do about these?!\Sometimes I'm not sure if you're incredibly bold\or incredibly stupid.\Yeah, for real...\But what if we do have to run a marathon? I have to wear my jacket!\I'll die of heatstroke! response:	I don't think they're gonna make us run a marathon.
context: What do you mean, everythi -\What do I do about these?!\Sometimes I'm not sure if you're incredibly bold\or incredibly stupid.\Yeah, for real...\But what if we do have to run a marathon? I have to wear my jacket!\I'll die of heatstroke!\I don't think they're gonna make us run a marathon. response:	Huh. You see the two of them together a lot lately.
context: What do I do about these?!\Sometimes I'm not sure if you're incredibly bold\or incredibly stupid.\Yeah, for real...\But what if we do have to run a marathon? I have to wear my jacket!\I'll die of heatstroke!\I don't think they're gonna make us run a marathon.\Huh. You see the two of them together a lot lately. response:	I never expected him to be in the picture.
context: Sometimes I'm not sure if you're incredibly bold\or incredibly stupid.\Yeah, for real...\But what if we do have to run a marathon? I have to wear my jacket!\I'll die of heatstroke!\I don't think they're gonna make us run a marathon.\Huh. You see the two of them together a lot lately.\I never expected him to be in the picture. response:	Hori, lemme see your notes!
context: or incredibly stupid.\Yeah, for real...\But what if we do have to run a marathon? I have to wear my jacket!\I'll die of heatstroke!\I don't think they're gonna make us run a marathon.\Huh. You see the two of them together a lot lately.\I never expected him to be in the picture.\Hori, lemme see your notes! response:	Oh, I wanna see, too!
context: Yeah, for real...\But what if we do have to run a marathon? I have to wear my jacket!\I'll die of heatstroke!\I don't think they're gonna make us run a marathon.\Huh. You see the two of them together a lot lately.\I never expected him to be in the picture.\Hori, lemme see your notes!\Oh, I wanna see, too! response:	Ugh, fine, but you really need to take your own.
context: But what if we do have to run a marathon? I have to wear my jacket!\I'll die of heatstroke!\I don't think they're gonna make us run a marathon.\Huh. You see the two of them together a lot lately.\I never expected him to be in the picture.\Hori, lemme see your notes!\Oh, I wanna see, too!\Ugh, fine, but you really need to take your own. response:	Thanks, Hori!
context: I'll die of heatstroke!\I don't think they're gonna make us run a marathon.\Huh. You see the two of them together a lot lately.\I never expected him to be in the picture.\Hori, lemme see your notes!\Oh, I wanna see, too!\Ugh, fine, but you really need to take your own.\Thanks, Hori! response:	Popular, huh?
context: I don't think they're gonna make us run a marathon.\Huh. You see the two of them together a lot lately.\I never expected him to be in the picture.\Hori, lemme see your notes!\Oh, I wanna see, too!\Ugh, fine, but you really need to take your own.\Thanks, Hori!\Popular, huh? response:	What, uh, what's popular?
context: Huh. You see the two of them together a lot lately.\I never expected him to be in the picture.\Hori, lemme see your notes!\Oh, I wanna see, too!\Ugh, fine, but you really need to take your own.\Thanks, Hori!\Popular, huh?\What, uh, what's popular? response:	Hori.
context: I never expected him to be in the picture.\Hori, lemme see your notes!\Oh, I wanna see, too!\Ugh, fine, but you really need to take your own.\Thanks, Hori!\Popular, huh?\What, uh, what's popular?\Hori. response:	Oh, yeah. I wish I could get good grades like her.
context: Hori, lemme see your notes!\Oh, I wanna see, too!\Ugh, fine, but you really need to take your own.\Thanks, Hori!\Popular, huh?\What, uh, what's popular?\Hori.\Oh, yeah. I wish I could get good grades like her. response:	Miyamura.
context: Oh, I wanna see, too!\Ugh, fine, but you really need to take your own.\Thanks, Hori!\Popular, huh?\What, uh, what's popular?\Hori.\Oh, yeah. I wish I could get good grades like her.\Miyamura. response:	Huh? Wh-What?
context: Ugh, fine, but you really need to take your own.\Thanks, Hori!\Popular, huh?\What, uh, what's popular?\Hori.\Oh, yeah. I wish I could get good grades like her.\Miyamura.\Huh? Wh-What? response:	You and Hori sure have been getting along lately.
context: Thanks, Hori!\Popular, huh?\What, uh, what's popular?\Hori.\Oh, yeah. I wish I could get good grades like her.\Miyamura.\Huh? Wh-What?\You and Hori sure have been getting along lately. response:	You two dating?
context: Popular, huh?\What, uh, what's popular?\Hori.\Oh, yeah. I wish I could get good grades like her.\Miyamura.\Huh? Wh-What?\You and Hori sure have been getting along lately.\You two dating? response:	No! Of course not, that's ridiculous!
context: What, uh, what's popular?\Hori.\Oh, yeah. I wish I could get good grades like her.\Miyamura.\Huh? Wh-What?\You and Hori sure have been getting along lately.\You two dating?\No! Of course not, that's ridiculous! response:	Yeah, thought so.
context: Hori.\Oh, yeah. I wish I could get good grades like her.\Miyamura.\Huh? Wh-What?\You and Hori sure have been getting along lately.\You two dating?\No! Of course not, that's ridiculous!\Yeah, thought so. response:	The two of you aren't anything alike.
context: Oh, yeah. I wish I could get good grades like her.\Miyamura.\Huh? Wh-What?\You and Hori sure have been getting along lately.\You two dating?\No! Of course not, that's ridiculous!\Yeah, thought so.\The two of you aren't anything alike. response:	Yeah, you're right. We wouldn't make a good couple.
context: Miyamura.\Huh? Wh-What?\You and Hori sure have been getting along lately.\You two dating?\No! Of course not, that's ridiculous!\Yeah, thought so.\The two of you aren't anything alike.\Yeah, you're right. We wouldn't make a good couple. response:	We just don't match up, uh...
context: Huh? Wh-What?\You and Hori sure have been getting along lately.\You two dating?\No! Of course not, that's ridiculous!\Yeah, thought so.\The two of you aren't anything alike.\Yeah, you're right. We wouldn't make a good couple.\We just don't match up, uh... response:	Use your words, man!
context: You and Hori sure have been getting along lately.\You two dating?\No! Of course not, that's ridiculous!\Yeah, thought so.\The two of you aren't anything alike.\Yeah, you're right. We wouldn't make a good couple.\We just don't match up, uh...\Use your words, man! response:	Don't see those two together often.
context: You two dating?\No! Of course not, that's ridiculous!\Yeah, thought so.\The two of you aren't anything alike.\Yeah, you're right. We wouldn't make a good couple.\We just don't match up, uh...\Use your words, man!\Don't see those two together often. response:	Let's go, Hori!
context: No! Of course not, that's ridiculous!\Yeah, thought so.\The two of you aren't anything alike.\Yeah, you're right. We wouldn't make a good couple.\We just don't match up, uh...\Use your words, man!\Don't see those two together often.\Let's go, Hori! response:	S-Sorry-oh.
context: Yeah, thought so.\The two of you aren't anything alike.\Yeah, you're right. We wouldn't make a good couple.\We just don't match up, uh...\Use your words, man!\Don't see those two together often.\Let's go, Hori!\S-Sorry-oh. response:	What?
context: The two of you aren't anything alike.\Yeah, you're right. We wouldn't make a good couple.\We just don't match up, uh...\Use your words, man!\Don't see those two together often.\Let's go, Hori!\S-Sorry-oh.\What? response:	Ishikawa-kun, do you have a crush on Hori-san?
context: Yeah, you're right. We wouldn't make a good couple.\We just don't match up, uh...\Use your words, man!\Don't see those two together often.\Let's go, Hori!\S-Sorry-oh.\What?\Ishikawa-kun, do you have a crush on Hori-san? response:	Wha-?!
context: We just don't match up, uh...\Use your words, man!\Don't see those two together often.\Let's go, Hori!\S-Sorry-oh.\What?\Ishikawa-kun, do you have a crush on Hori-san?\Wha-?! response:	S-So what if I do?!
context: Use your words, man!\Don't see those two together often.\Let's go, Hori!\S-Sorry-oh.\What?\Ishikawa-kun, do you have a crush on Hori-san?\Wha-?!\S-So what if I do?! response:	Wait, really?!
context: Don't see those two together often.\Let's go, Hori!\S-Sorry-oh.\What?\Ishikawa-kun, do you have a crush on Hori-san?\Wha-?!\S-So what if I do?!\Wait, really?! response:	What?!
context: Let's go, Hori!\S-Sorry-oh.\What?\Ishikawa-kun, do you have a crush on Hori-san?\Wha-?!\S-So what if I do?!\Wait, really?!\What?! response:	So that's why you always glare at me when I'm talking to Hori-san!
context: S-Sorry-oh.\What?\Ishikawa-kun, do you have a crush on Hori-san?\Wha-?!\S-So what if I do?!\Wait, really?!\What?!\So that's why you always glare at me when I'm talking to Hori-san! response:	W-Well, yeah, I do! So don't...
context: What?\Ishikawa-kun, do you have a crush on Hori-san?\Wha-?!\S-So what if I do?!\Wait, really?!\What?!\So that's why you always glare at me when I'm talking to Hori-san!\W-Well, yeah, I do! So don't... response:	Sorry, Ishikawa-kun, I didn't know you had a crush on Hori-san!
context: Ishikawa-kun, do you have a crush on Hori-san?\Wha-?!\S-So what if I do?!\Wait, really?!\What?!\So that's why you always glare at me when I'm talking to Hori-san!\W-Well, yeah, I do! So don't...\Sorry, Ishikawa-kun, I didn't know you had a crush on Hori-san! response:	Don't announce it to the whole school!
context: Wha-?!\S-So what if I do?!\Wait, really?!\What?!\So that's why you always glare at me when I'm talking to Hori-san!\W-Well, yeah, I do! So don't...\Sorry, Ishikawa-kun, I didn't know you had a crush on Hori-san!\Don't announce it to the whole school! response:	Oh, sorry! Is it still a secret? I'm so sorry!
context: S-So what if I do?!\Wait, really?!\What?!\So that's why you always glare at me when I'm talking to Hori-san!\W-Well, yeah, I do! So don't...\Sorry, Ishikawa-kun, I didn't know you had a crush on Hori-san!\Don't announce it to the whole school!\Oh, sorry! Is it still a secret? I'm so sorry! response:	Yo! What're you guys doing? We gotta go to P.E.!
context: Wait, really?!\What?!\So that's why you always glare at me when I'm talking to Hori-san!\W-Well, yeah, I do! So don't...\Sorry, Ishikawa-kun, I didn't know you had a crush on Hori-san!\Don't announce it to the whole school!\Oh, sorry! Is it still a secret? I'm so sorry!\Yo! What're you guys doing? We gotta go to P.E.! response:	We're already gonna be late, so let's take our time heading over.
context: What?!\So that's why you always glare at me when I'm talking to Hori-san!\W-Well, yeah, I do! So don't...\Sorry, Ishikawa-kun, I didn't know you had a crush on Hori-san!\Don't announce it to the whole school!\Oh, sorry! Is it still a secret? I'm so sorry!\Yo! What're you guys doing? We gotta go to P.E.!\We're already gonna be late, so let's take our time heading over. response:	Actually, here's something I've been wondering about for a while.
context: So that's why you always glare at me when I'm talking to Hori-san!\W-Well, yeah, I do! So don't...\Sorry, Ishikawa-kun, I didn't know you had a crush on Hori-san!\Don't announce it to the whole school!\Oh, sorry! Is it still a secret? I'm so sorry!\Yo! What're you guys doing? We gotta go to P.E.!\We're already gonna be late, so let's take our time heading over.\Actually, here's something I've been wondering about for a while. response:	Why are you wearing your winter uniform in the middle of summer?
context: W-Well, yeah, I do! So don't...\Sorry, Ishikawa-kun, I didn't know you had a crush on Hori-san!\Don't announce it to the whole school!\Oh, sorry! Is it still a secret? I'm so sorry!\Yo! What're you guys doing? We gotta go to P.E.!\We're already gonna be late, so let's take our time heading over.\Actually, here's something I've been wondering about for a while.\Why are you wearing your winter uniform in the middle of summer? response:	Um, uh...
context: Sorry, Ishikawa-kun, I didn't know you had a crush on Hori-san!\Don't announce it to the whole school!\Oh, sorry! Is it still a secret? I'm so sorry!\Yo! What're you guys doing? We gotta go to P.E.!\We're already gonna be late, so let's take our time heading over.\Actually, here's something I've been wondering about for a while.\Why are you wearing your winter uniform in the middle of summer?\Um, uh... response:	I get cold?
context: Don't announce it to the whole school!\Oh, sorry! Is it still a secret? I'm so sorry!\Yo! What're you guys doing? We gotta go to P.E.!\We're already gonna be late, so let's take our time heading over.\Actually, here's something I've been wondering about for a while.\Why are you wearing your winter uniform in the middle of summer?\Um, uh...\I get cold? response:	You're sweating buckets.
context: Oh, sorry! Is it still a secret? I'm so sorry!\Yo! What're you guys doing? We gotta go to P.E.!\We're already gonna be late, so let's take our time heading over.\Actually, here's something I've been wondering about for a while.\Why are you wearing your winter uniform in the middle of summer?\Um, uh...\I get cold?\You're sweating buckets. response:	I know what it's going to sound like, Ishikawa-kun,
context: Yo! What're you guys doing? We gotta go to P.E.!\We're already gonna be late, so let's take our time heading over.\Actually, here's something I've been wondering about for a while.\Why are you wearing your winter uniform in the middle of summer?\Um, uh...\I get cold?\You're sweating buckets.\I know what it's going to sound like, Ishikawa-kun, response:	but the only person who's seen me without a shirt on is Hori-san.
context: We're already gonna be late, so let's take our time heading over.\Actually, here's something I've been wondering about for a while.\Why are you wearing your winter uniform in the middle of summer?\Um, uh...\I get cold?\You're sweating buckets.\I know what it's going to sound like, Ishikawa-kun,\but the only person who's seen me without a shirt on is Hori-san. response:	What?! Why?!
context: Actually, here's something I've been wondering about for a while.\Why are you wearing your winter uniform in the middle of summer?\Um, uh...\I get cold?\You're sweating buckets.\I know what it's going to sound like, Ishikawa-kun,\but the only person who's seen me without a shirt on is Hori-san.\What?! Why?! response:	Ishikawa-kun, you won't snitch on me to a teacher, right?
context: Why are you wearing your winter uniform in the middle of summer?\Um, uh...\I get cold?\You're sweating buckets.\I know what it's going to sound like, Ishikawa-kun,\but the only person who's seen me without a shirt on is Hori-san.\What?! Why?!\Ishikawa-kun, you won't snitch on me to a teacher, right? response:	Hell no, I wouldn't!
context: Um, uh...\I get cold?\You're sweating buckets.\I know what it's going to sound like, Ishikawa-kun,\but the only person who's seen me without a shirt on is Hori-san.\What?! Why?!\Ishikawa-kun, you won't snitch on me to a teacher, right?\Hell no, I wouldn't! response:	It'd be a real pain if they found out...
context: I get cold?\You're sweating buckets.\I know what it's going to sound like, Ishikawa-kun,\but the only person who's seen me without a shirt on is Hori-san.\What?! Why?!\Ishikawa-kun, you won't snitch on me to a teacher, right?\Hell no, I wouldn't!\It'd be a real pain if they found out... response:	So please don't tell anyone.
context: You're sweating buckets.\I know what it's going to sound like, Ishikawa-kun,\but the only person who's seen me without a shirt on is Hori-san.\What?! Why?!\Ishikawa-kun, you won't snitch on me to a teacher, right?\Hell no, I wouldn't!\It'd be a real pain if they found out...\So please don't tell anyone. response:	What the hell? Are those tattoos? Wait, they're real?!
context: I know what it's going to sound like, Ishikawa-kun,\but the only person who's seen me without a shirt on is Hori-san.\What?! Why?!\Ishikawa-kun, you won't snitch on me to a teacher, right?\Hell no, I wouldn't!\It'd be a real pain if they found out...\So please don't tell anyone.\What the hell? Are those tattoos? Wait, they're real?! response:	Yeah.
context: but the only person who's seen me without a shirt on is Hori-san.\What?! Why?!\Ishikawa-kun, you won't snitch on me to a teacher, right?\Hell no, I wouldn't!\It'd be a real pain if they found out...\So please don't tell anyone.\What the hell? Are those tattoos? Wait, they're real?!\Yeah. response:	Yeah, I can see why you can't wear our short-sleeved uniform now.
context: What?! Why?!\Ishikawa-kun, you won't snitch on me to a teacher, right?\Hell no, I wouldn't!\It'd be a real pain if they found out...\So please don't tell anyone.\What the hell? Are those tattoos? Wait, they're real?!\Yeah.\Yeah, I can see why you can't wear our short-sleeved uniform now. response:	Yeah.
context: Ishikawa-kun, you won't snitch on me to a teacher, right?\Hell no, I wouldn't!\It'd be a real pain if they found out...\So please don't tell anyone.\What the hell? Are those tattoos? Wait, they're real?!\Yeah.\Yeah, I can see why you can't wear our short-sleeved uniform now.\Yeah. response:	Holy shit.
context: Hell no, I wouldn't!\It'd be a real pain if they found out...\So please don't tell anyone.\What the hell? Are those tattoos? Wait, they're real?!\Yeah.\Yeah, I can see why you can't wear our short-sleeved uniform now.\Yeah.\Holy shit. response:	I totally had you pinned for the weird, gloomy, otaku type,
context: It'd be a real pain if they found out...\So please don't tell anyone.\What the hell? Are those tattoos? Wait, they're real?!\Yeah.\Yeah, I can see why you can't wear our short-sleeved uniform now.\Yeah.\Holy shit.\I totally had you pinned for the weird, gloomy, otaku type, response:	but damn, was I wrong.
context: So please don't tell anyone.\What the hell? Are those tattoos? Wait, they're real?!\Yeah.\Yeah, I can see why you can't wear our short-sleeved uniform now.\Yeah.\Holy shit.\I totally had you pinned for the weird, gloomy, otaku type,\but damn, was I wrong. response:	You're wrong about otaku, but everything else is spot on.
context: What the hell? Are those tattoos? Wait, they're real?!\Yeah.\Yeah, I can see why you can't wear our short-sleeved uniform now.\Yeah.\Holy shit.\I totally had you pinned for the weird, gloomy, otaku type,\but damn, was I wrong.\You're wrong about otaku, but everything else is spot on. response:	Now that I'm getting a good look at him, he does have a nice face.
context: Yeah.\Yeah, I can see why you can't wear our short-sleeved uniform now.\Yeah.\Holy shit.\I totally had you pinned for the weird, gloomy, otaku type,\but damn, was I wrong.\You're wrong about otaku, but everything else is spot on.\Now that I'm getting a good look at him, he does have a nice face. response:	Though his hair is obnoxious.
context: Yeah, I can see why you can't wear our short-sleeved uniform now.\Yeah.\Holy shit.\I totally had you pinned for the weird, gloomy, otaku type,\but damn, was I wrong.\You're wrong about otaku, but everything else is spot on.\Now that I'm getting a good look at him, he does have a nice face.\Though his hair is obnoxious. response:	Was P.E. in the gym today?
context: Yeah.\Holy shit.\I totally had you pinned for the weird, gloomy, otaku type,\but damn, was I wrong.\You're wrong about otaku, but everything else is spot on.\Now that I'm getting a good look at him, he does have a nice face.\Though his hair is obnoxious.\Was P.E. in the gym today? response:	Is this the kind of face Hori's into?
context: Holy shit.\I totally had you pinned for the weird, gloomy, otaku type,\but damn, was I wrong.\You're wrong about otaku, but everything else is spot on.\Now that I'm getting a good look at him, he does have a nice face.\Though his hair is obnoxious.\Was P.E. in the gym today?\Is this the kind of face Hori's into? response:	Wh-What?
context: I totally had you pinned for the weird, gloomy, otaku type,\but damn, was I wrong.\You're wrong about otaku, but everything else is spot on.\Now that I'm getting a good look at him, he does have a nice face.\Though his hair is obnoxious.\Was P.E. in the gym today?\Is this the kind of face Hori's into?\Wh-What? response:	Whoa! Dude, you have piercings, too?!
context: but damn, was I wrong.\You're wrong about otaku, but everything else is spot on.\Now that I'm getting a good look at him, he does have a nice face.\Though his hair is obnoxious.\Was P.E. in the gym today?\Is this the kind of face Hori's into?\Wh-What?\Whoa! Dude, you have piercings, too?! response:	Okay, next!
context: You're wrong about otaku, but everything else is spot on.\Now that I'm getting a good look at him, he does have a nice face.\Though his hair is obnoxious.\Was P.E. in the gym today?\Is this the kind of face Hori's into?\Wh-What?\Whoa! Dude, you have piercings, too?!\Okay, next! response:	You're a funny guy.
context: Now that I'm getting a good look at him, he does have a nice face.\Though his hair is obnoxious.\Was P.E. in the gym today?\Is this the kind of face Hori's into?\Wh-What?\Whoa! Dude, you have piercings, too?!\Okay, next!\You're a funny guy. response:	Why get inked or pierced if you're just gonna end up hiding it?
context: Though his hair is obnoxious.\Was P.E. in the gym today?\Is this the kind of face Hori's into?\Wh-What?\Whoa! Dude, you have piercings, too?!\Okay, next!\You're a funny guy.\Why get inked or pierced if you're just gonna end up hiding it? response:	You know how you do things in the spur of the moment?
context: Was P.E. in the gym today?\Is this the kind of face Hori's into?\Wh-What?\Whoa! Dude, you have piercings, too?!\Okay, next!\You're a funny guy.\Why get inked or pierced if you're just gonna end up hiding it?\You know how you do things in the spur of the moment? response:	No, I don't.
context: Is this the kind of face Hori's into?\Wh-What?\Whoa! Dude, you have piercings, too?!\Okay, next!\You're a funny guy.\Why get inked or pierced if you're just gonna end up hiding it?\You know how you do things in the spur of the moment?\No, I don't. response:	If you're gonna keep hiding them, then I won't tell anyone.
context: Wh-What?\Whoa! Dude, you have piercings, too?!\Okay, next!\You're a funny guy.\Why get inked or pierced if you're just gonna end up hiding it?\You know how you do things in the spur of the moment?\No, I don't.\If you're gonna keep hiding them, then I won't tell anyone. response:	Though I wanna know why you and Hori-san suddenly got all buddy-buddy.
context: Whoa! Dude, you have piercings, too?!\Okay, next!\You're a funny guy.\Why get inked or pierced if you're just gonna end up hiding it?\You know how you do things in the spur of the moment?\No, I don't.\If you're gonna keep hiding them, then I won't tell anyone.\Though I wanna know why you and Hori-san suddenly got all buddy-buddy. response:	It wasn't sudden. It happened a little while back, actually.
context: Okay, next!\You're a funny guy.\Why get inked or pierced if you're just gonna end up hiding it?\You know how you do things in the spur of the moment?\No, I don't.\If you're gonna keep hiding them, then I won't tell anyone.\Though I wanna know why you and Hori-san suddenly got all buddy-buddy.\It wasn't sudden. It happened a little while back, actually. response:	But I get the feeling she's just being nice to me.
context: You're a funny guy.\Why get inked or pierced if you're just gonna end up hiding it?\You know how you do things in the spur of the moment?\No, I don't.\If you're gonna keep hiding them, then I won't tell anyone.\Though I wanna know why you and Hori-san suddenly got all buddy-buddy.\It wasn't sudden. It happened a little while back, actually.\But I get the feeling she's just being nice to me. response:	We're not anything more than friends, don't worry.
context: Why get inked or pierced if you're just gonna end up hiding it?\You know how you do things in the spur of the moment?\No, I don't.\If you're gonna keep hiding them, then I won't tell anyone.\Though I wanna know why you and Hori-san suddenly got all buddy-buddy.\It wasn't sudden. It happened a little while back, actually.\But I get the feeling she's just being nice to me.\We're not anything more than friends, don't worry. response:	So you don't mind if I ask her out?
context: You know how you do things in the spur of the moment?\No, I don't.\If you're gonna keep hiding them, then I won't tell anyone.\Though I wanna know why you and Hori-san suddenly got all buddy-buddy.\It wasn't sudden. It happened a little while back, actually.\But I get the feeling she's just being nice to me.\We're not anything more than friends, don't worry.\So you don't mind if I ask her out? response:	Wh-Why are you asking for my permission?
context: No, I don't.\If you're gonna keep hiding them, then I won't tell anyone.\Though I wanna know why you and Hori-san suddenly got all buddy-buddy.\It wasn't sudden. It happened a little while back, actually.\But I get the feeling she's just being nice to me.\We're not anything more than friends, don't worry.\So you don't mind if I ask her out?\Wh-Why are you asking for my permission? response:	I dunno, just felt like it.
context: If you're gonna keep hiding them, then I won't tell anyone.\Though I wanna know why you and Hori-san suddenly got all buddy-buddy.\It wasn't sudden. It happened a little while back, actually.\But I get the feeling she's just being nice to me.\We're not anything more than friends, don't worry.\So you don't mind if I ask her out?\Wh-Why are you asking for my permission?\I dunno, just felt like it. response:	That's up to Hori-san, not me.
context: Though I wanna know why you and Hori-san suddenly got all buddy-buddy.\It wasn't sudden. It happened a little while back, actually.\But I get the feeling she's just being nice to me.\We're not anything more than friends, don't worry.\So you don't mind if I ask her out?\Wh-Why are you asking for my permission?\I dunno, just felt like it.\That's up to Hori-san, not me. response:	I can't believe you skipped P.E., Toru...
context: It wasn't sudden. It happened a little while back, actually.\But I get the feeling she's just being nice to me.\We're not anything more than friends, don't worry.\So you don't mind if I ask her out?\Wh-Why are you asking for my permission?\I dunno, just felt like it.\That's up to Hori-san, not me.\I can't believe you skipped P.E., Toru... response:	You had gym duty, too! Instead, I had to be the one to clean up!
context: But I get the feeling she's just being nice to me.\We're not anything more than friends, don't worry.\So you don't mind if I ask her out?\Wh-Why are you asking for my permission?\I dunno, just felt like it.\That's up to Hori-san, not me.\I can't believe you skipped P.E., Toru...\You had gym duty, too! Instead, I had to be the one to clean up! response:	I said I'm sorry!
context: We're not anything more than friends, don't worry.\So you don't mind if I ask her out?\Wh-Why are you asking for my permission?\I dunno, just felt like it.\That's up to Hori-san, not me.\I can't believe you skipped P.E., Toru...\You had gym duty, too! Instead, I had to be the one to clean up!\I said I'm sorry! response:	Think about what you've done!
context: So you don't mind if I ask her out?\Wh-Why are you asking for my permission?\I dunno, just felt like it.\That's up to Hori-san, not me.\I can't believe you skipped P.E., Toru...\You had gym duty, too! Instead, I had to be the one to clean up!\I said I'm sorry!\Think about what you've done! response:	I am! I know!
context: Wh-Why are you asking for my permission?\I dunno, just felt like it.\That's up to Hori-san, not me.\I can't believe you skipped P.E., Toru...\You had gym duty, too! Instead, I had to be the one to clean up!\I said I'm sorry!\Think about what you've done!\I am! I know! response:	You were hanging out with Toru? That's random.
context: I dunno, just felt like it.\That's up to Hori-san, not me.\I can't believe you skipped P.E., Toru...\You had gym duty, too! Instead, I had to be the one to clean up!\I said I'm sorry!\Think about what you've done!\I am! I know!\You were hanging out with Toru? That's random. response:	Oh, yeah. We were just talking.
context: That's up to Hori-san, not me.\I can't believe you skipped P.E., Toru...\You had gym duty, too! Instead, I had to be the one to clean up!\I said I'm sorry!\Think about what you've done!\I am! I know!\You were hanging out with Toru? That's random.\Oh, yeah. We were just talking. response:	Hey, why're you avoiding me?
context: I can't believe you skipped P.E., Toru...\You had gym duty, too! Instead, I had to be the one to clean up!\I said I'm sorry!\Think about what you've done!\I am! I know!\You were hanging out with Toru? That's random.\Oh, yeah. We were just talking.\Hey, why're you avoiding me? response:	I'm not.
context: You had gym duty, too! Instead, I had to be the one to clean up!\I said I'm sorry!\Think about what you've done!\I am! I know!\You were hanging out with Toru? That's random.\Oh, yeah. We were just talking.\Hey, why're you avoiding me?\I'm not. response:	Look me in the eye when you're talking to me!
context: I said I'm sorry!\Think about what you've done!\I am! I know!\You were hanging out with Toru? That's random.\Oh, yeah. We were just talking.\Hey, why're you avoiding me?\I'm not.\Look me in the eye when you're talking to me! response:	I-I'm not, it's just...
context: Think about what you've done!\I am! I know!\You were hanging out with Toru? That's random.\Oh, yeah. We were just talking.\Hey, why're you avoiding me?\I'm not.\Look me in the eye when you're talking to me!\I-I'm not, it's just... response:	What is it? Did I do something wrong?
context: I am! I know!\You were hanging out with Toru? That's random.\Oh, yeah. We were just talking.\Hey, why're you avoiding me?\I'm not.\Look me in the eye when you're talking to me!\I-I'm not, it's just...\What is it? Did I do something wrong? response:	N-No...
context: You were hanging out with Toru? That's random.\Oh, yeah. We were just talking.\Hey, why're you avoiding me?\I'm not.\Look me in the eye when you're talking to me!\I-I'm not, it's just...\What is it? Did I do something wrong?\N-No... response:	Hori!
context: Oh, yeah. We were just talking.\Hey, why're you avoiding me?\I'm not.\Look me in the eye when you're talking to me!\I-I'm not, it's just...\What is it? Did I do something wrong?\N-No...\Hori! response:	Huh?
context: Hey, why're you avoiding me?\I'm not.\Look me in the eye when you're talking to me!\I-I'm not, it's just...\What is it? Did I do something wrong?\N-No...\Hori!\Huh? response:	I wanna talk to you later. Is after school okay?
context: I'm not.\Look me in the eye when you're talking to me!\I-I'm not, it's just...\What is it? Did I do something wrong?\N-No...\Hori!\Huh?\I wanna talk to you later. Is after school okay? response:	After school?
context: Look me in the eye when you're talking to me!\I-I'm not, it's just...\What is it? Did I do something wrong?\N-No...\Hori!\Huh?\I wanna talk to you later. Is after school okay?\After school? response:	Oh, but I-
context: I-I'm not, it's just...\What is it? Did I do something wrong?\N-No...\Hori!\Huh?\I wanna talk to you later. Is after school okay?\After school?\Oh, but I- response:	Hori-san, I'll go pick up Sota for you.
context: What is it? Did I do something wrong?\N-No...\Hori!\Huh?\I wanna talk to you later. Is after school okay?\After school?\Oh, but I-\Hori-san, I'll go pick up Sota for you. response:	Go talk with Ishikawa-kun, okay?
context: N-No...\Hori!\Huh?\I wanna talk to you later. Is after school okay?\After school?\Oh, but I-\Hori-san, I'll go pick up Sota for you.\Go talk with Ishikawa-kun, okay? response:	Huh? But...
context: Hori!\Huh?\I wanna talk to you later. Is after school okay?\After school?\Oh, but I-\Hori-san, I'll go pick up Sota for you.\Go talk with Ishikawa-kun, okay?\Huh? But... response:	Oh, she's home!
context: Huh?\I wanna talk to you later. Is after school okay?\After school?\Oh, but I-\Hori-san, I'll go pick up Sota for you.\Go talk with Ishikawa-kun, okay?\Huh? But...\Oh, she's home! response:	If they ended up dating,
context: I wanna talk to you later. Is after school okay?\After school?\Oh, but I-\Hori-san, I'll go pick up Sota for you.\Go talk with Ishikawa-kun, okay?\Huh? But...\Oh, she's home!\If they ended up dating, response:	I'd be a huge third wheel.
context: After school?\Oh, but I-\Hori-san, I'll go pick up Sota for you.\Go talk with Ishikawa-kun, okay?\Huh? But...\Oh, she's home!\If they ended up dating,\I'd be a huge third wheel. response:	Sorry I'm late, Sota! I'll start dinner in a little bit.
context: Oh, but I-\Hori-san, I'll go pick up Sota for you.\Go talk with Ishikawa-kun, okay?\Huh? But...\Oh, she's home!\If they ended up dating,\I'd be a huge third wheel.\Sorry I'm late, Sota! I'll start dinner in a little bit. response:	Okay!
context: Hori-san, I'll go pick up Sota for you.\Go talk with Ishikawa-kun, okay?\Huh? But...\Oh, she's home!\If they ended up dating,\I'd be a huge third wheel.\Sorry I'm late, Sota! I'll start dinner in a little bit.\Okay! response:	We need to talk.
context: Go talk with Ishikawa-kun, okay?\Huh? But...\Oh, she's home!\If they ended up dating,\I'd be a huge third wheel.\Sorry I'm late, Sota! I'll start dinner in a little bit.\Okay!\We need to talk. response:	If she says, you need to stop coming over, then that's that.
context: Huh? But...\Oh, she's home!\If they ended up dating,\I'd be a huge third wheel.\Sorry I'm late, Sota! I'll start dinner in a little bit.\Okay!\We need to talk.\If she says, you need to stop coming over, then that's that. response:	Toru told me everything.
context: Oh, she's home!\If they ended up dating,\I'd be a huge third wheel.\Sorry I'm late, Sota! I'll start dinner in a little bit.\Okay!\We need to talk.\If she says, you need to stop coming over, then that's that.\Toru told me everything. response:	Oh.
context: If they ended up dating,\I'd be a huge third wheel.\Sorry I'm late, Sota! I'll start dinner in a little bit.\Okay!\We need to talk.\If she says, you need to stop coming over, then that's that.\Toru told me everything.\Oh. response:	Did you seriously tell him you don't think we're a good match?
context: I'd be a huge third wheel.\Sorry I'm late, Sota! I'll start dinner in a little bit.\Okay!\We need to talk.\If she says, you need to stop coming over, then that's that.\Toru told me everything.\Oh.\Did you seriously tell him you don't think we're a good match? response:	Wha...? Huh?!
context: Sorry I'm late, Sota! I'll start dinner in a little bit.\Okay!\We need to talk.\If she says, you need to stop coming over, then that's that.\Toru told me everything.\Oh.\Did you seriously tell him you don't think we're a good match?\Wha...? Huh?! response:	Did you really say that you think I'm, I'm just being nice to you?!
context: Okay!\We need to talk.\If she says, you need to stop coming over, then that's that.\Toru told me everything.\Oh.\Did you seriously tell him you don't think we're a good match?\Wha...? Huh?!\Did you really say that you think I'm, I'm just being nice to you?! response:	Wait-What about Ishikawa-kun?
context: We need to talk.\If she says, you need to stop coming over, then that's that.\Toru told me everything.\Oh.\Did you seriously tell him you don't think we're a good match?\Wha...? Huh?!\Did you really say that you think I'm, I'm just being nice to you?!\Wait-What about Ishikawa-kun? response:	Forget about Toru right now!
context: If she says, you need to stop coming over, then that's that.\Toru told me everything.\Oh.\Did you seriously tell him you don't think we're a good match?\Wha...? Huh?!\Did you really say that you think I'm, I'm just being nice to you?!\Wait-What about Ishikawa-kun?\Forget about Toru right now! response:	Huh?!
context: Toru told me everything.\Oh.\Did you seriously tell him you don't think we're a good match?\Wha...? Huh?!\Did you really say that you think I'm, I'm just being nice to you?!\Wait-What about Ishikawa-kun?\Forget about Toru right now!\Huh?! response:	Did you say that?
context: Oh.\Did you seriously tell him you don't think we're a good match?\Wha...? Huh?!\Did you really say that you think I'm, I'm just being nice to you?!\Wait-What about Ishikawa-kun?\Forget about Toru right now!\Huh?!\Did you say that? response:	Did you tell him all that, Miyamura?!
context: Did you seriously tell him you don't think we're a good match?\Wha...? Huh?!\Did you really say that you think I'm, I'm just being nice to you?!\Wait-What about Ishikawa-kun?\Forget about Toru right now!\Huh?!\Did you say that?\Did you tell him all that, Miyamura?! response:	I did.
context: Wha...? Huh?!\Did you really say that you think I'm, I'm just being nice to you?!\Wait-What about Ishikawa-kun?\Forget about Toru right now!\Huh?!\Did you say that?\Did you tell him all that, Miyamura?!\I did. response:	That's really what you think this is?
context: Did you really say that you think I'm, I'm just being nice to you?!\Wait-What about Ishikawa-kun?\Forget about Toru right now!\Huh?!\Did you say that?\Did you tell him all that, Miyamura?!\I did.\That's really what you think this is? response:	You've been thinking that the whole time you've been coming over?
context: Wait-What about Ishikawa-kun?\Forget about Toru right now!\Huh?!\Did you say that?\Did you tell him all that, Miyamura?!\I did.\That's really what you think this is?\You've been thinking that the whole time you've been coming over? response:	No!
context: Forget about Toru right now!\Huh?!\Did you say that?\Did you tell him all that, Miyamura?!\I did.\That's really what you think this is?\You've been thinking that the whole time you've been coming over?\No! response:	No, just... Ishikawa-kun's right, I'm so gloomy and boring,
context: Huh?!\Did you say that?\Did you tell him all that, Miyamura?!\I did.\That's really what you think this is?\You've been thinking that the whole time you've been coming over?\No!\No, just... Ishikawa-kun's right, I'm so gloomy and boring, response:	I figured I was dragging down your reputation, or bothering you.
context: Did you say that?\Did you tell him all that, Miyamura?!\I did.\That's really what you think this is?\You've been thinking that the whole time you've been coming over?\No!\No, just... Ishikawa-kun's right, I'm so gloomy and boring,\I figured I was dragging down your reputation, or bothering you. response:	So it's not like I think it's true or anything!
context: Did you tell him all that, Miyamura?!\I did.\That's really what you think this is?\You've been thinking that the whole time you've been coming over?\No!\No, just... Ishikawa-kun's right, I'm so gloomy and boring,\I figured I was dragging down your reputation, or bothering you.\So it's not like I think it's true or anything! response:	Hori-san?! Why-?
context: I did.\That's really what you think this is?\You've been thinking that the whole time you've been coming over?\No!\No, just... Ishikawa-kun's right, I'm so gloomy and boring,\I figured I was dragging down your reputation, or bothering you.\So it's not like I think it's true or anything!\Hori-san?! Why-? response:	Why...? Why?
context: That's really what you think this is?\You've been thinking that the whole time you've been coming over?\No!\No, just... Ishikawa-kun's right, I'm so gloomy and boring,\I figured I was dragging down your reputation, or bothering you.\So it's not like I think it's true or anything!\Hori-san?! Why-?\Why...? Why? response:	Why would you give a crap about my reputation?!
context: You've been thinking that the whole time you've been coming over?\No!\No, just... Ishikawa-kun's right, I'm so gloomy and boring,\I figured I was dragging down your reputation, or bothering you.\So it's not like I think it's true or anything!\Hori-san?! Why-?\Why...? Why?\Why would you give a crap about my reputation?! response:	Don't just assume stuff without even asking!
context: No!\No, just... Ishikawa-kun's right, I'm so gloomy and boring,\I figured I was dragging down your reputation, or bothering you.\So it's not like I think it's true or anything!\Hori-san?! Why-?\Why...? Why?\Why would you give a crap about my reputation?!\Don't just assume stuff without even asking! response:	Don't you ever say something like that again, dummy!
context: No, just... Ishikawa-kun's right, I'm so gloomy and boring,\I figured I was dragging down your reputation, or bothering you.\So it's not like I think it's true or anything!\Hori-san?! Why-?\Why...? Why?\Why would you give a crap about my reputation?!\Don't just assume stuff without even asking!\Don't you ever say something like that again, dummy! response:	Sorry, Hori-san. I'm really sorry.
context: I figured I was dragging down your reputation, or bothering you.\So it's not like I think it's true or anything!\Hori-san?! Why-?\Why...? Why?\Why would you give a crap about my reputation?!\Don't just assume stuff without even asking!\Don't you ever say something like that again, dummy!\Sorry, Hori-san. I'm really sorry. response:	Just remembering what you said
context: So it's not like I think it's true or anything!\Hori-san?! Why-?\Why...? Why?\Why would you give a crap about my reputation?!\Don't just assume stuff without even asking!\Don't you ever say something like that again, dummy!\Sorry, Hori-san. I'm really sorry.\Just remembering what you said response:	makes me so mad!
context: Hori-san?! Why-?\Why...? Why?\Why would you give a crap about my reputation?!\Don't just assume stuff without even asking!\Don't you ever say something like that again, dummy!\Sorry, Hori-san. I'm really sorry.\Just remembering what you said\makes me so mad! response:	Wha-? Hori-san?!
context: Why...? Why?\Why would you give a crap about my reputation?!\Don't just assume stuff without even asking!\Don't you ever say something like that again, dummy!\Sorry, Hori-san. I'm really sorry.\Just remembering what you said\makes me so mad!\Wha-? Hori-san?! response:	If you stopped coming over, Miyamura,
context: Why would you give a crap about my reputation?!\Don't just assume stuff without even asking!\Don't you ever say something like that again, dummy!\Sorry, Hori-san. I'm really sorry.\Just remembering what you said\makes me so mad!\Wha-? Hori-san?!\If you stopped coming over, Miyamura, response:	-who'd wake me up when I fell asleep watching a movie?
context: Don't just assume stuff without even asking!\Don't you ever say something like that again, dummy!\Sorry, Hori-san. I'm really sorry.\Just remembering what you said\makes me so mad!\Wha-? Hori-san?!\If you stopped coming over, Miyamura,\-who'd wake me up when I fell asleep watching a movie? response:	-H-Hey- -who'd wake me up when I fell asleep watching a movie?
context: Don't you ever say something like that again, dummy!\Sorry, Hori-san. I'm really sorry.\Just remembering what you said\makes me so mad!\Wha-? Hori-san?!\If you stopped coming over, Miyamura,\-who'd wake me up when I fell asleep watching a movie?\-H-Hey- -who'd wake me up when I fell asleep watching a movie? response:	-who'd wake me up when I fell asleep watching a movie?
context: Sorry, Hori-san. I'm really sorry.\Just remembering what you said\makes me so mad!\Wha-? Hori-san?!\If you stopped coming over, Miyamura,\-who'd wake me up when I fell asleep watching a movie?\-H-Hey- -who'd wake me up when I fell asleep watching a movie?\-who'd wake me up when I fell asleep watching a movie? response:	-Or eat your portion of dinner?
context: Just remembering what you said\makes me so mad!\Wha-? Hori-san?!\If you stopped coming over, Miyamura,\-who'd wake me up when I fell asleep watching a movie?\-H-Hey- -who'd wake me up when I fell asleep watching a movie?\-who'd wake me up when I fell asleep watching a movie?\-Or eat your portion of dinner? response:	-Huh? -Or eat your portion of dinner?
context: makes me so mad!\Wha-? Hori-san?!\If you stopped coming over, Miyamura,\-who'd wake me up when I fell asleep watching a movie?\-H-Hey- -who'd wake me up when I fell asleep watching a movie?\-who'd wake me up when I fell asleep watching a movie?\-Or eat your portion of dinner?\-Huh? -Or eat your portion of dinner? response:	-Huh? -I'd have food left over!
context: Wha-? Hori-san?!\If you stopped coming over, Miyamura,\-who'd wake me up when I fell asleep watching a movie?\-H-Hey- -who'd wake me up when I fell asleep watching a movie?\-who'd wake me up when I fell asleep watching a movie?\-Or eat your portion of dinner?\-Huh? -Or eat your portion of dinner?\-Huh? -I'd have food left over! response:	-I'd have food left over!
context: If you stopped coming over, Miyamura,\-who'd wake me up when I fell asleep watching a movie?\-H-Hey- -who'd wake me up when I fell asleep watching a movie?\-who'd wake me up when I fell asleep watching a movie?\-Or eat your portion of dinner?\-Huh? -Or eat your portion of dinner?\-Huh? -I'd have food left over!\-I'd have food left over! response:	Toru?
context: -who'd wake me up when I fell asleep watching a movie?\-H-Hey- -who'd wake me up when I fell asleep watching a movie?\-who'd wake me up when I fell asleep watching a movie?\-Or eat your portion of dinner?\-Huh? -Or eat your portion of dinner?\-Huh? -I'd have food left over!\-I'd have food left over!\Toru? response:	I turned him down.
context: -H-Hey- -who'd wake me up when I fell asleep watching a movie?\-who'd wake me up when I fell asleep watching a movie?\-Or eat your portion of dinner?\-Huh? -Or eat your portion of dinner?\-Huh? -I'd have food left over!\-I'd have food left over!\Toru?\I turned him down. response:	Aww. He seems really sweet, though.
context: -who'd wake me up when I fell asleep watching a movie?\-Or eat your portion of dinner?\-Huh? -Or eat your portion of dinner?\-Huh? -I'd have food left over!\-I'd have food left over!\Toru?\I turned him down.\Aww. He seems really sweet, though. response:	What? You're creeping me out.
context: -Or eat your portion of dinner?\-Huh? -Or eat your portion of dinner?\-Huh? -I'd have food left over!\-I'd have food left over!\Toru?\I turned him down.\Aww. He seems really sweet, though.\What? You're creeping me out. response:	Do you have a crush on him or something?
context: -Huh? -Or eat your portion of dinner?\-Huh? -I'd have food left over!\-I'd have food left over!\Toru?\I turned him down.\Aww. He seems really sweet, though.\What? You're creeping me out.\Do you have a crush on him or something? response:	Why don't you guys date?
context: -Huh? -I'd have food left over!\-I'd have food left over!\Toru?\I turned him down.\Aww. He seems really sweet, though.\What? You're creeping me out.\Do you have a crush on him or something?\Why don't you guys date? response:	Oh, I don't think we'd make a good couple.
context: -I'd have food left over!\Toru?\I turned him down.\Aww. He seems really sweet, though.\What? You're creeping me out.\Do you have a crush on him or something?\Why don't you guys date?\Oh, I don't think we'd make a good couple. response:	That's your first reaction?
context: Toru?\I turned him down.\Aww. He seems really sweet, though.\What? You're creeping me out.\Do you have a crush on him or something?\Why don't you guys date?\Oh, I don't think we'd make a good couple.\That's your first reaction? response:	You Wear More Than One Face
context: I turned him down.\Aww. He seems really sweet, though.\What? You're creeping me out.\Do you have a crush on him or something?\Why don't you guys date?\Oh, I don't think we'd make a good couple.\That's your first reaction?\You Wear More Than One Face response:	Morning, Miyamura.
context: Aww. He seems really sweet, though.\What? You're creeping me out.\Do you have a crush on him or something?\Why don't you guys date?\Oh, I don't think we'd make a good couple.\That's your first reaction?\You Wear More Than One Face\Morning, Miyamura. response:	So, uh, yesterday, I...
context: What? You're creeping me out.\Do you have a crush on him or something?\Why don't you guys date?\Oh, I don't think we'd make a good couple.\That's your first reaction?\You Wear More Than One Face\Morning, Miyamura.\So, uh, yesterday, I... response:	You don't have to say it out loud, Ishikawa-kun!
context: Do you have a crush on him or something?\Why don't you guys date?\Oh, I don't think we'd make a good couple.\That's your first reaction?\You Wear More Than One Face\Morning, Miyamura.\So, uh, yesterday, I...\You don't have to say it out loud, Ishikawa-kun! response:	You're such a sweet guy!
context: Why don't you guys date?\Oh, I don't think we'd make a good couple.\That's your first reaction?\You Wear More Than One Face\Morning, Miyamura.\So, uh, yesterday, I...\You don't have to say it out loud, Ishikawa-kun!\You're such a sweet guy! response:	What's going on?
context: Oh, I don't think we'd make a good couple.\That's your first reaction?\You Wear More Than One Face\Morning, Miyamura.\So, uh, yesterday, I...\You don't have to say it out loud, Ishikawa-kun!\You're such a sweet guy!\What's going on? response:	No idea. Maybe he's getting asked out?
context: That's your first reaction?\You Wear More Than One Face\Morning, Miyamura.\So, uh, yesterday, I...\You don't have to say it out loud, Ishikawa-kun!\You're such a sweet guy!\What's going on?\No idea. Maybe he's getting asked out? response:	Who's doing the asking?