context: Morning. response:	Chiaki!
context: Morning.\Chiaki! response:	Why'd you ignore my text yesterday?!
context: Morning.\Chiaki!\Why'd you ignore my text yesterday?! response:	Sorry, wasn't feeling it.
context: Morning.\Chiaki!\Why'd you ignore my text yesterday?!\Sorry, wasn't feeling it. response:	I mean, every day, you're like, What'cha doin'?
context: Morning.\Chiaki!\Why'd you ignore my text yesterday?!\Sorry, wasn't feeling it.\I mean, every day, you're like, What'cha doin'? response:	Shut up!
context: Morning.\Chiaki!\Why'd you ignore my text yesterday?!\Sorry, wasn't feeling it.\I mean, every day, you're like, What'cha doin'?\Shut up! response:	Chiaki and I have been dating for nearly a year.
context: Morning.\Chiaki!\Why'd you ignore my text yesterday?!\Sorry, wasn't feeling it.\I mean, every day, you're like, What'cha doin'?\Shut up!\Chiaki and I have been dating for nearly a year. response:	We still haven't even kissed yet.
context: Morning.\Chiaki!\Why'd you ignore my text yesterday?!\Sorry, wasn't feeling it.\I mean, every day, you're like, What'cha doin'?\Shut up!\Chiaki and I have been dating for nearly a year.\We still haven't even kissed yet. response:	Point-Blank Relationship
context: Chiaki!\Why'd you ignore my text yesterday?!\Sorry, wasn't feeling it.\I mean, every day, you're like, What'cha doin'?\Shut up!\Chiaki and I have been dating for nearly a year.\We still haven't even kissed yet.\Point-Blank Relationship response:	What? You still haven't kissed, Kana?
context: Why'd you ignore my text yesterday?!\Sorry, wasn't feeling it.\I mean, every day, you're like, What'cha doin'?\Shut up!\Chiaki and I have been dating for nearly a year.\We still haven't even kissed yet.\Point-Blank Relationship\What? You still haven't kissed, Kana? response:	W-Well, it's only been a year.
context: Sorry, wasn't feeling it.\I mean, every day, you're like, What'cha doin'?\Shut up!\Chiaki and I have been dating for nearly a year.\We still haven't even kissed yet.\Point-Blank Relationship\What? You still haven't kissed, Kana?\W-Well, it's only been a year. response:	It's too early.
context: I mean, every day, you're like, What'cha doin'?\Shut up!\Chiaki and I have been dating for nearly a year.\We still haven't even kissed yet.\Point-Blank Relationship\What? You still haven't kissed, Kana?\W-Well, it's only been a year.\It's too early. response:	Isn't that a bit late?
context: Shut up!\Chiaki and I have been dating for nearly a year.\We still haven't even kissed yet.\Point-Blank Relationship\What? You still haven't kissed, Kana?\W-Well, it's only been a year.\It's too early.\Isn't that a bit late? response:	Hasn't Chiaki-kun said anything?
context: Chiaki and I have been dating for nearly a year.\We still haven't even kissed yet.\Point-Blank Relationship\What? You still haven't kissed, Kana?\W-Well, it's only been a year.\It's too early.\Isn't that a bit late?\Hasn't Chiaki-kun said anything? response:	Not really, he's like...
context: We still haven't even kissed yet.\Point-Blank Relationship\What? You still haven't kissed, Kana?\W-Well, it's only been a year.\It's too early.\Isn't that a bit late?\Hasn't Chiaki-kun said anything?\Not really, he's like... response:	Man, that was a huge dump.
context: Point-Blank Relationship\What? You still haven't kissed, Kana?\W-Well, it's only been a year.\It's too early.\Isn't that a bit late?\Hasn't Chiaki-kun said anything?\Not really, he's like...\Man, that was a huge dump. response:	You poop tanker!
context: What? You still haven't kissed, Kana?\W-Well, it's only been a year.\It's too early.\Isn't that a bit late?\Hasn't Chiaki-kun said anything?\Not really, he's like...\Man, that was a huge dump.\You poop tanker! response:	So what if I poop?! Everyone poops!
context: W-Well, it's only been a year.\It's too early.\Isn't that a bit late?\Hasn't Chiaki-kun said anything?\Not really, he's like...\Man, that was a huge dump.\You poop tanker!\So what if I poop?! Everyone poops! response:	You're so immature!
context: It's too early.\Isn't that a bit late?\Hasn't Chiaki-kun said anything?\Not really, he's like...\Man, that was a huge dump.\You poop tanker!\So what if I poop?! Everyone poops!\You're so immature! response:	Come to think of it,
context: Isn't that a bit late?\Hasn't Chiaki-kun said anything?\Not really, he's like...\Man, that was a huge dump.\You poop tanker!\So what if I poop?! Everyone poops!\You're so immature!\Come to think of it, response:	it feels more like we're siblings than dating.
context: Hasn't Chiaki-kun said anything?\Not really, he's like...\Man, that was a huge dump.\You poop tanker!\So what if I poop?! Everyone poops!\You're so immature!\Come to think of it,\it feels more like we're siblings than dating. response:	Hey, Chiaki, we get along well, right?
context: Not really, he's like...\Man, that was a huge dump.\You poop tanker!\So what if I poop?! Everyone poops!\You're so immature!\Come to think of it,\it feels more like we're siblings than dating.\Hey, Chiaki, we get along well, right? response:	Bang!
context: Man, that was a huge dump.\You poop tanker!\So what if I poop?! Everyone poops!\You're so immature!\Come to think of it,\it feels more like we're siblings than dating.\Hey, Chiaki, we get along well, right?\Bang! response:	Augh! I've been shot!
context: You poop tanker!\So what if I poop?! Everyone poops!\You're so immature!\Come to think of it,\it feels more like we're siblings than dating.\Hey, Chiaki, we get along well, right?\Bang!\Augh! I've been shot! response:	Yeah, we're definitely in sync, at least.
context: So what if I poop?! Everyone poops!\You're so immature!\Come to think of it,\it feels more like we're siblings than dating.\Hey, Chiaki, we get along well, right?\Bang!\Augh! I've been shot!\Yeah, we're definitely in sync, at least. response:	Perfectly.
context: You're so immature!\Come to think of it,\it feels more like we're siblings than dating.\Hey, Chiaki, we get along well, right?\Bang!\Augh! I've been shot!\Yeah, we're definitely in sync, at least.\Perfectly. response:	Hey, are you satisfied with this?
context: Come to think of it,\it feels more like we're siblings than dating.\Hey, Chiaki, we get along well, right?\Bang!\Augh! I've been shot!\Yeah, we're definitely in sync, at least.\Perfectly.\Hey, are you satisfied with this? response:	Our relationship, I mean.
context: it feels more like we're siblings than dating.\Hey, Chiaki, we get along well, right?\Bang!\Augh! I've been shot!\Yeah, we're definitely in sync, at least.\Perfectly.\Hey, are you satisfied with this?\Our relationship, I mean. response:	You're not?
context: Hey, Chiaki, we get along well, right?\Bang!\Augh! I've been shot!\Yeah, we're definitely in sync, at least.\Perfectly.\Hey, are you satisfied with this?\Our relationship, I mean.\You're not? response:	It's not that I'm not, but can't we be closer? Skinship-wise?
context: Bang!\Augh! I've been shot!\Yeah, we're definitely in sync, at least.\Perfectly.\Hey, are you satisfied with this?\Our relationship, I mean.\You're not?\It's not that I'm not, but can't we be closer? Skinship-wise? response:	Oh...
context: Augh! I've been shot!\Yeah, we're definitely in sync, at least.\Perfectly.\Hey, are you satisfied with this?\Our relationship, I mean.\You're not?\It's not that I'm not, but can't we be closer? Skinship-wise?\Oh... response:	Ready to rumble?
context: Yeah, we're definitely in sync, at least.\Perfectly.\Hey, are you satisfied with this?\Our relationship, I mean.\You're not?\It's not that I'm not, but can't we be closer? Skinship-wise?\Oh...\Ready to rumble? response:	N-No!
context: Perfectly.\Hey, are you satisfied with this?\Our relationship, I mean.\You're not?\It's not that I'm not, but can't we be closer? Skinship-wise?\Oh...\Ready to rumble?\N-No! response:	I meant relationship-type stuff!
context: Hey, are you satisfied with this?\Our relationship, I mean.\You're not?\It's not that I'm not, but can't we be closer? Skinship-wise?\Oh...\Ready to rumble?\N-No!\I meant relationship-type stuff! response:	You could have said so.
context: Our relationship, I mean.\You're not?\It's not that I'm not, but can't we be closer? Skinship-wise?\Oh...\Ready to rumble?\N-No!\I meant relationship-type stuff!\You could have said so. response:	You're awful.
context: You're not?\It's not that I'm not, but can't we be closer? Skinship-wise?\Oh...\Ready to rumble?\N-No!\I meant relationship-type stuff!\You could have said so.\You're awful. response:	I was just a toy to you, wasn't I?
context: It's not that I'm not, but can't we be closer? Skinship-wise?\Oh...\Ready to rumble?\N-No!\I meant relationship-type stuff!\You could have said so.\You're awful.\I was just a toy to you, wasn't I? response:	I'm not trying to be funny, here.
context: Oh...\Ready to rumble?\N-No!\I meant relationship-type stuff!\You could have said so.\You're awful.\I was just a toy to you, wasn't I?\I'm not trying to be funny, here. response:	What about, like, kissing and stuff?
context: Ready to rumble?\N-No!\I meant relationship-type stuff!\You could have said so.\You're awful.\I was just a toy to you, wasn't I?\I'm not trying to be funny, here.\What about, like, kissing and stuff? response:	That's way too embarrassing.
context: N-No!\I meant relationship-type stuff!\You could have said so.\You're awful.\I was just a toy to you, wasn't I?\I'm not trying to be funny, here.\What about, like, kissing and stuff?\That's way too embarrassing. response:	We aren't even dating.
context: I meant relationship-type stuff!\You could have said so.\You're awful.\I was just a toy to you, wasn't I?\I'm not trying to be funny, here.\What about, like, kissing and stuff?\That's way too embarrassing.\We aren't even dating. response:	It's embarrassing for me, too, but we're in a rel
context: You could have said so.\You're awful.\I was just a toy to you, wasn't I?\I'm not trying to be funny, here.\What about, like, kissing and stuff?\That's way too embarrassing.\We aren't even dating.\It's embarrassing for me, too, but we're in a rel response:	What?
context: You're awful.\I was just a toy to you, wasn't I?\I'm not trying to be funny, here.\What about, like, kissing and stuff?\That's way too embarrassing.\We aren't even dating.\It's embarrassing for me, too, but we're in a rel\What? response:	Do you really want to waste your time with me?
context: I was just a toy to you, wasn't I?\I'm not trying to be funny, here.\What about, like, kissing and stuff?\That's way too embarrassing.\We aren't even dating.\It's embarrassing for me, too, but we're in a rel\What?\Do you really want to waste your time with me? response:	Don't you have a crush or something?
context: I'm not trying to be funny, here.\What about, like, kissing and stuff?\That's way too embarrassing.\We aren't even dating.\It's embarrassing for me, too, but we're in a rel\What?\Do you really want to waste your time with me?\Don't you have a crush or something? response:	We are dating, right?
context: What about, like, kissing and stuff?\That's way too embarrassing.\We aren't even dating.\It's embarrassing for me, too, but we're in a rel\What?\Do you really want to waste your time with me?\Don't you have a crush or something?\We are dating, right? response:	Huh?
context: That's way too embarrassing.\We aren't even dating.\It's embarrassing for me, too, but we're in a rel\What?\Do you really want to waste your time with me?\Don't you have a crush or something?\We are dating, right?\Huh? response:	Who is?
context: We aren't even dating.\It's embarrassing for me, too, but we're in a rel\What?\Do you really want to waste your time with me?\Don't you have a crush or something?\We are dating, right?\Huh?\Who is? response:	We are.
context: It's embarrassing for me, too, but we're in a rel\What?\Do you really want to waste your time with me?\Don't you have a crush or something?\We are dating, right?\Huh?\Who is?\We are. response:	Wait a second, since when are we dating?!
context: What?\Do you really want to waste your time with me?\Don't you have a crush or something?\We are dating, right?\Huh?\Who is?\We are.\Wait a second, since when are we dating?! response:	I confessed to you last spring, remember?
context: Do you really want to waste your time with me?\Don't you have a crush or something?\We are dating, right?\Huh?\Who is?\We are.\Wait a second, since when are we dating?!\I confessed to you last spring, remember? response:	Coming home from school?
context: Don't you have a crush or something?\We are dating, right?\Huh?\Who is?\We are.\Wait a second, since when are we dating?!\I confessed to you last spring, remember?\Coming home from school? response:	H-Hey, I like you, Chiaki-kun.
context: We are dating, right?\Huh?\Who is?\We are.\Wait a second, since when are we dating?!\I confessed to you last spring, remember?\Coming home from school?\H-Hey, I like you, Chiaki-kun. response:	I like you more, stupid.
context: Huh?\Who is?\We are.\Wait a second, since when are we dating?!\I confessed to you last spring, remember?\Coming home from school?\H-Hey, I like you, Chiaki-kun.\I like you more, stupid. response:	Sorry, I thought that was a comedy bit.
context: Who is?\We are.\Wait a second, since when are we dating?!\I confessed to you last spring, remember?\Coming home from school?\H-Hey, I like you, Chiaki-kun.\I like you more, stupid.\Sorry, I thought that was a comedy bit. response:	I knew something wasn't right.
context: We are.\Wait a second, since when are we dating?!\I confessed to you last spring, remember?\Coming home from school?\H-Hey, I like you, Chiaki-kun.\I like you more, stupid.\Sorry, I thought that was a comedy bit.\I knew something wasn't right. response:	You wouldn't even try to hold hands.
context: Wait a second, since when are we dating?!\I confessed to you last spring, remember?\Coming home from school?\H-Hey, I like you, Chiaki-kun.\I like you more, stupid.\Sorry, I thought that was a comedy bit.\I knew something wasn't right.\You wouldn't even try to hold hands. response:	But you were always, like, my best friend,
context: I confessed to you last spring, remember?\Coming home from school?\H-Hey, I like you, Chiaki-kun.\I like you more, stupid.\Sorry, I thought that was a comedy bit.\I knew something wasn't right.\You wouldn't even try to hold hands.\But you were always, like, my best friend, response:	so maybe you were embarrassed.
context: Coming home from school?\H-Hey, I like you, Chiaki-kun.\I like you more, stupid.\Sorry, I thought that was a comedy bit.\I knew something wasn't right.\You wouldn't even try to hold hands.\But you were always, like, my best friend,\so maybe you were embarrassed. response:	I was okay with that, though,
context: H-Hey, I like you, Chiaki-kun.\I like you more, stupid.\Sorry, I thought that was a comedy bit.\I knew something wasn't right.\You wouldn't even try to hold hands.\But you were always, like, my best friend,\so maybe you were embarrassed.\I was okay with that, though, response:	since you were always right there.
context: I like you more, stupid.\Sorry, I thought that was a comedy bit.\I knew something wasn't right.\You wouldn't even try to hold hands.\But you were always, like, my best friend,\so maybe you were embarrassed.\I was okay with that, though,\since you were always right there. response:	Well, I guess we've always been close
context: Sorry, I thought that was a comedy bit.\I knew something wasn't right.\You wouldn't even try to hold hands.\But you were always, like, my best friend,\so maybe you were embarrassed.\I was okay with that, though,\since you were always right there.\Well, I guess we've always been close response:	but never touching.
context: I knew something wasn't right.\You wouldn't even try to hold hands.\But you were always, like, my best friend,\so maybe you were embarrassed.\I was okay with that, though,\since you were always right there.\Well, I guess we've always been close\but never touching. response:	What? Why are you crying?
context: You wouldn't even try to hold hands.\But you were always, like, my best friend,\so maybe you were embarrassed.\I was okay with that, though,\since you were always right there.\Well, I guess we've always been close\but never touching.\What? Why are you crying? response:	Because, because...
context: But you were always, like, my best friend,\so maybe you were embarrassed.\I was okay with that, though,\since you were always right there.\Well, I guess we've always been close\but never touching.\What? Why are you crying?\Because, because... response:	I've been texting you nonstop
context: so maybe you were embarrassed.\I was okay with that, though,\since you were always right there.\Well, I guess we've always been close\but never touching.\What? Why are you crying?\Because, because...\I've been texting you nonstop response:	and smacking you like we're that close.
context: I was okay with that, though,\since you were always right there.\Well, I guess we've always been close\but never touching.\What? Why are you crying?\Because, because...\I've been texting you nonstop\and smacking you like we're that close. response:	I'm so low.
context: since you were always right there.\Well, I guess we've always been close\but never touching.\What? Why are you crying?\Because, because...\I've been texting you nonstop\and smacking you like we're that close.\I'm so low. response:	Then let's hook up properly.
context: Well, I guess we've always been close\but never touching.\What? Why are you crying?\Because, because...\I've been texting you nonstop\and smacking you like we're that close.\I'm so low.\Then let's hook up properly. response:	What, is this another bit?
context: but never touching.\What? Why are you crying?\Because, because...\I've been texting you nonstop\and smacking you like we're that close.\I'm so low.\Then let's hook up properly.\What, is this another bit? response:	No!
context: What? Why are you crying?\Because, because...\I've been texting you nonstop\and smacking you like we're that close.\I'm so low.\Then let's hook up properly.\What, is this another bit?\No! response:	I've thought about being your boyfriend, too.
context: Because, because...\I've been texting you nonstop\and smacking you like we're that close.\I'm so low.\Then let's hook up properly.\What, is this another bit?\No!\I've thought about being your boyfriend, too. response:	But I couldn't tell how you felt, so I kept quiet.
context: I've been texting you nonstop\and smacking you like we're that close.\I'm so low.\Then let's hook up properly.\What, is this another bit?\No!\I've thought about being your boyfriend, too.\But I couldn't tell how you felt, so I kept quiet. response:	I like you.
context: and smacking you like we're that close.\I'm so low.\Then let's hook up properly.\What, is this another bit?\No!\I've thought about being your boyfriend, too.\But I couldn't tell how you felt, so I kept quiet.\I like you. response:	Let's date for real!
context: I'm so low.\Then let's hook up properly.\What, is this another bit?\No!\I've thought about being your boyfriend, too.\But I couldn't tell how you felt, so I kept quiet.\I like you.\Let's date for real! response:	Really?
context: Then let's hook up properly.\What, is this another bit?\No!\I've thought about being your boyfriend, too.\But I couldn't tell how you felt, so I kept quiet.\I like you.\Let's date for real!\Really? response:	Really.
context: What, is this another bit?\No!\I've thought about being your boyfriend, too.\But I couldn't tell how you felt, so I kept quiet.\I like you.\Let's date for real!\Really?\Really. response:	I'll text you like crazy.
context: No!\I've thought about being your boyfriend, too.\But I couldn't tell how you felt, so I kept quiet.\I like you.\Let's date for real!\Really?\Really.\I'll text you like crazy. response:	Yeah, text me.
context: I've thought about being your boyfriend, too.\But I couldn't tell how you felt, so I kept quiet.\I like you.\Let's date for real!\Really?\Really.\I'll text you like crazy.\Yeah, text me. response:	Can I smack you again?
context: But I couldn't tell how you felt, so I kept quiet.\I like you.\Let's date for real!\Really?\Really.\I'll text you like crazy.\Yeah, text me.\Can I smack you again? response:	Sure, smack me.
context: I like you.\Let's date for real!\Really?\Really.\I'll text you like crazy.\Yeah, text me.\Can I smack you again?\Sure, smack me. response:	Okay.
context: Let's date for real!\Really?\Really.\I'll text you like crazy.\Yeah, text me.\Can I smack you again?\Sure, smack me.\Okay. response:	So let's keep doing comedy bits, okay?
context: Really?\Really.\I'll text you like crazy.\Yeah, text me.\Can I smack you again?\Sure, smack me.\Okay.\So let's keep doing comedy bits, okay? response:	Hell no!
context: Really.\I'll text you like crazy.\Yeah, text me.\Can I smack you again?\Sure, smack me.\Okay.\So let's keep doing comedy bits, okay?\Hell no! response:	I confessed to my crush.
context: I'll text you like crazy.\Yeah, text me.\Can I smack you again?\Sure, smack me.\Okay.\So let's keep doing comedy bits, okay?\Hell no!\I confessed to my crush. response:	I'll Kill Senpai
context: Yeah, text me.\Can I smack you again?\Sure, smack me.\Okay.\So let's keep doing comedy bits, okay?\Hell no!\I confessed to my crush.\I'll Kill Senpai response:	And got rejected.
context: Can I smack you again?\Sure, smack me.\Okay.\So let's keep doing comedy bits, okay?\Hell no!\I confessed to my crush.\I'll Kill Senpai\And got rejected. response:	This sucks.
context: Sure, smack me.\Okay.\So let's keep doing comedy bits, okay?\Hell no!\I confessed to my crush.\I'll Kill Senpai\And got rejected.\This sucks. response:	I'm going home to sleep.
context: Okay.\So let's keep doing comedy bits, okay?\Hell no!\I confessed to my crush.\I'll Kill Senpai\And got rejected.\This sucks.\I'm going home to sleep. response:	Huh? Going home, Matsuura?
context: So let's keep doing comedy bits, okay?\Hell no!\I confessed to my crush.\I'll Kill Senpai\And got rejected.\This sucks.\I'm going home to sleep.\Huh? Going home, Matsuura? response:	What about club?
context: Hell no!\I confessed to my crush.\I'll Kill Senpai\And got rejected.\This sucks.\I'm going home to sleep.\Huh? Going home, Matsuura?\What about club? response:	Are you skipping? Hiuh?
context: I confessed to my crush.\I'll Kill Senpai\And got rejected.\This sucks.\I'm going home to sleep.\Huh? Going home, Matsuura?\What about club?\Are you skipping? Hiuh? response:	Sabotage? Huh?
context: I'll Kill Senpai\And got rejected.\This sucks.\I'm going home to sleep.\Huh? Going home, Matsuura?\What about club?\Are you skipping? Hiuh?\Sabotage? Huh? response:	Skipping? Huh?
context: And got rejected.\This sucks.\I'm going home to sleep.\Huh? Going home, Matsuura?\What about club?\Are you skipping? Hiuh?\Sabotage? Huh?\Skipping? Huh? response:	Katori-senpai, I'm not feeling well today.
context: This sucks.\I'm going home to sleep.\Huh? Going home, Matsuura?\What about club?\Are you skipping? Hiuh?\Sabotage? Huh?\Skipping? Huh?\Katori-senpai, I'm not feeling well today. response:	Oh, really?
context: I'm going home to sleep.\Huh? Going home, Matsuura?\What about club?\Are you skipping? Hiuh?\Sabotage? Huh?\Skipping? Huh?\Katori-senpai, I'm not feeling well today.\Oh, really? response:	You had a sad look on your face. I was sure you were heartbroken.
context: Huh? Going home, Matsuura?\What about club?\Are you skipping? Hiuh?\Sabotage? Huh?\Skipping? Huh?\Katori-senpai, I'm not feeling well today.\Oh, really?\You had a sad look on your face. I was sure you were heartbroken. response:	Huh?
context: What about club?\Are you skipping? Hiuh?\Sabotage? Huh?\Skipping? Huh?\Katori-senpai, I'm not feeling well today.\Oh, really?\You had a sad look on your face. I was sure you were heartbroken.\Huh? response:	I nailed it?
context: Are you skipping? Hiuh?\Sabotage? Huh?\Skipping? Huh?\Katori-senpai, I'm not feeling well today.\Oh, really?\You had a sad look on your face. I was sure you were heartbroken.\Huh?\I nailed it? response:	Huh?
context: Sabotage? Huh?\Skipping? Huh?\Katori-senpai, I'm not feeling well today.\Oh, really?\You had a sad look on your face. I was sure you were heartbroken.\Huh?\I nailed it?\Huh? response:	Sorry, should I not have asked?
context: Skipping? Huh?\Katori-senpai, I'm not feeling well today.\Oh, really?\You had a sad look on your face. I was sure you were heartbroken.\Huh?\I nailed it?\Huh?\Sorry, should I not have asked? response:	No, I don't care.
context: Katori-senpai, I'm not feeling well today.\Oh, really?\You had a sad look on your face. I was sure you were heartbroken.\Huh?\I nailed it?\Huh?\Sorry, should I not have asked?\No, I don't care. response:	But you worked up the courage, right?
context: Oh, really?\You had a sad look on your face. I was sure you were heartbroken.\Huh?\I nailed it?\Huh?\Sorry, should I not have asked?\No, I don't care.\But you worked up the courage, right? response:	That's awesome, don't you think?
context: You had a sad look on your face. I was sure you were heartbroken.\Huh?\I nailed it?\Huh?\Sorry, should I not have asked?\No, I don't care.\But you worked up the courage, right?\That's awesome, don't you think? response:	Senpai...
context: Huh?\I nailed it?\Huh?\Sorry, should I not have asked?\No, I don't care.\But you worked up the courage, right?\That's awesome, don't you think?\Senpai... response:	You have an absolutely dazzling look on your face right now.
context: I nailed it?\Huh?\Sorry, should I not have asked?\No, I don't care.\But you worked up the courage, right?\That's awesome, don't you think?\Senpai...\You have an absolutely dazzling look on your face right now. response:	Are you messing with me?
context: Huh?\Sorry, should I not have asked?\No, I don't care.\But you worked up the courage, right?\That's awesome, don't you think?\Senpai...\You have an absolutely dazzling look on your face right now.\Are you messing with me? response:	You are, aren't you?
context: Sorry, should I not have asked?\No, I don't care.\But you worked up the courage, right?\That's awesome, don't you think?\Senpai...\You have an absolutely dazzling look on your face right now.\Are you messing with me?\You are, aren't you? response:	Not at all.
context: No, I don't care.\But you worked up the courage, right?\That's awesome, don't you think?\Senpai...\You have an absolutely dazzling look on your face right now.\Are you messing with me?\You are, aren't you?\Not at all. response:	I'm trying to cheer you up.
context: But you worked up the courage, right?\That's awesome, don't you think?\Senpai...\You have an absolutely dazzling look on your face right now.\Are you messing with me?\You are, aren't you?\Not at all.\I'm trying to cheer you up. response:	Are you angry?
context: That's awesome, don't you think?\Senpai...\You have an absolutely dazzling look on your face right now.\Are you messing with me?\You are, aren't you?\Not at all.\I'm trying to cheer you up.\Are you angry? response:	I don't need you to cheer me up.
context: Senpai...\You have an absolutely dazzling look on your face right now.\Are you messing with me?\You are, aren't you?\Not at all.\I'm trying to cheer you up.\Are you angry?\I don't need you to cheer me up. response:	You're crying in here, though.
context: You have an absolutely dazzling look on your face right now.\Are you messing with me?\You are, aren't you?\Not at all.\I'm trying to cheer you up.\Are you angry?\I don't need you to cheer me up.\You're crying in here, though. response:	Sorry, my hand slipped.
context: Are you messing with me?\You are, aren't you?\Not at all.\I'm trying to cheer you up.\Are you angry?\I don't need you to cheer me up.\You're crying in here, though.\Sorry, my hand slipped. response:	Hit me all you want.
context: You are, aren't you?\Not at all.\I'm trying to cheer you up.\Are you angry?\I don't need you to cheer me up.\You're crying in here, though.\Sorry, my hand slipped.\Hit me all you want. response:	Huh?
context: Not at all.\I'm trying to cheer you up.\Are you angry?\I don't need you to cheer me up.\You're crying in here, though.\Sorry, my hand slipped.\Hit me all you want.\Huh? response:	But, it's really yourself you want to hit, is it not?
context: I'm trying to cheer you up.\Are you angry?\I don't need you to cheer me up.\You're crying in here, though.\Sorry, my hand slipped.\Hit me all you want.\Huh?\But, it's really yourself you want to hit, is it not? response:	You are messing with me.
context: Are you angry?\I don't need you to cheer me up.\You're crying in here, though.\Sorry, my hand slipped.\Hit me all you want.\Huh?\But, it's really yourself you want to hit, is it not?\You are messing with me. response:	Not at all.
context: I don't need you to cheer me up.\You're crying in here, though.\Sorry, my hand slipped.\Hit me all you want.\Huh?\But, it's really yourself you want to hit, is it not?\You are messing with me.\Not at all. response:	Besides, you feel better after hitting me, don't you?
context: You're crying in here, though.\Sorry, my hand slipped.\Hit me all you want.\Huh?\But, it's really yourself you want to hit, is it not?\You are messing with me.\Not at all.\Besides, you feel better after hitting me, don't you? response:	Senpai was doing that on purpose?
context: Sorry, my hand slipped.\Hit me all you want.\Huh?\But, it's really yourself you want to hit, is it not?\You are messing with me.\Not at all.\Besides, you feel better after hitting me, don't you?\Senpai was doing that on purpose? response:	Not that I feel grateful at all.
context: Hit me all you want.\Huh?\But, it's really yourself you want to hit, is it not?\You are messing with me.\Not at all.\Besides, you feel better after hitting me, don't you?\Senpai was doing that on purpose?\Not that I feel grateful at all. response:	Let me know if you need anything.
context: Huh?\But, it's really yourself you want to hit, is it not?\You are messing with me.\Not at all.\Besides, you feel better after hitting me, don't you?\Senpai was doing that on purpose?\Not that I feel grateful at all.\Let me know if you need anything. response:	No, I'm good.
context: But, it's really yourself you want to hit, is it not?\You are messing with me.\Not at all.\Besides, you feel better after hitting me, don't you?\Senpai was doing that on purpose?\Not that I feel grateful at all.\Let me know if you need anything.\No, I'm good. response:	Why do you even care so much?
context: You are messing with me.\Not at all.\Besides, you feel better after hitting me, don't you?\Senpai was doing that on purpose?\Not that I feel grateful at all.\Let me know if you need anything.\No, I'm good.\Why do you even care so much? response:	I'm your senpai. You're my kouhai.
context: Not at all.\Besides, you feel better after hitting me, don't you?\Senpai was doing that on purpose?\Not that I feel grateful at all.\Let me know if you need anything.\No, I'm good.\Why do you even care so much?\I'm your senpai. You're my kouhai. response:	Understand?
context: Besides, you feel better after hitting me, don't you?\Senpai was doing that on purpose?\Not that I feel grateful at all.\Let me know if you need anything.\No, I'm good.\Why do you even care so much?\I'm your senpai. You're my kouhai.\Understand? response:	Good, now you can make it to club.
context: Senpai was doing that on purpose?\Not that I feel grateful at all.\Let me know if you need anything.\No, I'm good.\Why do you even care so much?\I'm your senpai. You're my kouhai.\Understand?\Good, now you can make it to club. response:	Oh. Yeah...
context: Not that I feel grateful at all.\Let me know if you need anything.\No, I'm good.\Why do you even care so much?\I'm your senpai. You're my kouhai.\Understand?\Good, now you can make it to club.\Oh. Yeah... response:	Senpai's annoying, but he's a nice guy at heart.
context: Let me know if you need anything.\No, I'm good.\Why do you even care so much?\I'm your senpai. You're my kouhai.\Understand?\Good, now you can make it to club.\Oh. Yeah...\Senpai's annoying, but he's a nice guy at heart. response:	But he's annoying.
context: No, I'm good.\Why do you even care so much?\I'm your senpai. You're my kouhai.\Understand?\Good, now you can make it to club.\Oh. Yeah...\Senpai's annoying, but he's a nice guy at heart.\But he's annoying. response:	Excellent.
context: Why do you even care so much?\I'm your senpai. You're my kouhai.\Understand?\Good, now you can make it to club.\Oh. Yeah...\Senpai's annoying, but he's a nice guy at heart.\But he's annoying.\Excellent. response:	It gets lonely without our local idol.
context: I'm your senpai. You're my kouhai.\Understand?\Good, now you can make it to club.\Oh. Yeah...\Senpai's annoying, but he's a nice guy at heart.\But he's annoying.\Excellent.\It gets lonely without our local idol. response:	So annoying.
context: Understand?\Good, now you can make it to club.\Oh. Yeah...\Senpai's annoying, but he's a nice guy at heart.\But he's annoying.\Excellent.\It gets lonely without our local idol.\So annoying. response:	Huh? What's up?
context: Good, now you can make it to club.\Oh. Yeah...\Senpai's annoying, but he's a nice guy at heart.\But he's annoying.\Excellent.\It gets lonely without our local idol.\So annoying.\Huh? What's up? response:	Let's go.
context: Oh. Yeah...\Senpai's annoying, but he's a nice guy at heart.\But he's annoying.\Excellent.\It gets lonely without our local idol.\So annoying.\Huh? What's up?\Let's go. response:	Nothing's up.
context: Senpai's annoying, but he's a nice guy at heart.\But he's annoying.\Excellent.\It gets lonely without our local idol.\So annoying.\Huh? What's up?\Let's go.\Nothing's up. response:	Don't look at me.
context: But he's annoying.\Excellent.\It gets lonely without our local idol.\So annoying.\Huh? What's up?\Let's go.\Nothing's up.\Don't look at me. response:	Sorry.
context: Excellent.\It gets lonely without our local idol.\So annoying.\Huh? What's up?\Let's go.\Nothing's up.\Don't look at me.\Sorry. response:	You haven't fallen for me, have you?
context: It gets lonely without our local idol.\So annoying.\Huh? What's up?\Let's go.\Nothing's up.\Don't look at me.\Sorry.\You haven't fallen for me, have you? response:	Sorry I'm such a hottie.
context: So annoying.\Huh? What's up?\Let's go.\Nothing's up.\Don't look at me.\Sorry.\You haven't fallen for me, have you?\Sorry I'm such a hottie. response:	Huh?
context: Huh? What's up?\Let's go.\Nothing's up.\Don't look at me.\Sorry.\You haven't fallen for me, have you?\Sorry I'm such a hottie.\Huh? response:	What's wrong?
context: Let's go.\Nothing's up.\Don't look at me.\Sorry.\You haven't fallen for me, have you?\Sorry I'm such a hottie.\Huh?\What's wrong? response:	Huh?
context: Nothing's up.\Don't look at me.\Sorry.\You haven't fallen for me, have you?\Sorry I'm such a hottie.\Huh?\What's wrong?\Huh? response:	Yeah?
context: Don't look at me.\Sorry.\You haven't fallen for me, have you?\Sorry I'm such a hottie.\Huh?\What's wrong?\Huh?\Yeah? response:	Am I badass? Huh?
context: Sorry.\You haven't fallen for me, have you?\Sorry I'm such a hottie.\Huh?\What's wrong?\Huh?\Yeah?\Am I badass? Huh? response:	My crush called me out.
context: You haven't fallen for me, have you?\Sorry I'm such a hottie.\Huh?\What's wrong?\Huh?\Yeah?\Am I badass? Huh?\My crush called me out. response:	Would you like to go for lunch sometime?
context: Sorry I'm such a hottie.\Huh?\What's wrong?\Huh?\Yeah?\Am I badass? Huh?\My crush called me out.\Would you like to go for lunch sometime? response:	What? With me? Why?!
context: Huh?\What's wrong?\Huh?\Yeah?\Am I badass? Huh?\My crush called me out.\Would you like to go for lunch sometime?\What? With me? Why?! response:	I want to thank you for helping me the other day.
context: What's wrong?\Huh?\Yeah?\Am I badass? Huh?\My crush called me out.\Would you like to go for lunch sometime?\What? With me? Why?!\I want to thank you for helping me the other day. response:	Am I imposing?
context: Huh?\Yeah?\Am I badass? Huh?\My crush called me out.\Would you like to go for lunch sometime?\What? With me? Why?!\I want to thank you for helping me the other day.\Am I imposing? response:	N-No, not really.
context: Yeah?\Am I badass? Huh?\My crush called me out.\Would you like to go for lunch sometime?\What? With me? Why?!\I want to thank you for helping me the other day.\Am I imposing?\N-No, not really. response:	Thank goodness!
context: Am I badass? Huh?\My crush called me out.\Would you like to go for lunch sometime?\What? With me? Why?!\I want to thank you for helping me the other day.\Am I imposing?\N-No, not really.\Thank goodness! response:	Okay, I'll see you on Sunday.
context: My crush called me out.\Would you like to go for lunch sometime?\What? With me? Why?!\I want to thank you for helping me the other day.\Am I imposing?\N-No, not really.\Thank goodness!\Okay, I'll see you on Sunday. response:	Why is such a cute girl asking out an uggo like me?
context: Would you like to go for lunch sometime?\What? With me? Why?!\I want to thank you for helping me the other day.\Am I imposing?\N-No, not really.\Thank goodness!\Okay, I'll see you on Sunday.\Why is such a cute girl asking out an uggo like me? response:	Love Is Derpy
context: What? With me? Why?!\I want to thank you for helping me the other day.\Am I imposing?\N-No, not really.\Thank goodness!\Okay, I'll see you on Sunday.\Why is such a cute girl asking out an uggo like me?\Love Is Derpy response:	Did I get here too early?
context: I want to thank you for helping me the other day.\Am I imposing?\N-No, not really.\Thank goodness!\Okay, I'll see you on Sunday.\Why is such a cute girl asking out an uggo like me?\Love Is Derpy\Did I get here too early? response:	I've secretly been in love with this girl on my bus.
context: Am I imposing?\N-No, not really.\Thank goodness!\Okay, I'll see you on Sunday.\Why is such a cute girl asking out an uggo like me?\Love Is Derpy\Did I get here too early?\I've secretly been in love with this girl on my bus. response:	I never had the courage to talk to her.
context: N-No, not really.\Thank goodness!\Okay, I'll see you on Sunday.\Why is such a cute girl asking out an uggo like me?\Love Is Derpy\Did I get here too early?\I've secretly been in love with this girl on my bus.\I never had the courage to talk to her. response:	But one day...
context: Thank goodness!\Okay, I'll see you on Sunday.\Why is such a cute girl asking out an uggo like me?\Love Is Derpy\Did I get here too early?\I've secretly been in love with this girl on my bus.\I never had the courage to talk to her.\But one day... response:	A groper!
context: Okay, I'll see you on Sunday.\Why is such a cute girl asking out an uggo like me?\Love Is Derpy\Did I get here too early?\I've secretly been in love with this girl on my bus.\I never had the courage to talk to her.\But one day...\A groper! response:	M-Morning!
context: Why is such a cute girl asking out an uggo like me?\Love Is Derpy\Did I get here too early?\I've secretly been in love with this girl on my bus.\I never had the courage to talk to her.\But one day...\A groper!\M-Morning! response:	Wh-Where a coinkydink, Kurihara-san!
context: Love Is Derpy\Did I get here too early?\I've secretly been in love with this girl on my bus.\I never had the courage to talk to her.\But one day...\A groper!\M-Morning!\Wh-Where a coinkydink, Kurihara-san! response:	H-How's up?
context: Did I get here too early?\I've secretly been in love with this girl on my bus.\I never had the courage to talk to her.\But one day...\A groper!\M-Morning!\Wh-Where a coinkydink, Kurihara-san!\H-How's up? response:	I mean, wh-what's life?
context: I've secretly been in love with this girl on my bus.\I never had the courage to talk to her.\But one day...\A groper!\M-Morning!\Wh-Where a coinkydink, Kurihara-san!\H-How's up?\I mean, wh-what's life? response:	I thought I totally creeped her out.
context: I never had the courage to talk to her.\But one day...\A groper!\M-Morning!\Wh-Where a coinkydink, Kurihara-san!\H-How's up?\I mean, wh-what's life?\I thought I totally creeped her out. response:	I never thought she'd want to thank me.
context: But one day...\A groper!\M-Morning!\Wh-Where a coinkydink, Kurihara-san!\H-How's up?\I mean, wh-what's life?\I thought I totally creeped her out.\I never thought she'd want to thank me. response:	Wait, is she actually coming?
context: A groper!\M-Morning!\Wh-Where a coinkydink, Kurihara-san!\H-How's up?\I mean, wh-what's life?\I thought I totally creeped her out.\I never thought she'd want to thank me.\Wait, is she actually coming? response:	Isn't there no way she'd invite me?
context: M-Morning!\Wh-Where a coinkydink, Kurihara-san!\H-How's up?\I mean, wh-what's life?\I thought I totally creeped her out.\I never thought she'd want to thank me.\Wait, is she actually coming?\Isn't there no way she'd invite me? response:	That's it, it was all in my mind!
context: Wh-Where a coinkydink, Kurihara-san!\H-How's up?\I mean, wh-what's life?\I thought I totally creeped her out.\I never thought she'd want to thank me.\Wait, is she actually coming?\Isn't there no way she'd invite me?\That's it, it was all in my mind! response:	Yup, case closed.
context: H-How's up?\I mean, wh-what's life?\I thought I totally creeped her out.\I never thought she'd want to thank me.\Wait, is she actually coming?\Isn't there no way she'd invite me?\That's it, it was all in my mind!\Yup, case closed. response:	Thanks for waiting.
context: I mean, wh-what's life?\I thought I totally creeped her out.\I never thought she'd want to thank me.\Wait, is she actually coming?\Isn't there no way she'd invite me?\That's it, it was all in my mind!\Yup, case closed.\Thanks for waiting. response:	Heungh!
context: I thought I totally creeped her out.\I never thought she'd want to thank me.\Wait, is she actually coming?\Isn't there no way she'd invite me?\That's it, it was all in my mind!\Yup, case closed.\Thanks for waiting.\Heungh! response:	Heungh?
context: I never thought she'd want to thank me.\Wait, is she actually coming?\Isn't there no way she'd invite me?\That's it, it was all in my mind!\Yup, case closed.\Thanks for waiting.\Heungh!\Heungh? response:	What the heck is this?!
context: Wait, is she actually coming?\Isn't there no way she'd invite me?\That's it, it was all in my mind!\Yup, case closed.\Thanks for waiting.\Heungh!\Heungh?\What the heck is this?! response:	She's so cute!
context: Isn't there no way she'd invite me?\That's it, it was all in my mind!\Yup, case closed.\Thanks for waiting.\Heungh!\Heungh?\What the heck is this?!\She's so cute! response:	Um, please stop staring at me.
context: That's it, it was all in my mind!\Yup, case closed.\Thanks for waiting.\Heungh!\Heungh?\What the heck is this?!\She's so cute!\Um, please stop staring at me. response:	N-No, I'm not staring at all!
context: Yup, case closed.\Thanks for waiting.\Heungh!\Heungh?\What the heck is this?!\She's so cute!\Um, please stop staring at me.\N-No, I'm not staring at all! response:	I don't think you're cute or anything!
context: Thanks for waiting.\Heungh!\Heungh?\What the heck is this?!\She's so cute!\Um, please stop staring at me.\N-No, I'm not staring at all!\I don't think you're cute or anything! response:	No! I did! I do think you're cute, but your outfit!
context: Heungh!\Heungh?\What the heck is this?!\She's so cute!\Um, please stop staring at me.\N-No, I'm not staring at all!\I don't think you're cute or anything!\No! I did! I do think you're cute, but your outfit! response:	That's it, your outfit's cute!
context: Heungh?\What the heck is this?!\She's so cute!\Um, please stop staring at me.\N-No, I'm not staring at all!\I don't think you're cute or anything!\No! I did! I do think you're cute, but your outfit!\That's it, your outfit's cute! response:	I mean, not just your outfit, but...
context: What the heck is this?!\She's so cute!\Um, please stop staring at me.\N-No, I'm not staring at all!\I don't think you're cute or anything!\No! I did! I do think you're cute, but your outfit!\That's it, your outfit's cute!\I mean, not just your outfit, but... response:	Yamane-san, was it?
context: She's so cute!\Um, please stop staring at me.\N-No, I'm not staring at all!\I don't think you're cute or anything!\No! I did! I do think you're cute, but your outfit!\That's it, your outfit's cute!\I mean, not just your outfit, but...\Yamane-san, was it? response:	What should we have?
context: Um, please stop staring at me.\N-No, I'm not staring at all!\I don't think you're cute or anything!\No! I did! I do think you're cute, but your outfit!\That's it, your outfit's cute!\I mean, not just your outfit, but...\Yamane-san, was it?\What should we have? response:	It's on me.
context: N-No, I'm not staring at all!\I don't think you're cute or anything!\No! I did! I do think you're cute, but your outfit!\That's it, your outfit's cute!\I mean, not just your outfit, but...\Yamane-san, was it?\What should we have?\It's on me. response:	Huh?!
context: I don't think you're cute or anything!\No! I did! I do think you're cute, but your outfit!\That's it, your outfit's cute!\I mean, not just your outfit, but...\Yamane-san, was it?\What should we have?\It's on me.\Huh?! response:	What am I supposed to do, here?
context: No! I did! I do think you're cute, but your outfit!\That's it, your outfit's cute!\I mean, not just your outfit, but...\Yamane-san, was it?\What should we have?\It's on me.\Huh?!\What am I supposed to do, here? response:	I shouldn't go too pricey, but...
context: That's it, your outfit's cute!\I mean, not just your outfit, but...\Yamane-san, was it?\What should we have?\It's on me.\Huh?!\What am I supposed to do, here?\I shouldn't go too pricey, but... response:	Maybe somewhere cheap, quick, and tasty?
context: I mean, not just your outfit, but...\Yamane-san, was it?\What should we have?\It's on me.\Huh?!\What am I supposed to do, here?\I shouldn't go too pricey, but...\Maybe somewhere cheap, quick, and tasty? response:	Th-Then how about soba?
context: Yamane-san, was it?\What should we have?\It's on me.\Huh?!\What am I supposed to do, here?\I shouldn't go too pricey, but...\Maybe somewhere cheap, quick, and tasty?\Th-Then how about soba? response:	That sounds good!
context: What should we have?\It's on me.\Huh?!\What am I supposed to do, here?\I shouldn't go too pricey, but...\Maybe somewhere cheap, quick, and tasty?\Th-Then how about soba?\That sounds good! response:	There's a standing soba stall right there.
context: It's on me.\Huh?!\What am I supposed to do, here?\I shouldn't go too pricey, but...\Maybe somewhere cheap, quick, and tasty?\Th-Then how about soba?\That sounds good!\There's a standing soba stall right there. response:	Soba Udon
context: Huh?!\What am I supposed to do, here?\I shouldn't go too pricey, but...\Maybe somewhere cheap, quick, and tasty?\Th-Then how about soba?\That sounds good!\There's a standing soba stall right there.\Soba Udon response:	Come in.
context: What am I supposed to do, here?\I shouldn't go too pricey, but...\Maybe somewhere cheap, quick, and tasty?\Th-Then how about soba?\That sounds good!\There's a standing soba stall right there.\Soba Udon\Come in. response:	May I choose?
context: I shouldn't go too pricey, but...\Maybe somewhere cheap, quick, and tasty?\Th-Then how about soba?\That sounds good!\There's a standing soba stall right there.\Soba Udon\Come in.\May I choose? response:	S-Sure.
context: Maybe somewhere cheap, quick, and tasty?\Th-Then how about soba?\That sounds good!\There's a standing soba stall right there.\Soba Udon\Come in.\May I choose?\S-Sure. response:	You don't have to hold back.
context: Th-Then how about soba?\That sounds good!\There's a standing soba stall right there.\Soba Udon\Come in.\May I choose?\S-Sure.\You don't have to hold back. response:	O-Okay.
context: That sounds good!\There's a standing soba stall right there.\Soba Udon\Come in.\May I choose?\S-Sure.\You don't have to hold back.\O-Okay. response:	Should we order fountain drinks?
context: There's a standing soba stall right there.\Soba Udon\Come in.\May I choose?\S-Sure.\You don't have to hold back.\O-Okay.\Should we order fountain drinks? response:	I-It's fine, I'll go home right after we're done.
context: Soba Udon\Come in.\May I choose?\S-Sure.\You don't have to hold back.\O-Okay.\Should we order fountain drinks?\I-It's fine, I'll go home right after we're done. response:	Oh, of course.
context: Come in.\May I choose?\S-Sure.\You don't have to hold back.\O-Okay.\Should we order fountain drinks?\I-It's fine, I'll go home right after we're done.\Oh, of course. response:	No, it's not that I want to go home!
context: May I choose?\S-Sure.\You don't have to hold back.\O-Okay.\Should we order fountain drinks?\I-It's fine, I'll go home right after we're done.\Oh, of course.\No, it's not that I want to go home! response:	I'd love to be with you forever!
context: S-Sure.\You don't have to hold back.\O-Okay.\Should we order fountain drinks?\I-It's fine, I'll go home right after we're done.\Oh, of course.\No, it's not that I want to go home!\I'd love to be with you forever! response:	Wait, that was creepy, right?
context: You don't have to hold back.\O-Okay.\Should we order fountain drinks?\I-It's fine, I'll go home right after we're done.\Oh, of course.\No, it's not that I want to go home!\I'd love to be with you forever!\Wait, that was creepy, right? response:	D-Don't worry, I'll go home right away!
context: O-Okay.\Should we order fountain drinks?\I-It's fine, I'll go home right after we're done.\Oh, of course.\No, it's not that I want to go home!\I'd love to be with you forever!\Wait, that was creepy, right?\D-Don't worry, I'll go home right away! response:	I'd actually noticed you on the bus every morning.
context: Should we order fountain drinks?\I-It's fine, I'll go home right after we're done.\Oh, of course.\No, it's not that I want to go home!\I'd love to be with you forever!\Wait, that was creepy, right?\D-Don't worry, I'll go home right away!\I'd actually noticed you on the bus every morning. response:	What?
context: I-It's fine, I'll go home right after we're done.\Oh, of course.\No, it's not that I want to go home!\I'd love to be with you forever!\Wait, that was creepy, right?\D-Don't worry, I'll go home right away!\I'd actually noticed you on the bus every morning.\What? response:	You give your seat up for seniors all the time.
context: Oh, of course.\No, it's not that I want to go home!\I'd love to be with you forever!\Wait, that was creepy, right?\D-Don't worry, I'll go home right away!\I'd actually noticed you on the bus every morning.\What?\You give your seat up for seniors all the time. response:	I-I have to do good when I can,
context: No, it's not that I want to go home!\I'd love to be with you forever!\Wait, that was creepy, right?\D-Don't worry, I'll go home right away!\I'd actually noticed you on the bus every morning.\What?\You give your seat up for seniors all the time.\I-I have to do good when I can, response:	because, y'know, I'm a weirdo.
context: I'd love to be with you forever!\Wait, that was creepy, right?\D-Don't worry, I'll go home right away!\I'd actually noticed you on the bus every morning.\What?\You give your seat up for seniors all the time.\I-I have to do good when I can,\because, y'know, I'm a weirdo. response:	But when you helped me out...
context: Wait, that was creepy, right?\D-Don't worry, I'll go home right away!\I'd actually noticed you on the bus every morning.\What?\You give your seat up for seniors all the time.\I-I have to do good when I can,\because, y'know, I'm a weirdo.\But when you helped me out... response:	Sorry to remind you about that awfulness!
context: D-Don't worry, I'll go home right away!\I'd actually noticed you on the bus every morning.\What?\You give your seat up for seniors all the time.\I-I have to do good when I can,\because, y'know, I'm a weirdo.\But when you helped me out...\Sorry to remind you about that awfulness! response:	I'm such a failure!
context: I'd actually noticed you on the bus every morning.\What?\You give your seat up for seniors all the time.\I-I have to do good when I can,\because, y'know, I'm a weirdo.\But when you helped me out...\Sorry to remind you about that awfulness!\I'm such a failure! response:	She invited me out, and I'm ruining it.
context: What?\You give your seat up for seniors all the time.\I-I have to do good when I can,\because, y'know, I'm a weirdo.\But when you helped me out...\Sorry to remind you about that awfulness!\I'm such a failure!\She invited me out, and I'm ruining it. response:	You're so funny, Yamane-san.
context: You give your seat up for seniors all the time.\I-I have to do good when I can,\because, y'know, I'm a weirdo.\But when you helped me out...\Sorry to remind you about that awfulness!\I'm such a failure!\She invited me out, and I'm ruining it.\You're so funny, Yamane-san. response:	Oh, my face, right? I get that a lot.
context: I-I have to do good when I can,\because, y'know, I'm a weirdo.\But when you helped me out...\Sorry to remind you about that awfulness!\I'm such a failure!\She invited me out, and I'm ruining it.\You're so funny, Yamane-san.\Oh, my face, right? I get that a lot. response:	Your face is great, too.
context: because, y'know, I'm a weirdo.\But when you helped me out...\Sorry to remind you about that awfulness!\I'm such a failure!\She invited me out, and I'm ruining it.\You're so funny, Yamane-san.\Oh, my face, right? I get that a lot.\Your face is great, too. response:	M-M-Maybe for the Heian Period, but this is the 21st century.
context: But when you helped me out...\Sorry to remind you about that awfulness!\I'm such a failure!\She invited me out, and I'm ruining it.\You're so funny, Yamane-san.\Oh, my face, right? I get that a lot.\Your face is great, too.\M-M-Maybe for the Heian Period, but this is the 21st century. response:	Is she kidding?
context: Sorry to remind you about that awfulness!\I'm such a failure!\She invited me out, and I'm ruining it.\You're so funny, Yamane-san.\Oh, my face, right? I get that a lot.\Your face is great, too.\M-M-Maybe for the Heian Period, but this is the 21st century.\Is she kidding? response:	Or maybe I just look like a dorky mascot.
context: I'm such a failure!\She invited me out, and I'm ruining it.\You're so funny, Yamane-san.\Oh, my face, right? I get that a lot.\Your face is great, too.\M-M-Maybe for the Heian Period, but this is the 21st century.\Is she kidding?\Or maybe I just look like a dorky mascot. response:	Um...
context: She invited me out, and I'm ruining it.\You're so funny, Yamane-san.\Oh, my face, right? I get that a lot.\Your face is great, too.\M-M-Maybe for the Heian Period, but this is the 21st century.\Is she kidding?\Or maybe I just look like a dorky mascot.\Um... response:	Why?
context: You're so funny, Yamane-san.\Oh, my face, right? I get that a lot.\Your face is great, too.\M-M-Maybe for the Heian Period, but this is the 21st century.\Is she kidding?\Or maybe I just look like a dorky mascot.\Um...\Why? response:	Why the serious face?
context: Oh, my face, right? I get that a lot.\Your face is great, too.\M-M-Maybe for the Heian Period, but this is the 21st century.\Is she kidding?\Or maybe I just look like a dorky mascot.\Um...\Why?\Why the serious face? response:	Impossible!
context: Your face is great, too.\M-M-Maybe for the Heian Period, but this is the 21st century.\Is she kidding?\Or maybe I just look like a dorky mascot.\Um...\Why?\Why the serious face?\Impossible! response:	Seriously?!
context: M-M-Maybe for the Heian Period, but this is the 21st century.\Is she kidding?\Or maybe I just look like a dorky mascot.\Um...\Why?\Why the serious face?\Impossible!\Seriously?! response:	Are you serious?
context: Is she kidding?\Or maybe I just look like a dorky mascot.\Um...\Why?\Why the serious face?\Impossible!\Seriously?!\Are you serious? response:	No, no way this could happen to me!
context: Or maybe I just look like a dorky mascot.\Um...\Why?\Why the serious face?\Impossible!\Seriously?!\Are you serious?\No, no way this could happen to me! response:	She's deceiving you!
context: Um...\Why?\Why the serious face?\Impossible!\Seriously?!\Are you serious?\No, no way this could happen to me!\She's deceiving you! response:	Don't get your hopes up
context: Why?\Why the serious face?\Impossible!\Seriously?!\Are you serious?\No, no way this could happen to me!\She's deceiving you!\Don't get your hopes up response:	I've been getting ignored by girls for years.
context: Why the serious face?\Impossible!\Seriously?!\Are you serious?\No, no way this could happen to me!\She's deceiving you!\Don't get your hopes up\I've been getting ignored by girls for years. response:	Really?!
context: Impossible!\Seriously?!\Are you serious?\No, no way this could happen to me!\She's deceiving you!\Don't get your hopes up\I've been getting ignored by girls for years.\Really?! response:	No way no way no way
context: Seriously?!\Are you serious?\No, no way this could happen to me!\She's deceiving you!\Don't get your hopes up\I've been getting ignored by girls for years.\Really?!\No way no way no way response:	Why?
context: Are you serious?\No, no way this could happen to me!\She's deceiving you!\Don't get your hopes up\I've been getting ignored by girls for years.\Really?!\No way no way no way\Why? response:	Don't get your hopes up!
context: No, no way this could happen to me!\She's deceiving you!\Don't get your hopes up\I've been getting ignored by girls for years.\Really?!\No way no way no way\Why?\Don't get your hopes up! response:	What if she's serious?
context: She's deceiving you!\Don't get your hopes up\I've been getting ignored by girls for years.\Really?!\No way no way no way\Why?\Don't get your hopes up!\What if she's serious? response:	Why?
context: Don't get your hopes up\I've been getting ignored by girls for years.\Really?!\No way no way no way\Why?\Don't get your hopes up!\What if she's serious?\Why? response:	There's no way!
context: I've been getting ignored by girls for years.\Really?!\No way no way no way\Why?\Don't get your hopes up!\What if she's serious?\Why?\There's no way! response:	I'm not prepared for this
context: Really?!\No way no way no way\Why?\Don't get your hopes up!\What if she's serious?\Why?\There's no way!\I'm not prepared for this response:	Really?
context: No way no way no way\Why?\Don't get your hopes up!\What if she's serious?\Why?\There's no way!\I'm not prepared for this\Really? response:	If it's okay with you...
context: Why?\Don't get your hopes up!\What if she's serious?\Why?\There's no way!\I'm not prepared for this\Really?\If it's okay with you... response:	You'll regret getting your hopes up!
context: Don't get your hopes up!\What if she's serious?\Why?\There's no way!\I'm not prepared for this\Really?\If it's okay with you...\You'll regret getting your hopes up! response:	Badger Badger Mushroom
context: What if she's serious?\Why?\There's no way!\I'm not prepared for this\Really?\If it's okay with you...\You'll regret getting your hopes up!\Badger Badger Mushroom response:	Why does she look so serious?
context: Why?\There's no way!\I'm not prepared for this\Really?\If it's okay with you...\You'll regret getting your hopes up!\Badger Badger Mushroom\Why does she look so serious? response:	Nothing to see here
context: There's no way!\I'm not prepared for this\Really?\If it's okay with you...\You'll regret getting your hopes up!\Badger Badger Mushroom\Why does she look so serious?\Nothing to see here response:	Don't get your hopes up!
context: I'm not prepared for this\Really?\If it's okay with you...\You'll regret getting your hopes up!\Badger Badger Mushroom\Why does she look so serious?\Nothing to see here\Don't get your hopes up! response:	But what if she's serious?!
context: Really?\If it's okay with you...\You'll regret getting your hopes up!\Badger Badger Mushroom\Why does she look so serious?\Nothing to see here\Don't get your hopes up!\But what if she's serious?! response:	No, that's impossible!
context: If it's okay with you...\You'll regret getting your hopes up!\Badger Badger Mushroom\Why does she look so serious?\Nothing to see here\Don't get your hopes up!\But what if she's serious?!\No, that's impossible! response:	Would you...
context: You'll regret getting your hopes up!\Badger Badger Mushroom\Why does she look so serious?\Nothing to see here\Don't get your hopes up!\But what if she's serious?!\No, that's impossible!\Would you... response:	Wait, I'm not prepared!
context: Badger Badger Mushroom\Why does she look so serious?\Nothing to see here\Don't get your hopes up!\But what if she's serious?!\No, that's impossible!\Would you...\Wait, I'm not prepared! response:	Go out with me?!
context: Why does she look so serious?\Nothing to see here\Don't get your hopes up!\But what if she's serious?!\No, that's impossible!\Would you...\Wait, I'm not prepared!\Go out with me?! response:	Yes!
context: Nothing to see here\Don't get your hopes up!\But what if she's serious?!\No, that's impossible!\Would you...\Wait, I'm not prepared!\Go out with me?!\Yes! response:	Fountain drink, please.
context: Don't get your hopes up!\But what if she's serious?!\No, that's impossible!\Would you...\Wait, I'm not prepared!\Go out with me?!\Yes!\Fountain drink, please. response:	The person on cleanup duty went home.
context: But what if she's serious?!\No, that's impossible!\Would you...\Wait, I'm not prepared!\Go out with me?!\Yes!\Fountain drink, please.\The person on cleanup duty went home. response:	This sucks.
context: No, that's impossible!\Would you...\Wait, I'm not prepared!\Go out with me?!\Yes!\Fountain drink, please.\The person on cleanup duty went home.\This sucks. response:	Takano?
context: Would you...\Wait, I'm not prepared!\Go out with me?!\Yes!\Fountain drink, please.\The person on cleanup duty went home.\This sucks.\Takano? response:	Sugawara-kun.
context: Wait, I'm not prepared!\Go out with me?!\Yes!\Fountain drink, please.\The person on cleanup duty went home.\This sucks.\Takano?\Sugawara-kun. response:	Sugawara-kun is in my class.
context: Go out with me?!\Yes!\Fountain drink, please.\The person on cleanup duty went home.\This sucks.\Takano?\Sugawara-kun.\Sugawara-kun is in my class. response:	Cleanup Duty
context: Yes!\Fountain drink, please.\The person on cleanup duty went home.\This sucks.\Takano?\Sugawara-kun.\Sugawara-kun is in my class.\Cleanup Duty response:	Sometimes, we chat a little these days.
context: Fountain drink, please.\The person on cleanup duty went home.\This sucks.\Takano?\Sugawara-kun.\Sugawara-kun is in my class.\Cleanup Duty\Sometimes, we chat a little these days. response:	Cleaning up by yourself?
context: The person on cleanup duty went home.\This sucks.\Takano?\Sugawara-kun.\Sugawara-kun is in my class.\Cleanup Duty\Sometimes, we chat a little these days.\Cleaning up by yourself? response:	I'll help you.
context: This sucks.\Takano?\Sugawara-kun.\Sugawara-kun is in my class.\Cleanup Duty\Sometimes, we chat a little these days.\Cleaning up by yourself?\I'll help you. response:	But...
context: Takano?\Sugawara-kun.\Sugawara-kun is in my class.\Cleanup Duty\Sometimes, we chat a little these days.\Cleaning up by yourself?\I'll help you.\But... response:	It's too much for one person.
context: Sugawara-kun.\Sugawara-kun is in my class.\Cleanup Duty\Sometimes, we chat a little these days.\Cleaning up by yourself?\I'll help you.\But...\It's too much for one person. response:	I'll get a broom.
context: Sugawara-kun is in my class.\Cleanup Duty\Sometimes, we chat a little these days.\Cleaning up by yourself?\I'll help you.\But...\It's too much for one person.\I'll get a broom. response:	He's a good person.
context: Cleanup Duty\Sometimes, we chat a little these days.\Cleaning up by yourself?\I'll help you.\But...\It's too much for one person.\I'll get a broom.\He's a good person. response:	Huh?
context: Sometimes, we chat a little these days.\Cleaning up by yourself?\I'll help you.\But...\It's too much for one person.\I'll get a broom.\He's a good person.\Huh? response:	Cleanup duty, Suga-yan?
context: Cleaning up by yourself?\I'll help you.\But...\It's too much for one person.\I'll get a broom.\He's a good person.\Huh?\Cleanup duty, Suga-yan? response:	Practice is about to start.
context: I'll help you.\But...\It's too much for one person.\I'll get a broom.\He's a good person.\Huh?\Cleanup duty, Suga-yan?\Practice is about to start. response:	Y-Yeah, I'll be right there!
context: But...\It's too much for one person.\I'll get a broom.\He's a good person.\Huh?\Cleanup duty, Suga-yan?\Practice is about to start.\Y-Yeah, I'll be right there! response:	Sure.
context: It's too much for one person.\I'll get a broom.\He's a good person.\Huh?\Cleanup duty, Suga-yan?\Practice is about to start.\Y-Yeah, I'll be right there!\Sure. response:	I don't want to keep you from club practice, Sugawara-kun.
context: I'll get a broom.\He's a good person.\Huh?\Cleanup duty, Suga-yan?\Practice is about to start.\Y-Yeah, I'll be right there!\Sure.\I don't want to keep you from club practice, Sugawara-kun. response:	It's fine.
context: He's a good person.\Huh?\Cleanup duty, Suga-yan?\Practice is about to start.\Y-Yeah, I'll be right there!\Sure.\I don't want to keep you from club practice, Sugawara-kun.\It's fine. response:	I just want to help.
context: Huh?\Cleanup duty, Suga-yan?\Practice is about to start.\Y-Yeah, I'll be right there!\Sure.\I don't want to keep you from club practice, Sugawara-kun.\It's fine.\I just want to help. response:	Why is he so eager to help?
context: Cleanup duty, Suga-yan?\Practice is about to start.\Y-Yeah, I'll be right there!\Sure.\I don't want to keep you from club practice, Sugawara-kun.\It's fine.\I just want to help.\Why is he so eager to help? response:	Maybe he's a clean freak?
context: Practice is about to start.\Y-Yeah, I'll be right there!\Sure.\I don't want to keep you from club practice, Sugawara-kun.\It's fine.\I just want to help.\Why is he so eager to help?\Maybe he's a clean freak? response:	Do you help with cleaning often?
context: Y-Yeah, I'll be right there!\Sure.\I don't want to keep you from club practice, Sugawara-kun.\It's fine.\I just want to help.\Why is he so eager to help?\Maybe he's a clean freak?\Do you help with cleaning often? response:	No, not really, but, like, since you're...
context: Sure.\I don't want to keep you from club practice, Sugawara-kun.\It's fine.\I just want to help.\Why is he so eager to help?\Maybe he's a clean freak?\Do you help with cleaning often?\No, not really, but, like, since you're... response:	Since I'm what?
context: I don't want to keep you from club practice, Sugawara-kun.\It's fine.\I just want to help.\Why is he so eager to help?\Maybe he's a clean freak?\Do you help with cleaning often?\No, not really, but, like, since you're...\Since I'm what? response:	Is it something he doesn't want to say?
context: It's fine.\I just want to help.\Why is he so eager to help?\Maybe he's a clean freak?\Do you help with cleaning often?\No, not really, but, like, since you're...\Since I'm what?\Is it something he doesn't want to say? response:	Am I doing a crappy job of cleaning?
context: I just want to help.\Why is he so eager to help?\Maybe he's a clean freak?\Do you help with cleaning often?\No, not really, but, like, since you're...\Since I'm what?\Is it something he doesn't want to say?\Am I doing a crappy job of cleaning? response:	Sorry, I'll shut up and get to work.
context: Why is he so eager to help?\Maybe he's a clean freak?\Do you help with cleaning often?\No, not really, but, like, since you're...\Since I'm what?\Is it something he doesn't want to say?\Am I doing a crappy job of cleaning?\Sorry, I'll shut up and get to work. response:	Huh? Sure.
context: Maybe he's a clean freak?\Do you help with cleaning often?\No, not really, but, like, since you're...\Since I'm what?\Is it something he doesn't want to say?\Am I doing a crappy job of cleaning?\Sorry, I'll shut up and get to work.\Huh? Sure. response:	Did she figure out how I feel?
context: Do you help with cleaning often?\No, not really, but, like, since you're...\Since I'm what?\Is it something he doesn't want to say?\Am I doing a crappy job of cleaning?\Sorry, I'll shut up and get to work.\Huh? Sure.\Did she figure out how I feel? response:	J-Just so you know, I didn't mean that in a weird way!
context: No, not really, but, like, since you're...\Since I'm what?\Is it something he doesn't want to say?\Am I doing a crappy job of cleaning?\Sorry, I'll shut up and get to work.\Huh? Sure.\Did she figure out how I feel?\J-Just so you know, I didn't mean that in a weird way! response:	Sorry if I made you uncomfortable.
context: Since I'm what?\Is it something he doesn't want to say?\Am I doing a crappy job of cleaning?\Sorry, I'll shut up and get to work.\Huh? Sure.\Did she figure out how I feel?\J-Just so you know, I didn't mean that in a weird way!\Sorry if I made you uncomfortable. response:	No, sorry I didn't notice, either.
context: Is it something he doesn't want to say?\Am I doing a crappy job of cleaning?\Sorry, I'll shut up and get to work.\Huh? Sure.\Did she figure out how I feel?\J-Just so you know, I didn't mean that in a weird way!\Sorry if I made you uncomfortable.\No, sorry I didn't notice, either. response:	What should I do?
context: Am I doing a crappy job of cleaning?\Sorry, I'll shut up and get to work.\Huh? Sure.\Did she figure out how I feel?\J-Just so you know, I didn't mean that in a weird way!\Sorry if I made you uncomfortable.\No, sorry I didn't notice, either.\What should I do? response:	What? Do? About what?
context: Sorry, I'll shut up and get to work.\Huh? Sure.\Did she figure out how I feel?\J-Just so you know, I didn't mean that in a weird way!\Sorry if I made you uncomfortable.\No, sorry I didn't notice, either.\What should I do?\What? Do? About what? response:	Don't mind me.
context: Huh? Sure.\Did she figure out how I feel?\J-Just so you know, I didn't mean that in a weird way!\Sorry if I made you uncomfortable.\No, sorry I didn't notice, either.\What should I do?\What? Do? About what?\Don't mind me. response:	You're helping me because you noticed me, right?
context: Did she figure out how I feel?\J-Just so you know, I didn't mean that in a weird way!\Sorry if I made you uncomfortable.\No, sorry I didn't notice, either.\What should I do?\What? Do? About what?\Don't mind me.\You're helping me because you noticed me, right? response:	I was actually interested in you.
context: J-Just so you know, I didn't mean that in a weird way!\Sorry if I made you uncomfortable.\No, sorry I didn't notice, either.\What should I do?\What? Do? About what?\Don't mind me.\You're helping me because you noticed me, right?\I was actually interested in you. response:	I knew it.
context: Sorry if I made you uncomfortable.\No, sorry I didn't notice, either.\What should I do?\What? Do? About what?\Don't mind me.\You're helping me because you noticed me, right?\I was actually interested in you.\I knew it. response:	Sorry, I never learned about this stuff.
context: No, sorry I didn't notice, either.\What should I do?\What? Do? About what?\Don't mind me.\You're helping me because you noticed me, right?\I was actually interested in you.\I knew it.\Sorry, I never learned about this stuff. response:	I've never learned, either.
context: What should I do?\What? Do? About what?\Don't mind me.\You're helping me because you noticed me, right?\I was actually interested in you.\I knew it.\Sorry, I never learned about this stuff.\I've never learned, either. response:	Like, what do you want to do, Takano?
context: What? Do? About what?\Don't mind me.\You're helping me because you noticed me, right?\I was actually interested in you.\I knew it.\Sorry, I never learned about this stuff.\I've never learned, either.\Like, what do you want to do, Takano? response:	I want to get better at it.
context: Don't mind me.\You're helping me because you noticed me, right?\I was actually interested in you.\I knew it.\Sorry, I never learned about this stuff.\I've never learned, either.\Like, what do you want to do, Takano?\I want to get better at it. response:	Better? Huh?
context: You're helping me because you noticed me, right?\I was actually interested in you.\I knew it.\Sorry, I never learned about this stuff.\I've never learned, either.\Like, what do you want to do, Takano?\I want to get better at it.\Better? Huh? response:	Like, so that I can clean up better.
context: I was actually interested in you.\I knew it.\Sorry, I never learned about this stuff.\I've never learned, either.\Like, what do you want to do, Takano?\I want to get better at it.\Better? Huh?\Like, so that I can clean up better. response:	I think you're pretty enough as you are.
context: I knew it.\Sorry, I never learned about this stuff.\I've never learned, either.\Like, what do you want to do, Takano?\I want to get better at it.\Better? Huh?\Like, so that I can clean up better.\I think you're pretty enough as you are. response:	Really?
context: Sorry, I never learned about this stuff.\I've never learned, either.\Like, what do you want to do, Takano?\I want to get better at it.\Better? Huh?\Like, so that I can clean up better.\I think you're pretty enough as you are.\Really? response:	What should I do, then?
context: I've never learned, either.\Like, what do you want to do, Takano?\I want to get better at it.\Better? Huh?\Like, so that I can clean up better.\I think you're pretty enough as you are.\Really?\What should I do, then? response:	Well, I wanted to tell you...
context: Like, what do you want to do, Takano?\I want to get better at it.\Better? Huh?\Like, so that I can clean up better.\I think you're pretty enough as you are.\Really?\What should I do, then?\Well, I wanted to tell you... response:	No, maybe I'm rushing things.
context: I want to get better at it.\Better? Huh?\Like, so that I can clean up better.\I think you're pretty enough as you are.\Really?\What should I do, then?\Well, I wanted to tell you...\No, maybe I'm rushing things. response:	Take your time.
context: Better? Huh?\Like, so that I can clean up better.\I think you're pretty enough as you are.\Really?\What should I do, then?\Well, I wanted to tell you...\No, maybe I'm rushing things.\Take your time. response:	I'll be waiting.
context: Like, so that I can clean up better.\I think you're pretty enough as you are.\Really?\What should I do, then?\Well, I wanted to tell you...\No, maybe I'm rushing things.\Take your time.\I'll be waiting. response:	Wait, am I going too slow?
context: I think you're pretty enough as you are.\Really?\What should I do, then?\Well, I wanted to tell you...\No, maybe I'm rushing things.\Take your time.\I'll be waiting.\Wait, am I going too slow? response:	Sorry, I was taking too long.
context: Really?\What should I do, then?\Well, I wanted to tell you...\No, maybe I'm rushing things.\Take your time.\I'll be waiting.\Wait, am I going too slow?\Sorry, I was taking too long. response:	That's not true.
context: What should I do, then?\Well, I wanted to tell you...\No, maybe I'm rushing things.\Take your time.\I'll be waiting.\Wait, am I going too slow?\Sorry, I was taking too long.\That's not true. response:	Sorry, I'm really hasty.
context: Well, I wanted to tell you...\No, maybe I'm rushing things.\Take your time.\I'll be waiting.\Wait, am I going too slow?\Sorry, I was taking too long.\That's not true.\Sorry, I'm really hasty. response:	I'm just glad you know how I feel now.
context: No, maybe I'm rushing things.\Take your time.\I'll be waiting.\Wait, am I going too slow?\Sorry, I was taking too long.\That's not true.\Sorry, I'm really hasty.\I'm just glad you know how I feel now. response:	I'll ask you how you feel next time
context: Take your time.\I'll be waiting.\Wait, am I going too slow?\Sorry, I was taking too long.\That's not true.\Sorry, I'm really hasty.\I'm just glad you know how I feel now.\I'll ask you how you feel next time response:	Thanks.
context: I'll be waiting.\Wait, am I going too slow?\Sorry, I was taking too long.\That's not true.\Sorry, I'm really hasty.\I'm just glad you know how I feel now.\I'll ask you how you feel next time\Thanks. response:	I'll learn to clean quicker.
context: Wait, am I going too slow?\Sorry, I was taking too long.\That's not true.\Sorry, I'm really hasty.\I'm just glad you know how I feel now.\I'll ask you how you feel next time\Thanks.\I'll learn to clean quicker. response:	Huh?
context: Sorry, I was taking too long.\That's not true.\Sorry, I'm really hasty.\I'm just glad you know how I feel now.\I'll ask you how you feel next time\Thanks.\I'll learn to clean quicker.\Huh? response:	It isn't a topic that's easy to bring up.
context: That's not true.\Sorry, I'm really hasty.\I'm just glad you know how I feel now.\I'll ask you how you feel next time\Thanks.\I'll learn to clean quicker.\Huh?\It isn't a topic that's easy to bring up. response:	You sure are a good person.
context: Sorry, I'm really hasty.\I'm just glad you know how I feel now.\I'll ask you how you feel next time\Thanks.\I'll learn to clean quicker.\Huh?\It isn't a topic that's easy to bring up.\You sure are a good person. response:	Wait, what are we talking about?
context: I'm just glad you know how I feel now.\I'll ask you how you feel next time\Thanks.\I'll learn to clean quicker.\Huh?\It isn't a topic that's easy to bring up.\You sure are a good person.\Wait, what are we talking about? response:	About cleaning, right?
context: I'll ask you how you feel next time\Thanks.\I'll learn to clean quicker.\Huh?\It isn't a topic that's easy to bring up.\You sure are a good person.\Wait, what are we talking about?\About cleaning, right? response:	Huh?
context: Thanks.\I'll learn to clean quicker.\Huh?\It isn't a topic that's easy to bring up.\You sure are a good person.\Wait, what are we talking about?\About cleaning, right?\Huh? response:	Yeah, that's it!
context: I'll learn to clean quicker.\Huh?\It isn't a topic that's easy to bring up.\You sure are a good person.\Wait, what are we talking about?\About cleaning, right?\Huh?\Yeah, that's it! response:	Cleaning, right?!
context: Huh?\It isn't a topic that's easy to bring up.\You sure are a good person.\Wait, what are we talking about?\About cleaning, right?\Huh?\Yeah, that's it!\Cleaning, right?! response:	Next episode: Romantic Comedy.
context: It isn't a topic that's easy to bring up.\You sure are a good person.\Wait, what are we talking about?\About cleaning, right?\Huh?\Yeah, that's it!\Cleaning, right?!\Next episode: Romantic Comedy. response:	Romantic Comedy