context: It's up! Nice! response:	A feint!
context: It's up! Nice!\A feint! response:	Karasuno Johzenji
context: It's up! Nice!\A feint!\Karasuno Johzenji response:	Futamata!
context: It's up! Nice!\A feint!\Karasuno Johzenji\Futamata! response:	Again?! I'll stop them again!
context: It's up! Nice!\A feint!\Karasuno Johzenji\Futamata!\Again?! I'll stop them again! response:	This time, not with my face.
context: It's up! Nice!\A feint!\Karasuno Johzenji\Futamata!\Again?! I'll stop them again!\This time, not with my face. response:	Back attack!
context: It's up! Nice!\A feint!\Karasuno Johzenji\Futamata!\Again?! I'll stop them again!\This time, not with my face.\Back attack! response:	A break...
context: It's up! Nice!\A feint!\Karasuno Johzenji\Futamata!\Again?! I'll stop them again!\This time, not with my face.\Back attack!\A break... response:	I totally thought you were going to hit that.
context: A feint!\Karasuno Johzenji\Futamata!\Again?! I'll stop them again!\This time, not with my face.\Back attack!\A break...\I totally thought you were going to hit that. response:	You scared the crap out of me!
context: Karasuno Johzenji\Futamata!\Again?! I'll stop them again!\This time, not with my face.\Back attack!\A break...\I totally thought you were going to hit that.\You scared the crap out of me! response:	His own team didn't know he was going to do that.
context: Futamata!\Again?! I'll stop them again!\This time, not with my face.\Back attack!\A break...\I totally thought you were going to hit that.\You scared the crap out of me!\His own team didn't know he was going to do that. response:	But he was able to hit it so calmly.
context: Again?! I'll stop them again!\This time, not with my face.\Back attack!\A break...\I totally thought you were going to hit that.\You scared the crap out of me!\His own team didn't know he was going to do that.\But he was able to hit it so calmly. response:	They're vicious... How creepy.
context: This time, not with my face.\Back attack!\A break...\I totally thought you were going to hit that.\You scared the crap out of me!\His own team didn't know he was going to do that.\But he was able to hit it so calmly.\They're vicious... How creepy. response:	Johzenji seems to be doing well after their time out.
context: Back attack!\A break...\I totally thought you were going to hit that.\You scared the crap out of me!\His own team didn't know he was going to do that.\But he was able to hit it so calmly.\They're vicious... How creepy.\Johzenji seems to be doing well after their time out. response:	Yeah... They're starting to actually look at their opponents as they're playing.
context: A break...\I totally thought you were going to hit that.\You scared the crap out of me!\His own team didn't know he was going to do that.\But he was able to hit it so calmly.\They're vicious... How creepy.\Johzenji seems to be doing well after their time out.\Yeah... They're starting to actually look at their opponents as they're playing. response:	That's not good.
context: I totally thought you were going to hit that.\You scared the crap out of me!\His own team didn't know he was going to do that.\But he was able to hit it so calmly.\They're vicious... How creepy.\Johzenji seems to be doing well after their time out.\Yeah... They're starting to actually look at their opponents as they're playing.\That's not good. response:	Haikyu!!
context: You scared the crap out of me!\His own team didn't know he was going to do that.\But he was able to hit it so calmly.\They're vicious... How creepy.\Johzenji seems to be doing well after their time out.\Yeah... They're starting to actually look at their opponents as they're playing.\That's not good.\Haikyu!! response:	Episode 16: Next
context: His own team didn't know he was going to do that.\But he was able to hit it so calmly.\They're vicious... How creepy.\Johzenji seems to be doing well after their time out.\Yeah... They're starting to actually look at their opponents as they're playing.\That's not good.\Haikyu!!\Episode 16: Next response:	I'm not saying you need to play seriously.
context: But he was able to hit it so calmly.\They're vicious... How creepy.\Johzenji seems to be doing well after their time out.\Yeah... They're starting to actually look at their opponents as they're playing.\That's not good.\Haikyu!!\Episode 16: Next\I'm not saying you need to play seriously. response:	You guys may seem stupid, but you're not, are you?
context: They're vicious... How creepy.\Johzenji seems to be doing well after their time out.\Yeah... They're starting to actually look at their opponents as they're playing.\That's not good.\Haikyu!!\Episode 16: Next\I'm not saying you need to play seriously.\You guys may seem stupid, but you're not, are you? response:	Huh?
context: Johzenji seems to be doing well after their time out.\Yeah... They're starting to actually look at their opponents as they're playing.\That's not good.\Haikyu!!\Episode 16: Next\I'm not saying you need to play seriously.\You guys may seem stupid, but you're not, are you?\Huh? response:	Playing doesn't equal not thinking.
context: Yeah... They're starting to actually look at their opponents as they're playing.\That's not good.\Haikyu!!\Episode 16: Next\I'm not saying you need to play seriously.\You guys may seem stupid, but you're not, are you?\Huh?\Playing doesn't equal not thinking. response:	Left! Left!
context: That's not good.\Haikyu!!\Episode 16: Next\I'm not saying you need to play seriously.\You guys may seem stupid, but you're not, are you?\Huh?\Playing doesn't equal not thinking.\Left! Left! response:	Nice!
context: Haikyu!!\Episode 16: Next\I'm not saying you need to play seriously.\You guys may seem stupid, but you're not, are you?\Huh?\Playing doesn't equal not thinking.\Left! Left!\Nice! response:	It's up! Get the last one!
context: Episode 16: Next\I'm not saying you need to play seriously.\You guys may seem stupid, but you're not, are you?\Huh?\Playing doesn't equal not thinking.\Left! Left!\Nice!\It's up! Get the last one! response:	When you're not sure they're actually going to hit,
context: I'm not saying you need to play seriously.\You guys may seem stupid, but you're not, are you?\Huh?\Playing doesn't equal not thinking.\Left! Left!\Nice!\It's up! Get the last one!\When you're not sure they're actually going to hit, response:	don't go up to block, and take a step back.
context: You guys may seem stupid, but you're not, are you?\Huh?\Playing doesn't equal not thinking.\Left! Left!\Nice!\It's up! Get the last one!\When you're not sure they're actually going to hit,\don't go up to block, and take a step back. response:	Right on point!
context: Huh?\Playing doesn't equal not thinking.\Left! Left!\Nice!\It's up! Get the last one!\When you're not sure they're actually going to hit,\don't go up to block, and take a step back.\Right on point! response:	I have no complaints if you actually stop them.
context: Playing doesn't equal not thinking.\Left! Left!\Nice!\It's up! Get the last one!\When you're not sure they're actually going to hit,\don't go up to block, and take a step back.\Right on point!\I have no complaints if you actually stop them. response:	When you know how to move
context: Left! Left!\Nice!\It's up! Get the last one!\When you're not sure they're actually going to hit,\don't go up to block, and take a step back.\Right on point!\I have no complaints if you actually stop them.\When you know how to move response:	and have the skill to actually do it, that's when you can actually play freely.
context: Nice!\It's up! Get the last one!\When you're not sure they're actually going to hit,\don't go up to block, and take a step back.\Right on point!\I have no complaints if you actually stop them.\When you know how to move\and have the skill to actually do it, that's when you can actually play freely. response:	I guess the more we improve, the more we'll see people like that.
context: It's up! Get the last one!\When you're not sure they're actually going to hit,\don't go up to block, and take a step back.\Right on point!\I have no complaints if you actually stop them.\When you know how to move\and have the skill to actually do it, that's when you can actually play freely.\I guess the more we improve, the more we'll see people like that. response:	Tsukishima, nice serve!
context: When you're not sure they're actually going to hit,\don't go up to block, and take a step back.\Right on point!\I have no complaints if you actually stop them.\When you know how to move\and have the skill to actually do it, that's when you can actually play freely.\I guess the more we improve, the more we'll see people like that.\Tsukishima, nice serve! response:	Here he comes! 10!
context: don't go up to block, and take a step back.\Right on point!\I have no complaints if you actually stop them.\When you know how to move\and have the skill to actually do it, that's when you can actually play freely.\I guess the more we improve, the more we'll see people like that.\Tsukishima, nice serve!\Here he comes! 10! response:	Hey, listen up a sec.
context: Right on point!\I have no complaints if you actually stop them.\When you know how to move\and have the skill to actually do it, that's when you can actually play freely.\I guess the more we improve, the more we'll see people like that.\Tsukishima, nice serve!\Here he comes! 10!\Hey, listen up a sec. response:	Johzenji hasn't been able to stop Hinata's quick yet,
context: I have no complaints if you actually stop them.\When you know how to move\and have the skill to actually do it, that's when you can actually play freely.\I guess the more we improve, the more we'll see people like that.\Tsukishima, nice serve!\Here he comes! 10!\Hey, listen up a sec.\Johzenji hasn't been able to stop Hinata's quick yet, response:	so they'd better get this point.
context: When you know how to move\and have the skill to actually do it, that's when you can actually play freely.\I guess the more we improve, the more we'll see people like that.\Tsukishima, nice serve!\Here he comes! 10!\Hey, listen up a sec.\Johzenji hasn't been able to stop Hinata's quick yet,\so they'd better get this point. response:	Nice receive.
context: and have the skill to actually do it, that's when you can actually play freely.\I guess the more we improve, the more we'll see people like that.\Tsukishima, nice serve!\Here he comes! 10!\Hey, listen up a sec.\Johzenji hasn't been able to stop Hinata's quick yet,\so they'd better get this point.\Nice receive. response:	Their 10 jumped up! That quick is coming!
context: I guess the more we improve, the more we'll see people like that.\Tsukishima, nice serve!\Here he comes! 10!\Hey, listen up a sec.\Johzenji hasn't been able to stop Hinata's quick yet,\so they'd better get this point.\Nice receive.\Their 10 jumped up! That quick is coming! response:	Er, huh?
context: Tsukishima, nice serve!\Here he comes! 10!\Hey, listen up a sec.\Johzenji hasn't been able to stop Hinata's quick yet,\so they'd better get this point.\Nice receive.\Their 10 jumped up! That quick is coming!\Er, huh? response:	Johzenji's blockers aren't marking 10?
context: Here he comes! 10!\Hey, listen up a sec.\Johzenji hasn't been able to stop Hinata's quick yet,\so they'd better get this point.\Nice receive.\Their 10 jumped up! That quick is coming!\Er, huh?\Johzenji's blockers aren't marking 10? response:	If we can't block it, it's better to go for the receive.
context: Hey, listen up a sec.\Johzenji hasn't been able to stop Hinata's quick yet,\so they'd better get this point.\Nice receive.\Their 10 jumped up! That quick is coming!\Er, huh?\Johzenji's blockers aren't marking 10?\If we can't block it, it's better to go for the receive. response:	Whoa! They did it!
context: Johzenji hasn't been able to stop Hinata's quick yet,\so they'd better get this point.\Nice receive.\Their 10 jumped up! That quick is coming!\Er, huh?\Johzenji's blockers aren't marking 10?\If we can't block it, it's better to go for the receive.\Whoa! They did it! response:	They managed to counter by not marking 10!
context: so they'd better get this point.\Nice receive.\Their 10 jumped up! That quick is coming!\Er, huh?\Johzenji's blockers aren't marking 10?\If we can't block it, it's better to go for the receive.\Whoa! They did it!\They managed to counter by not marking 10! response:	It went over!
context: Nice receive.\Their 10 jumped up! That quick is coming!\Er, huh?\Johzenji's blockers aren't marking 10?\If we can't block it, it's better to go for the receive.\Whoa! They did it!\They managed to counter by not marking 10!\It went over! response:	Playing doesn't equal not thinking.
context: Their 10 jumped up! That quick is coming!\Er, huh?\Johzenji's blockers aren't marking 10?\If we can't block it, it's better to go for the receive.\Whoa! They did it!\They managed to counter by not marking 10!\It went over!\Playing doesn't equal not thinking. response:	Having the simulation in your head and reality join together...
context: Er, huh?\Johzenji's blockers aren't marking 10?\If we can't block it, it's better to go for the receive.\Whoa! They did it!\They managed to counter by not marking 10!\It went over!\Playing doesn't equal not thinking.\Having the simulation in your head and reality join together... response:	Karasuno Johzenji
context: Johzenji's blockers aren't marking 10?\If we can't block it, it's better to go for the receive.\Whoa! They did it!\They managed to counter by not marking 10!\It went over!\Playing doesn't equal not thinking.\Having the simulation in your head and reality join together...\Karasuno Johzenji response:	A two-point difference, huh...
context: If we can't block it, it's better to go for the receive.\Whoa! They did it!\They managed to counter by not marking 10!\It went over!\Playing doesn't equal not thinking.\Having the simulation in your head and reality join together...\Karasuno Johzenji\A two-point difference, huh... response:	This happened to them with Aoba Johsai, too.
context: Whoa! They did it!\They managed to counter by not marking 10!\It went over!\Playing doesn't equal not thinking.\Having the simulation in your head and reality join together...\Karasuno Johzenji\A two-point difference, huh...\This happened to them with Aoba Johsai, too. response:	Eh?
context: They managed to counter by not marking 10!\It went over!\Playing doesn't equal not thinking.\Having the simulation in your head and reality join together...\Karasuno Johzenji\A two-point difference, huh...\This happened to them with Aoba Johsai, too.\Eh? response:	Hinata's spike is still pretty light.
context: It went over!\Playing doesn't equal not thinking.\Having the simulation in your head and reality join together...\Karasuno Johzenji\A two-point difference, huh...\This happened to them with Aoba Johsai, too.\Eh?\Hinata's spike is still pretty light. response:	I don't want to get blocked,
context: Playing doesn't equal not thinking.\Having the simulation in your head and reality join together...\Karasuno Johzenji\A two-point difference, huh...\This happened to them with Aoba Johsai, too.\Eh?\Hinata's spike is still pretty light.\I don't want to get blocked, response:	but being ignored by the blockers is even more frustrating. Why?!
context: Having the simulation in your head and reality join together...\Karasuno Johzenji\A two-point difference, huh...\This happened to them with Aoba Johsai, too.\Eh?\Hinata's spike is still pretty light.\I don't want to get blocked,\but being ignored by the blockers is even more frustrating. Why?! response:	Kageyama!
context: Karasuno Johzenji\A two-point difference, huh...\This happened to them with Aoba Johsai, too.\Eh?\Hinata's spike is still pretty light.\I don't want to get blocked,\but being ignored by the blockers is even more frustrating. Why?!\Kageyama! response:	Could you give me another one next time?
context: A two-point difference, huh...\This happened to them with Aoba Johsai, too.\Eh?\Hinata's spike is still pretty light.\I don't want to get blocked,\but being ignored by the blockers is even more frustrating. Why?!\Kageyama!\Could you give me another one next time? response:	One more, nice serve!
context: This happened to them with Aoba Johsai, too.\Eh?\Hinata's spike is still pretty light.\I don't want to get blocked,\but being ignored by the blockers is even more frustrating. Why?!\Kageyama!\Could you give me another one next time?\One more, nice serve! response:	Got it!
context: Eh?\Hinata's spike is still pretty light.\I don't want to get blocked,\but being ignored by the blockers is even more frustrating. Why?!\Kageyama!\Could you give me another one next time?\One more, nice serve!\Got it! response:	I can see it.
context: Hinata's spike is still pretty light.\I don't want to get blocked,\but being ignored by the blockers is even more frustrating. Why?!\Kageyama!\Could you give me another one next time?\One more, nice serve!\Got it!\I can see it. response:	Seriously?
context: I don't want to get blocked,\but being ignored by the blockers is even more frustrating. Why?!\Kageyama!\Could you give me another one next time?\One more, nice serve!\Got it!\I can see it.\Seriously? response:	Nice kill!
context: but being ignored by the blockers is even more frustrating. Why?!\Kageyama!\Could you give me another one next time?\One more, nice serve!\Got it!\I can see it.\Seriously?\Nice kill! response:	I guess this means things have changed since the Seijoh match.
context: Kageyama!\Could you give me another one next time?\One more, nice serve!\Got it!\I can see it.\Seriously?\Nice kill!\I guess this means things have changed since the Seijoh match. response:	Karasuno Johzenji
context: Could you give me another one next time?\One more, nice serve!\Got it!\I can see it.\Seriously?\Nice kill!\I guess this means things have changed since the Seijoh match.\Karasuno Johzenji response:	Hinata! Give'em one more!
context: One more, nice serve!\Got it!\I can see it.\Seriously?\Nice kill!\I guess this means things have changed since the Seijoh match.\Karasuno Johzenji\Hinata! Give'em one more! response:	A receive from that close up?
context: Got it!\I can see it.\Seriously?\Nice kill!\I guess this means things have changed since the Seijoh match.\Karasuno Johzenji\Hinata! Give'em one more!\A receive from that close up? response:	If we can touch it...
context: I can see it.\Seriously?\Nice kill!\I guess this means things have changed since the Seijoh match.\Karasuno Johzenji\Hinata! Give'em one more!\A receive from that close up?\If we can touch it... response:	All right!
context: Seriously?\Nice kill!\I guess this means things have changed since the Seijoh match.\Karasuno Johzenji\Hinata! Give'em one more!\A receive from that close up?\If we can touch it...\All right! response:	So their play is to touch the ball
context: Nice kill!\I guess this means things have changed since the Seijoh match.\Karasuno Johzenji\Hinata! Give'em one more!\A receive from that close up?\If we can touch it...\All right!\So their play is to touch the ball response:	before we can hit it into a space they can't reach.
context: I guess this means things have changed since the Seijoh match.\Karasuno Johzenji\Hinata! Give'em one more!\A receive from that close up?\If we can touch it...\All right!\So their play is to touch the ball\before we can hit it into a space they can't reach. response:	I'll win the next one!
context: Karasuno Johzenji\Hinata! Give'em one more!\A receive from that close up?\If we can touch it...\All right!\So their play is to touch the ball\before we can hit it into a space they can't reach.\I'll win the next one! response:	Hinata, isn't there a move you haven't done yet today?
context: Hinata! Give'em one more!\A receive from that close up?\If we can touch it...\All right!\So their play is to touch the ball\before we can hit it into a space they can't reach.\I'll win the next one!\Hinata, isn't there a move you haven't done yet today? response:	Your new special move.
context: A receive from that close up?\If we can touch it...\All right!\So their play is to touch the ball\before we can hit it into a space they can't reach.\I'll win the next one!\Hinata, isn't there a move you haven't done yet today?\Your new special move. response:	Karasuno Johzenji
context: If we can touch it...\All right!\So their play is to touch the ball\before we can hit it into a space they can't reach.\I'll win the next one!\Hinata, isn't there a move you haven't done yet today?\Your new special move.\Karasuno Johzenji response:	Nice receive!
context: All right!\So their play is to touch the ball\before we can hit it into a space they can't reach.\I'll win the next one!\Hinata, isn't there a move you haven't done yet today?\Your new special move.\Karasuno Johzenji\Nice receive! response:	Go, Hinata!
context: So their play is to touch the ball\before we can hit it into a space they can't reach.\I'll win the next one!\Hinata, isn't there a move you haven't done yet today?\Your new special move.\Karasuno Johzenji\Nice receive!\Go, Hinata! response:	Bring it!
context: before we can hit it into a space they can't reach.\I'll win the next one!\Hinata, isn't there a move you haven't done yet today?\Your new special move.\Karasuno Johzenji\Nice receive!\Go, Hinata!\Bring it! response:	All right!
context: I'll win the next one!\Hinata, isn't there a move you haven't done yet today?\Your new special move.\Karasuno Johzenji\Nice receive!\Go, Hinata!\Bring it!\All right! response:	Karasuno Johzenji
context: Hinata, isn't there a move you haven't done yet today?\Your new special move.\Karasuno Johzenji\Nice receive!\Go, Hinata!\Bring it!\All right!\Karasuno Johzenji response:	Match point!
context: Your new special move.\Karasuno Johzenji\Nice receive!\Go, Hinata!\Bring it!\All right!\Karasuno Johzenji\Match point! response:	All right, you guys...
context: Karasuno Johzenji\Nice receive!\Go, Hinata!\Bring it!\All right!\Karasuno Johzenji\Match point!\All right, you guys... response:	Let's play for real.
context: Nice receive!\Go, Hinata!\Bring it!\All right!\Karasuno Johzenji\Match point!\All right, you guys...\Let's play for real. response:	Simplicity and Fortitude Johzenji Parents' Association
context: Go, Hinata!\Bring it!\All right!\Karasuno Johzenji\Match point!\All right, you guys...\Let's play for real.\Simplicity and Fortitude Johzenji Parents' Association response:	Got it!
context: Bring it!\All right!\Karasuno Johzenji\Match point!\All right, you guys...\Let's play for real.\Simplicity and Fortitude Johzenji Parents' Association\Got it! response:	Another synchronized attack?!
context: All right!\Karasuno Johzenji\Match point!\All right, you guys...\Let's play for real.\Simplicity and Fortitude Johzenji Parents' Association\Got it!\Another synchronized attack?! response:	Those guys aren't thinking about when they mess up,
context: Karasuno Johzenji\Match point!\All right, you guys...\Let's play for real.\Simplicity and Fortitude Johzenji Parents' Association\Got it!\Another synchronized attack?!\Those guys aren't thinking about when they mess up, response:	even for a second.
context: Match point!\All right, you guys...\Let's play for real.\Simplicity and Fortitude Johzenji Parents' Association\Got it!\Another synchronized attack?!\Those guys aren't thinking about when they mess up,\even for a second. response:	Just the pleasure they feel when they succeed.
context: All right, you guys...\Let's play for real.\Simplicity and Fortitude Johzenji Parents' Association\Got it!\Another synchronized attack?!\Those guys aren't thinking about when they mess up,\even for a second.\Just the pleasure they feel when they succeed. response:	Be careful! That one isn't like before!
context: Let's play for real.\Simplicity and Fortitude Johzenji Parents' Association\Got it!\Another synchronized attack?!\Those guys aren't thinking about when they mess up,\even for a second.\Just the pleasure they feel when they succeed.\Be careful! That one isn't like before! response:	All right!
context: Simplicity and Fortitude Johzenji Parents' Association\Got it!\Another synchronized attack?!\Those guys aren't thinking about when they mess up,\even for a second.\Just the pleasure they feel when they succeed.\Be careful! That one isn't like before!\All right! response:	We did it!
context: Got it!\Another synchronized attack?!\Those guys aren't thinking about when they mess up,\even for a second.\Just the pleasure they feel when they succeed.\Be careful! That one isn't like before!\All right!\We did it! response:	Now they've made it into the quarterfinals.
context: Another synchronized attack?!\Those guys aren't thinking about when they mess up,\even for a second.\Just the pleasure they feel when they succeed.\Be careful! That one isn't like before!\All right!\We did it!\Now they've made it into the quarterfinals. response:	I expected that ending...
context: Those guys aren't thinking about when they mess up,\even for a second.\Just the pleasure they feel when they succeed.\Be careful! That one isn't like before!\All right!\We did it!\Now they've made it into the quarterfinals.\I expected that ending... response:	Karasuno Johzenji
context: even for a second.\Just the pleasure they feel when they succeed.\Be careful! That one isn't like before!\All right!\We did it!\Now they've made it into the quarterfinals.\I expected that ending...\Karasuno Johzenji response:	Are we really done? Damn it...
context: Just the pleasure they feel when they succeed.\Be careful! That one isn't like before!\All right!\We did it!\Now they've made it into the quarterfinals.\I expected that ending...\Karasuno Johzenji\Are we really done? Damn it... response:	And I was just getting hyped up!
context: Be careful! That one isn't like before!\All right!\We did it!\Now they've made it into the quarterfinals.\I expected that ending...\Karasuno Johzenji\Are we really done? Damn it...\And I was just getting hyped up! response:	They still look like they want to play.
context: All right!\We did it!\Now they've made it into the quarterfinals.\I expected that ending...\Karasuno Johzenji\Are we really done? Damn it...\And I was just getting hyped up!\They still look like they want to play. response:	They're terrifying...
context: We did it!\Now they've made it into the quarterfinals.\I expected that ending...\Karasuno Johzenji\Are we really done? Damn it...\And I was just getting hyped up!\They still look like they want to play.\They're terrifying... response:	Thanks.
context: Now they've made it into the quarterfinals.\I expected that ending...\Karasuno Johzenji\Are we really done? Damn it...\And I was just getting hyped up!\They still look like they want to play.\They're terrifying...\Thanks. response:	Eh?
context: I expected that ending...\Karasuno Johzenji\Are we really done? Damn it...\And I was just getting hyped up!\They still look like they want to play.\They're terrifying...\Thanks.\Eh? response:	It appears that you really do understand those guys better than I do.
context: Karasuno Johzenji\Are we really done? Damn it...\And I was just getting hyped up!\They still look like they want to play.\They're terrifying...\Thanks.\Eh?\It appears that you really do understand those guys better than I do. response:	Because of that, they didn't completely break down.
context: Are we really done? Damn it...\And I was just getting hyped up!\They still look like they want to play.\They're terrifying...\Thanks.\Eh?\It appears that you really do understand those guys better than I do.\Because of that, they didn't completely break down. response:	I guess I should expect that from a third-year.
context: And I was just getting hyped up!\They still look like they want to play.\They're terrifying...\Thanks.\Eh?\It appears that you really do understand those guys better than I do.\Because of that, they didn't completely break down.\I guess I should expect that from a third-year. response:	No...
context: They still look like they want to play.\They're terrifying...\Thanks.\Eh?\It appears that you really do understand those guys better than I do.\Because of that, they didn't completely break down.\I guess I should expect that from a third-year.\No... response:	Thank you very much!
context: They're terrifying...\Thanks.\Eh?\It appears that you really do understand those guys better than I do.\Because of that, they didn't completely break down.\I guess I should expect that from a third-year.\No...\Thank you very much! response:	So I wasn't imagining it.
context: Thanks.\Eh?\It appears that you really do understand those guys better than I do.\Because of that, they didn't completely break down.\I guess I should expect that from a third-year.\No...\Thank you very much!\So I wasn't imagining it. response:	Their quick is evolving.
context: Eh?\It appears that you really do understand those guys better than I do.\Because of that, they didn't completely break down.\I guess I should expect that from a third-year.\No...\Thank you very much!\So I wasn't imagining it.\Their quick is evolving. response:	All right. I'm gonna go on ahead.
context: It appears that you really do understand those guys better than I do.\Because of that, they didn't completely break down.\I guess I should expect that from a third-year.\No...\Thank you very much!\So I wasn't imagining it.\Their quick is evolving.\All right. I'm gonna go on ahead. response:	Don't stay too long.
context: Because of that, they didn't completely break down.\I guess I should expect that from a third-year.\No...\Thank you very much!\So I wasn't imagining it.\Their quick is evolving.\All right. I'm gonna go on ahead.\Don't stay too long. response:	Johzenji High School
context: I guess I should expect that from a third-year.\No...\Thank you very much!\So I wasn't imagining it.\Their quick is evolving.\All right. I'm gonna go on ahead.\Don't stay too long.\Johzenji High School response:	Well, I guess, if anything...
context: No...\Thank you very much!\So I wasn't imagining it.\Their quick is evolving.\All right. I'm gonna go on ahead.\Don't stay too long.\Johzenji High School\Well, I guess, if anything... response:	I don't mind you guys getting hyped up,
context: Thank you very much!\So I wasn't imagining it.\Their quick is evolving.\All right. I'm gonna go on ahead.\Don't stay too long.\Johzenji High School\Well, I guess, if anything...\I don't mind you guys getting hyped up, response:	just don't lose control.
context: So I wasn't imagining it.\Their quick is evolving.\All right. I'm gonna go on ahead.\Don't stay too long.\Johzenji High School\Well, I guess, if anything...\I don't mind you guys getting hyped up,\just don't lose control. response:	There's no one to whip your butts into shape anymore.
context: Their quick is evolving.\All right. I'm gonna go on ahead.\Don't stay too long.\Johzenji High School\Well, I guess, if anything...\I don't mind you guys getting hyped up,\just don't lose control.\There's no one to whip your butts into shape anymore. response:	All right, dismissed.
context: All right. I'm gonna go on ahead.\Don't stay too long.\Johzenji High School\Well, I guess, if anything...\I don't mind you guys getting hyped up,\just don't lose control.\There's no one to whip your butts into shape anymore.\All right, dismissed. response:	Don't skip your stretches.
context: Don't stay too long.\Johzenji High School\Well, I guess, if anything...\I don't mind you guys getting hyped up,\just don't lose control.\There's no one to whip your butts into shape anymore.\All right, dismissed.\Don't skip your stretches. response:	Ah, um...
context: Johzenji High School\Well, I guess, if anything...\I don't mind you guys getting hyped up,\just don't lose control.\There's no one to whip your butts into shape anymore.\All right, dismissed.\Don't skip your stretches.\Ah, um... response:	Don't you guys give Runa-chan a hard time.
context: Well, I guess, if anything...\I don't mind you guys getting hyped up,\just don't lose control.\There's no one to whip your butts into shape anymore.\All right, dismissed.\Don't skip your stretches.\Ah, um...\Don't you guys give Runa-chan a hard time. response:	She's still a first-year, so I'll be watching you guys.
context: I don't mind you guys getting hyped up,\just don't lose control.\There's no one to whip your butts into shape anymore.\All right, dismissed.\Don't skip your stretches.\Ah, um...\Don't you guys give Runa-chan a hard time.\She's still a first-year, so I'll be watching you guys. response:	Also... About your style where you always go all-out with playing around...
context: just don't lose control.\There's no one to whip your butts into shape anymore.\All right, dismissed.\Don't skip your stretches.\Ah, um...\Don't you guys give Runa-chan a hard time.\She's still a first-year, so I'll be watching you guys.\Also... About your style where you always go all-out with playing around... response:	I actually like that a lot.
context: There's no one to whip your butts into shape anymore.\All right, dismissed.\Don't skip your stretches.\Ah, um...\Don't you guys give Runa-chan a hard time.\She's still a first-year, so I'll be watching you guys.\Also... About your style where you always go all-out with playing around...\I actually like that a lot. response:	Let's go. The next team is here.
context: All right, dismissed.\Don't skip your stretches.\Ah, um...\Don't you guys give Runa-chan a hard time.\She's still a first-year, so I'll be watching you guys.\Also... About your style where you always go all-out with playing around...\I actually like that a lot.\Let's go. The next team is here. response:	Th-Thank you very much!
context: Don't skip your stretches.\Ah, um...\Don't you guys give Runa-chan a hard time.\She's still a first-year, so I'll be watching you guys.\Also... About your style where you always go all-out with playing around...\I actually like that a lot.\Let's go. The next team is here.\Th-Thank you very much! response:	You did it!
context: Ah, um...\Don't you guys give Runa-chan a hard time.\She's still a first-year, so I'll be watching you guys.\Also... About your style where you always go all-out with playing around...\I actually like that a lot.\Let's go. The next team is here.\Th-Thank you very much!\You did it! response:	Ye-ah!
context: Don't you guys give Runa-chan a hard time.\She's still a first-year, so I'll be watching you guys.\Also... About your style where you always go all-out with playing around...\I actually like that a lot.\Let's go. The next team is here.\Th-Thank you very much!\You did it!\Ye-ah! response:	Ye-ah!
context: She's still a first-year, so I'll be watching you guys.\Also... About your style where you always go all-out with playing around...\I actually like that a lot.\Let's go. The next team is here.\Th-Thank you very much!\You did it!\Ye-ah!\Ye-ah! response:	E-Eekyay?!
context: Also... About your style where you always go all-out with playing around...\I actually like that a lot.\Let's go. The next team is here.\Th-Thank you very much!\You did it!\Ye-ah!\Ye-ah!\E-Eekyay?! response:	You both doing a jumping high-five at her is a bit much.
context: I actually like that a lot.\Let's go. The next team is here.\Th-Thank you very much!\You did it!\Ye-ah!\Ye-ah!\E-Eekyay?!\You both doing a jumping high-five at her is a bit much. response:	R-Right...
context: Let's go. The next team is here.\Th-Thank you very much!\You did it!\Ye-ah!\Ye-ah!\E-Eekyay?!\You both doing a jumping high-five at her is a bit much.\R-Right... response:	Yay! Yay! Yay!
context: Th-Thank you very much!\You did it!\Ye-ah!\Ye-ah!\E-Eekyay?!\You both doing a jumping high-five at her is a bit much.\R-Right...\Yay! Yay! Yay! response:	I'm going to stop you tomorrow.
context: You did it!\Ye-ah!\Ye-ah!\E-Eekyay?!\You both doing a jumping high-five at her is a bit much.\R-Right...\Yay! Yay! Yay!\I'm going to stop you tomorrow. response:	And I'm going to get through!
context: Ye-ah!\Ye-ah!\E-Eekyay?!\You both doing a jumping high-five at her is a bit much.\R-Right...\Yay! Yay! Yay!\I'm going to stop you tomorrow.\And I'm going to get through! response:	Shut up!
context: Ye-ah!\E-Eekyay?!\You both doing a jumping high-five at her is a bit much.\R-Right...\Yay! Yay! Yay!\I'm going to stop you tomorrow.\And I'm going to get through!\Shut up! response:	I wonder if he was waiting just to tell Hinata that...
context: E-Eekyay?!\You both doing a jumping high-five at her is a bit much.\R-Right...\Yay! Yay! Yay!\I'm going to stop you tomorrow.\And I'm going to get through!\Shut up!\I wonder if he was waiting just to tell Hinata that... response:	The game on court B's done?
context: You both doing a jumping high-five at her is a bit much.\R-Right...\Yay! Yay! Yay!\I'm going to stop you tomorrow.\And I'm going to get through!\Shut up!\I wonder if he was waiting just to tell Hinata that...\The game on court B's done? response:	That would mean whoever won that game is our next opponent.
context: R-Right...\Yay! Yay! Yay!\I'm going to stop you tomorrow.\And I'm going to get through!\Shut up!\I wonder if he was waiting just to tell Hinata that...\The game on court B's done?\That would mean whoever won that game is our next opponent. response:	Wakunan Sensho
context: Yay! Yay! Yay!\I'm going to stop you tomorrow.\And I'm going to get through!\Shut up!\I wonder if he was waiting just to tell Hinata that...\The game on court B's done?\That would mean whoever won that game is our next opponent.\Wakunan Sensho response:	You can do it, Takeru!
context: I'm going to stop you tomorrow.\And I'm going to get through!\Shut up!\I wonder if he was waiting just to tell Hinata that...\The game on court B's done?\That would mean whoever won that game is our next opponent.\Wakunan Sensho\You can do it, Takeru! response:	You can do it, Takeru! Nice kill, Takeru!
context: And I'm going to get through!\Shut up!\I wonder if he was waiting just to tell Hinata that...\The game on court B's done?\That would mean whoever won that game is our next opponent.\Wakunan Sensho\You can do it, Takeru!\You can do it, Takeru! Nice kill, Takeru! response:	Takeru
context: Shut up!\I wonder if he was waiting just to tell Hinata that...\The game on court B's done?\That would mean whoever won that game is our next opponent.\Wakunan Sensho\You can do it, Takeru!\You can do it, Takeru! Nice kill, Takeru!\Takeru response:	Yeah!
context: I wonder if he was waiting just to tell Hinata that...\The game on court B's done?\That would mean whoever won that game is our next opponent.\Wakunan Sensho\You can do it, Takeru!\You can do it, Takeru! Nice kill, Takeru!\Takeru\Yeah! response:	His family's here to cheer him on?!
context: The game on court B's done?\That would mean whoever won that game is our next opponent.\Wakunan Sensho\You can do it, Takeru!\You can do it, Takeru! Nice kill, Takeru!\Takeru\Yeah!\His family's here to cheer him on?! response:	That's the team Ukai-san said
context: That would mean whoever won that game is our next opponent.\Wakunan Sensho\You can do it, Takeru!\You can do it, Takeru! Nice kill, Takeru!\Takeru\Yeah!\His family's here to cheer him on?!\That's the team Ukai-san said response:	we need to look out for before the Inter-High prelims, too...
context: Wakunan Sensho\You can do it, Takeru!\You can do it, Takeru! Nice kill, Takeru!\Takeru\Yeah!\His family's here to cheer him on?!\That's the team Ukai-san said\we need to look out for before the Inter-High prelims, too... response:	In order to fight Date Tech again,
context: You can do it, Takeru!\You can do it, Takeru! Nice kill, Takeru!\Takeru\Yeah!\His family's here to cheer him on?!\That's the team Ukai-san said\we need to look out for before the Inter-High prelims, too...\In order to fight Date Tech again, response:	we need to beat them first!
context: You can do it, Takeru! Nice kill, Takeru!\Takeru\Yeah!\His family's here to cheer him on?!\That's the team Ukai-san said\we need to look out for before the Inter-High prelims, too...\In order to fight Date Tech again,\we need to beat them first! response:	Haikyu!!
context: Takeru\Yeah!\His family's here to cheer him on?!\That's the team Ukai-san said\we need to look out for before the Inter-High prelims, too...\In order to fight Date Tech again,\we need to beat them first!\Haikyu!! response:	Haikyu!!
context: Yeah!\His family's here to cheer him on?!\That's the team Ukai-san said\we need to look out for before the Inter-High prelims, too...\In order to fight Date Tech again,\we need to beat them first!\Haikyu!!\Haikyu!! response:	Congratulations on completing the first day.
context: His family's here to cheer him on?!\That's the team Ukai-san said\we need to look out for before the Inter-High prelims, too...\In order to fight Date Tech again,\we need to beat them first!\Haikyu!!\Haikyu!!\Congratulations on completing the first day. response:	Thank you!
context: That's the team Ukai-san said\we need to look out for before the Inter-High prelims, too...\In order to fight Date Tech again,\we need to beat them first!\Haikyu!!\Haikyu!!\Congratulations on completing the first day.\Thank you! response:	Unlike our other opponents, Wakutani South
context: we need to look out for before the Inter-High prelims, too...\In order to fight Date Tech again,\we need to beat them first!\Haikyu!!\Haikyu!!\Congratulations on completing the first day.\Thank you!\Unlike our other opponents, Wakutani South response:	has third-years left on the team, just like us.
context: In order to fight Date Tech again,\we need to beat them first!\Haikyu!!\Haikyu!!\Congratulations on completing the first day.\Thank you!\Unlike our other opponents, Wakutani South\has third-years left on the team, just like us. response:	They are a well-rounded team.
context: we need to beat them first!\Haikyu!!\Haikyu!!\Congratulations on completing the first day.\Thank you!\Unlike our other opponents, Wakutani South\has third-years left on the team, just like us.\They are a well-rounded team. response:	Their defense and tenacity are close to Nekoma's.
context: Haikyu!!\Haikyu!!\Congratulations on completing the first day.\Thank you!\Unlike our other opponents, Wakutani South\has third-years left on the team, just like us.\They are a well-rounded team.\Their defense and tenacity are close to Nekoma's. response:	Don't lose your temper just because you can't get your attack in.
context: Haikyu!!\Congratulations on completing the first day.\Thank you!\Unlike our other opponents, Wakutani South\has third-years left on the team, just like us.\They are a well-rounded team.\Their defense and tenacity are close to Nekoma's.\Don't lose your temper just because you can't get your attack in. response:	Especially the hyperactive ones and simpletons.
context: Congratulations on completing the first day.\Thank you!\Unlike our other opponents, Wakutani South\has third-years left on the team, just like us.\They are a well-rounded team.\Their defense and tenacity are close to Nekoma's.\Don't lose your temper just because you can't get your attack in.\Especially the hyperactive ones and simpletons. response:	It'll be fine. We'll follow up on them.
context: Thank you!\Unlike our other opponents, Wakutani South\has third-years left on the team, just like us.\They are a well-rounded team.\Their defense and tenacity are close to Nekoma's.\Don't lose your temper just because you can't get your attack in.\Especially the hyperactive ones and simpletons.\It'll be fine. We'll follow up on them. response:	Th-Thank you very much.
context: Unlike our other opponents, Wakutani South\has third-years left on the team, just like us.\They are a well-rounded team.\Their defense and tenacity are close to Nekoma's.\Don't lose your temper just because you can't get your attack in.\Especially the hyperactive ones and simpletons.\It'll be fine. We'll follow up on them.\Th-Thank you very much. response:	Damn it. They're more under control than I made it sound.
context: has third-years left on the team, just like us.\They are a well-rounded team.\Their defense and tenacity are close to Nekoma's.\Don't lose your temper just because you can't get your attack in.\Especially the hyperactive ones and simpletons.\It'll be fine. We'll follow up on them.\Th-Thank you very much.\Damn it. They're more under control than I made it sound. response:	Yeah, leave it to me.
context: They are a well-rounded team.\Their defense and tenacity are close to Nekoma's.\Don't lose your temper just because you can't get your attack in.\Especially the hyperactive ones and simpletons.\It'll be fine. We'll follow up on them.\Th-Thank you very much.\Damn it. They're more under control than I made it sound.\Yeah, leave it to me. response:	All right. We're going to make it through tomorrow, too.
context: Their defense and tenacity are close to Nekoma's.\Don't lose your temper just because you can't get your attack in.\Especially the hyperactive ones and simpletons.\It'll be fine. We'll follow up on them.\Th-Thank you very much.\Damn it. They're more under control than I made it sound.\Yeah, leave it to me.\All right. We're going to make it through tomorrow, too. response:	Karasuno, fight!
context: Don't lose your temper just because you can't get your attack in.\Especially the hyperactive ones and simpletons.\It'll be fine. We'll follow up on them.\Th-Thank you very much.\Damn it. They're more under control than I made it sound.\Yeah, leave it to me.\All right. We're going to make it through tomorrow, too.\Karasuno, fight! response:	Yeah!
context: Especially the hyperactive ones and simpletons.\It'll be fine. We'll follow up on them.\Th-Thank you very much.\Damn it. They're more under control than I made it sound.\Yeah, leave it to me.\All right. We're going to make it through tomorrow, too.\Karasuno, fight!\Yeah! response:	Qualifying Tournament Grouping (Boys) Winner
context: It'll be fine. We'll follow up on them.\Th-Thank you very much.\Damn it. They're more under control than I made it sound.\Yeah, leave it to me.\All right. We're going to make it through tomorrow, too.\Karasuno, fight!\Yeah!\Qualifying Tournament Grouping (Boys) Winner response:	Go, go, Takeru!
context: Th-Thank you very much.\Damn it. They're more under control than I made it sound.\Yeah, leave it to me.\All right. We're going to make it through tomorrow, too.\Karasuno, fight!\Yeah!\Qualifying Tournament Grouping (Boys) Winner\Go, go, Takeru! response:	Go, go, Takeru! Go, go, Wakunan!
context: Damn it. They're more under control than I made it sound.\Yeah, leave it to me.\All right. We're going to make it through tomorrow, too.\Karasuno, fight!\Yeah!\Qualifying Tournament Grouping (Boys) Winner\Go, go, Takeru!\Go, go, Takeru! Go, go, Wakunan! response:	There are even more than yesterday.
context: Yeah, leave it to me.\All right. We're going to make it through tomorrow, too.\Karasuno, fight!\Yeah!\Qualifying Tournament Grouping (Boys) Winner\Go, go, Takeru!\Go, go, Takeru! Go, go, Wakunan!\There are even more than yesterday. response:	A younger brother?
context: All right. We're going to make it through tomorrow, too.\Karasuno, fight!\Yeah!\Qualifying Tournament Grouping (Boys) Winner\Go, go, Takeru!\Go, go, Takeru! Go, go, Wakunan!\There are even more than yesterday.\A younger brother? response:	Why do you look so jealous?
context: Karasuno, fight!\Yeah!\Qualifying Tournament Grouping (Boys) Winner\Go, go, Takeru!\Go, go, Takeru! Go, go, Wakunan!\There are even more than yesterday.\A younger brother?\Why do you look so jealous? response:	Come on, concentrate.
context: Yeah!\Qualifying Tournament Grouping (Boys) Winner\Go, go, Takeru!\Go, go, Takeru! Go, go, Wakunan!\There are even more than yesterday.\A younger brother?\Why do you look so jealous?\Come on, concentrate. response:	Go, go, Takeru!
context: Qualifying Tournament Grouping (Boys) Winner\Go, go, Takeru!\Go, go, Takeru! Go, go, Wakunan!\There are even more than yesterday.\A younger brother?\Why do you look so jealous?\Come on, concentrate.\Go, go, Takeru! response:	What's the matter, Ukai-kun?
context: Go, go, Takeru!\Go, go, Takeru! Go, go, Wakunan!\There are even more than yesterday.\A younger brother?\Why do you look so jealous?\Come on, concentrate.\Go, go, Takeru!\What's the matter, Ukai-kun? response:	We're going all out, Sensei.
context: Go, go, Takeru! Go, go, Wakunan!\There are even more than yesterday.\A younger brother?\Why do you look so jealous?\Come on, concentrate.\Go, go, Takeru!\What's the matter, Ukai-kun?\We're going all out, Sensei. response:	Huh?
context: There are even more than yesterday.\A younger brother?\Why do you look so jealous?\Come on, concentrate.\Go, go, Takeru!\What's the matter, Ukai-kun?\We're going all out, Sensei.\Huh? response:	It might just be my gut feeling,
context: A younger brother?\Why do you look so jealous?\Come on, concentrate.\Go, go, Takeru!\What's the matter, Ukai-kun?\We're going all out, Sensei.\Huh?\It might just be my gut feeling, response:	Go, go, Takeru! Go, go, Wakunan!
context: Why do you look so jealous?\Come on, concentrate.\Go, go, Takeru!\What's the matter, Ukai-kun?\We're going all out, Sensei.\Huh?\It might just be my gut feeling,\Go, go, Takeru! Go, go, Wakunan! response:	but this Wakunan team
context: Come on, concentrate.\Go, go, Takeru!\What's the matter, Ukai-kun?\We're going all out, Sensei.\Huh?\It might just be my gut feeling,\Go, go, Takeru! Go, go, Wakunan!\but this Wakunan team response:	may be hard for our team to handle.
context: Go, go, Takeru!\What's the matter, Ukai-kun?\We're going all out, Sensei.\Huh?\It might just be my gut feeling,\Go, go, Takeru! Go, go, Wakunan!\but this Wakunan team\may be hard for our team to handle. response:	Karasuno Wakunan
context: What's the matter, Ukai-kun?\We're going all out, Sensei.\Huh?\It might just be my gut feeling,\Go, go, Takeru! Go, go, Wakunan!\but this Wakunan team\may be hard for our team to handle.\Karasuno Wakunan response:	Captains.
context: We're going all out, Sensei.\Huh?\It might just be my gut feeling,\Go, go, Takeru! Go, go, Wakunan!\but this Wakunan team\may be hard for our team to handle.\Karasuno Wakunan\Captains. response:	Let's play.
context: Huh?\It might just be my gut feeling,\Go, go, Takeru! Go, go, Wakunan!\but this Wakunan team\may be hard for our team to handle.\Karasuno Wakunan\Captains.\Let's play. response:	There'll be no lowering our guard.
context: It might just be my gut feeling,\Go, go, Takeru! Go, go, Wakunan!\but this Wakunan team\may be hard for our team to handle.\Karasuno Wakunan\Captains.\Let's play.\There'll be no lowering our guard. response:	We're honored.
context: Go, go, Takeru! Go, go, Wakunan!\but this Wakunan team\may be hard for our team to handle.\Karasuno Wakunan\Captains.\Let's play.\There'll be no lowering our guard.\We're honored. response:	Heyo.
context: but this Wakunan team\may be hard for our team to handle.\Karasuno Wakunan\Captains.\Let's play.\There'll be no lowering our guard.\We're honored.\Heyo. response:	Ah, Shimada-san, hello.
context: may be hard for our team to handle.\Karasuno Wakunan\Captains.\Let's play.\There'll be no lowering our guard.\We're honored.\Heyo.\Ah, Shimada-san, hello. response:	Are you by yourself?
context: Karasuno Wakunan\Captains.\Let's play.\There'll be no lowering our guard.\We're honored.\Heyo.\Ah, Shimada-san, hello.\Are you by yourself? response:	Takinoue has work today.
context: Captains.\Let's play.\There'll be no lowering our guard.\We're honored.\Heyo.\Ah, Shimada-san, hello.\Are you by yourself?\Takinoue has work today. response:	He said he could probably come by in the afternoon.
context: Let's play.\There'll be no lowering our guard.\We're honored.\Heyo.\Ah, Shimada-san, hello.\Are you by yourself?\Takinoue has work today.\He said he could probably come by in the afternoon. response:	Man, I'm getting hyped!
context: There'll be no lowering our guard.\We're honored.\Heyo.\Ah, Shimada-san, hello.\Are you by yourself?\Takinoue has work today.\He said he could probably come by in the afternoon.\Man, I'm getting hyped! response:	This really gets you fired up, huh?
context: We're honored.\Heyo.\Ah, Shimada-san, hello.\Are you by yourself?\Takinoue has work today.\He said he could probably come by in the afternoon.\Man, I'm getting hyped!\This really gets you fired up, huh? response:	Hello.
context: Heyo.\Ah, Shimada-san, hello.\Are you by yourself?\Takinoue has work today.\He said he could probably come by in the afternoon.\Man, I'm getting hyped!\This really gets you fired up, huh?\Hello. response:	She reminds me of someone...
context: Ah, Shimada-san, hello.\Are you by yourself?\Takinoue has work today.\He said he could probably come by in the afternoon.\Man, I'm getting hyped!\This really gets you fired up, huh?\Hello.\She reminds me of someone... response:	Hey! Thanks for always taking care of Ryunosuke.
context: Are you by yourself?\Takinoue has work today.\He said he could probably come by in the afternoon.\Man, I'm getting hyped!\This really gets you fired up, huh?\Hello.\She reminds me of someone...\Hey! Thanks for always taking care of Ryunosuke. response:	I'm his older sister, Saeko.
context: Takinoue has work today.\He said he could probably come by in the afternoon.\Man, I'm getting hyped!\This really gets you fired up, huh?\Hello.\She reminds me of someone...\Hey! Thanks for always taking care of Ryunosuke.\I'm his older sister, Saeko. response:	Tanaka's sister!
context: He said he could probably come by in the afternoon.\Man, I'm getting hyped!\This really gets you fired up, huh?\Hello.\She reminds me of someone...\Hey! Thanks for always taking care of Ryunosuke.\I'm his older sister, Saeko.\Tanaka's sister! response:	They look alike.
context: Man, I'm getting hyped!\This really gets you fired up, huh?\Hello.\She reminds me of someone...\Hey! Thanks for always taking care of Ryunosuke.\I'm his older sister, Saeko.\Tanaka's sister!\They look alike. response:	Ryu! Ryu-chan!
context: This really gets you fired up, huh?\Hello.\She reminds me of someone...\Hey! Thanks for always taking care of Ryunosuke.\I'm his older sister, Saeko.\Tanaka's sister!\They look alike.\Ryu! Ryu-chan! response:	Ne-san!
context: Hello.\She reminds me of someone...\Hey! Thanks for always taking care of Ryunosuke.\I'm his older sister, Saeko.\Tanaka's sister!\They look alike.\Ryu! Ryu-chan!\Ne-san! response:	Geh.
context: She reminds me of someone...\Hey! Thanks for always taking care of Ryunosuke.\I'm his older sister, Saeko.\Tanaka's sister!\They look alike.\Ryu! Ryu-chan!\Ne-san!\Geh. response:	I came to cheer you on!
context: Hey! Thanks for always taking care of Ryunosuke.\I'm his older sister, Saeko.\Tanaka's sister!\They look alike.\Ryu! Ryu-chan!\Ne-san!\Geh.\I came to cheer you on! response:	Let's play!
context: I'm his older sister, Saeko.\Tanaka's sister!\They look alike.\Ryu! Ryu-chan!\Ne-san!\Geh.\I came to cheer you on!\Let's play! response:	Get'em!
context: Tanaka's sister!\They look alike.\Ryu! Ryu-chan!\Ne-san!\Geh.\I came to cheer you on!\Let's play!\Get'em! response:	The second day begins...
context: They look alike.\Ryu! Ryu-chan!\Ne-san!\Geh.\I came to cheer you on!\Let's play!\Get'em!\The second day begins... response:	They'd better survive.
context: Ryu! Ryu-chan!\Ne-san!\Geh.\I came to cheer you on!\Let's play!\Get'em!\The second day begins...\They'd better survive. response:	Bring it!
context: Ne-san!\Geh.\I came to cheer you on!\Let's play!\Get'em!\The second day begins...\They'd better survive.\Bring it! response:	Nice serve!
context: Geh.\I came to cheer you on!\Let's play!\Get'em!\The second day begins...\They'd better survive.\Bring it!\Nice serve! response:	Got it!
context: I came to cheer you on!\Let's play!\Get'em!\The second day begins...\They'd better survive.\Bring it!\Nice serve!\Got it! response:	Good! First, break through with a quick!
context: Let's play!\Get'em!\The second day begins...\They'd better survive.\Bring it!\Nice serve!\Got it!\Good! First, break through with a quick! response:	All right!
context: Get'em!\The second day begins...\They'd better survive.\Bring it!\Nice serve!\Got it!\Good! First, break through with a quick!\All right! response:	All right!
context: The second day begins...\They'd better survive.\Bring it!\Nice serve!\Got it!\Good! First, break through with a quick!\All right!\All right! response:	Hinata, nice kill!
context: They'd better survive.\Bring it!\Nice serve!\Got it!\Good! First, break through with a quick!\All right!\All right!\Hinata, nice kill! response:	Wh-What the heck was that?!
context: Bring it!\Nice serve!\Got it!\Good! First, break through with a quick!\All right!\All right!\Hinata, nice kill!\Wh-What the heck was that?! response:	A quick? Was that just luck?
context: Nice serve!\Got it!\Good! First, break through with a quick!\All right!\All right!\Hinata, nice kill!\Wh-What the heck was that?!\A quick? Was that just luck? response:	All right, we're shutting them down quickly next.
context: Got it!\Good! First, break through with a quick!\All right!\All right!\Hinata, nice kill!\Wh-What the heck was that?!\A quick? Was that just luck?\All right, we're shutting them down quickly next. response:	Yes!
context: Good! First, break through with a quick!\All right!\All right!\Hinata, nice kill!\Wh-What the heck was that?!\A quick? Was that just luck?\All right, we're shutting them down quickly next.\Yes! response:	Yeah!
context: All right!\All right!\Hinata, nice kill!\Wh-What the heck was that?!\A quick? Was that just luck?\All right, we're shutting them down quickly next.\Yes!\Yeah! response:	What? Wakunan doesn't seem very surprised by that quick.
context: All right!\Hinata, nice kill!\Wh-What the heck was that?!\A quick? Was that just luck?\All right, we're shutting them down quickly next.\Yes!\Yeah!\What? Wakunan doesn't seem very surprised by that quick. response:	There's no one in Karasuno
context: Hinata, nice kill!\Wh-What the heck was that?!\A quick? Was that just luck?\All right, we're shutting them down quickly next.\Yes!\Yeah!\What? Wakunan doesn't seem very surprised by that quick.\There's no one in Karasuno response:	that you can call a flightless bird anymore.
context: Wh-What the heck was that?!\A quick? Was that just luck?\All right, we're shutting them down quickly next.\Yes!\Yeah!\What? Wakunan doesn't seem very surprised by that quick.\There's no one in Karasuno\that you can call a flightless bird anymore. response:	They're the most outrageous team in the prefecture.
context: A quick? Was that just luck?\All right, we're shutting them down quickly next.\Yes!\Yeah!\What? Wakunan doesn't seem very surprised by that quick.\There's no one in Karasuno\that you can call a flightless bird anymore.\They're the most outrageous team in the prefecture. response:	We're super lucky to be able to play them.
context: All right, we're shutting them down quickly next.\Yes!\Yeah!\What? Wakunan doesn't seem very surprised by that quick.\There's no one in Karasuno\that you can call a flightless bird anymore.\They're the most outrageous team in the prefecture.\We're super lucky to be able to play them. response:	Looks like they've figured out how to deal with Hinata...
context: Yes!\Yeah!\What? Wakunan doesn't seem very surprised by that quick.\There's no one in Karasuno\that you can call a flightless bird anymore.\They're the most outrageous team in the prefecture.\We're super lucky to be able to play them.\Looks like they've figured out how to deal with Hinata... response:	They don't seem panicked at all.
context: Yeah!\What? Wakunan doesn't seem very surprised by that quick.\There's no one in Karasuno\that you can call a flightless bird anymore.\They're the most outrageous team in the prefecture.\We're super lucky to be able to play them.\Looks like they've figured out how to deal with Hinata...\They don't seem panicked at all. response:	I'm not sure if they're a bad match
context: What? Wakunan doesn't seem very surprised by that quick.\There's no one in Karasuno\that you can call a flightless bird anymore.\They're the most outrageous team in the prefecture.\We're super lucky to be able to play them.\Looks like they've figured out how to deal with Hinata...\They don't seem panicked at all.\I'm not sure if they're a bad match response:	or if they're just a team we won't do well against.
context: There's no one in Karasuno\that you can call a flightless bird anymore.\They're the most outrageous team in the prefecture.\We're super lucky to be able to play them.\Looks like they've figured out how to deal with Hinata...\They don't seem panicked at all.\I'm not sure if they're a bad match\or if they're just a team we won't do well against. response:	Yeah.
context: that you can call a flightless bird anymore.\They're the most outrageous team in the prefecture.\We're super lucky to be able to play them.\Looks like they've figured out how to deal with Hinata...\They don't seem panicked at all.\I'm not sure if they're a bad match\or if they're just a team we won't do well against.\Yeah. response:	Unlike the trend up until now,
context: They're the most outrageous team in the prefecture.\We're super lucky to be able to play them.\Looks like they've figured out how to deal with Hinata...\They don't seem panicked at all.\I'm not sure if they're a bad match\or if they're just a team we won't do well against.\Yeah.\Unlike the trend up until now, response:	where Karasuno fights a team that just keeps throwing attacks at them,
context: We're super lucky to be able to play them.\Looks like they've figured out how to deal with Hinata...\They don't seem panicked at all.\I'm not sure if they're a bad match\or if they're just a team we won't do well against.\Yeah.\Unlike the trend up until now,\where Karasuno fights a team that just keeps throwing attacks at them, response:	we have a problem handling teams
context: Looks like they've figured out how to deal with Hinata...\They don't seem panicked at all.\I'm not sure if they're a bad match\or if they're just a team we won't do well against.\Yeah.\Unlike the trend up until now,\where Karasuno fights a team that just keeps throwing attacks at them,\we have a problem handling teams response:	Their 9's serve is powerful!
context: They don't seem panicked at all.\I'm not sure if they're a bad match\or if they're just a team we won't do well against.\Yeah.\Unlike the trend up until now,\where Karasuno fights a team that just keeps throwing attacks at them,\we have a problem handling teams\Their 9's serve is powerful! response:	Don't let your guard down!
context: I'm not sure if they're a bad match\or if they're just a team we won't do well against.\Yeah.\Unlike the trend up until now,\where Karasuno fights a team that just keeps throwing attacks at them,\we have a problem handling teams\Their 9's serve is powerful!\Don't let your guard down! response:	that keep their own pace and deal with us intelligently.
context: or if they're just a team we won't do well against.\Yeah.\Unlike the trend up until now,\where Karasuno fights a team that just keeps throwing attacks at them,\we have a problem handling teams\Their 9's serve is powerful!\Don't let your guard down!\that keep their own pace and deal with us intelligently. response:	Right!
context: Yeah.\Unlike the trend up until now,\where Karasuno fights a team that just keeps throwing attacks at them,\we have a problem handling teams\Their 9's serve is powerful!\Don't let your guard down!\that keep their own pace and deal with us intelligently.\Right! response:	Seijoh and Nekoma are exactly that.
context: Unlike the trend up until now,\where Karasuno fights a team that just keeps throwing attacks at them,\we have a problem handling teams\Their 9's serve is powerful!\Don't let your guard down!\that keep their own pace and deal with us intelligently.\Right!\Seijoh and Nekoma are exactly that. response:	I see.
context: where Karasuno fights a team that just keeps throwing attacks at them,\we have a problem handling teams\Their 9's serve is powerful!\Don't let your guard down!\that keep their own pace and deal with us intelligently.\Right!\Seijoh and Nekoma are exactly that.\I see. response:	Opponents who aren't surprised by that quick...
context: we have a problem handling teams\Their 9's serve is powerful!\Don't let your guard down!\that keep their own pace and deal with us intelligently.\Right!\Seijoh and Nekoma are exactly that.\I see.\Opponents who aren't surprised by that quick... response:	Now, what are they gonna do?
context: Their 9's serve is powerful!\Don't let your guard down!\that keep their own pace and deal with us intelligently.\Right!\Seijoh and Nekoma are exactly that.\I see.\Opponents who aren't surprised by that quick...\Now, what are they gonna do? response:	Hinata, looks like
context: Don't let your guard down!\that keep their own pace and deal with us intelligently.\Right!\Seijoh and Nekoma are exactly that.\I see.\Opponents who aren't surprised by that quick...\Now, what are they gonna do?\Hinata, looks like response:	a powerhouse school is on their guard with you.
context: that keep their own pace and deal with us intelligently.\Right!\Seijoh and Nekoma are exactly that.\I see.\Opponents who aren't surprised by that quick...\Now, what are they gonna do?\Hinata, looks like\a powerhouse school is on their guard with you. response:	They've probably been researching you...
context: Right!\Seijoh and Nekoma are exactly that.\I see.\Opponents who aren't surprised by that quick...\Now, what are they gonna do?\Hinata, looks like\a powerhouse school is on their guard with you.\They've probably been researching you... response:	Researching you... Researching you...
context: Seijoh and Nekoma are exactly that.\I see.\Opponents who aren't surprised by that quick...\Now, what are they gonna do?\Hinata, looks like\a powerhouse school is on their guard with you.\They've probably been researching you...\Researching you... Researching you... response:	Researching you... Researching you...
context: I see.\Opponents who aren't surprised by that quick...\Now, what are they gonna do?\Hinata, looks like\a powerhouse school is on their guard with you.\They've probably been researching you...\Researching you... Researching you...\Researching you... Researching you... response:	A powerhouse school... researching me?
context: Opponents who aren't surprised by that quick...\Now, what are they gonna do?\Hinata, looks like\a powerhouse school is on their guard with you.\They've probably been researching you...\Researching you... Researching you...\Researching you... Researching you...\A powerhouse school... researching me? response:	Man, you're totally overshadowing us.
context: Now, what are they gonna do?\Hinata, looks like\a powerhouse school is on their guard with you.\They've probably been researching you...\Researching you... Researching you...\Researching you... Researching you...\A powerhouse school... researching me?\Man, you're totally overshadowing us. response:	But I am able to triumph over myself from yesterday.
context: Hinata, looks like\a powerhouse school is on their guard with you.\They've probably been researching you...\Researching you... Researching you...\Researching you... Researching you...\A powerhouse school... researching me?\Man, you're totally overshadowing us.\But I am able to triumph over myself from yesterday. response:	Hey, if you guys are just watching Hinata, I'm gonna peck yer eyes out.
context: a powerhouse school is on their guard with you.\They've probably been researching you...\Researching you... Researching you...\Researching you... Researching you...\A powerhouse school... researching me?\Man, you're totally overshadowing us.\But I am able to triumph over myself from yesterday.\Hey, if you guys are just watching Hinata, I'm gonna peck yer eyes out. response:	Well done, Captain.
context: They've probably been researching you...\Researching you... Researching you...\Researching you... Researching you...\A powerhouse school... researching me?\Man, you're totally overshadowing us.\But I am able to triumph over myself from yesterday.\Hey, if you guys are just watching Hinata, I'm gonna peck yer eyes out.\Well done, Captain. response:	He knows exactly how to get them going.
context: Researching you... Researching you...\Researching you... Researching you...\A powerhouse school... researching me?\Man, you're totally overshadowing us.\But I am able to triumph over myself from yesterday.\Hey, if you guys are just watching Hinata, I'm gonna peck yer eyes out.\Well done, Captain.\He knows exactly how to get them going. response:	Karasuno Wakunan
context: Researching you... Researching you...\A powerhouse school... researching me?\Man, you're totally overshadowing us.\But I am able to triumph over myself from yesterday.\Hey, if you guys are just watching Hinata, I'm gonna peck yer eyes out.\Well done, Captain.\He knows exactly how to get them going.\Karasuno Wakunan response:	Kageyama, nice serve!
context: A powerhouse school... researching me?\Man, you're totally overshadowing us.\But I am able to triumph over myself from yesterday.\Hey, if you guys are just watching Hinata, I'm gonna peck yer eyes out.\Well done, Captain.\He knows exactly how to get them going.\Karasuno Wakunan\Kageyama, nice serve! response:	That felt perfect against my hand.
context: Man, you're totally overshadowing us.\But I am able to triumph over myself from yesterday.\Hey, if you guys are just watching Hinata, I'm gonna peck yer eyes out.\Well done, Captain.\He knows exactly how to get them going.\Karasuno Wakunan\Kageyama, nice serve!\That felt perfect against my hand. response:	That's intense!
context: But I am able to triumph over myself from yesterday.\Hey, if you guys are just watching Hinata, I'm gonna peck yer eyes out.\Well done, Captain.\He knows exactly how to get them going.\Karasuno Wakunan\Kageyama, nice serve!\That felt perfect against my hand.\That's intense! response:	Nice receive!
context: Hey, if you guys are just watching Hinata, I'm gonna peck yer eyes out.\Well done, Captain.\He knows exactly how to get them going.\Karasuno Wakunan\Kageyama, nice serve!\That felt perfect against my hand.\That's intense!\Nice receive! response:	Pineapple Head is coming in from behind.
context: Well done, Captain.\He knows exactly how to get them going.\Karasuno Wakunan\Kageyama, nice serve!\That felt perfect against my hand.\That's intense!\Nice receive!\Pineapple Head is coming in from behind. response:	He's so fast!
context: He knows exactly how to get them going.\Karasuno Wakunan\Kageyama, nice serve!\That felt perfect against my hand.\That's intense!\Nice receive!\Pineapple Head is coming in from behind.\He's so fast! response:	You can do it, Wakunan!
context: Karasuno Wakunan\Kageyama, nice serve!\That felt perfect against my hand.\That's intense!\Nice receive!\Pineapple Head is coming in from behind.\He's so fast!\You can do it, Wakunan! response:	Whoa! From the furthest back?
context: Kageyama, nice serve!\That felt perfect against my hand.\That's intense!\Nice receive!\Pineapple Head is coming in from behind.\He's so fast!\You can do it, Wakunan!\Whoa! From the furthest back? response:	Tabi, nice kill!
context: That felt perfect against my hand.\That's intense!\Nice receive!\Pineapple Head is coming in from behind.\He's so fast!\You can do it, Wakunan!\Whoa! From the furthest back?\Tabi, nice kill! response:	You can do it, Wakunan!
context: That's intense!\Nice receive!\Pineapple Head is coming in from behind.\He's so fast!\You can do it, Wakunan!\Whoa! From the furthest back?\Tabi, nice kill!\You can do it, Wakunan! response:	A delayed attack, huh?
context: Nice receive!\Pineapple Head is coming in from behind.\He's so fast!\You can do it, Wakunan!\Whoa! From the furthest back?\Tabi, nice kill!\You can do it, Wakunan!\A delayed attack, huh? response:	So that's Wakunan's weapon, their combination...
context: Pineapple Head is coming in from behind.\He's so fast!\You can do it, Wakunan!\Whoa! From the furthest back?\Tabi, nice kill!\You can do it, Wakunan!\A delayed attack, huh?\So that's Wakunan's weapon, their combination... response:	Though their average height is not very high,
context: He's so fast!\You can do it, Wakunan!\Whoa! From the furthest back?\Tabi, nice kill!\You can do it, Wakunan!\A delayed attack, huh?\So that's Wakunan's weapon, their combination...\Though their average height is not very high, response:	you can definitely see why they're always a top team in the prefecture.
context: You can do it, Wakunan!\Whoa! From the furthest back?\Tabi, nice kill!\You can do it, Wakunan!\A delayed attack, huh?\So that's Wakunan's weapon, their combination...\Though their average height is not very high,\you can definitely see why they're always a top team in the prefecture. response:	Yeah, but that's not Wakunan's only weapon.
context: Whoa! From the furthest back?\Tabi, nice kill!\You can do it, Wakunan!\A delayed attack, huh?\So that's Wakunan's weapon, their combination...\Though their average height is not very high,\you can definitely see why they're always a top team in the prefecture.\Yeah, but that's not Wakunan's only weapon. response:	Eh?
context: Tabi, nice kill!\You can do it, Wakunan!\A delayed attack, huh?\So that's Wakunan's weapon, their combination...\Though their average height is not very high,\you can definitely see why they're always a top team in the prefecture.\Yeah, but that's not Wakunan's only weapon.\Eh? response:	Don't keep reacting to the spiker each time!
context: You can do it, Wakunan!\A delayed attack, huh?\So that's Wakunan's weapon, their combination...\Though their average height is not very high,\you can definitely see why they're always a top team in the prefecture.\Yeah, but that's not Wakunan's only weapon.\Eh?\Don't keep reacting to the spiker each time! response:	Go after the ball!
context: A delayed attack, huh?\So that's Wakunan's weapon, their combination...\Though their average height is not very high,\you can definitely see why they're always a top team in the prefecture.\Yeah, but that's not Wakunan's only weapon.\Eh?\Don't keep reacting to the spiker each time!\Go after the ball! response:	I-I know that! In my head...
context: So that's Wakunan's weapon, their combination...\Though their average height is not very high,\you can definitely see why they're always a top team in the prefecture.\Yeah, but that's not Wakunan's only weapon.\Eh?\Don't keep reacting to the spiker each time!\Go after the ball!\I-I know that! In my head... response:	But your body acts on its own...
context: Though their average height is not very high,\you can definitely see why they're always a top team in the prefecture.\Yeah, but that's not Wakunan's only weapon.\Eh?\Don't keep reacting to the spiker each time!\Go after the ball!\I-I know that! In my head...\But your body acts on its own... response:	I know how that feels.
context: you can definitely see why they're always a top team in the prefecture.\Yeah, but that's not Wakunan's only weapon.\Eh?\Don't keep reacting to the spiker each time!\Go after the ball!\I-I know that! In my head...\But your body acts on its own...\I know how that feels. response:	Karasuno Wakunan
context: Yeah, but that's not Wakunan's only weapon.\Eh?\Don't keep reacting to the spiker each time!\Go after the ball!\I-I know that! In my head...\But your body acts on its own...\I know how that feels.\Karasuno Wakunan response:	Nice receive!
context: Eh?\Don't keep reacting to the spiker each time!\Go after the ball!\I-I know that! In my head...\But your body acts on its own...\I know how that feels.\Karasuno Wakunan\Nice receive! response:	It's up! Cover!
context: Don't keep reacting to the spiker each time!\Go after the ball!\I-I know that! In my head...\But your body acts on its own...\I know how that feels.\Karasuno Wakunan\Nice receive!\It's up! Cover! response:	Takeru! Get the last!
context: Go after the ball!\I-I know that! In my head...\But your body acts on its own...\I know how that feels.\Karasuno Wakunan\Nice receive!\It's up! Cover!\Takeru! Get the last! response:	We're going to stop it! Ready, and...
context: I-I know that! In my head...\But your body acts on its own...\I know how that feels.\Karasuno Wakunan\Nice receive!\It's up! Cover!\Takeru! Get the last!\We're going to stop it! Ready, and... response:	A wipe...
context: But your body acts on its own...\I know how that feels.\Karasuno Wakunan\Nice receive!\It's up! Cover!\Takeru! Get the last!\We're going to stop it! Ready, and...\A wipe... response:	All right!
context: I know how that feels.\Karasuno Wakunan\Nice receive!\It's up! Cover!\Takeru! Get the last!\We're going to stop it! Ready, and...\A wipe...\All right! response:	They were targeting the edge of my hands.
context: Karasuno Wakunan\Nice receive!\It's up! Cover!\Takeru! Get the last!\We're going to stop it! Ready, and...\A wipe...\All right!\They were targeting the edge of my hands. response:	It would appear that Nakashima-kun's technique in mid-air battles
context: Nice receive!\It's up! Cover!\Takeru! Get the last!\We're going to stop it! Ready, and...\A wipe...\All right!\They were targeting the edge of my hands.\It would appear that Nakashima-kun's technique in mid-air battles response:	is as troublesome as his combination.
context: It's up! Cover!\Takeru! Get the last!\We're going to stop it! Ready, and...\A wipe...\All right!\They were targeting the edge of my hands.\It would appear that Nakashima-kun's technique in mid-air battles\is as troublesome as his combination. response:	Nakashima Takeru...
context: Takeru! Get the last!\We're going to stop it! Ready, and...\A wipe...\All right!\They were targeting the edge of my hands.\It would appear that Nakashima-kun's technique in mid-air battles\is as troublesome as his combination.\Nakashima Takeru... response:	Shiro! One more, nice serve!
context: We're going to stop it! Ready, and...\A wipe...\All right!\They were targeting the edge of my hands.\It would appear that Nakashima-kun's technique in mid-air battles\is as troublesome as his combination.\Nakashima Takeru...\Shiro! One more, nice serve! response:	His play style might be the most similar in the prefecture...
context: A wipe...\All right!\They were targeting the edge of my hands.\It would appear that Nakashima-kun's technique in mid-air battles\is as troublesome as his combination.\Nakashima Takeru...\Shiro! One more, nice serve!\His play style might be the most similar in the prefecture... response:	to the former Little Giant.
context: All right!\They were targeting the edge of my hands.\It would appear that Nakashima-kun's technique in mid-air battles\is as troublesome as his combination.\Nakashima Takeru...\Shiro! One more, nice serve!\His play style might be the most similar in the prefecture...\to the former Little Giant. response:	Takeru-ni, go!
context: They were targeting the edge of my hands.\It would appear that Nakashima-kun's technique in mid-air battles\is as troublesome as his combination.\Nakashima Takeru...\Shiro! One more, nice serve!\His play style might be the most similar in the prefecture...\to the former Little Giant.\Takeru-ni, go! response:	Takeru
context: It would appear that Nakashima-kun's technique in mid-air battles\is as troublesome as his combination.\Nakashima Takeru...\Shiro! One more, nice serve!\His play style might be the most similar in the prefecture...\to the former Little Giant.\Takeru-ni, go!\Takeru response:	All right!
context: is as troublesome as his combination.\Nakashima Takeru...\Shiro! One more, nice serve!\His play style might be the most similar in the prefecture...\to the former Little Giant.\Takeru-ni, go!\Takeru\All right! response:	Nakashima again! So good!
context: Nakashima Takeru...\Shiro! One more, nice serve!\His play style might be the most similar in the prefecture...\to the former Little Giant.\Takeru-ni, go!\Takeru\All right!\Nakashima again! So good! response:	This is how the pace is going to be...
context: Shiro! One more, nice serve!\His play style might be the most similar in the prefecture...\to the former Little Giant.\Takeru-ni, go!\Takeru\All right!\Nakashima again! So good!\This is how the pace is going to be... response:	They won't get too far ahead of us,
context: His play style might be the most similar in the prefecture...\to the former Little Giant.\Takeru-ni, go!\Takeru\All right!\Nakashima again! So good!\This is how the pace is going to be...\They won't get too far ahead of us, response:	but we won't be able to take the lead.
context: to the former Little Giant.\Takeru-ni, go!\Takeru\All right!\Nakashima again! So good!\This is how the pace is going to be...\They won't get too far ahead of us,\but we won't be able to take the lead. response:	Does this mean that Nakashima-kun
context: Takeru-ni, go!\Takeru\All right!\Nakashima again! So good!\This is how the pace is going to be...\They won't get too far ahead of us,\but we won't be able to take the lead.\Does this mean that Nakashima-kun response:	can see really well, just like Hinata-kun?
context: Takeru\All right!\Nakashima again! So good!\This is how the pace is going to be...\They won't get too far ahead of us,\but we won't be able to take the lead.\Does this mean that Nakashima-kun\can see really well, just like Hinata-kun? response:	I don't know just how much Nakashima can see.
context: All right!\Nakashima again! So good!\This is how the pace is going to be...\They won't get too far ahead of us,\but we won't be able to take the lead.\Does this mean that Nakashima-kun\can see really well, just like Hinata-kun?\I don't know just how much Nakashima can see. response:	Rather than aiming for small spaces like Hinata,
context: Nakashima again! So good!\This is how the pace is going to be...\They won't get too far ahead of us,\but we won't be able to take the lead.\Does this mean that Nakashima-kun\can see really well, just like Hinata-kun?\I don't know just how much Nakashima can see.\Rather than aiming for small spaces like Hinata, response:	I think he uses angles.
context: This is how the pace is going to be...\They won't get too far ahead of us,\but we won't be able to take the lead.\Does this mean that Nakashima-kun\can see really well, just like Hinata-kun?\I don't know just how much Nakashima can see.\Rather than aiming for small spaces like Hinata,\I think he uses angles. response:	I think he changes the angle of his spikes.
context: They won't get too far ahead of us,\but we won't be able to take the lead.\Does this mean that Nakashima-kun\can see really well, just like Hinata-kun?\I don't know just how much Nakashima can see.\Rather than aiming for small spaces like Hinata,\I think he uses angles.\I think he changes the angle of his spikes. response:	He'll hit it against the blocker's hand,
context: but we won't be able to take the lead.\Does this mean that Nakashima-kun\can see really well, just like Hinata-kun?\I don't know just how much Nakashima can see.\Rather than aiming for small spaces like Hinata,\I think he uses angles.\I think he changes the angle of his spikes.\He'll hit it against the blocker's hand, response:	to change up the angle of the rebound.
context: Does this mean that Nakashima-kun\can see really well, just like Hinata-kun?\I don't know just how much Nakashima can see.\Rather than aiming for small spaces like Hinata,\I think he uses angles.\I think he changes the angle of his spikes.\He'll hit it against the blocker's hand,\to change up the angle of the rebound. response:	Tsukishima, it's written all over your face.
context: can see really well, just like Hinata-kun?\I don't know just how much Nakashima can see.\Rather than aiming for small spaces like Hinata,\I think he uses angles.\I think he changes the angle of his spikes.\He'll hit it against the blocker's hand,\to change up the angle of the rebound.\Tsukishima, it's written all over your face. response:	Concentrate on that receive!
context: I don't know just how much Nakashima can see.\Rather than aiming for small spaces like Hinata,\I think he uses angles.\I think he changes the angle of his spikes.\He'll hit it against the blocker's hand,\to change up the angle of the rebound.\Tsukishima, it's written all over your face.\Concentrate on that receive! response:	A strong one's coming!
context: Rather than aiming for small spaces like Hinata,\I think he uses angles.\I think he changes the angle of his spikes.\He'll hit it against the blocker's hand,\to change up the angle of the rebound.\Tsukishima, it's written all over your face.\Concentrate on that receive!\A strong one's coming! response:	Well, as a blocker, spikers like that
context: I think he uses angles.\I think he changes the angle of his spikes.\He'll hit it against the blocker's hand,\to change up the angle of the rebound.\Tsukishima, it's written all over your face.\Concentrate on that receive!\A strong one's coming!\Well, as a blocker, spikers like that response:	are just plain annoying.
context: I think he changes the angle of his spikes.\He'll hit it against the blocker's hand,\to change up the angle of the rebound.\Tsukishima, it's written all over your face.\Concentrate on that receive!\A strong one's coming!\Well, as a blocker, spikers like that\are just plain annoying. response:	Shiro, one more! Nice serve!
context: He'll hit it against the blocker's hand,\to change up the angle of the rebound.\Tsukishima, it's written all over your face.\Concentrate on that receive!\A strong one's coming!\Well, as a blocker, spikers like that\are just plain annoying.\Shiro, one more! Nice serve! response:	Right into the center!
context: to change up the angle of the rebound.\Tsukishima, it's written all over your face.\Concentrate on that receive!\A strong one's coming!\Well, as a blocker, spikers like that\are just plain annoying.\Shiro, one more! Nice serve!\Right into the center! response:	I knew it was coming, but it's still so fast!
context: Tsukishima, it's written all over your face.\Concentrate on that receive!\A strong one's coming!\Well, as a blocker, spikers like that\are just plain annoying.\Shiro, one more! Nice serve!\Right into the center!\I knew it was coming, but it's still so fast! response:	Karasuno's 10 isn't losing to Wakunan's 1.
context: Concentrate on that receive!\A strong one's coming!\Well, as a blocker, spikers like that\are just plain annoying.\Shiro, one more! Nice serve!\Right into the center!\I knew it was coming, but it's still so fast!\Karasuno's 10 isn't losing to Wakunan's 1. response:	All right!
context: A strong one's coming!\Well, as a blocker, spikers like that\are just plain annoying.\Shiro, one more! Nice serve!\Right into the center!\I knew it was coming, but it's still so fast!\Karasuno's 10 isn't losing to Wakunan's 1.\All right! response:	Damn it!
context: Well, as a blocker, spikers like that\are just plain annoying.\Shiro, one more! Nice serve!\Right into the center!\I knew it was coming, but it's still so fast!\Karasuno's 10 isn't losing to Wakunan's 1.\All right!\Damn it! response:	Tanaka-san, nice serve!
context: are just plain annoying.\Shiro, one more! Nice serve!\Right into the center!\I knew it was coming, but it's still so fast!\Karasuno's 10 isn't losing to Wakunan's 1.\All right!\Damn it!\Tanaka-san, nice serve! response:	You almost had it!
context: Shiro, one more! Nice serve!\Right into the center!\I knew it was coming, but it's still so fast!\Karasuno's 10 isn't losing to Wakunan's 1.\All right!\Damn it!\Tanaka-san, nice serve!\You almost had it! response:	Yeah! Leave it to me!
context: Right into the center!\I knew it was coming, but it's still so fast!\Karasuno's 10 isn't losing to Wakunan's 1.\All right!\Damn it!\Tanaka-san, nice serve!\You almost had it!\Yeah! Leave it to me! response:	You're reading them, though.
context: I knew it was coming, but it's still so fast!\Karasuno's 10 isn't losing to Wakunan's 1.\All right!\Damn it!\Tanaka-san, nice serve!\You almost had it!\Yeah! Leave it to me!\You're reading them, though. response:	You'll get the next one for sure!
context: Karasuno's 10 isn't losing to Wakunan's 1.\All right!\Damn it!\Tanaka-san, nice serve!\You almost had it!\Yeah! Leave it to me!\You're reading them, though.\You'll get the next one for sure! response:	Half of that is just trying to get you riled up.
context: All right!\Damn it!\Tanaka-san, nice serve!\You almost had it!\Yeah! Leave it to me!\You're reading them, though.\You'll get the next one for sure!\Half of that is just trying to get you riled up. response:	Don't give in.
context: Damn it!\Tanaka-san, nice serve!\You almost had it!\Yeah! Leave it to me!\You're reading them, though.\You'll get the next one for sure!\Half of that is just trying to get you riled up.\Don't give in. response:	Oh?
context: Tanaka-san, nice serve!\You almost had it!\Yeah! Leave it to me!\You're reading them, though.\You'll get the next one for sure!\Half of that is just trying to get you riled up.\Don't give in.\Oh? response:	It appears that Wakunan has one blocker on Hinata for sure,
context: You almost had it!\Yeah! Leave it to me!\You're reading them, though.\You'll get the next one for sure!\Half of that is just trying to get you riled up.\Don't give in.\Oh?\It appears that Wakunan has one blocker on Hinata for sure, response:	but won't pursue, apparently.
context: Yeah! Leave it to me!\You're reading them, though.\You'll get the next one for sure!\Half of that is just trying to get you riled up.\Don't give in.\Oh?\It appears that Wakunan has one blocker on Hinata for sure,\but won't pursue, apparently. response:	They put a tall middle blocker on Hinata,
context: You're reading them, though.\You'll get the next one for sure!\Half of that is just trying to get you riled up.\Don't give in.\Oh?\It appears that Wakunan has one blocker on Hinata for sure,\but won't pursue, apparently.\They put a tall middle blocker on Hinata, response:	and rather than stop him,
context: You'll get the next one for sure!\Half of that is just trying to get you riled up.\Don't give in.\Oh?\It appears that Wakunan has one blocker on Hinata for sure,\but won't pursue, apparently.\They put a tall middle blocker on Hinata,\and rather than stop him, response:	they limit his course and make it easier to receive.
context: Half of that is just trying to get you riled up.\Don't give in.\Oh?\It appears that Wakunan has one blocker on Hinata for sure,\but won't pursue, apparently.\They put a tall middle blocker on Hinata,\and rather than stop him,\they limit his course and make it easier to receive. response:	It's impossible to completely stop Hinata...
context: Don't give in.\Oh?\It appears that Wakunan has one blocker on Hinata for sure,\but won't pursue, apparently.\They put a tall middle blocker on Hinata,\and rather than stop him,\they limit his course and make it easier to receive.\It's impossible to completely stop Hinata... response:	They understand that,
context: Oh?\It appears that Wakunan has one blocker on Hinata for sure,\but won't pursue, apparently.\They put a tall middle blocker on Hinata,\and rather than stop him,\they limit his course and make it easier to receive.\It's impossible to completely stop Hinata...\They understand that, response:	but they're still not going to let Hinata do what he wants.
context: It appears that Wakunan has one blocker on Hinata for sure,\but won't pursue, apparently.\They put a tall middle blocker on Hinata,\and rather than stop him,\they limit his course and make it easier to receive.\It's impossible to completely stop Hinata...\They understand that,\but they're still not going to let Hinata do what he wants. response:	But...
context: but won't pursue, apparently.\They put a tall middle blocker on Hinata,\and rather than stop him,\they limit his course and make it easier to receive.\It's impossible to completely stop Hinata...\They understand that,\but they're still not going to let Hinata do what he wants.\But... response:	Our next generation of Little Giants
context: They put a tall middle blocker on Hinata,\and rather than stop him,\they limit his course and make it easier to receive.\It's impossible to completely stop Hinata...\They understand that,\but they're still not going to let Hinata do what he wants.\But...\Our next generation of Little Giants response:	are going all out in a mid-air battle, but...
context: and rather than stop him,\they limit his course and make it easier to receive.\It's impossible to completely stop Hinata...\They understand that,\but they're still not going to let Hinata do what he wants.\But...\Our next generation of Little Giants\are going all out in a mid-air battle, but... response:	Don't forget about our kingly ace, either.
context: they limit his course and make it easier to receive.\It's impossible to completely stop Hinata...\They understand that,\but they're still not going to let Hinata do what he wants.\But...\Our next generation of Little Giants\are going all out in a mid-air battle, but...\Don't forget about our kingly ace, either. response:	Right.
context: It's impossible to completely stop Hinata...\They understand that,\but they're still not going to let Hinata do what he wants.\But...\Our next generation of Little Giants\are going all out in a mid-air battle, but...\Don't forget about our kingly ace, either.\Right. response:	Looks like I don't need to say anything.
context: They understand that,\but they're still not going to let Hinata do what he wants.\But...\Our next generation of Little Giants\are going all out in a mid-air battle, but...\Don't forget about our kingly ace, either.\Right.\Looks like I don't need to say anything. response:	Nice serve!
context: but they're still not going to let Hinata do what he wants.\But...\Our next generation of Little Giants\are going all out in a mid-air battle, but...\Don't forget about our kingly ace, either.\Right.\Looks like I don't need to say anything.\Nice serve! response:	I knew it. Their middle blocker is on Hinata.
context: But...\Our next generation of Little Giants\are going all out in a mid-air battle, but...\Don't forget about our kingly ace, either.\Right.\Looks like I don't need to say anything.\Nice serve!\I knew it. Their middle blocker is on Hinata. response:	And the other two are dealing with our other spikers.
context: Our next generation of Little Giants\are going all out in a mid-air battle, but...\Don't forget about our kingly ace, either.\Right.\Looks like I don't need to say anything.\Nice serve!\I knew it. Their middle blocker is on Hinata.\And the other two are dealing with our other spikers. response:	However, if you're going to stop our ace...
context: are going all out in a mid-air battle, but...\Don't forget about our kingly ace, either.\Right.\Looks like I don't need to say anything.\Nice serve!\I knew it. Their middle blocker is on Hinata.\And the other two are dealing with our other spikers.\However, if you're going to stop our ace... response:	You need to bring an iron wall.
context: Don't forget about our kingly ace, either.\Right.\Looks like I don't need to say anything.\Nice serve!\I knew it. Their middle blocker is on Hinata.\And the other two are dealing with our other spikers.\However, if you're going to stop our ace...\You need to bring an iron wall. response:	Damn it...
context: Right.\Looks like I don't need to say anything.\Nice serve!\I knew it. Their middle blocker is on Hinata.\And the other two are dealing with our other spikers.\However, if you're going to stop our ace...\You need to bring an iron wall.\Damn it... response:	Asahi-san!
context: Looks like I don't need to say anything.\Nice serve!\I knew it. Their middle blocker is on Hinata.\And the other two are dealing with our other spikers.\However, if you're going to stop our ace...\You need to bring an iron wall.\Damn it...\Asahi-san! response:	Nice kill!
context: Nice serve!\I knew it. Their middle blocker is on Hinata.\And the other two are dealing with our other spikers.\However, if you're going to stop our ace...\You need to bring an iron wall.\Damn it...\Asahi-san!\Nice kill! response:	Right...
context: I knew it. Their middle blocker is on Hinata.\And the other two are dealing with our other spikers.\However, if you're going to stop our ace...\You need to bring an iron wall.\Damn it...\Asahi-san!\Nice kill!\Right... response:	All right, we're good.
context: And the other two are dealing with our other spikers.\However, if you're going to stop our ace...\You need to bring an iron wall.\Damn it...\Asahi-san!\Nice kill!\Right...\All right, we're good. response:	Everyone's calm. This is how we're going proceed.
context: However, if you're going to stop our ace...\You need to bring an iron wall.\Damn it...\Asahi-san!\Nice kill!\Right...\All right, we're good.\Everyone's calm. This is how we're going proceed. response:	Damn it...
context: You need to bring an iron wall.\Damn it...\Asahi-san!\Nice kill!\Right...\All right, we're good.\Everyone's calm. This is how we're going proceed.\Damn it... response:	It's okay. Let's get the next one!
context: Damn it...\Asahi-san!\Nice kill!\Right...\All right, we're good.\Everyone's calm. This is how we're going proceed.\Damn it...\It's okay. Let's get the next one! response:	Karasuno Wakunan
context: Asahi-san!\Nice kill!\Right...\All right, we're good.\Everyone's calm. This is how we're going proceed.\Damn it...\It's okay. Let's get the next one!\Karasuno Wakunan response:	3! 3!
context: Nice kill!\Right...\All right, we're good.\Everyone's calm. This is how we're going proceed.\Damn it...\It's okay. Let's get the next one!\Karasuno Wakunan\3! 3! response:	All right!
context: Right...\All right, we're good.\Everyone's calm. This is how we're going proceed.\Damn it...\It's okay. Let's get the next one!\Karasuno Wakunan\3! 3!\All right! response:	Is Karasuno's attacking from the left more?
context: All right, we're good.\Everyone's calm. This is how we're going proceed.\Damn it...\It's okay. Let's get the next one!\Karasuno Wakunan\3! 3!\All right!\Is Karasuno's attacking from the left more? response:	That goatee guy is super strong.
context: Everyone's calm. This is how we're going proceed.\Damn it...\It's okay. Let's get the next one!\Karasuno Wakunan\3! 3!\All right!\Is Karasuno's attacking from the left more?\That goatee guy is super strong. response:	What?!
context: Damn it...\It's okay. Let's get the next one!\Karasuno Wakunan\3! 3!\All right!\Is Karasuno's attacking from the left more?\That goatee guy is super strong.\What?! response:	Karasuno Wakunan
context: It's okay. Let's get the next one!\Karasuno Wakunan\3! 3!\All right!\Is Karasuno's attacking from the left more?\That goatee guy is super strong.\What?!\Karasuno Wakunan response:	All right!
context: Karasuno Wakunan\3! 3!\All right!\Is Karasuno's attacking from the left more?\That goatee guy is super strong.\What?!\Karasuno Wakunan\All right! response:	Hey, they finally have a two-point lead.
context: 3! 3!\All right!\Is Karasuno's attacking from the left more?\That goatee guy is super strong.\What?!\Karasuno Wakunan\All right!\Hey, they finally have a two-point lead. response:	It finally feels like the match is moving.
context: All right!\Is Karasuno's attacking from the left more?\That goatee guy is super strong.\What?!\Karasuno Wakunan\All right!\Hey, they finally have a two-point lead.\It finally feels like the match is moving. response:	All right! This is our chance!
context: Is Karasuno's attacking from the left more?\That goatee guy is super strong.\What?!\Karasuno Wakunan\All right!\Hey, they finally have a two-point lead.\It finally feels like the match is moving.\All right! This is our chance! response:	Let's make sure we take it!
context: That goatee guy is super strong.\What?!\Karasuno Wakunan\All right!\Hey, they finally have a two-point lead.\It finally feels like the match is moving.\All right! This is our chance!\Let's make sure we take it! response:	Right!
context: What?!\Karasuno Wakunan\All right!\Hey, they finally have a two-point lead.\It finally feels like the match is moving.\All right! This is our chance!\Let's make sure we take it!\Right! response:	Damn it!
context: Karasuno Wakunan\All right!\Hey, they finally have a two-point lead.\It finally feels like the match is moving.\All right! This is our chance!\Let's make sure we take it!\Right!\Damn it! response:	Hey, Tabi.
context: All right!\Hey, they finally have a two-point lead.\It finally feels like the match is moving.\All right! This is our chance!\Let's make sure we take it!\Right!\Damn it!\Hey, Tabi. response:	Over on the right, in the third row, there's a super cute girl.
context: Hey, they finally have a two-point lead.\It finally feels like the match is moving.\All right! This is our chance!\Let's make sure we take it!\Right!\Damn it!\Hey, Tabi.\Over on the right, in the third row, there's a super cute girl. response:	Seriously?
context: It finally feels like the match is moving.\All right! This is our chance!\Let's make sure we take it!\Right!\Damn it!\Hey, Tabi.\Over on the right, in the third row, there's a super cute girl.\Seriously? response:	Whoa!
context: All right! This is our chance!\Let's make sure we take it!\Right!\Damn it!\Hey, Tabi.\Over on the right, in the third row, there's a super cute girl.\Seriously?\Whoa! response:	Keep getting the ball to me!
context: Let's make sure we take it!\Right!\Damn it!\Hey, Tabi.\Over on the right, in the third row, there's a super cute girl.\Seriously?\Whoa!\Keep getting the ball to me! response:	Right, right...
context: Right!\Damn it!\Hey, Tabi.\Over on the right, in the third row, there's a super cute girl.\Seriously?\Whoa!\Keep getting the ball to me!\Right, right... response:	I'm gonna get this next one, no matter what!
context: Damn it!\Hey, Tabi.\Over on the right, in the third row, there's a super cute girl.\Seriously?\Whoa!\Keep getting the ball to me!\Right, right...\I'm gonna get this next one, no matter what! response:	Good work, Takeru.
context: Hey, Tabi.\Over on the right, in the third row, there's a super cute girl.\Seriously?\Whoa!\Keep getting the ball to me!\Right, right...\I'm gonna get this next one, no matter what!\Good work, Takeru. response:	He definitely knows Tabi well.
context: Over on the right, in the third row, there's a super cute girl.\Seriously?\Whoa!\Keep getting the ball to me!\Right, right...\I'm gonna get this next one, no matter what!\Good work, Takeru.\He definitely knows Tabi well. response:	Fight!
context: Seriously?\Whoa!\Keep getting the ball to me!\Right, right...\I'm gonna get this next one, no matter what!\Good work, Takeru.\He definitely knows Tabi well.\Fight! response:	I'm used to surviving in a Jurassic Park filled with free-willed people.
context: Whoa!\Keep getting the ball to me!\Right, right...\I'm gonna get this next one, no matter what!\Good work, Takeru.\He definitely knows Tabi well.\Fight!\I'm used to surviving in a Jurassic Park filled with free-willed people. response:	I'm gonna go play.
context: Keep getting the ball to me!\Right, right...\I'm gonna get this next one, no matter what!\Good work, Takeru.\He definitely knows Tabi well.\Fight!\I'm used to surviving in a Jurassic Park filled with free-willed people.\I'm gonna go play. response:	What?!
context: Right, right...\I'm gonna get this next one, no matter what!\Good work, Takeru.\He definitely knows Tabi well.\Fight!\I'm used to surviving in a Jurassic Park filled with free-willed people.\I'm gonna go play.\What?! response:	If my house is Jurassic Park,
context: I'm gonna get this next one, no matter what!\Good work, Takeru.\He definitely knows Tabi well.\Fight!\I'm used to surviving in a Jurassic Park filled with free-willed people.\I'm gonna go play.\What?!\If my house is Jurassic Park, response:	Yay!
context: Good work, Takeru.\He definitely knows Tabi well.\Fight!\I'm used to surviving in a Jurassic Park filled with free-willed people.\I'm gonna go play.\What?!\If my house is Jurassic Park,\Yay! response:	this is just a zoo.
context: He definitely knows Tabi well.\Fight!\I'm used to surviving in a Jurassic Park filled with free-willed people.\I'm gonna go play.\What?!\If my house is Jurassic Park,\Yay!\this is just a zoo. response:	Makoto, where are you going?!
context: Fight!\I'm used to surviving in a Jurassic Park filled with free-willed people.\I'm gonna go play.\What?!\If my house is Jurassic Park,\Yay!\this is just a zoo.\Makoto, where are you going?! response:	Okay, say Ah.
context: I'm used to surviving in a Jurassic Park filled with free-willed people.\I'm gonna go play.\What?!\If my house is Jurassic Park,\Yay!\this is just a zoo.\Makoto, where are you going?!\Okay, say Ah. response:	Don't underestimate the second brother who's been through hell.
context: I'm gonna go play.\What?!\If my house is Jurassic Park,\Yay!\this is just a zoo.\Makoto, where are you going?!\Okay, say Ah.\Don't underestimate the second brother who's been through hell. response:	Aah.
context: What?!\If my house is Jurassic Park,\Yay!\this is just a zoo.\Makoto, where are you going?!\Okay, say Ah.\Don't underestimate the second brother who's been through hell.\Aah. response:	We're Wakunan, known for our tenacity!
context: If my house is Jurassic Park,\Yay!\this is just a zoo.\Makoto, where are you going?!\Okay, say Ah.\Don't underestimate the second brother who's been through hell.\Aah.\We're Wakunan, known for our tenacity! response:	This is when we show what we're worth!
context: Yay!\this is just a zoo.\Makoto, where are you going?!\Okay, say Ah.\Don't underestimate the second brother who's been through hell.\Aah.\We're Wakunan, known for our tenacity!\This is when we show what we're worth! response:	Yeah!
context: this is just a zoo.\Makoto, where are you going?!\Okay, say Ah.\Don't underestimate the second brother who's been through hell.\Aah.\We're Wakunan, known for our tenacity!\This is when we show what we're worth!\Yeah! response:	Their captain's a pretty good foundation, as well.
context: Makoto, where are you going?!\Okay, say Ah.\Don't underestimate the second brother who's been through hell.\Aah.\We're Wakunan, known for our tenacity!\This is when we show what we're worth!\Yeah!\Their captain's a pretty good foundation, as well. response:	Yeah. If that last game was a bunch of playing,
context: Okay, say Ah.\Don't underestimate the second brother who's been through hell.\Aah.\We're Wakunan, known for our tenacity!\This is when we show what we're worth!\Yeah!\Their captain's a pretty good foundation, as well.\Yeah. If that last game was a bunch of playing, response:	this match is going to be about the captains.
context: Don't underestimate the second brother who's been through hell.\Aah.\We're Wakunan, known for our tenacity!\This is when we show what we're worth!\Yeah!\Their captain's a pretty good foundation, as well.\Yeah. If that last game was a bunch of playing,\this match is going to be about the captains. response:	11! 11!
context: Aah.\We're Wakunan, known for our tenacity!\This is when we show what we're worth!\Yeah!\Their captain's a pretty good foundation, as well.\Yeah. If that last game was a bunch of playing,\this match is going to be about the captains.\11! 11! response:	Nice cover!
context: We're Wakunan, known for our tenacity!\This is when we show what we're worth!\Yeah!\Their captain's a pretty good foundation, as well.\Yeah. If that last game was a bunch of playing,\this match is going to be about the captains.\11! 11!\Nice cover! response:	He got it again!
context: This is when we show what we're worth!\Yeah!\Their captain's a pretty good foundation, as well.\Yeah. If that last game was a bunch of playing,\this match is going to be about the captains.\11! 11!\Nice cover!\He got it again! response:	I'm counting on you!
context: Yeah!\Their captain's a pretty good foundation, as well.\Yeah. If that last game was a bunch of playing,\this match is going to be about the captains.\11! 11!\Nice cover!\He got it again!\I'm counting on you! response:	They're both great at connecting.
context: Their captain's a pretty good foundation, as well.\Yeah. If that last game was a bunch of playing,\this match is going to be about the captains.\11! 11!\Nice cover!\He got it again!\I'm counting on you!\They're both great at connecting. response:	Asahi!
context: Yeah. If that last game was a bunch of playing,\this match is going to be about the captains.\11! 11!\Nice cover!\He got it again!\I'm counting on you!\They're both great at connecting.\Asahi! response:	Nice, Akiu!
context: this match is going to be about the captains.\11! 11!\Nice cover!\He got it again!\I'm counting on you!\They're both great at connecting.\Asahi!\Nice, Akiu! response:	He got it again!
context: 11! 11!\Nice cover!\He got it again!\I'm counting on you!\They're both great at connecting.\Asahi!\Nice, Akiu!\He got it again! response:	Cover! Cover!
context: Nice cover!\He got it again!\I'm counting on you!\They're both great at connecting.\Asahi!\Nice, Akiu!\He got it again!\Cover! Cover! response:	It's hard to even watch.
context: He got it again!\I'm counting on you!\They're both great at connecting.\Asahi!\Nice, Akiu!\He got it again!\Cover! Cover!\It's hard to even watch. response:	This is the longest rally of the day.
context: I'm counting on you!\They're both great at connecting.\Asahi!\Nice, Akiu!\He got it again!\Cover! Cover!\It's hard to even watch.\This is the longest rally of the day. response:	Whoever gets this is going to get the momentum of the game.
context: They're both great at connecting.\Asahi!\Nice, Akiu!\He got it again!\Cover! Cover!\It's hard to even watch.\This is the longest rally of the day.\Whoever gets this is going to get the momentum of the game. response:	Don't let your guard down!
context: Asahi!\Nice, Akiu!\He got it again!\Cover! Cover!\It's hard to even watch.\This is the longest rally of the day.\Whoever gets this is going to get the momentum of the game.\Don't let your guard down! response:	We're definitely going to get this one!
context: Nice, Akiu!\He got it again!\Cover! Cover!\It's hard to even watch.\This is the longest rally of the day.\Whoever gets this is going to get the momentum of the game.\Don't let your guard down!\We're definitely going to get this one! response:	Yeah!
context: He got it again!\Cover! Cover!\It's hard to even watch.\This is the longest rally of the day.\Whoever gets this is going to get the momentum of the game.\Don't let your guard down!\We're definitely going to get this one!\Yeah! response:	Takeru, I'm counting on you!
context: Cover! Cover!\It's hard to even watch.\This is the longest rally of the day.\Whoever gets this is going to get the momentum of the game.\Don't let your guard down!\We're definitely going to get this one!\Yeah!\Takeru, I'm counting on you! response:	Yeah!
context: It's hard to even watch.\This is the longest rally of the day.\Whoever gets this is going to get the momentum of the game.\Don't let your guard down!\We're definitely going to get this one!\Yeah!\Takeru, I'm counting on you!\Yeah! response:	Three blockers!
context: This is the longest rally of the day.\Whoever gets this is going to get the momentum of the game.\Don't let your guard down!\We're definitely going to get this one!\Yeah!\Takeru, I'm counting on you!\Yeah!\Three blockers! response:	Another wipe...
context: Whoever gets this is going to get the momentum of the game.\Don't let your guard down!\We're definitely going to get this one!\Yeah!\Takeru, I'm counting on you!\Yeah!\Three blockers!\Another wipe... response:	Go!
context: Don't let your guard down!\We're definitely going to get this one!\Yeah!\Takeru, I'm counting on you!\Yeah!\Three blockers!\Another wipe...\Go! response:	Get the last one over!
context: We're definitely going to get this one!\Yeah!\Takeru, I'm counting on you!\Yeah!\Three blockers!\Another wipe...\Go!\Get the last one over! response:	Go!
context: Yeah!\Takeru, I'm counting on you!\Yeah!\Three blockers!\Another wipe...\Go!\Get the last one over!\Go! response:	We did it!
context: Takeru, I'm counting on you!\Yeah!\Three blockers!\Another wipe...\Go!\Get the last one over!\Go!\We did it! response:	All right!
context: Yeah!\Three blockers!\Another wipe...\Go!\Get the last one over!\Go!\We did it!\All right! response:	Er...
context: Three blockers!\Another wipe...\Go!\Get the last one over!\Go!\We did it!\All right!\Er... response:	Huh?
context: Another wipe...\Go!\Get the last one over!\Go!\We did it!\All right!\Er...\Huh? response:	Daichi-san?
context: Go!\Get the last one over!\Go!\We did it!\All right!\Er...\Huh?\Daichi-san? response:	That's so cool, having your family cheer you on.
context: Get the last one over!\Go!\We did it!\All right!\Er...\Huh?\Daichi-san?\That's so cool, having your family cheer you on. response:	I would hate it.
context: Go!\We did it!\All right!\Er...\Huh?\Daichi-san?\That's so cool, having your family cheer you on.\I would hate it. response:	Why?
context: We did it!\All right!\Er...\Huh?\Daichi-san?\That's so cool, having your family cheer you on.\I would hate it.\Why? response:	Well, I actually understand how Tsukishima feels.
context: All right!\Er...\Huh?\Daichi-san?\That's so cool, having your family cheer you on.\I would hate it.\Why?\Well, I actually understand how Tsukishima feels. response:	Huh?
context: Er...\Huh?\Daichi-san?\That's so cool, having your family cheer you on.\I would hate it.\Why?\Well, I actually understand how Tsukishima feels.\Huh? response:	I'm not sure how to feel about having
context: Huh?\Daichi-san?\That's so cool, having your family cheer you on.\I would hate it.\Why?\Well, I actually understand how Tsukishima feels.\Huh?\I'm not sure how to feel about having response:	the same opinion as Tanaka-san.
context: Daichi-san?\That's so cool, having your family cheer you on.\I would hate it.\Why?\Well, I actually understand how Tsukishima feels.\Huh?\I'm not sure how to feel about having\the same opinion as Tanaka-san. response:	Episode 17: The Battle Without Will Power
context: That's so cool, having your family cheer you on.\I would hate it.\Why?\Well, I actually understand how Tsukishima feels.\Huh?\I'm not sure how to feel about having\the same opinion as Tanaka-san.\Episode 17: The Battle Without Will Power response:	Next time on Haikyu!! : The Battle Without Will Power.