context: Netherworld Encyclopaedia response:	jou jou yuu jou ban jin ma ji kai chou
context: Netherworld Encyclopaedia\jou jou yuu jou ban jin ma ji kai chou response:	hai! i ccha i ma shou!
context: Netherworld Encyclopaedia\jou jou yuu jou ban jin ma ji kai chou\hai! i ccha i ma shou! response:	ki mi wa best best friend
context: Netherworld Encyclopaedia\jou jou yuu jou ban jin ma ji kai chou\hai! i ccha i ma shou!\ki mi wa best best friend response:	(furai!) cho tto fu za ke te mi ta ra
context: Netherworld Encyclopaedia\jou jou yuu jou ban jin ma ji kai chou\hai! i ccha i ma shou!\ki mi wa best best friend\(furai!) cho tto fu za ke te mi ta ra response:	(La La La)
context: Netherworld Encyclopaedia\jou jou yuu jou ban jin ma ji kai chou\hai! i ccha i ma shou!\ki mi wa best best friend\(furai!) cho tto fu za ke te mi ta ra\(La La La) response:	(faito!) ke n ka shi cha tta to ki mo
context: Netherworld Encyclopaedia\jou jou yuu jou ban jin ma ji kai chou\hai! i ccha i ma shou!\ki mi wa best best friend\(furai!) cho tto fu za ke te mi ta ra\(La La La)\(faito!) ke n ka shi cha tta to ki mo response:	sa su ga sai kou friend
context: Netherworld Encyclopaedia\jou jou yuu jou ban jin ma ji kai chou\hai! i ccha i ma shou!\ki mi wa best best friend\(furai!) cho tto fu za ke te mi ta ra\(La La La)\(faito!) ke n ka shi cha tta to ki mo\sa su ga sai kou friend response:	wa ke wa ka nnai nai
context: jou jou yuu jou ban jin ma ji kai chou\hai! i ccha i ma shou!\ki mi wa best best friend\(furai!) cho tto fu za ke te mi ta ra\(La La La)\(faito!) ke n ka shi cha tta to ki mo\sa su ga sai kou friend\wa ke wa ka nnai nai response:	jou jou yuu jou ban jin ma ji kai chou
context: hai! i ccha i ma shou!\ki mi wa best best friend\(furai!) cho tto fu za ke te mi ta ra\(La La La)\(faito!) ke n ka shi cha tta to ki mo\sa su ga sai kou friend\wa ke wa ka nnai nai\jou jou yuu jou ban jin ma ji kai chou response:	cha cha la cha la cha cha
context: ki mi wa best best friend\(furai!) cho tto fu za ke te mi ta ra\(La La La)\(faito!) ke n ka shi cha tta to ki mo\sa su ga sai kou friend\wa ke wa ka nnai nai\jou jou yuu jou ban jin ma ji kai chou\cha cha la cha la cha cha response:	(!) S
context: (furai!) cho tto fu za ke te mi ta ra\(La La La)\(faito!) ke n ka shi cha tta to ki mo\sa su ga sai kou friend\wa ke wa ka nnai nai\jou jou yuu jou ban jin ma ji kai chou\cha cha la cha la cha cha\(!) S response:	(!)
context: (La La La)\(faito!) ke n ka shi cha tta to ki mo\sa su ga sai kou friend\wa ke wa ka nnai nai\jou jou yuu jou ban jin ma ji kai chou\cha cha la cha la cha cha\(!) S\(!) response:	(!)
context: (faito!) ke n ka shi cha tta to ki mo\sa su ga sai kou friend\wa ke wa ka nnai nai\jou jou yuu jou ban jin ma ji kai chou\cha cha la cha la cha cha\(!) S\(!)\(!) response:	(!) H
context: sa su ga sai kou friend\wa ke wa ka nnai nai\jou jou yuu jou ban jin ma ji kai chou\cha cha la cha la cha cha\(!) S\(!)\(!)\(!) H response:	(!)
context: wa ke wa ka nnai nai\jou jou yuu jou ban jin ma ji kai chou\cha cha la cha la cha cha\(!) S\(!)\(!)\(!) H\(!) response:	(!)
context: jou jou yuu jou ban jin ma ji kai chou\cha cha la cha la cha cha\(!) S\(!)\(!)\(!) H\(!)\(!) response:	friend
context: cha cha la cha la cha cha\(!) S\(!)\(!)\(!) H\(!)\(!)\friend response:	Hey!
context: (!) S\(!)\(!)\(!) H\(!)\(!)\friend\Hey! response:	( !)
context: (!)\(!)\(!) H\(!)\(!)\friend\Hey!\( !) response:	Amazing friendship, the absolute best!
context: (!)\(!) H\(!)\(!)\friend\Hey!\( !)\Amazing friendship, the absolute best! response:	All right! I'll say it!
context: (!) H\(!)\(!)\friend\Hey!\( !)\Amazing friendship, the absolute best!\All right! I'll say it! response:	You are my best, best friend!
context: (!)\(!)\friend\Hey!\( !)\Amazing friendship, the absolute best!\All right! I'll say it!\You are my best, best friend! response:	(Fly!) When I joke around a bit,
context: (!)\friend\Hey!\( !)\Amazing friendship, the absolute best!\All right! I'll say it!\You are my best, best friend!\(Fly!) When I joke around a bit, response:	(Shine!) You joke around more in response.
context: friend\Hey!\( !)\Amazing friendship, the absolute best!\All right! I'll say it!\You are my best, best friend!\(Fly!) When I joke around a bit,\(Shine!) You joke around more in response. response:	(La La La) Nothing is better than this!
context: Hey!\( !)\Amazing friendship, the absolute best!\All right! I'll say it!\You are my best, best friend!\(Fly!) When I joke around a bit,\(Shine!) You joke around more in response.\(La La La) Nothing is better than this! response:	(Why!) Even if something bad happens,
context: ( !)\Amazing friendship, the absolute best!\All right! I'll say it!\You are my best, best friend!\(Fly!) When I joke around a bit,\(Shine!) You joke around more in response.\(La La La) Nothing is better than this!\(Why!) Even if something bad happens, response:	(Fine!) I immediately forget about it!
context: Amazing friendship, the absolute best!\All right! I'll say it!\You are my best, best friend!\(Fly!) When I joke around a bit,\(Shine!) You joke around more in response.\(La La La) Nothing is better than this!\(Why!) Even if something bad happens,\(Fine!) I immediately forget about it! response:	(La La La)
context: All right! I'll say it!\You are my best, best friend!\(Fly!) When I joke around a bit,\(Shine!) You joke around more in response.\(La La La) Nothing is better than this!\(Why!) Even if something bad happens,\(Fine!) I immediately forget about it!\(La La La) response:	Always keep it going!
context: You are my best, best friend!\(Fly!) When I joke around a bit,\(Shine!) You joke around more in response.\(La La La) Nothing is better than this!\(Why!) Even if something bad happens,\(Fine!) I immediately forget about it!\(La La La)\Always keep it going! response:	Being together 24 hours a day isn't a problem.
context: (Fly!) When I joke around a bit,\(Shine!) You joke around more in response.\(La La La) Nothing is better than this!\(Why!) Even if something bad happens,\(Fine!) I immediately forget about it!\(La La La)\Always keep it going!\Being together 24 hours a day isn't a problem. response:	Just like twins, or a parent and child, or clone cyborgs.
context: (Shine!) You joke around more in response.\(La La La) Nothing is better than this!\(Why!) Even if something bad happens,\(Fine!) I immediately forget about it!\(La La La)\Always keep it going!\Being together 24 hours a day isn't a problem.\Just like twins, or a parent and child, or clone cyborgs. response:	Then isn't there no reason to clear your eyes?
context: (La La La) Nothing is better than this!\(Why!) Even if something bad happens,\(Fine!) I immediately forget about it!\(La La La)\Always keep it going!\Being together 24 hours a day isn't a problem.\Just like twins, or a parent and child, or clone cyborgs.\Then isn't there no reason to clear your eyes? response:	Those are completely, completely different issues.
context: (Why!) Even if something bad happens,\(Fine!) I immediately forget about it!\(La La La)\Always keep it going!\Being together 24 hours a day isn't a problem.\Just like twins, or a parent and child, or clone cyborgs.\Then isn't there no reason to clear your eyes?\Those are completely, completely different issues. response:	(Fight!) Even when I get in a fight with you,
context: (Fine!) I immediately forget about it!\(La La La)\Always keep it going!\Being together 24 hours a day isn't a problem.\Just like twins, or a parent and child, or clone cyborgs.\Then isn't there no reason to clear your eyes?\Those are completely, completely different issues.\(Fight!) Even when I get in a fight with you, response:	(Down!) even when I get really down,
context: (La La La)\Always keep it going!\Being together 24 hours a day isn't a problem.\Just like twins, or a parent and child, or clone cyborgs.\Then isn't there no reason to clear your eyes?\Those are completely, completely different issues.\(Fight!) Even when I get in a fight with you,\(Down!) even when I get really down, response:	(Shy!) even when I feel like I want to be alone,
context: Always keep it going!\Being together 24 hours a day isn't a problem.\Just like twins, or a parent and child, or clone cyborgs.\Then isn't there no reason to clear your eyes?\Those are completely, completely different issues.\(Fight!) Even when I get in a fight with you,\(Down!) even when I get really down,\(Shy!) even when I feel like I want to be alone, response:	before I realise it, you're right there; we'll be together even in death!
context: Being together 24 hours a day isn't a problem.\Just like twins, or a parent and child, or clone cyborgs.\Then isn't there no reason to clear your eyes?\Those are completely, completely different issues.\(Fight!) Even when I get in a fight with you,\(Down!) even when I get really down,\(Shy!) even when I feel like I want to be alone,\before I realise it, you're right there; we'll be together even in death! response:	I wonder why it is.
context: Just like twins, or a parent and child, or clone cyborgs.\Then isn't there no reason to clear your eyes?\Those are completely, completely different issues.\(Fight!) Even when I get in a fight with you,\(Down!) even when I get really down,\(Shy!) even when I feel like I want to be alone,\before I realise it, you're right there; we'll be together even in death!\I wonder why it is. response:	I want to be with you.
context: Then isn't there no reason to clear your eyes?\Those are completely, completely different issues.\(Fight!) Even when I get in a fight with you,\(Down!) even when I get really down,\(Shy!) even when I feel like I want to be alone,\before I realise it, you're right there; we'll be together even in death!\I wonder why it is.\I want to be with you. response:	When I'm with you,
context: Those are completely, completely different issues.\(Fight!) Even when I get in a fight with you,\(Down!) even when I get really down,\(Shy!) even when I feel like I want to be alone,\before I realise it, you're right there; we'll be together even in death!\I wonder why it is.\I want to be with you.\When I'm with you, response:	time goes 100 times faster!
context: (Fight!) Even when I get in a fight with you,\(Down!) even when I get really down,\(Shy!) even when I feel like I want to be alone,\before I realise it, you're right there; we'll be together even in death!\I wonder why it is.\I want to be with you.\When I'm with you,\time goes 100 times faster! response:	It's fun, isn't it?
context: (Down!) even when I get really down,\(Shy!) even when I feel like I want to be alone,\before I realise it, you're right there; we'll be together even in death!\I wonder why it is.\I want to be with you.\When I'm with you,\time goes 100 times faster!\It's fun, isn't it? response:	It's way too fun!
context: (Shy!) even when I feel like I want to be alone,\before I realise it, you're right there; we'll be together even in death!\I wonder why it is.\I want to be with you.\When I'm with you,\time goes 100 times faster!\It's fun, isn't it?\It's way too fun! response:	As expected of my best friend!
context: before I realise it, you're right there; we'll be together even in death!\I wonder why it is.\I want to be with you.\When I'm with you,\time goes 100 times faster!\It's fun, isn't it?\It's way too fun!\As expected of my best friend! response:	What is it?
context: I wonder why it is.\I want to be with you.\When I'm with you,\time goes 100 times faster!\It's fun, isn't it?\It's way too fun!\As expected of my best friend!\What is it? response:	The synchro is amazing!
context: I want to be with you.\When I'm with you,\time goes 100 times faster!\It's fun, isn't it?\It's way too fun!\As expected of my best friend!\What is it?\The synchro is amazing! response:	Always making an uproar,
context: When I'm with you,\time goes 100 times faster!\It's fun, isn't it?\It's way too fun!\As expected of my best friend!\What is it?\The synchro is amazing!\Always making an uproar, response:	bothering the neighbours a lot.
context: time goes 100 times faster!\It's fun, isn't it?\It's way too fun!\As expected of my best friend!\What is it?\The synchro is amazing!\Always making an uproar,\bothering the neighbours a lot. response:	What time is it now?
context: It's fun, isn't it?\It's way too fun!\As expected of my best friend!\What is it?\The synchro is amazing!\Always making an uproar,\bothering the neighbours a lot.\What time is it now? response:	And then yo de le hi hoo!
context: It's way too fun!\As expected of my best friend!\What is it?\The synchro is amazing!\Always making an uproar,\bothering the neighbours a lot.\What time is it now?\And then yo de le hi hoo! response:	I don't get it at all!
context: As expected of my best friend!\What is it?\The synchro is amazing!\Always making an uproar,\bothering the neighbours a lot.\What time is it now?\And then yo de le hi hoo!\I don't get it at all! response:	So re doh si la!
context: What is it?\The synchro is amazing!\Always making an uproar,\bothering the neighbours a lot.\What time is it now?\And then yo de le hi hoo!\I don't get it at all!\So re doh si la! response:	It's better than I imagined, the absolute best!
context: The synchro is amazing!\Always making an uproar,\bothering the neighbours a lot.\What time is it now?\And then yo de le hi hoo!\I don't get it at all!\So re doh si la!\It's better than I imagined, the absolute best! response:	Even if I say this and that, we're still friends. (Hooray!)
context: Always making an uproar,\bothering the neighbours a lot.\What time is it now?\And then yo de le hi hoo!\I don't get it at all!\So re doh si la!\It's better than I imagined, the absolute best!\Even if I say this and that, we're still friends. (Hooray!) response:	Amazing friendship, the absolute best!
context: bothering the neighbours a lot.\What time is it now?\And then yo de le hi hoo!\I don't get it at all!\So re doh si la!\It's better than I imagined, the absolute best!\Even if I say this and that, we're still friends. (Hooray!)\Amazing friendship, the absolute best! response:	Cha Cha La Cha La Cha Cha!
context: What time is it now?\And then yo de le hi hoo!\I don't get it at all!\So re doh si la!\It's better than I imagined, the absolute best!\Even if I say this and that, we're still friends. (Hooray!)\Amazing friendship, the absolute best!\Cha Cha La Cha La Cha Cha! response:	The colours of the flowers
context: And then yo de le hi hoo!\I don't get it at all!\So re doh si la!\It's better than I imagined, the absolute best!\Even if I say this and that, we're still friends. (Hooray!)\Amazing friendship, the absolute best!\Cha Cha La Cha La Cha Cha!\The colours of the flowers response:	The shadows of the clouds
context: I don't get it at all!\So re doh si la!\It's better than I imagined, the absolute best!\Even if I say this and that, we're still friends. (Hooray!)\Amazing friendship, the absolute best!\Cha Cha La Cha La Cha Cha!\The colours of the flowers\The shadows of the clouds response:	They're so nostalgic
context: So re doh si la!\It's better than I imagined, the absolute best!\Even if I say this and that, we're still friends. (Hooray!)\Amazing friendship, the absolute best!\Cha Cha La Cha La Cha Cha!\The colours of the flowers\The shadows of the clouds\They're so nostalgic response:	Those memories
context: It's better than I imagined, the absolute best!\Even if I say this and that, we're still friends. (Hooray!)\Amazing friendship, the absolute best!\Cha Cha La Cha La Cha Cha!\The colours of the flowers\The shadows of the clouds\They're so nostalgic\Those memories response:	They are left behind
context: Even if I say this and that, we're still friends. (Hooray!)\Amazing friendship, the absolute best!\Cha Cha La Cha La Cha Cha!\The colours of the flowers\The shadows of the clouds\They're so nostalgic\Those memories\They are left behind response:	A window to days gone by
context: Amazing friendship, the absolute best!\Cha Cha La Cha La Cha Cha!\The colours of the flowers\The shadows of the clouds\They're so nostalgic\Those memories\They are left behind\A window to days gone by response:	It's time to leave the nest
context: Cha Cha La Cha La Cha Cha!\The colours of the flowers\The shadows of the clouds\They're so nostalgic\Those memories\They are left behind\A window to days gone by\It's time to leave the nest response:	Today is goodbye
context: The colours of the flowers\The shadows of the clouds\They're so nostalgic\Those memories\They are left behind\A window to days gone by\It's time to leave the nest\Today is goodbye response:	Farewell, and so long, teacher
context: The shadows of the clouds\They're so nostalgic\Those memories\They are left behind\A window to days gone by\It's time to leave the nest\Today is goodbye\Farewell, and so long, teacher response:	Farewell, and so long, my friend
context: They're so nostalgic\Those memories\They are left behind\A window to days gone by\It's time to leave the nest\Today is goodbye\Farewell, and so long, teacher\Farewell, and so long, my friend response:	For the sake of a beautiful tomorrow
context: Those memories\They are left behind\A window to days gone by\It's time to leave the nest\Today is goodbye\Farewell, and so long, teacher\Farewell, and so long, my friend\For the sake of a beautiful tomorrow response:	Nichijou 87
context: They are left behind\A window to days gone by\It's time to leave the nest\Today is goodbye\Farewell, and so long, teacher\Farewell, and so long, my friend\For the sake of a beautiful tomorrow\Nichijou 87 response:	Nichijou 88
context: A window to days gone by\It's time to leave the nest\Today is goodbye\Farewell, and so long, teacher\Farewell, and so long, my friend\For the sake of a beautiful tomorrow\Nichijou 87\Nichijou 88 response:	Love-Like
context: It's time to leave the nest\Today is goodbye\Farewell, and so long, teacher\Farewell, and so long, my friend\For the sake of a beautiful tomorrow\Nichijou 87\Nichijou 88\Love-Like response:	Love-Like
context: Today is goodbye\Farewell, and so long, teacher\Farewell, and so long, my friend\For the sake of a beautiful tomorrow\Nichijou 87\Nichijou 88\Love-Like\Love-Like response:	Love-Like
context: Farewell, and so long, teacher\Farewell, and so long, my friend\For the sake of a beautiful tomorrow\Nichijou 87\Nichijou 88\Love-Like\Love-Like\Love-Like response:	Love-Like
context: Farewell, and so long, my friend\For the sake of a beautiful tomorrow\Nichijou 87\Nichijou 88\Love-Like\Love-Like\Love-Like\Love-Like response:	Love-Like
context: For the sake of a beautiful tomorrow\Nichijou 87\Nichijou 88\Love-Like\Love-Like\Love-Like\Love-Like\Love-Like response:	Love-Like
context: Nichijou 87\Nichijou 88\Love-Like\Love-Like\Love-Like\Love-Like\Love-Like\Love-Like response:	Love-Like
context: Nichijou 88\Love-Like\Love-Like\Love-Like\Love-Like\Love-Like\Love-Like\Love-Like response:	Nichijou 89
context: Love-Like\Love-Like\Love-Like\Love-Like\Love-Like\Love-Like\Love-Like\Nichijou 89 response:	Big Sale
context: Love-Like\Love-Like\Love-Like\Love-Like\Love-Like\Love-Like\Nichijou 89\Big Sale response:	The Next Day
context: Love-Like\Love-Like\Love-Like\Love-Like\Love-Like\Nichijou 89\Big Sale\The Next Day response:	Sakurai-sensei
context: Love-Like\Love-Like\Love-Like\Love-Like\Nichijou 89\Big Sale\The Next Day\Sakurai-sensei response:	Takasaki-sensei
context: Love-Like\Love-Like\Love-Like\Nichijou 89\Big Sale\The Next Day\Sakurai-sensei\Takasaki-sensei response:	Ah, this is also youth
context: Love-Like\Love-Like\Nichijou 89\Big Sale\The Next Day\Sakurai-sensei\Takasaki-sensei\Ah, this is also youth response:	Nichijou 90
context: Love-Like\Nichijou 89\Big Sale\The Next Day\Sakurai-sensei\Takasaki-sensei\Ah, this is also youth\Nichijou 90 response:	Hours Later
context: Nichijou 89\Big Sale\The Next Day\Sakurai-sensei\Takasaki-sensei\Ah, this is also youth\Nichijou 90\Hours Later response:	Nichijou 91
context: Big Sale\The Next Day\Sakurai-sensei\Takasaki-sensei\Ah, this is also youth\Nichijou 90\Hours Later\Nichijou 91 response:	Fay Kingdom's Advisor to the Throne
context: The Next Day\Sakurai-sensei\Takasaki-sensei\Ah, this is also youth\Nichijou 90\Hours Later\Nichijou 91\Fay Kingdom's Advisor to the Throne response:	Also known as: Persistent Negotiator
context: Sakurai-sensei\Takasaki-sensei\Ah, this is also youth\Nichijou 90\Hours Later\Nichijou 91\Fay Kingdom's Advisor to the Throne\Also known as: Persistent Negotiator response:	Netherworld Encyclopaedia
context: Takasaki-sensei\Ah, this is also youth\Nichijou 90\Hours Later\Nichijou 91\Fay Kingdom's Advisor to the Throne\Also known as: Persistent Negotiator\Netherworld Encyclopaedia response:	Netherworld Encyclopaedia
context: Ah, this is also youth\Nichijou 90\Hours Later\Nichijou 91\Fay Kingdom's Advisor to the Throne\Also known as: Persistent Negotiator\Netherworld Encyclopaedia\Netherworld Encyclopaedia response:	Netherworld Encyclopaedia
context: Nichijou 90\Hours Later\Nichijou 91\Fay Kingdom's Advisor to the Throne\Also known as: Persistent Negotiator\Netherworld Encyclopaedia\Netherworld Encyclopaedia\Netherworld Encyclopaedia response:	Netherworld Encyclopaedia
context: Hours Later\Nichijou 91\Fay Kingdom's Advisor to the Throne\Also known as: Persistent Negotiator\Netherworld Encyclopaedia\Netherworld Encyclopaedia\Netherworld Encyclopaedia\Netherworld Encyclopaedia response:	Netherworld Encyclopaedia
context: Nichijou 91\Fay Kingdom's Advisor to the Throne\Also known as: Persistent Negotiator\Netherworld Encyclopaedia\Netherworld Encyclopaedia\Netherworld Encyclopaedia\Netherworld Encyclopaedia\Netherworld Encyclopaedia response:	Netherworld Encyclopaedia
context: Fay Kingdom's Advisor to the Throne\Also known as: Persistent Negotiator\Netherworld Encyclopaedia\Netherworld Encyclopaedia\Netherworld Encyclopaedia\Netherworld Encyclopaedia\Netherworld Encyclopaedia\Netherworld Encyclopaedia response:	Netherworld Encyclopaedia
context: Also known as: Persistent Negotiator\Netherworld Encyclopaedia\Netherworld Encyclopaedia\Netherworld Encyclopaedia\Netherworld Encyclopaedia\Netherworld Encyclopaedia\Netherworld Encyclopaedia\Netherworld Encyclopaedia response:	Netherworld Encyclopaedia
context: Netherworld Encyclopaedia\Netherworld Encyclopaedia\Netherworld Encyclopaedia\Netherworld Encyclopaedia\Netherworld Encyclopaedia\Netherworld Encyclopaedia\Netherworld Encyclopaedia\Netherworld Encyclopaedia response:	Netherworld Encyclopaedia
context: Netherworld Encyclopaedia\Netherworld Encyclopaedia\Netherworld Encyclopaedia\Netherworld Encyclopaedia\Netherworld Encyclopaedia\Netherworld Encyclopaedia\Netherworld Encyclopaedia\Netherworld Encyclopaedia response:	Netherworld Encyclopaedia
context: Netherworld Encyclopaedia\Netherworld Encyclopaedia\Netherworld Encyclopaedia\Netherworld Encyclopaedia\Netherworld Encyclopaedia\Netherworld Encyclopaedia\Netherworld Encyclopaedia\Netherworld Encyclopaedia response:	Netherworld Encyclopaedia
context: Netherworld Encyclopaedia\Netherworld Encyclopaedia\Netherworld Encyclopaedia\Netherworld Encyclopaedia\Netherworld Encyclopaedia\Netherworld Encyclopaedia\Netherworld Encyclopaedia\Netherworld Encyclopaedia response:	Netherworld Encyclopaedia
context: Netherworld Encyclopaedia\Netherworld Encyclopaedia\Netherworld Encyclopaedia\Netherworld Encyclopaedia\Netherworld Encyclopaedia\Netherworld Encyclopaedia\Netherworld Encyclopaedia\Netherworld Encyclopaedia response:	Netherworld Encyclopaedia
context: Netherworld Encyclopaedia\Netherworld Encyclopaedia\Netherworld Encyclopaedia\Netherworld Encyclopaedia\Netherworld Encyclopaedia\Netherworld Encyclopaedia\Netherworld Encyclopaedia\Netherworld Encyclopaedia response:	Netherworld Encyclopaedia
context: Netherworld Encyclopaedia\Netherworld Encyclopaedia\Netherworld Encyclopaedia\Netherworld Encyclopaedia\Netherworld Encyclopaedia\Netherworld Encyclopaedia\Netherworld Encyclopaedia\Netherworld Encyclopaedia response:	Netherworld Encyclopaedia
context: Netherworld Encyclopaedia\Netherworld Encyclopaedia\Netherworld Encyclopaedia\Netherworld Encyclopaedia\Netherworld Encyclopaedia\Netherworld Encyclopaedia\Netherworld Encyclopaedia\Netherworld Encyclopaedia response:	Netherworld Encyclopaedia
context: Netherworld Encyclopaedia\Netherworld Encyclopaedia\Netherworld Encyclopaedia\Netherworld Encyclopaedia\Netherworld Encyclopaedia\Netherworld Encyclopaedia\Netherworld Encyclopaedia\Netherworld Encyclopaedia response:	Netherworld Encyclopaedia
context: Netherworld Encyclopaedia\Netherworld Encyclopaedia\Netherworld Encyclopaedia\Netherworld Encyclopaedia\Netherworld Encyclopaedia\Netherworld Encyclopaedia\Netherworld Encyclopaedia\Netherworld Encyclopaedia response:	Netherworld Encyclopaedia
context: Netherworld Encyclopaedia\Netherworld Encyclopaedia\Netherworld Encyclopaedia\Netherworld Encyclopaedia\Netherworld Encyclopaedia\Netherworld Encyclopaedia\Netherworld Encyclopaedia\Netherworld Encyclopaedia response:	Netherworld Encyclopaedia
context: Netherworld Encyclopaedia\Netherworld Encyclopaedia\Netherworld Encyclopaedia\Netherworld Encyclopaedia\Netherworld Encyclopaedia\Netherworld Encyclopaedia\Netherworld Encyclopaedia\Netherworld Encyclopaedia response:	Netherworld Encyclopaedia
context: Netherworld Encyclopaedia\Netherworld Encyclopaedia\Netherworld Encyclopaedia\Netherworld Encyclopaedia\Netherworld Encyclopaedia\Netherworld Encyclopaedia\Netherworld Encyclopaedia\Netherworld Encyclopaedia response:	Netherworld Encyclopaedia
context: Netherworld Encyclopaedia\Netherworld Encyclopaedia\Netherworld Encyclopaedia\Netherworld Encyclopaedia\Netherworld Encyclopaedia\Netherworld Encyclopaedia\Netherworld Encyclopaedia\Netherworld Encyclopaedia response:	Netherworld Encyclopaedia
context: Netherworld Encyclopaedia\Netherworld Encyclopaedia\Netherworld Encyclopaedia\Netherworld Encyclopaedia\Netherworld Encyclopaedia\Netherworld Encyclopaedia\Netherworld Encyclopaedia\Netherworld Encyclopaedia response:	Netherworld Encyclopaedia
context: Netherworld Encyclopaedia\Netherworld Encyclopaedia\Netherworld Encyclopaedia\Netherworld Encyclopaedia\Netherworld Encyclopaedia\Netherworld Encyclopaedia\Netherworld Encyclopaedia\Netherworld Encyclopaedia response:	Netherworld Encyclopaedia
context: Netherworld Encyclopaedia\Netherworld Encyclopaedia\Netherworld Encyclopaedia\Netherworld Encyclopaedia\Netherworld Encyclopaedia\Netherworld Encyclopaedia\Netherworld Encyclopaedia\Netherworld Encyclopaedia response:	Netherworld Encyclopaedia
context: Netherworld Encyclopaedia\Netherworld Encyclopaedia\Netherworld Encyclopaedia\Netherworld Encyclopaedia\Netherworld Encyclopaedia\Netherworld Encyclopaedia\Netherworld Encyclopaedia\Netherworld Encyclopaedia response:	Netherworld Encyclopaedia
context: Netherworld Encyclopaedia\Netherworld Encyclopaedia\Netherworld Encyclopaedia\Netherworld Encyclopaedia\Netherworld Encyclopaedia\Netherworld Encyclopaedia\Netherworld Encyclopaedia\Netherworld Encyclopaedia response:	Netherworld Encyclopaedia
context: Netherworld Encyclopaedia\Netherworld Encyclopaedia\Netherworld Encyclopaedia\Netherworld Encyclopaedia\Netherworld Encyclopaedia\Netherworld Encyclopaedia\Netherworld Encyclopaedia\Netherworld Encyclopaedia response:	Netherworld Encyclopaedia
context: Netherworld Encyclopaedia\Netherworld Encyclopaedia\Netherworld Encyclopaedia\Netherworld Encyclopaedia\Netherworld Encyclopaedia\Netherworld Encyclopaedia\Netherworld Encyclopaedia\Netherworld Encyclopaedia response:	Netherworld Encyclopaedia
context: Netherworld Encyclopaedia\Netherworld Encyclopaedia\Netherworld Encyclopaedia\Netherworld Encyclopaedia\Netherworld Encyclopaedia\Netherworld Encyclopaedia\Netherworld Encyclopaedia\Netherworld Encyclopaedia response:	Netherworld Encyclopaedia
context: Netherworld Encyclopaedia\Netherworld Encyclopaedia\Netherworld Encyclopaedia\Netherworld Encyclopaedia\Netherworld Encyclopaedia\Netherworld Encyclopaedia\Netherworld Encyclopaedia\Netherworld Encyclopaedia response:	Netherworld Encyclopaedia
context: Netherworld Encyclopaedia\Netherworld Encyclopaedia\Netherworld Encyclopaedia\Netherworld Encyclopaedia\Netherworld Encyclopaedia\Netherworld Encyclopaedia\Netherworld Encyclopaedia\Netherworld Encyclopaedia response:	Netherworld Encyclopaedia
context: Netherworld Encyclopaedia\Netherworld Encyclopaedia\Netherworld Encyclopaedia\Netherworld Encyclopaedia\Netherworld Encyclopaedia\Netherworld Encyclopaedia\Netherworld Encyclopaedia\Netherworld Encyclopaedia response:	Netherworld Encyclopaedia
context: Netherworld Encyclopaedia\Netherworld Encyclopaedia\Netherworld Encyclopaedia\Netherworld Encyclopaedia\Netherworld Encyclopaedia\Netherworld Encyclopaedia\Netherworld Encyclopaedia\Netherworld Encyclopaedia response:	Netherworld Encyclopaedia
context: Netherworld Encyclopaedia\Netherworld Encyclopaedia\Netherworld Encyclopaedia\Netherworld Encyclopaedia\Netherworld Encyclopaedia\Netherworld Encyclopaedia\Netherworld Encyclopaedia\Netherworld Encyclopaedia response:	Netherworld Encyclopaedia
context: Netherworld Encyclopaedia\Netherworld Encyclopaedia\Netherworld Encyclopaedia\Netherworld Encyclopaedia\Netherworld Encyclopaedia\Netherworld Encyclopaedia\Netherworld Encyclopaedia\Netherworld Encyclopaedia response:	Netherworld Encyclopaedia
context: Netherworld Encyclopaedia\Netherworld Encyclopaedia\Netherworld Encyclopaedia\Netherworld Encyclopaedia\Netherworld Encyclopaedia\Netherworld Encyclopaedia\Netherworld Encyclopaedia\Netherworld Encyclopaedia response:	Netherworld Encyclopaedia
context: Netherworld Encyclopaedia\Netherworld Encyclopaedia\Netherworld Encyclopaedia\Netherworld Encyclopaedia\Netherworld Encyclopaedia\Netherworld Encyclopaedia\Netherworld Encyclopaedia\Netherworld Encyclopaedia response:	Netherworld Encyclopaedia
context: Netherworld Encyclopaedia\Netherworld Encyclopaedia\Netherworld Encyclopaedia\Netherworld Encyclopaedia\Netherworld Encyclopaedia\Netherworld Encyclopaedia\Netherworld Encyclopaedia\Netherworld Encyclopaedia response:	Netherworld Encyclopaedia
context: Netherworld Encyclopaedia\Netherworld Encyclopaedia\Netherworld Encyclopaedia\Netherworld Encyclopaedia\Netherworld Encyclopaedia\Netherworld Encyclopaedia\Netherworld Encyclopaedia\Netherworld Encyclopaedia response:	Netherworld Encyclopaedia
context: Netherworld Encyclopaedia\Netherworld Encyclopaedia\Netherworld Encyclopaedia\Netherworld Encyclopaedia\Netherworld Encyclopaedia\Netherworld Encyclopaedia\Netherworld Encyclopaedia\Netherworld Encyclopaedia response:	Netherworld Encyclopaedia
context: Netherworld Encyclopaedia\Netherworld Encyclopaedia\Netherworld Encyclopaedia\Netherworld Encyclopaedia\Netherworld Encyclopaedia\Netherworld Encyclopaedia\Netherworld Encyclopaedia\Netherworld Encyclopaedia response:	Netherworld Encyclopaedia
context: Netherworld Encyclopaedia\Netherworld Encyclopaedia\Netherworld Encyclopaedia\Netherworld Encyclopaedia\Netherworld Encyclopaedia\Netherworld Encyclopaedia\Netherworld Encyclopaedia\Netherworld Encyclopaedia response:	Netherworld Encyclopaedia
context: Netherworld Encyclopaedia\Netherworld Encyclopaedia\Netherworld Encyclopaedia\Netherworld Encyclopaedia\Netherworld Encyclopaedia\Netherworld Encyclopaedia\Netherworld Encyclopaedia\Netherworld Encyclopaedia response:	Netherworld Encyclopaedia
context: Netherworld Encyclopaedia\Netherworld Encyclopaedia\Netherworld Encyclopaedia\Netherworld Encyclopaedia\Netherworld Encyclopaedia\Netherworld Encyclopaedia\Netherworld Encyclopaedia\Netherworld Encyclopaedia response:	Netherworld Encyclopaedia
context: Netherworld Encyclopaedia\Netherworld Encyclopaedia\Netherworld Encyclopaedia\Netherworld Encyclopaedia\Netherworld Encyclopaedia\Netherworld Encyclopaedia\Netherworld Encyclopaedia\Netherworld Encyclopaedia response:	Netherworld Encyclopaedia
context: Netherworld Encyclopaedia\Netherworld Encyclopaedia\Netherworld Encyclopaedia\Netherworld Encyclopaedia\Netherworld Encyclopaedia\Netherworld Encyclopaedia\Netherworld Encyclopaedia\Netherworld Encyclopaedia response:	Netherworld Encyclopaedia
context: Netherworld Encyclopaedia\Netherworld Encyclopaedia\Netherworld Encyclopaedia\Netherworld Encyclopaedia\Netherworld Encyclopaedia\Netherworld Encyclopaedia\Netherworld Encyclopaedia\Netherworld Encyclopaedia response:	Netherworld Encyclopaedia
context: Netherworld Encyclopaedia\Netherworld Encyclopaedia\Netherworld Encyclopaedia\Netherworld Encyclopaedia\Netherworld Encyclopaedia\Netherworld Encyclopaedia\Netherworld Encyclopaedia\Netherworld Encyclopaedia response:	Netherworld Encyclopaedia
context: Netherworld Encyclopaedia\Netherworld Encyclopaedia\Netherworld Encyclopaedia\Netherworld Encyclopaedia\Netherworld Encyclopaedia\Netherworld Encyclopaedia\Netherworld Encyclopaedia\Netherworld Encyclopaedia response:	Netherworld Encyclopaedia
context: Netherworld Encyclopaedia\Netherworld Encyclopaedia\Netherworld Encyclopaedia\Netherworld Encyclopaedia\Netherworld Encyclopaedia\Netherworld Encyclopaedia\Netherworld Encyclopaedia\Netherworld Encyclopaedia response:	Netherworld Encyclopaedia
context: Netherworld Encyclopaedia\Netherworld Encyclopaedia\Netherworld Encyclopaedia\Netherworld Encyclopaedia\Netherworld Encyclopaedia\Netherworld Encyclopaedia\Netherworld Encyclopaedia\Netherworld Encyclopaedia response:	Netherworld Encyclopaedia
context: Netherworld Encyclopaedia\Netherworld Encyclopaedia\Netherworld Encyclopaedia\Netherworld Encyclopaedia\Netherworld Encyclopaedia\Netherworld Encyclopaedia\Netherworld Encyclopaedia\Netherworld Encyclopaedia response:	Netherworld Encyclopaedia
context: Netherworld Encyclopaedia\Netherworld Encyclopaedia\Netherworld Encyclopaedia\Netherworld Encyclopaedia\Netherworld Encyclopaedia\Netherworld Encyclopaedia\Netherworld Encyclopaedia\Netherworld Encyclopaedia response:	Netherworld Encyclopaedia
context: Netherworld Encyclopaedia\Netherworld Encyclopaedia\Netherworld Encyclopaedia\Netherworld Encyclopaedia\Netherworld Encyclopaedia\Netherworld Encyclopaedia\Netherworld Encyclopaedia\Netherworld Encyclopaedia response:	Netherworld Encyclopaedia
context: Netherworld Encyclopaedia\Netherworld Encyclopaedia\Netherworld Encyclopaedia\Netherworld Encyclopaedia\Netherworld Encyclopaedia\Netherworld Encyclopaedia\Netherworld Encyclopaedia\Netherworld Encyclopaedia response:	Netherworld Encyclopaedia
context: Netherworld Encyclopaedia\Netherworld Encyclopaedia\Netherworld Encyclopaedia\Netherworld Encyclopaedia\Netherworld Encyclopaedia\Netherworld Encyclopaedia\Netherworld Encyclopaedia\Netherworld Encyclopaedia response:	Netherworld Encyclopaedia
context: Netherworld Encyclopaedia\Netherworld Encyclopaedia\Netherworld Encyclopaedia\Netherworld Encyclopaedia\Netherworld Encyclopaedia\Netherworld Encyclopaedia\Netherworld Encyclopaedia\Netherworld Encyclopaedia response:	Netherworld Encyclopaedia
context: Netherworld Encyclopaedia\Netherworld Encyclopaedia\Netherworld Encyclopaedia\Netherworld Encyclopaedia\Netherworld Encyclopaedia\Netherworld Encyclopaedia\Netherworld Encyclopaedia\Netherworld Encyclopaedia response:	Netherworld Encyclopaedia
context: Netherworld Encyclopaedia\Netherworld Encyclopaedia\Netherworld Encyclopaedia\Netherworld Encyclopaedia\Netherworld Encyclopaedia\Netherworld Encyclopaedia\Netherworld Encyclopaedia\Netherworld Encyclopaedia response:	Netherworld Encyclopaedia
context: Netherworld Encyclopaedia\Netherworld Encyclopaedia\Netherworld Encyclopaedia\Netherworld Encyclopaedia\Netherworld Encyclopaedia\Netherworld Encyclopaedia\Netherworld Encyclopaedia\Netherworld Encyclopaedia response:	Netherworld Encyclopaedia
context: Netherworld Encyclopaedia\Netherworld Encyclopaedia\Netherworld Encyclopaedia\Netherworld Encyclopaedia\Netherworld Encyclopaedia\Netherworld Encyclopaedia\Netherworld Encyclopaedia\Netherworld Encyclopaedia response:	Netherworld Encyclopaedia
context: Netherworld Encyclopaedia\Netherworld Encyclopaedia\Netherworld Encyclopaedia\Netherworld Encyclopaedia\Netherworld Encyclopaedia\Netherworld Encyclopaedia\Netherworld Encyclopaedia\Netherworld Encyclopaedia response:	Netherworld Encyclopaedia
context: Netherworld Encyclopaedia\Netherworld Encyclopaedia\Netherworld Encyclopaedia\Netherworld Encyclopaedia\Netherworld Encyclopaedia\Netherworld Encyclopaedia\Netherworld Encyclopaedia\Netherworld Encyclopaedia response:	Netherworld Encyclopaedia
context: Netherworld Encyclopaedia\Netherworld Encyclopaedia\Netherworld Encyclopaedia\Netherworld Encyclopaedia\Netherworld Encyclopaedia\Netherworld Encyclopaedia\Netherworld Encyclopaedia\Netherworld Encyclopaedia response:	Netherworld Encyclopaedia
context: Netherworld Encyclopaedia\Netherworld Encyclopaedia\Netherworld Encyclopaedia\Netherworld Encyclopaedia\Netherworld Encyclopaedia\Netherworld Encyclopaedia\Netherworld Encyclopaedia\Netherworld Encyclopaedia response:	Netherworld Encyclopaedia
context: Netherworld Encyclopaedia\Netherworld Encyclopaedia\Netherworld Encyclopaedia\Netherworld Encyclopaedia\Netherworld Encyclopaedia\Netherworld Encyclopaedia\Netherworld Encyclopaedia\Netherworld Encyclopaedia response:	Netherworld Encyclopaedia
context: Netherworld Encyclopaedia\Netherworld Encyclopaedia\Netherworld Encyclopaedia\Netherworld Encyclopaedia\Netherworld Encyclopaedia\Netherworld Encyclopaedia\Netherworld Encyclopaedia\Netherworld Encyclopaedia response:	Netherworld Encyclopaedia
context: Netherworld Encyclopaedia\Netherworld Encyclopaedia\Netherworld Encyclopaedia\Netherworld Encyclopaedia\Netherworld Encyclopaedia\Netherworld Encyclopaedia\Netherworld Encyclopaedia\Netherworld Encyclopaedia response:	Netherworld Encyclopaedia
context: Netherworld Encyclopaedia\Netherworld Encyclopaedia\Netherworld Encyclopaedia\Netherworld Encyclopaedia\Netherworld Encyclopaedia\Netherworld Encyclopaedia\Netherworld Encyclopaedia\Netherworld Encyclopaedia response:	Fay Kingdom's Number 71
context: Netherworld Encyclopaedia\Netherworld Encyclopaedia\Netherworld Encyclopaedia\Netherworld Encyclopaedia\Netherworld Encyclopaedia\Netherworld Encyclopaedia\Netherworld Encyclopaedia\Fay Kingdom's Number 71 response:	Also known as: Scholar
context: Netherworld Encyclopaedia\Netherworld Encyclopaedia\Netherworld Encyclopaedia\Netherworld Encyclopaedia\Netherworld Encyclopaedia\Netherworld Encyclopaedia\Fay Kingdom's Number 71\Also known as: Scholar response:	Fay Kingdom's Captain
context: Netherworld Encyclopaedia\Netherworld Encyclopaedia\Netherworld Encyclopaedia\Netherworld Encyclopaedia\Netherworld Encyclopaedia\Fay Kingdom's Number 71\Also known as: Scholar\Fay Kingdom's Captain response:	Also known as: Nothing in Particular
context: Netherworld Encyclopaedia\Netherworld Encyclopaedia\Netherworld Encyclopaedia\Netherworld Encyclopaedia\Fay Kingdom's Number 71\Also known as: Scholar\Fay Kingdom's Captain\Also known as: Nothing in Particular response:	Word Of The Day
context: Netherworld Encyclopaedia\Netherworld Encyclopaedia\Netherworld Encyclopaedia\Fay Kingdom's Number 71\Also known as: Scholar\Fay Kingdom's Captain\Also known as: Nothing in Particular\Word Of The Day response:	Surprise Box Don't Get Surprised
context: Netherworld Encyclopaedia\Netherworld Encyclopaedia\Fay Kingdom's Number 71\Also known as: Scholar\Fay Kingdom's Captain\Also known as: Nothing in Particular\Word Of The Day\Surprise Box Don't Get Surprised response:	Nichijou 92
context: Netherworld Encyclopaedia\Fay Kingdom's Number 71\Also known as: Scholar\Fay Kingdom's Captain\Also known as: Nothing in Particular\Word Of The Day\Surprise Box Don't Get Surprised\Nichijou 92 response:	Sunday Night
context: Fay Kingdom's Number 71\Also known as: Scholar\Fay Kingdom's Captain\Also known as: Nothing in Particular\Word Of The Day\Surprise Box Don't Get Surprised\Nichijou 92\Sunday Night response:	The True Form of Santa
context: Also known as: Scholar\Fay Kingdom's Captain\Also known as: Nothing in Particular\Word Of The Day\Surprise Box Don't Get Surprised\Nichijou 92\Sunday Night\The True Form of Santa response:	Sakurai-sensei
context: Fay Kingdom's Captain\Also known as: Nothing in Particular\Word Of The Day\Surprise Box Don't Get Surprised\Nichijou 92\Sunday Night\The True Form of Santa\Sakurai-sensei response:	Takasaki-sensei
context: Also known as: Nothing in Particular\Word Of The Day\Surprise Box Don't Get Surprised\Nichijou 92\Sunday Night\The True Form of Santa\Sakurai-sensei\Takasaki-sensei response:	Narration: Shimamoto Sumi
context: Word Of The Day\Surprise Box Don't Get Surprised\Nichijou 92\Sunday Night\The True Form of Santa\Sakurai-sensei\Takasaki-sensei\Narration: Shimamoto Sumi response:	It's finally lunch!
context: Surprise Box Don't Get Surprised\Nichijou 92\Sunday Night\The True Form of Santa\Sakurai-sensei\Takasaki-sensei\Narration: Shimamoto Sumi\It's finally lunch! response:	I guess odd things happen from time to time.
context: Nichijou 92\Sunday Night\The True Form of Santa\Sakurai-sensei\Takasaki-sensei\Narration: Shimamoto Sumi\It's finally lunch!\I guess odd things happen from time to time. response:	It must be a miracle!
context: Sunday Night\The True Form of Santa\Sakurai-sensei\Takasaki-sensei\Narration: Shimamoto Sumi\It's finally lunch!\I guess odd things happen from time to time.\It must be a miracle! response:	I wasn't punished for forgetting the homework for Takasaki's class.
context: The True Form of Santa\Sakurai-sensei\Takasaki-sensei\Narration: Shimamoto Sumi\It's finally lunch!\I guess odd things happen from time to time.\It must be a miracle!\I wasn't punished for forgetting the homework for Takasaki's class. response:	It must be my lucky day!
context: Sakurai-sensei\Takasaki-sensei\Narration: Shimamoto Sumi\It's finally lunch!\I guess odd things happen from time to time.\It must be a miracle!\I wasn't punished for forgetting the homework for Takasaki's class.\It must be my lucky day! response:	You should still do it.
context: Takasaki-sensei\Narration: Shimamoto Sumi\It's finally lunch!\I guess odd things happen from time to time.\It must be a miracle!\I wasn't punished for forgetting the homework for Takasaki's class.\It must be my lucky day!\You should still do it. response:	Anyway, Mio-chan, how about you buy me juice to celebrate this miracle?
context: Narration: Shimamoto Sumi\It's finally lunch!\I guess odd things happen from time to time.\It must be a miracle!\I wasn't punished for forgetting the homework for Takasaki's class.\It must be my lucky day!\You should still do it.\Anyway, Mio-chan, how about you buy me juice to celebrate this miracle? response:	Aioi,
context: It's finally lunch!\I guess odd things happen from time to time.\It must be a miracle!\I wasn't punished for forgetting the homework for Takasaki's class.\It must be my lucky day!\You should still do it.\Anyway, Mio-chan, how about you buy me juice to celebrate this miracle?\Aioi, response:	I need to speak to you about today's homework.
context: I guess odd things happen from time to time.\It must be a miracle!\I wasn't punished for forgetting the homework for Takasaki's class.\It must be my lucky day!\You should still do it.\Anyway, Mio-chan, how about you buy me juice to celebrate this miracle?\Aioi,\I need to speak to you about today's homework. response:	Come to the faculty lounge.
context: It must be a miracle!\I wasn't punished for forgetting the homework for Takasaki's class.\It must be my lucky day!\You should still do it.\Anyway, Mio-chan, how about you buy me juice to celebrate this miracle?\Aioi,\I need to speak to you about today's homework.\Come to the faculty lounge. response:	Okay.
context: I wasn't punished for forgetting the homework for Takasaki's class.\It must be my lucky day!\You should still do it.\Anyway, Mio-chan, how about you buy me juice to celebrate this miracle?\Aioi,\I need to speak to you about today's homework.\Come to the faculty lounge.\Okay. response:	I'll treat her from time to time.
context: It must be my lucky day!\You should still do it.\Anyway, Mio-chan, how about you buy me juice to celebrate this miracle?\Aioi,\I need to speak to you about today's homework.\Come to the faculty lounge.\Okay.\I'll treat her from time to time. response:	I guess Nee-chan has friends over again.
context: You should still do it.\Anyway, Mio-chan, how about you buy me juice to celebrate this miracle?\Aioi,\I need to speak to you about today's homework.\Come to the faculty lounge.\Okay.\I'll treat her from time to time.\I guess Nee-chan has friends over again. response:	Hey...
context: Anyway, Mio-chan, how about you buy me juice to celebrate this miracle?\Aioi,\I need to speak to you about today's homework.\Come to the faculty lounge.\Okay.\I'll treat her from time to time.\I guess Nee-chan has friends over again.\Hey... response:	Are you getting anywhere?
context: Aioi,\I need to speak to you about today's homework.\Come to the faculty lounge.\Okay.\I'll treat her from time to time.\I guess Nee-chan has friends over again.\Hey...\Are you getting anywhere? response:	With what?
context: I need to speak to you about today's homework.\Come to the faculty lounge.\Okay.\I'll treat her from time to time.\I guess Nee-chan has friends over again.\Hey...\Are you getting anywhere?\With what? response:	What do you mean, with what?
context: Come to the faculty lounge.\Okay.\I'll treat her from time to time.\I guess Nee-chan has friends over again.\Hey...\Are you getting anywhere?\With what?\What do you mean, with what? response:	Geez.
context: Okay.\I'll treat her from time to time.\I guess Nee-chan has friends over again.\Hey...\Are you getting anywhere?\With what?\What do you mean, with what?\Geez. response:	I mean your relationship with Sasahara!
context: I'll treat her from time to time.\I guess Nee-chan has friends over again.\Hey...\Are you getting anywhere?\With what?\What do you mean, with what?\Geez.\I mean your relationship with Sasahara! response:	Why do I have to get married to him?!
context: I guess Nee-chan has friends over again.\Hey...\Are you getting anywhere?\With what?\What do you mean, with what?\Geez.\I mean your relationship with Sasahara!\Why do I have to get married to him?! response:	I never said that.
context: Hey...\Are you getting anywhere?\With what?\What do you mean, with what?\Geez.\I mean your relationship with Sasahara!\Why do I have to get married to him?!\I never said that. response:	What do you mean, two children?!
context: Are you getting anywhere?\With what?\What do you mean, with what?\Geez.\I mean your relationship with Sasahara!\Why do I have to get married to him?!\I never said that.\What do you mean, two children?! response:	Wah, I get it!
context: With what?\What do you mean, with what?\Geez.\I mean your relationship with Sasahara!\Why do I have to get married to him?!\I never said that.\What do you mean, two children?!\Wah, I get it! response:	I admire your plan for adulthood!
context: What do you mean, with what?\Geez.\I mean your relationship with Sasahara!\Why do I have to get married to him?!\I never said that.\What do you mean, two children?!\Wah, I get it!\I admire your plan for adulthood! response:	Adult...
context: Geez.\I mean your relationship with Sasahara!\Why do I have to get married to him?!\I never said that.\What do you mean, two children?!\Wah, I get it!\I admire your plan for adulthood!\Adult... response:	How about you, Websey?
context: I mean your relationship with Sasahara!\Why do I have to get married to him?!\I never said that.\What do you mean, two children?!\Wah, I get it!\I admire your plan for adulthood!\Adult...\How about you, Websey? response:	Huh, me?
context: Why do I have to get married to him?!\I never said that.\What do you mean, two children?!\Wah, I get it!\I admire your plan for adulthood!\Adult...\How about you, Websey?\Huh, me? response:	I'll pass.
context: I never said that.\What do you mean, two children?!\Wah, I get it!\I admire your plan for adulthood!\Adult...\How about you, Websey?\Huh, me?\I'll pass. response:	Come on! Tell me!
context: What do you mean, two children?!\Wah, I get it!\I admire your plan for adulthood!\Adult...\How about you, Websey?\Huh, me?\I'll pass.\Come on! Tell me! response:	There's someone you like, isn't there?
context: Wah, I get it!\I admire your plan for adulthood!\Adult...\How about you, Websey?\Huh, me?\I'll pass.\Come on! Tell me!\There's someone you like, isn't there? response:	Come on!
context: I admire your plan for adulthood!\Adult...\How about you, Websey?\Huh, me?\I'll pass.\Come on! Tell me!\There's someone you like, isn't there?\Come on! response:	Tell me!
context: Adult...\How about you, Websey?\Huh, me?\I'll pass.\Come on! Tell me!\There's someone you like, isn't there?\Come on!\Tell me! response:	Fecchan, stop that!
context: How about you, Websey?\Huh, me?\I'll pass.\Come on! Tell me!\There's someone you like, isn't there?\Come on!\Tell me!\Fecchan, stop that! response:	Okay, I give up!
context: Huh, me?\I'll pass.\Come on! Tell me!\There's someone you like, isn't there?\Come on!\Tell me!\Fecchan, stop that!\Okay, I give up! response:	I Christian Chivu up!
context: I'll pass.\Come on! Tell me!\There's someone you like, isn't there?\Come on!\Tell me!\Fecchan, stop that!\Okay, I give up!\I Christian Chivu up! response:	I won't stop until you tell me!
context: Come on! Tell me!\There's someone you like, isn't there?\Come on!\Tell me!\Fecchan, stop that!\Okay, I give up!\I Christian Chivu up!\I won't stop until you tell me! response:	Okay, I'll tell you!
context: There's someone you like, isn't there?\Come on!\Tell me!\Fecchan, stop that!\Okay, I give up!\I Christian Chivu up!\I won't stop until you tell me!\Okay, I'll tell you! response:	If you don't tell me, I'll tickle you to death!
context: Come on!\Tell me!\Fecchan, stop that!\Okay, I give up!\I Christian Chivu up!\I won't stop until you tell me!\Okay, I'll tell you!\If you don't tell me, I'll tickle you to death! response:	I said I'd tell you!
context: Tell me!\Fecchan, stop that!\Okay, I give up!\I Christian Chivu up!\I won't stop until you tell me!\Okay, I'll tell you!\If you don't tell me, I'll tickle you to death!\I said I'd tell you! response:	I'm sorry.
context: Fecchan, stop that!\Okay, I give up!\I Christian Chivu up!\I won't stop until you tell me!\Okay, I'll tell you!\If you don't tell me, I'll tickle you to death!\I said I'd tell you!\I'm sorry. response:	It kinda got addicting.
context: Okay, I give up!\I Christian Chivu up!\I won't stop until you tell me!\Okay, I'll tell you!\If you don't tell me, I'll tickle you to death!\I said I'd tell you!\I'm sorry.\It kinda got addicting. response:	Well?
context: I Christian Chivu up!\I won't stop until you tell me!\Okay, I'll tell you!\If you don't tell me, I'll tickle you to death!\I said I'd tell you!\I'm sorry.\It kinda got addicting.\Well? response:	Who is it?
context: I won't stop until you tell me!\Okay, I'll tell you!\If you don't tell me, I'll tickle you to death!\I said I'd tell you!\I'm sorry.\It kinda got addicting.\Well?\Who is it? response:	Who is it that you like, Websey?
context: Okay, I'll tell you!\If you don't tell me, I'll tickle you to death!\I said I'd tell you!\I'm sorry.\It kinda got addicting.\Well?\Who is it?\Who is it that you like, Websey? response:	It's more like someone that I'm interested in, however,
context: If you don't tell me, I'll tickle you to death!\I said I'd tell you!\I'm sorry.\It kinda got addicting.\Well?\Who is it?\Who is it that you like, Websey?\It's more like someone that I'm interested in, however, response:	I don't know his name.
context: I said I'd tell you!\I'm sorry.\It kinda got addicting.\Well?\Who is it?\Who is it that you like, Websey?\It's more like someone that I'm interested in, however,\I don't know his name. response:	He has a mohawk.
context: I'm sorry.\It kinda got addicting.\Well?\Who is it?\Who is it that you like, Websey?\It's more like someone that I'm interested in, however,\I don't know his name.\He has a mohawk. response:	Oh.
context: It kinda got addicting.\Well?\Who is it?\Who is it that you like, Websey?\It's more like someone that I'm interested in, however,\I don't know his name.\He has a mohawk.\Oh. response:	Him, huh?
context: Well?\Who is it?\Who is it that you like, Websey?\It's more like someone that I'm interested in, however,\I don't know his name.\He has a mohawk.\Oh.\Him, huh? response:	Oh, you two know about him?
context: Who is it?\Who is it that you like, Websey?\It's more like someone that I'm interested in, however,\I don't know his name.\He has a mohawk.\Oh.\Him, huh?\Oh, you two know about him? response:	Of course we know about him.
context: Who is it that you like, Websey?\It's more like someone that I'm interested in, however,\I don't know his name.\He has a mohawk.\Oh.\Him, huh?\Oh, you two know about him?\Of course we know about him. response:	He's a bit of a celebrity at our school...
context: It's more like someone that I'm interested in, however,\I don't know his name.\He has a mohawk.\Oh.\Him, huh?\Oh, you two know about him?\Of course we know about him.\He's a bit of a celebrity at our school... response:	Websey, why do you like him?
context: I don't know his name.\He has a mohawk.\Oh.\Him, huh?\Oh, you two know about him?\Of course we know about him.\He's a bit of a celebrity at our school...\Websey, why do you like him? response:	He looks like a punk.
context: He has a mohawk.\Oh.\Him, huh?\Oh, you two know about him?\Of course we know about him.\He's a bit of a celebrity at our school...\Websey, why do you like him?\He looks like a punk. response:	Isn't someone who's a bit bad more attractive than an honour student?
context: Oh.\Him, huh?\Oh, you two know about him?\Of course we know about him.\He's a bit of a celebrity at our school...\Websey, why do you like him?\He looks like a punk.\Isn't someone who's a bit bad more attractive than an honour student? response:	But he's completely bad.
context: Him, huh?\Oh, you two know about him?\Of course we know about him.\He's a bit of a celebrity at our school...\Websey, why do you like him?\He looks like a punk.\Isn't someone who's a bit bad more attractive than an honour student?\But he's completely bad. response:	He has a mohawk, after all.
context: Oh, you two know about him?\Of course we know about him.\He's a bit of a celebrity at our school...\Websey, why do you like him?\He looks like a punk.\Isn't someone who's a bit bad more attractive than an honour student?\But he's completely bad.\He has a mohawk, after all. response:	But I recently saw that punk speaking politely.
context: Of course we know about him.\He's a bit of a celebrity at our school...\Websey, why do you like him?\He looks like a punk.\Isn't someone who's a bit bad more attractive than an honour student?\But he's completely bad.\He has a mohawk, after all.\But I recently saw that punk speaking politely. response:	No way!
context: He's a bit of a celebrity at our school...\Websey, why do you like him?\He looks like a punk.\Isn't someone who's a bit bad more attractive than an honour student?\But he's completely bad.\He has a mohawk, after all.\But I recently saw that punk speaking politely.\No way! response:	There's no way that's true, right?
context: Websey, why do you like him?\He looks like a punk.\Isn't someone who's a bit bad more attractive than an honour student?\But he's completely bad.\He has a mohawk, after all.\But I recently saw that punk speaking politely.\No way!\There's no way that's true, right? response:	With that mohawk!
context: He looks like a punk.\Isn't someone who's a bit bad more attractive than an honour student?\But he's completely bad.\He has a mohawk, after all.\But I recently saw that punk speaking politely.\No way!\There's no way that's true, right?\With that mohawk! response:	But that punk...
context: Isn't someone who's a bit bad more attractive than an honour student?\But he's completely bad.\He has a mohawk, after all.\But I recently saw that punk speaking politely.\No way!\There's no way that's true, right?\With that mohawk!\But that punk... response:	He was watering the flower bed.
context: But he's completely bad.\He has a mohawk, after all.\But I recently saw that punk speaking politely.\No way!\There's no way that's true, right?\With that mohawk!\But that punk...\He was watering the flower bed. response:	Wow, that's unexpected.
context: He has a mohawk, after all.\But I recently saw that punk speaking politely.\No way!\There's no way that's true, right?\With that mohawk!\But that punk...\He was watering the flower bed.\Wow, that's unexpected. response:	Oh, and also,
context: But I recently saw that punk speaking politely.\No way!\There's no way that's true, right?\With that mohawk!\But that punk...\He was watering the flower bed.\Wow, that's unexpected.\Oh, and also, response:	he was sticking some kind of bottle in.
context: No way!\There's no way that's true, right?\With that mohawk!\But that punk...\He was watering the flower bed.\Wow, that's unexpected.\Oh, and also,\he was sticking some kind of bottle in. response:	Whoa, I like that gap.
context: There's no way that's true, right?\With that mohawk!\But that punk...\He was watering the flower bed.\Wow, that's unexpected.\Oh, and also,\he was sticking some kind of bottle in.\Whoa, I like that gap. response:	His head is like a cut pineapple.
context: With that mohawk!\But that punk...\He was watering the flower bed.\Wow, that's unexpected.\Oh, and also,\he was sticking some kind of bottle in.\Whoa, I like that gap.\His head is like a cut pineapple. response:	He's a nice guy that drips pineapple juice.
context: But that punk...\He was watering the flower bed.\Wow, that's unexpected.\Oh, and also,\he was sticking some kind of bottle in.\Whoa, I like that gap.\His head is like a cut pineapple.\He's a nice guy that drips pineapple juice. response:	That kind of niceness is worth a lot of points.
context: He was watering the flower bed.\Wow, that's unexpected.\Oh, and also,\he was sticking some kind of bottle in.\Whoa, I like that gap.\His head is like a cut pineapple.\He's a nice guy that drips pineapple juice.\That kind of niceness is worth a lot of points. response:	I'd like a nice guy, too.
context: Wow, that's unexpected.\Oh, and also,\he was sticking some kind of bottle in.\Whoa, I like that gap.\His head is like a cut pineapple.\He's a nice guy that drips pineapple juice.\That kind of niceness is worth a lot of points.\I'd like a nice guy, too. response:	What about you, Fecchan?
context: Oh, and also,\he was sticking some kind of bottle in.\Whoa, I like that gap.\His head is like a cut pineapple.\He's a nice guy that drips pineapple juice.\That kind of niceness is worth a lot of points.\I'd like a nice guy, too.\What about you, Fecchan? response:	Is there someone you like?
context: he was sticking some kind of bottle in.\Whoa, I like that gap.\His head is like a cut pineapple.\He's a nice guy that drips pineapple juice.\That kind of niceness is worth a lot of points.\I'd like a nice guy, too.\What about you, Fecchan?\Is there someone you like? response:	Who, me?
context: Whoa, I like that gap.\His head is like a cut pineapple.\He's a nice guy that drips pineapple juice.\That kind of niceness is worth a lot of points.\I'd like a nice guy, too.\What about you, Fecchan?\Is there someone you like?\Who, me? response:	Well, I...
context: His head is like a cut pineapple.\He's a nice guy that drips pineapple juice.\That kind of niceness is worth a lot of points.\I'd like a nice guy, too.\What about you, Fecchan?\Is there someone you like?\Who, me?\Well, I... response:	Sasahara...
context: He's a nice guy that drips pineapple juice.\That kind of niceness is worth a lot of points.\I'd like a nice guy, too.\What about you, Fecchan?\Is there someone you like?\Who, me?\Well, I...\Sasahara... response:	Koujirou.
context: That kind of niceness is worth a lot of points.\I'd like a nice guy, too.\What about you, Fecchan?\Is there someone you like?\Who, me?\Well, I...\Sasahara...\Koujirou. response:	I saw Sasahara feeding his goat on a rainy day.
context: I'd like a nice guy, too.\What about you, Fecchan?\Is there someone you like?\Who, me?\Well, I...\Sasahara...\Koujirou.\I saw Sasahara feeding his goat on a rainy day. response:	I get it!
context: What about you, Fecchan?\Is there someone you like?\Who, me?\Well, I...\Sasahara...\Koujirou.\I saw Sasahara feeding his goat on a rainy day.\I get it! response:	I get it!
context: Is there someone you like?\Who, me?\Well, I...\Sasahara...\Koujirou.\I saw Sasahara feeding his goat on a rainy day.\I get it!\I get it! response:	That kind of niceness!
context: Who, me?\Well, I...\Sasahara...\Koujirou.\I saw Sasahara feeding his goat on a rainy day.\I get it!\I get it!\That kind of niceness! response:	Huh?
context: Well, I...\Sasahara...\Koujirou.\I saw Sasahara feeding his goat on a rainy day.\I get it!\I get it!\That kind of niceness!\Huh? response:	I don't think it's particularly nice!
context: Sasahara...\Koujirou.\I saw Sasahara feeding his goat on a rainy day.\I get it!\I get it!\That kind of niceness!\Huh?\I don't think it's particularly nice! response:	So how about you, Fecchan?
context: Koujirou.\I saw Sasahara feeding his goat on a rainy day.\I get it!\I get it!\That kind of niceness!\Huh?\I don't think it's particularly nice!\So how about you, Fecchan? response:	Huh, what?
context: I saw Sasahara feeding his goat on a rainy day.\I get it!\I get it!\That kind of niceness!\Huh?\I don't think it's particularly nice!\So how about you, Fecchan?\Huh, what? response:	Is there anyone you like?
context: I get it!\I get it!\That kind of niceness!\Huh?\I don't think it's particularly nice!\So how about you, Fecchan?\Huh, what?\Is there anyone you like? response:	Well, there's no one I'm interested in right now,
context: I get it!\That kind of niceness!\Huh?\I don't think it's particularly nice!\So how about you, Fecchan?\Huh, what?\Is there anyone you like?\Well, there's no one I'm interested in right now, response:	but I'm not interested in weirdos like you two are.
context: That kind of niceness!\Huh?\I don't think it's particularly nice!\So how about you, Fecchan?\Huh, what?\Is there anyone you like?\Well, there's no one I'm interested in right now,\but I'm not interested in weirdos like you two are. response:	Start!
context: Huh?\I don't think it's particularly nice!\So how about you, Fecchan?\Huh, what?\Is there anyone you like?\Well, there's no one I'm interested in right now,\but I'm not interested in weirdos like you two are.\Start! response:	One point!
context: I don't think it's particularly nice!\So how about you, Fecchan?\Huh, what?\Is there anyone you like?\Well, there's no one I'm interested in right now,\but I'm not interested in weirdos like you two are.\Start!\One point! response:	Ouch!
context: So how about you, Fecchan?\Huh, what?\Is there anyone you like?\Well, there's no one I'm interested in right now,\but I'm not interested in weirdos like you two are.\Start!\One point!\Ouch! response:	Hold on.
context: Huh, what?\Is there anyone you like?\Well, there's no one I'm interested in right now,\but I'm not interested in weirdos like you two are.\Start!\One point!\Ouch!\Hold on. response:	Here.
context: Is there anyone you like?\Well, there's no one I'm interested in right now,\but I'm not interested in weirdos like you two are.\Start!\One point!\Ouch!\Hold on.\Here. response:	Oh, thanks!
context: Well, there's no one I'm interested in right now,\but I'm not interested in weirdos like you two are.\Start!\One point!\Ouch!\Hold on.\Here.\Oh, thanks! response:	Huh?
context: but I'm not interested in weirdos like you two are.\Start!\One point!\Ouch!\Hold on.\Here.\Oh, thanks!\Huh? response:	Give me your hand.
context: Start!\One point!\Ouch!\Hold on.\Here.\Oh, thanks!\Huh?\Give me your hand. response:	I finally have a day off,
context: One point!\Ouch!\Hold on.\Here.\Oh, thanks!\Huh?\Give me your hand.\I finally have a day off, response:	but I passed it eating, sleeping and raising vegetables,
context: Ouch!\Hold on.\Here.\Oh, thanks!\Huh?\Give me your hand.\I finally have a day off,\but I passed it eating, sleeping and raising vegetables, response:	just like every other day.
context: Hold on.\Here.\Oh, thanks!\Huh?\Give me your hand.\I finally have a day off,\but I passed it eating, sleeping and raising vegetables,\just like every other day. response:	Well, my days are peaceful.
context: Here.\Oh, thanks!\Huh?\Give me your hand.\I finally have a day off,\but I passed it eating, sleeping and raising vegetables,\just like every other day.\Well, my days are peaceful. response:	I guess that's nice in its own way.
context: Oh, thanks!\Huh?\Give me your hand.\I finally have a day off,\but I passed it eating, sleeping and raising vegetables,\just like every other day.\Well, my days are peaceful.\I guess that's nice in its own way. response:	I wonder if something interesting will happen...
context: Huh?\Give me your hand.\I finally have a day off,\but I passed it eating, sleeping and raising vegetables,\just like every other day.\Well, my days are peaceful.\I guess that's nice in its own way.\I wonder if something interesting will happen... response:	Hello.
context: Give me your hand.\I finally have a day off,\but I passed it eating, sleeping and raising vegetables,\just like every other day.\Well, my days are peaceful.\I guess that's nice in its own way.\I wonder if something interesting will happen...\Hello. response:	Casual?
context: I finally have a day off,\but I passed it eating, sleeping and raising vegetables,\just like every other day.\Well, my days are peaceful.\I guess that's nice in its own way.\I wonder if something interesting will happen...\Hello.\Casual? response:	Sakurai-sensei...
context: but I passed it eating, sleeping and raising vegetables,\just like every other day.\Well, my days are peaceful.\I guess that's nice in its own way.\I wonder if something interesting will happen...\Hello.\Casual?\Sakurai-sensei... response:	Casual?
context: just like every other day.\Well, my days are peaceful.\I guess that's nice in its own way.\I wonder if something interesting will happen...\Hello.\Casual?\Sakurai-sensei...\Casual? response:	Takasaki-sensei, are you out shopping, too?
context: Well, my days are peaceful.\I guess that's nice in its own way.\I wonder if something interesting will happen...\Hello.\Casual?\Sakurai-sensei...\Casual?\Takasaki-sensei, are you out shopping, too? response:	It's tied up!
context: I guess that's nice in its own way.\I wonder if something interesting will happen...\Hello.\Casual?\Sakurai-sensei...\Casual?\Takasaki-sensei, are you out shopping, too?\It's tied up! response:	Also, running into each other on a day off...
context: I wonder if something interesting will happen...\Hello.\Casual?\Sakurai-sensei...\Casual?\Takasaki-sensei, are you out shopping, too?\It's tied up!\Also, running into each other on a day off... response:	It feels like I'm seeing something very private...
context: Hello.\Casual?\Sakurai-sensei...\Casual?\Takasaki-sensei, are you out shopping, too?\It's tied up!\Also, running into each other on a day off...\It feels like I'm seeing something very private... response:	I feel extremely moved!
context: Casual?\Sakurai-sensei...\Casual?\Takasaki-sensei, are you out shopping, too?\It's tied up!\Also, running into each other on a day off...\It feels like I'm seeing something very private...\I feel extremely moved! response:	Oh, I'm sorry!
context: Sakurai-sensei...\Casual?\Takasaki-sensei, are you out shopping, too?\It's tied up!\Also, running into each other on a day off...\It feels like I'm seeing something very private...\I feel extremely moved!\Oh, I'm sorry! response:	Are you hurt?
context: Casual?\Takasaki-sensei, are you out shopping, too?\It's tied up!\Also, running into each other on a day off...\It feels like I'm seeing something very private...\I feel extremely moved!\Oh, I'm sorry!\Are you hurt? response:	Oh, sorry!
context: Takasaki-sensei, are you out shopping, too?\It's tied up!\Also, running into each other on a day off...\It feels like I'm seeing something very private...\I feel extremely moved!\Oh, I'm sorry!\Are you hurt?\Oh, sorry! response:	I just felt moved.
context: It's tied up!\Also, running into each other on a day off...\It feels like I'm seeing something very private...\I feel extremely moved!\Oh, I'm sorry!\Are you hurt?\Oh, sorry!\I just felt moved. response:	Sakurai-sensei, are you out shopping, too?
context: Also, running into each other on a day off...\It feels like I'm seeing something very private...\I feel extremely moved!\Oh, I'm sorry!\Are you hurt?\Oh, sorry!\I just felt moved.\Sakurai-sensei, are you out shopping, too? response:	Oh, yes.
context: It feels like I'm seeing something very private...\I feel extremely moved!\Oh, I'm sorry!\Are you hurt?\Oh, sorry!\I just felt moved.\Sakurai-sensei, are you out shopping, too?\Oh, yes. response:	Green onions were on sale, so I bought a lot!
context: I feel extremely moved!\Oh, I'm sorry!\Are you hurt?\Oh, sorry!\I just felt moved.\Sakurai-sensei, are you out shopping, too?\Oh, yes.\Green onions were on sale, so I bought a lot! response:	Green onions, huh?
context: Oh, I'm sorry!\Are you hurt?\Oh, sorry!\I just felt moved.\Sakurai-sensei, are you out shopping, too?\Oh, yes.\Green onions were on sale, so I bought a lot!\Green onions, huh? response:	If you wanted bamboo shoots, you could have told me,
context: Are you hurt?\Oh, sorry!\I just felt moved.\Sakurai-sensei, are you out shopping, too?\Oh, yes.\Green onions were on sale, so I bought a lot!\Green onions, huh?\If you wanted bamboo shoots, you could have told me, response:	and I would have given you some.
context: Oh, sorry!\I just felt moved.\Sakurai-sensei, are you out shopping, too?\Oh, yes.\Green onions were on sale, so I bought a lot!\Green onions, huh?\If you wanted bamboo shoots, you could have told me,\and I would have given you some. response:	Bamboo shoots?
context: I just felt moved.\Sakurai-sensei, are you out shopping, too?\Oh, yes.\Green onions were on sale, so I bought a lot!\Green onions, huh?\If you wanted bamboo shoots, you could have told me,\and I would have given you some.\Bamboo shoots? response:	Well, I have a bit of a garden at my home.
context: Sakurai-sensei, are you out shopping, too?\Oh, yes.\Green onions were on sale, so I bought a lot!\Green onions, huh?\If you wanted bamboo shoots, you could have told me,\and I would have given you some.\Bamboo shoots?\Well, I have a bit of a garden at my home. response:	Well, what can I say...
context: Oh, yes.\Green onions were on sale, so I bought a lot!\Green onions, huh?\If you wanted bamboo shoots, you could have told me,\and I would have given you some.\Bamboo shoots?\Well, I have a bit of a garden at my home.\Well, what can I say... response:	I see!
context: Green onions were on sale, so I bought a lot!\Green onions, huh?\If you wanted bamboo shoots, you could have told me,\and I would have given you some.\Bamboo shoots?\Well, I have a bit of a garden at my home.\Well, what can I say...\I see! response:	That's amazing!
context: Green onions, huh?\If you wanted bamboo shoots, you could have told me,\and I would have given you some.\Bamboo shoots?\Well, I have a bit of a garden at my home.\Well, what can I say...\I see!\That's amazing! response:	Meeting on a day off...
context: If you wanted bamboo shoots, you could have told me,\and I would have given you some.\Bamboo shoots?\Well, I have a bit of a garden at my home.\Well, what can I say...\I see!\That's amazing!\Meeting on a day off... response:	It feels like it's fate.
context: and I would have given you some.\Bamboo shoots?\Well, I have a bit of a garden at my home.\Well, what can I say...\I see!\That's amazing!\Meeting on a day off...\It feels like it's fate. response:	Like we're bound by fate.
context: Bamboo shoots?\Well, I have a bit of a garden at my home.\Well, what can I say...\I see!\That's amazing!\Meeting on a day off...\It feels like it's fate.\Like we're bound by fate. response:	Is this coincidence causing this feeling?
context: Well, I have a bit of a garden at my home.\Well, what can I say...\I see!\That's amazing!\Meeting on a day off...\It feels like it's fate.\Like we're bound by fate.\Is this coincidence causing this feeling? response:	To be honest, I'm surprised myself.
context: Well, what can I say...\I see!\That's amazing!\Meeting on a day off...\It feels like it's fate.\Like we're bound by fate.\Is this coincidence causing this feeling?\To be honest, I'm surprised myself. response:	This is the first time I've felt this way.
context: I see!\That's amazing!\Meeting on a day off...\It feels like it's fate.\Like we're bound by fate.\Is this coincidence causing this feeling?\To be honest, I'm surprised myself.\This is the first time I've felt this way. response:	I wish I were a green onion.
context: That's amazing!\Meeting on a day off...\It feels like it's fate.\Like we're bound by fate.\Is this coincidence causing this feeling?\To be honest, I'm surprised myself.\This is the first time I've felt this way.\I wish I were a green onion. response:	Are you okay?
context: Meeting on a day off...\It feels like it's fate.\Like we're bound by fate.\Is this coincidence causing this feeling?\To be honest, I'm surprised myself.\This is the first time I've felt this way.\I wish I were a green onion.\Are you okay? response:	You look like you're in pain!
context: It feels like it's fate.\Like we're bound by fate.\Is this coincidence causing this feeling?\To be honest, I'm surprised myself.\This is the first time I've felt this way.\I wish I were a green onion.\Are you okay?\You look like you're in pain! response:	Would you like to go rest somewhere?
context: Like we're bound by fate.\Is this coincidence causing this feeling?\To be honest, I'm surprised myself.\This is the first time I've felt this way.\I wish I were a green onion.\Are you okay?\You look like you're in pain!\Would you like to go rest somewhere? response:	I'm sorry!
context: Is this coincidence causing this feeling?\To be honest, I'm surprised myself.\This is the first time I've felt this way.\I wish I were a green onion.\Are you okay?\You look like you're in pain!\Would you like to go rest somewhere?\I'm sorry! response:	I'm completely fine!
context: To be honest, I'm surprised myself.\This is the first time I've felt this way.\I wish I were a green onion.\Are you okay?\You look like you're in pain!\Would you like to go rest somewhere?\I'm sorry!\I'm completely fine! response:	I wasn't thinking about anythin -
context: This is the first time I've felt this way.\I wish I were a green onion.\Are you okay?\You look like you're in pain!\Would you like to go rest somewhere?\I'm sorry!\I'm completely fine!\I wasn't thinking about anythin - response:	Would you like to go rest somewhere?
context: I wish I were a green onion.\Are you okay?\You look like you're in pain!\Would you like to go rest somewhere?\I'm sorry!\I'm completely fine!\I wasn't thinking about anythin -\Would you like to go rest somewhere? response:	Thinking...
context: Are you okay?\You look like you're in pain!\Would you like to go rest somewhere?\I'm sorry!\I'm completely fine!\I wasn't thinking about anythin -\Would you like to go rest somewhere?\Thinking... response:	Would you like to go rest somewhere?
context: You look like you're in pain!\Would you like to go rest somewhere?\I'm sorry!\I'm completely fine!\I wasn't thinking about anythin -\Would you like to go rest somewhere?\Thinking...\Would you like to go rest somewhere? response:	Would you like to go rest somewhere?
context: Would you like to go rest somewhere?\I'm sorry!\I'm completely fine!\I wasn't thinking about anythin -\Would you like to go rest somewhere?\Thinking...\Would you like to go rest somewhere?\Would you like to go rest somewhere? response:	Would you like to go rest somewhere?
context: I'm sorry!\I'm completely fine!\I wasn't thinking about anythin -\Would you like to go rest somewhere?\Thinking...\Would you like to go rest somewhere?\Would you like to go rest somewhere?\Would you like to go rest somewhere? response:	That's amazingly enough...
context: I'm completely fine!\I wasn't thinking about anythin -\Would you like to go rest somewhere?\Thinking...\Would you like to go rest somewhere?\Would you like to go rest somewhere?\Would you like to go rest somewhere?\That's amazingly enough... response:	Now! Sakurai-sensei, there's a park over that way!
context: I wasn't thinking about anythin -\Would you like to go rest somewhere?\Thinking...\Would you like to go rest somewhere?\Would you like to go rest somewhere?\Would you like to go rest somewhere?\That's amazingly enough...\Now! Sakurai-sensei, there's a park over that way! response:	Let's head that way!
context: Would you like to go rest somewhere?\Thinking...\Would you like to go rest somewhere?\Would you like to go rest somewhere?\Would you like to go rest somewhere?\That's amazingly enough...\Now! Sakurai-sensei, there's a park over that way!\Let's head that way! response:	Oh, yes!
context: Thinking...\Would you like to go rest somewhere?\Would you like to go rest somewhere?\Would you like to go rest somewhere?\That's amazingly enough...\Now! Sakurai-sensei, there's a park over that way!\Let's head that way!\Oh, yes! response:	Well...
context: Would you like to go rest somewhere?\Would you like to go rest somewhere?\Would you like to go rest somewhere?\That's amazingly enough...\Now! Sakurai-sensei, there's a park over that way!\Let's head that way!\Oh, yes!\Well... response:	I would never have thought this would happen.
context: Would you like to go rest somewhere?\Would you like to go rest somewhere?\That's amazingly enough...\Now! Sakurai-sensei, there's a park over that way!\Let's head that way!\Oh, yes!\Well...\I would never have thought this would happen. response:	Isn't this what you would call...
context: Would you like to go rest somewhere?\That's amazingly enough...\Now! Sakurai-sensei, there's a park over that way!\Let's head that way!\Oh, yes!\Well...\I would never have thought this would happen.\Isn't this what you would call... response:	Aioi!
context: That's amazingly enough...\Now! Sakurai-sensei, there's a park over that way!\Let's head that way!\Oh, yes!\Well...\I would never have thought this would happen.\Isn't this what you would call...\Aioi! response:	Sakurai-sensei, let's go to that empty lot, instead.
context: Now! Sakurai-sensei, there's a park over that way!\Let's head that way!\Oh, yes!\Well...\I would never have thought this would happen.\Isn't this what you would call...\Aioi!\Sakurai-sensei, let's go to that empty lot, instead. response:	Why is Aioi here?
context: Let's head that way!\Oh, yes!\Well...\I would never have thought this would happen.\Isn't this what you would call...\Aioi!\Sakurai-sensei, let's go to that empty lot, instead.\Why is Aioi here? response:	If she were to find out...
context: Oh, yes!\Well...\I would never have thought this would happen.\Isn't this what you would call...\Aioi!\Sakurai-sensei, let's go to that empty lot, instead.\Why is Aioi here?\If she were to find out... response:	Oh, what are you two doing?
context: Well...\I would never have thought this would happen.\Isn't this what you would call...\Aioi!\Sakurai-sensei, let's go to that empty lot, instead.\Why is Aioi here?\If she were to find out...\Oh, what are you two doing? response:	You idiot!
context: I would never have thought this would happen.\Isn't this what you would call...\Aioi!\Sakurai-sensei, let's go to that empty lot, instead.\Why is Aioi here?\If she were to find out...\Oh, what are you two doing?\You idiot! response:	This is sort of... well... um... that!
context: Isn't this what you would call...\Aioi!\Sakurai-sensei, let's go to that empty lot, instead.\Why is Aioi here?\If she were to find out...\Oh, what are you two doing?\You idiot!\This is sort of... well... um... that! response:	Good day!
context: Aioi!\Sakurai-sensei, let's go to that empty lot, instead.\Why is Aioi here?\If she were to find out...\Oh, what are you two doing?\You idiot!\This is sort of... well... um... that!\Good day! response:	Geez, I didn't know that you two were dating.
context: Sakurai-sensei, let's go to that empty lot, instead.\Why is Aioi here?\If she were to find out...\Oh, what are you two doing?\You idiot!\This is sort of... well... um... that!\Good day!\Geez, I didn't know that you two were dating. response:	You idiot!
context: Why is Aioi here?\If she were to find out...\Oh, what are you two doing?\You idiot!\This is sort of... well... um... that!\Good day!\Geez, I didn't know that you two were dating.\You idiot! response:	Don't tease teachers!
context: If she were to find out...\Oh, what are you two doing?\You idiot!\This is sort of... well... um... that!\Good day!\Geez, I didn't know that you two were dating.\You idiot!\Don't tease teachers! response:	But you guys seem so happy!
context: Oh, what are you two doing?\You idiot!\This is sort of... well... um... that!\Good day!\Geez, I didn't know that you two were dating.\You idiot!\Don't tease teachers!\But you guys seem so happy! response:	You...
context: You idiot!\This is sort of... well... um... that!\Good day!\Geez, I didn't know that you two were dating.\You idiot!\Don't tease teachers!\But you guys seem so happy!\You... response:	Sakurai-sensei, good morning.
context: This is sort of... well... um... that!\Good day!\Geez, I didn't know that you two were dating.\You idiot!\Don't tease teachers!\But you guys seem so happy!\You...\Sakurai-sensei, good morning. response:	Way to go, you two!
context: Good day!\Geez, I didn't know that you two were dating.\You idiot!\Don't tease teachers!\But you guys seem so happy!\You...\Sakurai-sensei, good morning.\Way to go, you two! response:	Hot stuff!
context: Geez, I didn't know that you two were dating.\You idiot!\Don't tease teachers!\But you guys seem so happy!\You...\Sakurai-sensei, good morning.\Way to go, you two!\Hot stuff! response:	You idiots!
context: You idiot!\Don't tease teachers!\But you guys seem so happy!\You...\Sakurai-sensei, good morning.\Way to go, you two!\Hot stuff!\You idiots! response:	Don't laugh at it!
context: Don't tease teachers!\But you guys seem so happy!\You...\Sakurai-sensei, good morning.\Way to go, you two!\Hot stuff!\You idiots!\Don't laugh at it! response:	Geez, those brats.
context: But you guys seem so happy!\You...\Sakurai-sensei, good morning.\Way to go, you two!\Hot stuff!\You idiots!\Don't laugh at it!\Geez, those brats. response:	I'm, well...
context: You...\Sakurai-sensei, good morning.\Way to go, you two!\Hot stuff!\You idiots!\Don't laugh at it!\Geez, those brats.\I'm, well... response:	I'm sorry about all this trouble.
context: Sakurai-sensei, good morning.\Way to go, you two!\Hot stuff!\You idiots!\Don't laugh at it!\Geez, those brats.\I'm, well...\I'm sorry about all this trouble. response:	Oh, it's fine.
context: Way to go, you two!\Hot stuff!\You idiots!\Don't laugh at it!\Geez, those brats.\I'm, well...\I'm sorry about all this trouble.\Oh, it's fine. response:	I'm actually kind of happy.
context: Hot stuff!\You idiots!\Don't laugh at it!\Geez, those brats.\I'm, well...\I'm sorry about all this trouble.\Oh, it's fine.\I'm actually kind of happy. response:	Good enough!
context: You idiots!\Don't laugh at it!\Geez, those brats.\I'm, well...\I'm sorry about all this trouble.\Oh, it's fine.\I'm actually kind of happy.\Good enough! response:	What's wrong with me?!
context: Don't laugh at it!\Geez, those brats.\I'm, well...\I'm sorry about all this trouble.\Oh, it's fine.\I'm actually kind of happy.\Good enough!\What's wrong with me?! response:	There's no way it would end so nicely!
context: Geez, those brats.\I'm, well...\I'm sorry about all this trouble.\Oh, it's fine.\I'm actually kind of happy.\Good enough!\What's wrong with me?!\There's no way it would end so nicely! response:	Anyway, I need to...
context: I'm, well...\I'm sorry about all this trouble.\Oh, it's fine.\I'm actually kind of happy.\Good enough!\What's wrong with me?!\There's no way it would end so nicely!\Anyway, I need to... response:	Wow, that surprised me.
context: I'm sorry about all this trouble.\Oh, it's fine.\I'm actually kind of happy.\Good enough!\What's wrong with me?!\There's no way it would end so nicely!\Anyway, I need to...\Wow, that surprised me. response:	Oh, shoot!
context: Oh, it's fine.\I'm actually kind of happy.\Good enough!\What's wrong with me?!\There's no way it would end so nicely!\Anyway, I need to...\Wow, that surprised me.\Oh, shoot! response:	What are you doing, Takasaki-sensei?
context: I'm actually kind of happy.\Good enough!\What's wrong with me?!\There's no way it would end so nicely!\Anyway, I need to...\Wow, that surprised me.\Oh, shoot!\What are you doing, Takasaki-sensei? response:	Oh, what a coincidence! It's Sakurai-sensei!
context: Good enough!\What's wrong with me?!\There's no way it would end so nicely!\Anyway, I need to...\Wow, that surprised me.\Oh, shoot!\What are you doing, Takasaki-sensei?\Oh, what a coincidence! It's Sakurai-sensei! response:	And Aioi!
context: What's wrong with me?!\There's no way it would end so nicely!\Anyway, I need to...\Wow, that surprised me.\Oh, shoot!\What are you doing, Takasaki-sensei?\Oh, what a coincidence! It's Sakurai-sensei!\And Aioi! response:	It's Aioi, right?!
context: There's no way it would end so nicely!\Anyway, I need to...\Wow, that surprised me.\Oh, shoot!\What are you doing, Takasaki-sensei?\Oh, what a coincidence! It's Sakurai-sensei!\And Aioi!\It's Aioi, right?! response:	I must not have been paying attention.
context: Anyway, I need to...\Wow, that surprised me.\Oh, shoot!\What are you doing, Takasaki-sensei?\Oh, what a coincidence! It's Sakurai-sensei!\And Aioi!\It's Aioi, right?!\I must not have been paying attention. response:	I didn't see you!
context: Wow, that surprised me.\Oh, shoot!\What are you doing, Takasaki-sensei?\Oh, what a coincidence! It's Sakurai-sensei!\And Aioi!\It's Aioi, right?!\I must not have been paying attention.\I didn't see you! response:	Aioi?
context: Oh, shoot!\What are you doing, Takasaki-sensei?\Oh, what a coincidence! It's Sakurai-sensei!\And Aioi!\It's Aioi, right?!\I must not have been paying attention.\I didn't see you!\Aioi? response:	It's you, right, Aioi?
context: What are you doing, Takasaki-sensei?\Oh, what a coincidence! It's Sakurai-sensei!\And Aioi!\It's Aioi, right?!\I must not have been paying attention.\I didn't see you!\Aioi?\It's you, right, Aioi? response:	You sure look like Aioi.
context: Oh, what a coincidence! It's Sakurai-sensei!\And Aioi!\It's Aioi, right?!\I must not have been paying attention.\I didn't see you!\Aioi?\It's you, right, Aioi?\You sure look like Aioi. response:	Well, anyway,
context: And Aioi!\It's Aioi, right?!\I must not have been paying attention.\I didn't see you!\Aioi?\It's you, right, Aioi?\You sure look like Aioi.\Well, anyway, response:	I have to do that, so I'll be leaving.
context: It's Aioi, right?!\I must not have been paying attention.\I didn't see you!\Aioi?\It's you, right, Aioi?\You sure look like Aioi.\Well, anyway,\I have to do that, so I'll be leaving. response:	I guess...
context: I must not have been paying attention.\I didn't see you!\Aioi?\It's you, right, Aioi?\You sure look like Aioi.\Well, anyway,\I have to do that, so I'll be leaving.\I guess... response:	Sorry for calling you out so unexpectedly.
context: I didn't see you!\Aioi?\It's you, right, Aioi?\You sure look like Aioi.\Well, anyway,\I have to do that, so I'll be leaving.\I guess...\Sorry for calling you out so unexpectedly. response:	Were you able to sleep yesterday?
context: Aioi?\It's you, right, Aioi?\You sure look like Aioi.\Well, anyway,\I have to do that, so I'll be leaving.\I guess...\Sorry for calling you out so unexpectedly.\Were you able to sleep yesterday? response:	Yeah, but I had a weird dream.
context: It's you, right, Aioi?\You sure look like Aioi.\Well, anyway,\I have to do that, so I'll be leaving.\I guess...\Sorry for calling you out so unexpectedly.\Were you able to sleep yesterday?\Yeah, but I had a weird dream. response:	A weird dream?
context: You sure look like Aioi.\Well, anyway,\I have to do that, so I'll be leaving.\I guess...\Sorry for calling you out so unexpectedly.\Were you able to sleep yesterday?\Yeah, but I had a weird dream.\A weird dream? response:	Well, I dreamt that we kissed right here.
context: Well, anyway,\I have to do that, so I'll be leaving.\I guess...\Sorry for calling you out so unexpectedly.\Were you able to sleep yesterday?\Yeah, but I had a weird dream.\A weird dream?\Well, I dreamt that we kissed right here. response:	Shall I make that dream come true?
context: I have to do that, so I'll be leaving.\I guess...\Sorry for calling you out so unexpectedly.\Were you able to sleep yesterday?\Yeah, but I had a weird dream.\A weird dream?\Well, I dreamt that we kissed right here.\Shall I make that dream come true? response:	Professor, would you like some snacks?
context: I guess...\Sorry for calling you out so unexpectedly.\Were you able to sleep yesterday?\Yeah, but I had a weird dream.\A weird dream?\Well, I dreamt that we kissed right here.\Shall I make that dream come true?\Professor, would you like some snacks? response:	Do you actually love me?
context: Sorry for calling you out so unexpectedly.\Were you able to sleep yesterday?\Yeah, but I had a weird dream.\A weird dream?\Well, I dreamt that we kissed right here.\Shall I make that dream come true?\Professor, would you like some snacks?\Do you actually love me? response:	The result of a month's research.
context: Were you able to sleep yesterday?\Yeah, but I had a weird dream.\A weird dream?\Well, I dreamt that we kissed right here.\Shall I make that dream come true?\Professor, would you like some snacks?\Do you actually love me?\The result of a month's research. response:	I have learned that every Saturday...
context: Yeah, but I had a weird dream.\A weird dream?\Well, I dreamt that we kissed right here.\Shall I make that dream come true?\Professor, would you like some snacks?\Do you actually love me?\The result of a month's research.\I have learned that every Saturday... response:	It's almost time for her to come out.
context: A weird dream?\Well, I dreamt that we kissed right here.\Shall I make that dream come true?\Professor, would you like some snacks?\Do you actually love me?\The result of a month's research.\I have learned that every Saturday...\It's almost time for her to come out. response:	I will trail her when she comes out after shopping.
context: Well, I dreamt that we kissed right here.\Shall I make that dream come true?\Professor, would you like some snacks?\Do you actually love me?\The result of a month's research.\I have learned that every Saturday...\It's almost time for her to come out.\I will trail her when she comes out after shopping. response:	When we reach an area without anyone around,
context: Shall I make that dream come true?\Professor, would you like some snacks?\Do you actually love me?\The result of a month's research.\I have learned that every Saturday...\It's almost time for her to come out.\I will trail her when she comes out after shopping.\When we reach an area without anyone around, response:	I'll use this Mr. Short Circuit,
context: Professor, would you like some snacks?\Do you actually love me?\The result of a month's research.\I have learned that every Saturday...\It's almost time for her to come out.\I will trail her when she comes out after shopping.\When we reach an area without anyone around,\I'll use this Mr. Short Circuit, response:	which I didn't get the chance to test before,
context: Do you actually love me?\The result of a month's research.\I have learned that every Saturday...\It's almost time for her to come out.\I will trail her when she comes out after shopping.\When we reach an area without anyone around,\I'll use this Mr. Short Circuit,\which I didn't get the chance to test before, response:	and then I'll take her home.
context: The result of a month's research.\I have learned that every Saturday...\It's almost time for her to come out.\I will trail her when she comes out after shopping.\When we reach an area without anyone around,\I'll use this Mr. Short Circuit,\which I didn't get the chance to test before,\and then I'll take her home. response:	It's perfect.
context: I have learned that every Saturday...\It's almost time for her to come out.\I will trail her when she comes out after shopping.\When we reach an area without anyone around,\I'll use this Mr. Short Circuit,\which I didn't get the chance to test before,\and then I'll take her home.\It's perfect. response:	I will definitely study you today,
context: It's almost time for her to come out.\I will trail her when she comes out after shopping.\When we reach an area without anyone around,\I'll use this Mr. Short Circuit,\which I didn't get the chance to test before,\and then I'll take her home.\It's perfect.\I will definitely study you today, response:	Shinonome Nano.
context: I will trail her when she comes out after shopping.\When we reach an area without anyone around,\I'll use this Mr. Short Circuit,\which I didn't get the chance to test before,\and then I'll take her home.\It's perfect.\I will definitely study you today,\Shinonome Nano. response:	Huh?
context: When we reach an area without anyone around,\I'll use this Mr. Short Circuit,\which I didn't get the chance to test before,\and then I'll take her home.\It's perfect.\I will definitely study you today,\Shinonome Nano.\Huh? response:	Why isn't Shinonome coming?
context: I'll use this Mr. Short Circuit,\which I didn't get the chance to test before,\and then I'll take her home.\It's perfect.\I will definitely study you today,\Shinonome Nano.\Huh?\Why isn't Shinonome coming? response:	Do you not always go to this supermarket?
context: which I didn't get the chance to test before,\and then I'll take her home.\It's perfect.\I will definitely study you today,\Shinonome Nano.\Huh?\Why isn't Shinonome coming?\Do you not always go to this supermarket? response:	No, I've waited this long!
context: and then I'll take her home.\It's perfect.\I will definitely study you today,\Shinonome Nano.\Huh?\Why isn't Shinonome coming?\Do you not always go to this supermarket?\No, I've waited this long! response:	If I leave now, there's a chance I'll miss her.
context: It's perfect.\I will definitely study you today,\Shinonome Nano.\Huh?\Why isn't Shinonome coming?\Do you not always go to this supermarket?\No, I've waited this long!\If I leave now, there's a chance I'll miss her. response:	Huh?
context: I will definitely study you today,\Shinonome Nano.\Huh?\Why isn't Shinonome coming?\Do you not always go to this supermarket?\No, I've waited this long!\If I leave now, there's a chance I'll miss her.\Huh? response:	Oh, it really is you, Nakamura-sensei.
context: Shinonome Nano.\Huh?\Why isn't Shinonome coming?\Do you not always go to this supermarket?\No, I've waited this long!\If I leave now, there's a chance I'll miss her.\Huh?\Oh, it really is you, Nakamura-sensei. response:	Good day.
context: Huh?\Why isn't Shinonome coming?\Do you not always go to this supermarket?\No, I've waited this long!\If I leave now, there's a chance I'll miss her.\Huh?\Oh, it really is you, Nakamura-sensei.\Good day. response:	It's Sideburns, who teaches language!
context: Why isn't Shinonome coming?\Do you not always go to this supermarket?\No, I've waited this long!\If I leave now, there's a chance I'll miss her.\Huh?\Oh, it really is you, Nakamura-sensei.\Good day.\It's Sideburns, who teaches language! response:	Hello.
context: Do you not always go to this supermarket?\No, I've waited this long!\If I leave now, there's a chance I'll miss her.\Huh?\Oh, it really is you, Nakamura-sensei.\Good day.\It's Sideburns, who teaches language!\Hello. response:	You weren't in your lab coat, so I didn't realise it was you at first.
context: No, I've waited this long!\If I leave now, there's a chance I'll miss her.\Huh?\Oh, it really is you, Nakamura-sensei.\Good day.\It's Sideburns, who teaches language!\Hello.\You weren't in your lab coat, so I didn't realise it was you at first. response:	Sideburns has come at a bad time.
context: If I leave now, there's a chance I'll miss her.\Huh?\Oh, it really is you, Nakamura-sensei.\Good day.\It's Sideburns, who teaches language!\Hello.\You weren't in your lab coat, so I didn't realise it was you at first.\Sideburns has come at a bad time. response:	If he doesn't need anything, I hope he'll just leave.
context: Huh?\Oh, it really is you, Nakamura-sensei.\Good day.\It's Sideburns, who teaches language!\Hello.\You weren't in your lab coat, so I didn't realise it was you at first.\Sideburns has come at a bad time.\If he doesn't need anything, I hope he'll just leave. response:	If Shinonome were to come at this time...
context: Oh, it really is you, Nakamura-sensei.\Good day.\It's Sideburns, who teaches language!\Hello.\You weren't in your lab coat, so I didn't realise it was you at first.\Sideburns has come at a bad time.\If he doesn't need anything, I hope he'll just leave.\If Shinonome were to come at this time... response:	Well, Nakamura-sensei, your casual clothes are a bit boyish.
context: Good day.\It's Sideburns, who teaches language!\Hello.\You weren't in your lab coat, so I didn't realise it was you at first.\Sideburns has come at a bad time.\If he doesn't need anything, I hope he'll just leave.\If Shinonome were to come at this time...\Well, Nakamura-sensei, your casual clothes are a bit boyish. response:	It's kind of cute.
context: It's Sideburns, who teaches language!\Hello.\You weren't in your lab coat, so I didn't realise it was you at first.\Sideburns has come at a bad time.\If he doesn't need anything, I hope he'll just leave.\If Shinonome were to come at this time...\Well, Nakamura-sensei, your casual clothes are a bit boyish.\It's kind of cute. response:	Oh, not really...
context: Hello.\You weren't in your lab coat, so I didn't realise it was you at first.\Sideburns has come at a bad time.\If he doesn't need anything, I hope he'll just leave.\If Shinonome were to come at this time...\Well, Nakamura-sensei, your casual clothes are a bit boyish.\It's kind of cute.\Oh, not really... response:	No, it's such a difference from your regular lab coat.
context: You weren't in your lab coat, so I didn't realise it was you at first.\Sideburns has come at a bad time.\If he doesn't need anything, I hope he'll just leave.\If Shinonome were to come at this time...\Well, Nakamura-sensei, your casual clothes are a bit boyish.\It's kind of cute.\Oh, not really...\No, it's such a difference from your regular lab coat. response:	It makes you look innocent...
context: Sideburns has come at a bad time.\If he doesn't need anything, I hope he'll just leave.\If Shinonome were to come at this time...\Well, Nakamura-sensei, your casual clothes are a bit boyish.\It's kind of cute.\Oh, not really...\No, it's such a difference from your regular lab coat.\It makes you look innocent... response:	I'll retreat for today!
context: If he doesn't need anything, I hope he'll just leave.\If Shinonome were to come at this time...\Well, Nakamura-sensei, your casual clothes are a bit boyish.\It's kind of cute.\Oh, not really...\No, it's such a difference from your regular lab coat.\It makes you look innocent...\I'll retreat for today! response:	Huh?
context: If Shinonome were to come at this time...\Well, Nakamura-sensei, your casual clothes are a bit boyish.\It's kind of cute.\Oh, not really...\No, it's such a difference from your regular lab coat.\It makes you look innocent...\I'll retreat for today!\Huh? response:	Nakamura-sensei?!
context: Well, Nakamura-sensei, your casual clothes are a bit boyish.\It's kind of cute.\Oh, not really...\No, it's such a difference from your regular lab coat.\It makes you look innocent...\I'll retreat for today!\Huh?\Nakamura-sensei?! response:	Have you thought about what you'd like to do...
context: It's kind of cute.\Oh, not really...\No, it's such a difference from your regular lab coat.\It makes you look innocent...\I'll retreat for today!\Huh?\Nakamura-sensei?!\Have you thought about what you'd like to do... response:	I have.
context: Oh, not really...\No, it's such a difference from your regular lab coat.\It makes you look innocent...\I'll retreat for today!\Huh?\Nakamura-sensei?!\Have you thought about what you'd like to do...\I have. response:	Would you like to get a job?
context: No, it's such a difference from your regular lab coat.\It makes you look innocent...\I'll retreat for today!\Huh?\Nakamura-sensei?!\Have you thought about what you'd like to do...\I have.\Would you like to get a job? response:	Would you like to go to school?
context: It makes you look innocent...\I'll retreat for today!\Huh?\Nakamura-sensei?!\Have you thought about what you'd like to do...\I have.\Would you like to get a job?\Would you like to go to school? response:	I understand.
context: I'll retreat for today!\Huh?\Nakamura-sensei?!\Have you thought about what you'd like to do...\I have.\Would you like to get a job?\Would you like to go to school?\I understand. response:	The Wood Cube isn't here...
context: Huh?\Nakamura-sensei?!\Have you thought about what you'd like to do...\I have.\Would you like to get a job?\Would you like to go to school?\I understand.\The Wood Cube isn't here... response:	But how did it disappear from the safe?
context: Nakamura-sensei?!\Have you thought about what you'd like to do...\I have.\Would you like to get a job?\Would you like to go to school?\I understand.\The Wood Cube isn't here...\But how did it disappear from the safe? response:	Well, there's a reward for finding it.
context: Have you thought about what you'd like to do...\I have.\Would you like to get a job?\Would you like to go to school?\I understand.\The Wood Cube isn't here...\But how did it disappear from the safe?\Well, there's a reward for finding it. response:	So I'm fine with it.
context: I have.\Would you like to get a job?\Would you like to go to school?\I understand.\The Wood Cube isn't here...\But how did it disappear from the safe?\Well, there's a reward for finding it.\So I'm fine with it. response:	The Advisor found one of them earlier.
context: Would you like to get a job?\Would you like to go to school?\I understand.\The Wood Cube isn't here...\But how did it disappear from the safe?\Well, there's a reward for finding it.\So I'm fine with it.\The Advisor found one of them earlier. response:	There's only one left to find?
context: Would you like to go to school?\I understand.\The Wood Cube isn't here...\But how did it disappear from the safe?\Well, there's a reward for finding it.\So I'm fine with it.\The Advisor found one of them earlier.\There's only one left to find? response:	I need to get serious.
context: I understand.\The Wood Cube isn't here...\But how did it disappear from the safe?\Well, there's a reward for finding it.\So I'm fine with it.\The Advisor found one of them earlier.\There's only one left to find?\I need to get serious. response:	If I show my worth here, I could gain favour with the throne.
context: The Wood Cube isn't here...\But how did it disappear from the safe?\Well, there's a reward for finding it.\So I'm fine with it.\The Advisor found one of them earlier.\There's only one left to find?\I need to get serious.\If I show my worth here, I could gain favour with the throne. response:	Hey, look over there.
context: But how did it disappear from the safe?\Well, there's a reward for finding it.\So I'm fine with it.\The Advisor found one of them earlier.\There's only one left to find?\I need to get serious.\If I show my worth here, I could gain favour with the throne.\Hey, look over there. response:	Give back the Wood Cube.
context: Well, there's a reward for finding it.\So I'm fine with it.\The Advisor found one of them earlier.\There's only one left to find?\I need to get serious.\If I show my worth here, I could gain favour with the throne.\Hey, look over there.\Give back the Wood Cube. response:	Hey, hey.
context: So I'm fine with it.\The Advisor found one of them earlier.\There's only one left to find?\I need to get serious.\If I show my worth here, I could gain favour with the throne.\Hey, look over there.\Give back the Wood Cube.\Hey, hey. response:	What are you saying, young lady?
context: The Advisor found one of them earlier.\There's only one left to find?\I need to get serious.\If I show my worth here, I could gain favour with the throne.\Hey, look over there.\Give back the Wood Cube.\Hey, hey.\What are you saying, young lady? response:	How did you get in?
context: There's only one left to find?\I need to get serious.\If I show my worth here, I could gain favour with the throne.\Hey, look over there.\Give back the Wood Cube.\Hey, hey.\What are you saying, young lady?\How did you get in? response:	Are you a stowaway?
context: I need to get serious.\If I show my worth here, I could gain favour with the throne.\Hey, look over there.\Give back the Wood Cube.\Hey, hey.\What are you saying, young lady?\How did you get in?\Are you a stowaway? response:	If you are, there's a severe punishment.
context: If I show my worth here, I could gain favour with the throne.\Hey, look over there.\Give back the Wood Cube.\Hey, hey.\What are you saying, young lady?\How did you get in?\Are you a stowaway?\If you are, there's a severe punishment. response:	It's either a minimum of 10 years in prison...
context: Hey, look over there.\Give back the Wood Cube.\Hey, hey.\What are you saying, young lady?\How did you get in?\Are you a stowaway?\If you are, there's a severe punishment.\It's either a minimum of 10 years in prison... response:	Just kidding -
context: Give back the Wood Cube.\Hey, hey.\What are you saying, young lady?\How did you get in?\Are you a stowaway?\If you are, there's a severe punishment.\It's either a minimum of 10 years in prison...\Just kidding - response:	Number 22!
context: Hey, hey.\What are you saying, young lady?\How did you get in?\Are you a stowaway?\If you are, there's a severe punishment.\It's either a minimum of 10 years in prison...\Just kidding -\Number 22! response:	Why, you! What are you doing?!
context: What are you saying, young lady?\How did you get in?\Are you a stowaway?\If you are, there's a severe punishment.\It's either a minimum of 10 years in prison...\Just kidding -\Number 22!\Why, you! What are you doing?! response:	Wait!
context: How did you get in?\Are you a stowaway?\If you are, there's a severe punishment.\It's either a minimum of 10 years in prison...\Just kidding -\Number 22!\Why, you! What are you doing?!\Wait! response:	Wait, wait, wait!
context: Are you a stowaway?\If you are, there's a severe punishment.\It's either a minimum of 10 years in prison...\Just kidding -\Number 22!\Why, you! What are you doing?!\Wait!\Wait, wait, wait! response:	I'm all right.
context: If you are, there's a severe punishment.\It's either a minimum of 10 years in prison...\Just kidding -\Number 22!\Why, you! What are you doing?!\Wait!\Wait, wait, wait!\I'm all right. response:	I just let my guard down a bit.
context: It's either a minimum of 10 years in prison...\Just kidding -\Number 22!\Why, you! What are you doing?!\Wait!\Wait, wait, wait!\I'm all right.\I just let my guard down a bit. response:	Leave this to me.
context: Just kidding -\Number 22!\Why, you! What are you doing?!\Wait!\Wait, wait, wait!\I'm all right.\I just let my guard down a bit.\Leave this to me. response:	You've got a pretty face, but you act a bit rough, little girl.
context: Number 22!\Why, you! What are you doing?!\Wait!\Wait, wait, wait!\I'm all right.\I just let my guard down a bit.\Leave this to me.\You've got a pretty face, but you act a bit rough, little girl. response:	Hey,
context: Why, you! What are you doing?!\Wait!\Wait, wait, wait!\I'm all right.\I just let my guard down a bit.\Leave this to me.\You've got a pretty face, but you act a bit rough, little girl.\Hey, response:	playtime is over, all ri -
context: Wait!\Wait, wait, wait!\I'm all right.\I just let my guard down a bit.\Leave this to me.\You've got a pretty face, but you act a bit rough, little girl.\Hey,\playtime is over, all ri - response:	Is he okay?!
context: Wait, wait, wait!\I'm all right.\I just let my guard down a bit.\Leave this to me.\You've got a pretty face, but you act a bit rough, little girl.\Hey,\playtime is over, all ri -\Is he okay?! response:	No, he's dead!
context: I'm all right.\I just let my guard down a bit.\Leave this to me.\You've got a pretty face, but you act a bit rough, little girl.\Hey,\playtime is over, all ri -\Is he okay?!\No, he's dead! response:	That bastard!
context: I just let my guard down a bit.\Leave this to me.\You've got a pretty face, but you act a bit rough, little girl.\Hey,\playtime is over, all ri -\Is he okay?!\No, he's dead!\That bastard! response:	A stowaway is after the Wood Cubes?!
context: Leave this to me.\You've got a pretty face, but you act a bit rough, little girl.\Hey,\playtime is over, all ri -\Is he okay?!\No, he's dead!\That bastard!\A stowaway is after the Wood Cubes?! response:	Move around to the rear!
context: You've got a pretty face, but you act a bit rough, little girl.\Hey,\playtime is over, all ri -\Is he okay?!\No, he's dead!\That bastard!\A stowaway is after the Wood Cubes?!\Move around to the rear! response:	Surround her!
context: Hey,\playtime is over, all ri -\Is he okay?!\No, he's dead!\That bastard!\A stowaway is after the Wood Cubes?!\Move around to the rear!\Surround her! response:	Everyone, please be quiet.
context: playtime is over, all ri -\Is he okay?!\No, he's dead!\That bastard!\A stowaway is after the Wood Cubes?!\Move around to the rear!\Surround her!\Everyone, please be quiet. response:	There's no need to get so excited.
context: Is he okay?!\No, he's dead!\That bastard!\A stowaway is after the Wood Cubes?!\Move around to the rear!\Surround her!\Everyone, please be quiet.\There's no need to get so excited. response:	Advisor!
context: No, he's dead!\That bastard!\A stowaway is after the Wood Cubes?!\Move around to the rear!\Surround her!\Everyone, please be quiet.\There's no need to get so excited.\Advisor! response:	Leave this to me.
context: That bastard!\A stowaway is after the Wood Cubes?!\Move around to the rear!\Surround her!\Everyone, please be quiet.\There's no need to get so excited.\Advisor!\Leave this to me. response:	The Advisor should be able to do something in this situation.
context: A stowaway is after the Wood Cubes?!\Move around to the rear!\Surround her!\Everyone, please be quiet.\There's no need to get so excited.\Advisor!\Leave this to me.\The Advisor should be able to do something in this situation. response:	She came aboard all alone to get the Wood Cubes.
context: Move around to the rear!\Surround her!\Everyone, please be quiet.\There's no need to get so excited.\Advisor!\Leave this to me.\The Advisor should be able to do something in this situation.\She came aboard all alone to get the Wood Cubes. response:	She must be a spy from somewhere.
context: Surround her!\Everyone, please be quiet.\There's no need to get so excited.\Advisor!\Leave this to me.\The Advisor should be able to do something in this situation.\She came aboard all alone to get the Wood Cubes.\She must be a spy from somewhere. response:	But that amazing strength...
context: Everyone, please be quiet.\There's no need to get so excited.\Advisor!\Leave this to me.\The Advisor should be able to do something in this situation.\She came aboard all alone to get the Wood Cubes.\She must be a spy from somewhere.\But that amazing strength... response:	If I could tame it, it would become a powerful weapon for our country.
context: There's no need to get so excited.\Advisor!\Leave this to me.\The Advisor should be able to do something in this situation.\She came aboard all alone to get the Wood Cubes.\She must be a spy from somewhere.\But that amazing strength...\If I could tame it, it would become a powerful weapon for our country. response:	Luckily, I also have a Wood Cube.
context: Advisor!\Leave this to me.\The Advisor should be able to do something in this situation.\She came aboard all alone to get the Wood Cubes.\She must be a spy from somewhere.\But that amazing strength...\If I could tame it, it would become a powerful weapon for our country.\Luckily, I also have a Wood Cube. response:	If this is what she wants,
context: Leave this to me.\The Advisor should be able to do something in this situation.\She came aboard all alone to get the Wood Cubes.\She must be a spy from somewhere.\But that amazing strength...\If I could tame it, it would become a powerful weapon for our country.\Luckily, I also have a Wood Cube.\If this is what she wants, response:	I might be able to get her to change sides if I make a good offer.
context: The Advisor should be able to do something in this situation.\She came aboard all alone to get the Wood Cubes.\She must be a spy from somewhere.\But that amazing strength...\If I could tame it, it would become a powerful weapon for our country.\Luckily, I also have a Wood Cube.\If this is what she wants,\I might be able to get her to change sides if I make a good offer. response:	This is the Wood Cube that you're after.
context: She came aboard all alone to get the Wood Cubes.\She must be a spy from somewhere.\But that amazing strength...\If I could tame it, it would become a powerful weapon for our country.\Luckily, I also have a Wood Cube.\If this is what she wants,\I might be able to get her to change sides if I make a good offer.\This is the Wood Cube that you're after. response:	How about it? Why not...
context: She must be a spy from somewhere.\But that amazing strength...\If I could tame it, it would become a powerful weapon for our country.\Luckily, I also have a Wood Cube.\If this is what she wants,\I might be able to get her to change sides if I make a good offer.\This is the Wood Cube that you're after.\How about it? Why not... response:	Advisor!
context: But that amazing strength...\If I could tame it, it would become a powerful weapon for our country.\Luckily, I also have a Wood Cube.\If this is what she wants,\I might be able to get her to change sides if I make a good offer.\This is the Wood Cube that you're after.\How about it? Why not...\Advisor! response:	No!
context: If I could tame it, it would become a powerful weapon for our country.\Luckily, I also have a Wood Cube.\If this is what she wants,\I might be able to get her to change sides if I make a good offer.\This is the Wood Cube that you're after.\How about it? Why not...\Advisor!\No! response:	He's dead!
context: Luckily, I also have a Wood Cube.\If this is what she wants,\I might be able to get her to change sides if I make a good offer.\This is the Wood Cube that you're after.\How about it? Why not...\Advisor!\No!\He's dead! response:	This is bad!
context: If this is what she wants,\I might be able to get her to change sides if I make a good offer.\This is the Wood Cube that you're after.\How about it? Why not...\Advisor!\No!\He's dead!\This is bad! response:	That bastard killed the Advisor!
context: I might be able to get her to change sides if I make a good offer.\This is the Wood Cube that you're after.\How about it? Why not...\Advisor!\No!\He's dead!\This is bad!\That bastard killed the Advisor! response:	You bastard!
context: This is the Wood Cube that you're after.\How about it? Why not...\Advisor!\No!\He's dead!\This is bad!\That bastard killed the Advisor!\You bastard! response:	Don't think you'll get out of this alive!
context: How about it? Why not...\Advisor!\No!\He's dead!\This is bad!\That bastard killed the Advisor!\You bastard!\Don't think you'll get out of this alive! response:	This is bad!
context: Advisor!\No!\He's dead!\This is bad!\That bastard killed the Advisor!\You bastard!\Don't think you'll get out of this alive!\This is bad! response:	This is bad!
context: No!\He's dead!\This is bad!\That bastard killed the Advisor!\You bastard!\Don't think you'll get out of this alive!\This is bad!\This is bad! response:	This is extremely bad!
context: He's dead!\This is bad!\That bastard killed the Advisor!\You bastard!\Don't think you'll get out of this alive!\This is bad!\This is bad!\This is extremely bad! response:	What's wrong, Scholar?!
context: This is bad!\That bastard killed the Advisor!\You bastard!\Don't think you'll get out of this alive!\This is bad!\This is bad!\This is extremely bad!\What's wrong, Scholar?! response:	What's bad?
context: That bastard killed the Advisor!\You bastard!\Don't think you'll get out of this alive!\This is bad!\This is bad!\This is extremely bad!\What's wrong, Scholar?!\What's bad? response:	It's very bad!
context: You bastard!\Don't think you'll get out of this alive!\This is bad!\This is bad!\This is extremely bad!\What's wrong, Scholar?!\What's bad?\It's very bad! response:	Just now, she attached a Wood Cube.
context: Don't think you'll get out of this alive!\This is bad!\This is bad!\This is extremely bad!\What's wrong, Scholar?!\What's bad?\It's very bad!\Just now, she attached a Wood Cube. response:	What's more, she already has another one attached by her ear.
context: This is bad!\This is bad!\This is extremely bad!\What's wrong, Scholar?!\What's bad?\It's very bad!\Just now, she attached a Wood Cube.\What's more, she already has another one attached by her ear. response:	That's another Wood Cube!
context: This is bad!\This is extremely bad!\What's wrong, Scholar?!\What's bad?\It's very bad!\Just now, she attached a Wood Cube.\What's more, she already has another one attached by her ear.\That's another Wood Cube! response:	She has gathered the Wood Cubes!
context: This is extremely bad!\What's wrong, Scholar?!\What's bad?\It's very bad!\Just now, she attached a Wood Cube.\What's more, she already has another one attached by her ear.\That's another Wood Cube!\She has gathered the Wood Cubes! response:	But even if she's gathered them,
context: What's wrong, Scholar?!\What's bad?\It's very bad!\Just now, she attached a Wood Cube.\What's more, she already has another one attached by her ear.\That's another Wood Cube!\She has gathered the Wood Cubes!\But even if she's gathered them, response:	if she doesn't know how to summon the ancient weapon...
context: What's bad?\It's very bad!\Just now, she attached a Wood Cube.\What's more, she already has another one attached by her ear.\That's another Wood Cube!\She has gathered the Wood Cubes!\But even if she's gathered them,\if she doesn't know how to summon the ancient weapon... response:	That's right!
context: It's very bad!\Just now, she attached a Wood Cube.\What's more, she already has another one attached by her ear.\That's another Wood Cube!\She has gathered the Wood Cubes!\But even if she's gathered them,\if she doesn't know how to summon the ancient weapon...\That's right! response:	We still have a chance!
context: Just now, she attached a Wood Cube.\What's more, she already has another one attached by her ear.\That's another Wood Cube!\She has gathered the Wood Cubes!\But even if she's gathered them,\if she doesn't know how to summon the ancient weapon...\That's right!\We still have a chance! response:	Shut up!
context: What's more, she already has another one attached by her ear.\That's another Wood Cube!\She has gathered the Wood Cubes!\But even if she's gathered them,\if she doesn't know how to summon the ancient weapon...\That's right!\We still have a chance!\Shut up! response:	According to this Netherworld Encyclopaedia,
context: That's another Wood Cube!\She has gathered the Wood Cubes!\But even if she's gathered them,\if she doesn't know how to summon the ancient weapon...\That's right!\We still have a chance!\Shut up!\According to this Netherworld Encyclopaedia, response:	a person who obtains the Wood Cubes...
context: She has gathered the Wood Cubes!\But even if she's gathered them,\if she doesn't know how to summon the ancient weapon...\That's right!\We still have a chance!\Shut up!\According to this Netherworld Encyclopaedia,\a person who obtains the Wood Cubes... response:	In other words,
context: But even if she's gathered them,\if she doesn't know how to summon the ancient weapon...\That's right!\We still have a chance!\Shut up!\According to this Netherworld Encyclopaedia,\a person who obtains the Wood Cubes...\In other words, response:	a person who obtains the Wood Cubes...
context: if she doesn't know how to summon the ancient weapon...\That's right!\We still have a chance!\Shut up!\According to this Netherworld Encyclopaedia,\a person who obtains the Wood Cubes...\In other words,\a person who obtains the Wood Cubes... response:	What was that?!
context: That's right!\We still have a chance!\Shut up!\According to this Netherworld Encyclopaedia,\a person who obtains the Wood Cubes...\In other words,\a person who obtains the Wood Cubes...\What was that?! response:	Could you explain it again?
context: We still have a chance!\Shut up!\According to this Netherworld Encyclopaedia,\a person who obtains the Wood Cubes...\In other words,\a person who obtains the Wood Cubes...\What was that?!\Could you explain it again? response:	Yeah, explain it once more!
context: Shut up!\According to this Netherworld Encyclopaedia,\a person who obtains the Wood Cubes...\In other words,\a person who obtains the Wood Cubes...\What was that?!\Could you explain it again?\Yeah, explain it once more! response:	In other words -
context: According to this Netherworld Encyclopaedia,\a person who obtains the Wood Cubes...\In other words,\a person who obtains the Wood Cubes...\What was that?!\Could you explain it again?\Yeah, explain it once more!\In other words - response:	I shouldn't need to say it!
context: a person who obtains the Wood Cubes...\In other words,\a person who obtains the Wood Cubes...\What was that?!\Could you explain it again?\Yeah, explain it once more!\In other words -\I shouldn't need to say it! response:	It's foolish to approach her!
context: In other words,\a person who obtains the Wood Cubes...\What was that?!\Could you explain it again?\Yeah, explain it once more!\In other words -\I shouldn't need to say it!\It's foolish to approach her! response:	The world could be destroyed!
context: a person who obtains the Wood Cubes...\What was that?!\Could you explain it again?\Yeah, explain it once more!\In other words -\I shouldn't need to say it!\It's foolish to approach her!\The world could be destroyed! response:	It's over!
context: What was that?!\Could you explain it again?\Yeah, explain it once more!\In other words -\I shouldn't need to say it!\It's foolish to approach her!\The world could be destroyed!\It's over! response:	It's over!
context: Could you explain it again?\Yeah, explain it once more!\In other words -\I shouldn't need to say it!\It's foolish to approach her!\The world could be destroyed!\It's over!\It's over! response:	Don't despair!
context: Yeah, explain it once more!\In other words -\I shouldn't need to say it!\It's foolish to approach her!\The world could be destroyed!\It's over!\It's over!\Don't despair! response:	Nothing comes from despair.
context: In other words -\I shouldn't need to say it!\It's foolish to approach her!\The world could be destroyed!\It's over!\It's over!\Don't despair!\Nothing comes from despair. response:	Not even a bit.
context: I shouldn't need to say it!\It's foolish to approach her!\The world could be destroyed!\It's over!\It's over!\Don't despair!\Nothing comes from despair.\Not even a bit. response:	Captain!
context: It's foolish to approach her!\The world could be destroyed!\It's over!\It's over!\Don't despair!\Nothing comes from despair.\Not even a bit.\Captain! response:	Captain!
context: The world could be destroyed!\It's over!\It's over!\Don't despair!\Nothing comes from despair.\Not even a bit.\Captain!\Captain! response:	Captain!
context: It's over!\It's over!\Don't despair!\Nothing comes from despair.\Not even a bit.\Captain!\Captain!\Captain! response:	Listen. If we fight head-on, even for a bit, we're finished.
context: It's over!\Don't despair!\Nothing comes from despair.\Not even a bit.\Captain!\Captain!\Captain!\Listen. If we fight head-on, even for a bit, we're finished. response:	We have no chance.
context: Don't despair!\Nothing comes from despair.\Not even a bit.\Captain!\Captain!\Captain!\Listen. If we fight head-on, even for a bit, we're finished.\We have no chance. response:	However!
context: Nothing comes from despair.\Not even a bit.\Captain!\Captain!\Captain!\Listen. If we fight head-on, even for a bit, we're finished.\We have no chance.\However! response:	Even for a bit, our opponent is all alone.
context: Not even a bit.\Captain!\Captain!\Captain!\Listen. If we fight head-on, even for a bit, we're finished.\We have no chance.\However!\Even for a bit, our opponent is all alone. response:	While we, on the other hand, have numbers.
context: Captain!\Captain!\Captain!\Listen. If we fight head-on, even for a bit, we're finished.\We have no chance.\However!\Even for a bit, our opponent is all alone.\While we, on the other hand, have numbers. response:	Therefore!
context: Captain!\Captain!\Listen. If we fight head-on, even for a bit, we're finished.\We have no chance.\However!\Even for a bit, our opponent is all alone.\While we, on the other hand, have numbers.\Therefore! response:	We should all try to take back the Wood Cubes together.
context: Captain!\Listen. If we fight head-on, even for a bit, we're finished.\We have no chance.\However!\Even for a bit, our opponent is all alone.\While we, on the other hand, have numbers.\Therefore!\We should all try to take back the Wood Cubes together. response:	I'll take the lead!
context: Listen. If we fight head-on, even for a bit, we're finished.\We have no chance.\However!\Even for a bit, our opponent is all alone.\While we, on the other hand, have numbers.\Therefore!\We should all try to take back the Wood Cubes together.\I'll take the lead! response:	After me!
context: We have no chance.\However!\Even for a bit, our opponent is all alone.\While we, on the other hand, have numbers.\Therefore!\We should all try to take back the Wood Cubes together.\I'll take the lead!\After me! response:	Captain!
context: However!\Even for a bit, our opponent is all alone.\While we, on the other hand, have numbers.\Therefore!\We should all try to take back the Wood Cubes together.\I'll take the lead!\After me!\Captain! response:	No! Leave me! Go!
context: Even for a bit, our opponent is all alone.\While we, on the other hand, have numbers.\Therefore!\We should all try to take back the Wood Cubes together.\I'll take the lead!\After me!\Captain!\No! Leave me! Go! response:	B-But!
context: While we, on the other hand, have numbers.\Therefore!\We should all try to take back the Wood Cubes together.\I'll take the lead!\After me!\Captain!\No! Leave me! Go!\B-But! response:	You fool!
context: Therefore!\We should all try to take back the Wood Cubes together.\I'll take the lead!\After me!\Captain!\No! Leave me! Go!\B-But!\You fool! response:	I don't recall raising you to be so soft!
context: We should all try to take back the Wood Cubes together.\I'll take the lead!\After me!\Captain!\No! Leave me! Go!\B-But!\You fool!\I don't recall raising you to be so soft! response:	It's over.
context: I'll take the lead!\After me!\Captain!\No! Leave me! Go!\B-But!\You fool!\I don't recall raising you to be so soft!\It's over. response:	The Advisor was killed.
context: After me!\Captain!\No! Leave me! Go!\B-But!\You fool!\I don't recall raising you to be so soft!\It's over.\The Advisor was killed. response:	The Captain can't move.
context: Captain!\No! Leave me! Go!\B-But!\You fool!\I don't recall raising you to be so soft!\It's over.\The Advisor was killed.\The Captain can't move. response:	We can't do anything more.
context: No! Leave me! Go!\B-But!\You fool!\I don't recall raising you to be so soft!\It's over.\The Advisor was killed.\The Captain can't move.\We can't do anything more. response:	One...
context: B-But!\You fool!\I don't recall raising you to be so soft!\It's over.\The Advisor was killed.\The Captain can't move.\We can't do anything more.\One... response:	One for all...
context: You fool!\I don't recall raising you to be so soft!\It's over.\The Advisor was killed.\The Captain can't move.\We can't do anything more.\One...\One for all... response:	Captain!
context: I don't recall raising you to be so soft!\It's over.\The Advisor was killed.\The Captain can't move.\We can't do anything more.\One...\One for all...\Captain! response:	I've been in this troop for 12 years now.
context: It's over.\The Advisor was killed.\The Captain can't move.\We can't do anything more.\One...\One for all...\Captain!\I've been in this troop for 12 years now. response:	These 12 years of memories...
context: The Advisor was killed.\The Captain can't move.\We can't do anything more.\One...\One for all...\Captain!\I've been in this troop for 12 years now.\These 12 years of memories... response:	Ending like this...
context: The Captain can't move.\We can't do anything more.\One...\One for all...\Captain!\I've been in this troop for 12 years now.\These 12 years of memories...\Ending like this... response:	To that monster...
context: We can't do anything more.\One...\One for all...\Captain!\I've been in this troop for 12 years now.\These 12 years of memories...\Ending like this...\To that monster... response:	In a place like this...
context: One...\One for all...\Captain!\I've been in this troop for 12 years now.\These 12 years of memories...\Ending like this...\To that monster...\In a place like this... response:	In a place like this...
context: One for all...\Captain!\I've been in this troop for 12 years now.\These 12 years of memories...\Ending like this...\To that monster...\In a place like this...\In a place like this... response:	Like I'd let that happen!
context: Captain!\I've been in this troop for 12 years now.\These 12 years of memories...\Ending like this...\To that monster...\In a place like this...\In a place like this...\Like I'd let that happen! response:	It's over!
context: I've been in this troop for 12 years now.\These 12 years of memories...\Ending like this...\To that monster...\In a place like this...\In a place like this...\Like I'd let that happen!\It's over! response:	No! I don't want to die!
context: These 12 years of memories...\Ending like this...\To that monster...\In a place like this...\In a place like this...\Like I'd let that happen!\It's over!\No! I don't want to die! response:	I'm gonna go wash my face.
context: Ending like this...\To that monster...\In a place like this...\In a place like this...\Like I'd let that happen!\It's over!\No! I don't want to die!\I'm gonna go wash my face. response:	So obvious!
context: To that monster...\In a place like this...\In a place like this...\Like I'd let that happen!\It's over!\No! I don't want to die!\I'm gonna go wash my face.\So obvious! response:	Oh, boy.
context: In a place like this...\In a place like this...\Like I'd let that happen!\It's over!\No! I don't want to die!\I'm gonna go wash my face.\So obvious!\Oh, boy. response:	Well, I've got nothing better to do,
context: In a place like this...\Like I'd let that happen!\It's over!\No! I don't want to die!\I'm gonna go wash my face.\So obvious!\Oh, boy.\Well, I've got nothing better to do, response:	so I guess I'll play along with the kid.
context: Like I'd let that happen!\It's over!\No! I don't want to die!\I'm gonna go wash my face.\So obvious!\Oh, boy.\Well, I've got nothing better to do,\so I guess I'll play along with the kid. response:	Creating free time is a skill.
context: It's over!\No! I don't want to die!\I'm gonna go wash my face.\So obvious!\Oh, boy.\Well, I've got nothing better to do,\so I guess I'll play along with the kid.\Creating free time is a skill. response:	Your hair is messy.
context: No! I don't want to die!\I'm gonna go wash my face.\So obvious!\Oh, boy.\Well, I've got nothing better to do,\so I guess I'll play along with the kid.\Creating free time is a skill.\Your hair is messy. response:	It's kind of cute.
context: I'm gonna go wash my face.\So obvious!\Oh, boy.\Well, I've got nothing better to do,\so I guess I'll play along with the kid.\Creating free time is a skill.\Your hair is messy.\It's kind of cute. response:	It's kind of cute.
context: So obvious!\Oh, boy.\Well, I've got nothing better to do,\so I guess I'll play along with the kid.\Creating free time is a skill.\Your hair is messy.\It's kind of cute.\It's kind of cute. response:	What the heck am I doing?!
context: Oh, boy.\Well, I've got nothing better to do,\so I guess I'll play along with the kid.\Creating free time is a skill.\Your hair is messy.\It's kind of cute.\It's kind of cute.\What the heck am I doing?! response:	I went first.
context: Well, I've got nothing better to do,\so I guess I'll play along with the kid.\Creating free time is a skill.\Your hair is messy.\It's kind of cute.\It's kind of cute.\What the heck am I doing?!\I went first. response:	I had a very nice bath.
context: so I guess I'll play along with the kid.\Creating free time is a skill.\Your hair is messy.\It's kind of cute.\It's kind of cute.\What the heck am I doing?!\I went first.\I had a very nice bath. response:	I'm an Ai-Ai-Gasa.
context: Creating free time is a skill.\Your hair is messy.\It's kind of cute.\It's kind of cute.\What the heck am I doing?!\I went first.\I had a very nice bath.\I'm an Ai-Ai-Gasa. response:	Why don't you try drawing me once in a while?
context: Your hair is messy.\It's kind of cute.\It's kind of cute.\What the heck am I doing?!\I went first.\I had a very nice bath.\I'm an Ai-Ai-Gasa.\Why don't you try drawing me once in a while? response:	Write your name on the right,
context: It's kind of cute.\It's kind of cute.\What the heck am I doing?!\I went first.\I had a very nice bath.\I'm an Ai-Ai-Gasa.\Why don't you try drawing me once in a while?\Write your name on the right, response:	and on the left... You don't have any name to write?
context: It's kind of cute.\What the heck am I doing?!\I went first.\I had a very nice bath.\I'm an Ai-Ai-Gasa.\Why don't you try drawing me once in a while?\Write your name on the right,\and on the left... You don't have any name to write? response:	Next time on Nichijou: Episode 22.
context: What the heck am I doing?!\I went first.\I had a very nice bath.\I'm an Ai-Ai-Gasa.\Why don't you try drawing me once in a while?\Write your name on the right,\and on the left... You don't have any name to write?\Next time on Nichijou: Episode 22. response:	Look forward to it!