context: I was having a dream... response:	Please wake up, groom.
context: I was having a dream...\Please wake up, groom. response:	The bride is ready.
context: I was having a dream...\Please wake up, groom.\The bride is ready. response:	A dream of the unbelievable day that brought us together.
context: I was having a dream...\Please wake up, groom.\The bride is ready.\A dream of the unbelievable day that brought us together. response:	Barbecue beef combo.
context: I was having a dream...\Please wake up, groom.\The bride is ready.\A dream of the unbelievable day that brought us together.\Barbecue beef combo. response:	Without beef.
context: I was having a dream...\Please wake up, groom.\The bride is ready.\A dream of the unbelievable day that brought us together.\Barbecue beef combo.\Without beef. response:	Sure thing.
context: I was having a dream...\Please wake up, groom.\The bride is ready.\A dream of the unbelievable day that brought us together.\Barbecue beef combo.\Without beef.\Sure thing. response:	You'd think the cheapest item on this cafeteria's menu would be rice, but no.
context: I was having a dream...\Please wake up, groom.\The bride is ready.\A dream of the unbelievable day that brought us together.\Barbecue beef combo.\Without beef.\Sure thing.\You'd think the cheapest item on this cafeteria's menu would be rice, but no. response:	Barbecue Beef Combo
context: Please wake up, groom.\The bride is ready.\A dream of the unbelievable day that brought us together.\Barbecue beef combo.\Without beef.\Sure thing.\You'd think the cheapest item on this cafeteria's menu would be rice, but no.\Barbecue Beef Combo response:	Rice Miso Soup Pickled Vegetables
context: The bride is ready.\A dream of the unbelievable day that brought us together.\Barbecue beef combo.\Without beef.\Sure thing.\You'd think the cheapest item on this cafeteria's menu would be rice, but no.\Barbecue Beef Combo\Rice Miso Soup Pickled Vegetables response:	Subtract 200 yen for the beef from the barbecue beef combo,
context: A dream of the unbelievable day that brought us together.\Barbecue beef combo.\Without beef.\Sure thing.\You'd think the cheapest item on this cafeteria's menu would be rice, but no.\Barbecue Beef Combo\Rice Miso Soup Pickled Vegetables\Subtract 200 yen for the beef from the barbecue beef combo, response:	and you get rice plus miso soup and pickled veggies for the price of rice.
context: Barbecue beef combo.\Without beef.\Sure thing.\You'd think the cheapest item on this cafeteria's menu would be rice, but no.\Barbecue Beef Combo\Rice Miso Soup Pickled Vegetables\Subtract 200 yen for the beef from the barbecue beef combo,\and you get rice plus miso soup and pickled veggies for the price of rice. response:	You get free, unlimited water, too.
context: Without beef.\Sure thing.\You'd think the cheapest item on this cafeteria's menu would be rice, but no.\Barbecue Beef Combo\Rice Miso Soup Pickled Vegetables\Subtract 200 yen for the beef from the barbecue beef combo,\and you get rice plus miso soup and pickled veggies for the price of rice.\You get free, unlimited water, too. response:	School cafeteria for the win.
context: Sure thing.\You'd think the cheapest item on this cafeteria's menu would be rice, but no.\Barbecue Beef Combo\Rice Miso Soup Pickled Vegetables\Subtract 200 yen for the beef from the barbecue beef combo,\and you get rice plus miso soup and pickled veggies for the price of rice.\You get free, unlimited water, too.\School cafeteria for the win. response:	Uesugi-kun's on his own again.
context: You'd think the cheapest item on this cafeteria's menu would be rice, but no.\Barbecue Beef Combo\Rice Miso Soup Pickled Vegetables\Subtract 200 yen for the beef from the barbecue beef combo,\and you get rice plus miso soup and pickled veggies for the price of rice.\You get free, unlimited water, too.\School cafeteria for the win.\Uesugi-kun's on his own again. response:	Oh, man.
context: Barbecue Beef Combo\Rice Miso Soup Pickled Vegetables\Subtract 200 yen for the beef from the barbecue beef combo,\and you get rice plus miso soup and pickled veggies for the price of rice.\You get free, unlimited water, too.\School cafeteria for the win.\Uesugi-kun's on his own again.\Oh, man. response:	The Quintessential Quintuplets
context: Rice Miso Soup Pickled Vegetables\Subtract 200 yen for the beef from the barbecue beef combo,\and you get rice plus miso soup and pickled veggies for the price of rice.\You get free, unlimited water, too.\School cafeteria for the win.\Uesugi-kun's on his own again.\Oh, man.\The Quintessential Quintuplets response:	The Quintessential Quintuplets
context: Subtract 200 yen for the beef from the barbecue beef combo,\and you get rice plus miso soup and pickled veggies for the price of rice.\You get free, unlimited water, too.\School cafeteria for the win.\Uesugi-kun's on his own again.\Oh, man.\The Quintessential Quintuplets\The Quintessential Quintuplets response:	The Quint es sen tial Quin tup lets
context: and you get rice plus miso soup and pickled veggies for the price of rice.\You get free, unlimited water, too.\School cafeteria for the win.\Uesugi-kun's on his own again.\Oh, man.\The Quintessential Quintuplets\The Quintessential Quintuplets\The Quint es sen tial Quin tup lets response:	The Quintessential Quintuplets
context: You get free, unlimited water, too.\School cafeteria for the win.\Uesugi-kun's on his own again.\Oh, man.\The Quintessential Quintuplets\The Quintessential Quintuplets\The Quint es sen tial Quin tup lets\The Quintessential Quintuplets response:	Yo, who's that?
context: School cafeteria for the win.\Uesugi-kun's on his own again.\Oh, man.\The Quintessential Quintuplets\The Quintessential Quintuplets\The Quint es sen tial Quin tup lets\The Quintessential Quintuplets\Yo, who's that? response:	Someone's sitting with Uesugi?
context: Uesugi-kun's on his own again.\Oh, man.\The Quintessential Quintuplets\The Quintessential Quintuplets\The Quint es sen tial Quin tup lets\The Quintessential Quintuplets\Yo, who's that?\Someone's sitting with Uesugi? response:	That never happens!
context: Oh, man.\The Quintessential Quintuplets\The Quintessential Quintuplets\The Quint es sen tial Quin tup lets\The Quintessential Quintuplets\Yo, who's that?\Someone's sitting with Uesugi?\That never happens! response:	She isn't wearing our uniform...
context: The Quintessential Quintuplets\The Quintessential Quintuplets\The Quint es sen tial Quin tup lets\The Quintessential Quintuplets\Yo, who's that?\Someone's sitting with Uesugi?\That never happens!\She isn't wearing our uniform... response:	Wait, how did this even happen?
context: The Quintessential Quintuplets\The Quint es sen tial Quin tup lets\The Quintessential Quintuplets\Yo, who's that?\Someone's sitting with Uesugi?\That never happens!\She isn't wearing our uniform...\Wait, how did this even happen? response:	I got here first.
context: The Quint es sen tial Quin tup lets\The Quintessential Quintuplets\Yo, who's that?\Someone's sitting with Uesugi?\That never happens!\She isn't wearing our uniform...\Wait, how did this even happen?\I got here first. response:	The next table over is available.
context: The Quintessential Quintuplets\Yo, who's that?\Someone's sitting with Uesugi?\That never happens!\She isn't wearing our uniform...\Wait, how did this even happen?\I got here first.\The next table over is available. response:	Move, please.
context: Yo, who's that?\Someone's sitting with Uesugi?\That never happens!\She isn't wearing our uniform...\Wait, how did this even happen?\I got here first.\The next table over is available.\Move, please. response:	This is where I sit every day.
context: Someone's sitting with Uesugi?\That never happens!\She isn't wearing our uniform...\Wait, how did this even happen?\I got here first.\The next table over is available.\Move, please.\This is where I sit every day. response:	You move.
context: That never happens!\She isn't wearing our uniform...\Wait, how did this even happen?\I got here first.\The next table over is available.\Move, please.\This is where I sit every day.\You move. response:	Look, Uesugi-kun's having lunch with a girl.
context: She isn't wearing our uniform...\Wait, how did this even happen?\I got here first.\The next table over is available.\Move, please.\This is where I sit every day.\You move.\Look, Uesugi-kun's having lunch with a girl. response:	For real? Yikes!
context: Wait, how did this even happen?\I got here first.\The next table over is available.\Move, please.\This is where I sit every day.\You move.\Look, Uesugi-kun's having lunch with a girl.\For real? Yikes! response:	Tch. Those stupid...
context: I got here first.\The next table over is available.\Move, please.\This is where I sit every day.\You move.\Look, Uesugi-kun's having lunch with a girl.\For real? Yikes!\Tch. Those stupid... response:	She's all red.
context: The next table over is available.\Move, please.\This is where I sit every day.\You move.\Look, Uesugi-kun's having lunch with a girl.\For real? Yikes!\Tch. Those stupid...\She's all red. response:	No one forced you, you know.
context: Move, please.\This is where I sit every day.\You move.\Look, Uesugi-kun's having lunch with a girl.\For real? Yikes!\Tch. Those stupid...\She's all red.\No one forced you, you know. response:	Udon for 250 yen.
context: This is where I sit every day.\You move.\Look, Uesugi-kun's having lunch with a girl.\For real? Yikes!\Tch. Those stupid...\She's all red.\No one forced you, you know.\Udon for 250 yen. response:	Two shrimp tempura for 150 each.
context: You move.\Look, Uesugi-kun's having lunch with a girl.\For real? Yikes!\Tch. Those stupid...\She's all red.\No one forced you, you know.\Udon for 250 yen.\Two shrimp tempura for 150 each. response:	Squid tempura for 100.
context: Look, Uesugi-kun's having lunch with a girl.\For real? Yikes!\Tch. Those stupid...\She's all red.\No one forced you, you know.\Udon for 250 yen.\Two shrimp tempura for 150 each.\Squid tempura for 100. response:	Chicken tempura.
context: For real? Yikes!\Tch. Those stupid...\She's all red.\No one forced you, you know.\Udon for 250 yen.\Two shrimp tempura for 150 each.\Squid tempura for 100.\Chicken tempura. response:	Yam tempura.
context: Tch. Those stupid...\She's all red.\No one forced you, you know.\Udon for 250 yen.\Two shrimp tempura for 150 each.\Squid tempura for 100.\Chicken tempura.\Yam tempura. response:	And a pudding dessert to top it off!
context: She's all red.\No one forced you, you know.\Udon for 250 yen.\Two shrimp tempura for 150 each.\Squid tempura for 100.\Chicken tempura.\Yam tempura.\And a pudding dessert to top it off! response:	Yen
context: No one forced you, you know.\Udon for 250 yen.\Two shrimp tempura for 150 each.\Squid tempura for 100.\Chicken tempura.\Yam tempura.\And a pudding dessert to top it off!\Yen response:	Yen
context: Udon for 250 yen.\Two shrimp tempura for 150 each.\Squid tempura for 100.\Chicken tempura.\Yam tempura.\And a pudding dessert to top it off!\Yen\Yen response:	Over 1,000 yen on lunch? What are you, filthy rich?!
context: Two shrimp tempura for 150 each.\Squid tempura for 100.\Chicken tempura.\Yam tempura.\And a pudding dessert to top it off!\Yen\Yen\Over 1,000 yen on lunch? What are you, filthy rich?! response:	Well, do as you like.
context: Squid tempura for 100.\Chicken tempura.\Yam tempura.\And a pudding dessert to top it off!\Yen\Yen\Over 1,000 yen on lunch? What are you, filthy rich?!\Well, do as you like. response:	Time to eat.
context: Chicken tempura.\Yam tempura.\And a pudding dessert to top it off!\Yen\Yen\Over 1,000 yen on lunch? What are you, filthy rich?!\Well, do as you like.\Time to eat. response:	Mind your manners.
context: Yam tempura.\And a pudding dessert to top it off!\Yen\Yen\Over 1,000 yen on lunch? What are you, filthy rich?!\Well, do as you like.\Time to eat.\Mind your manners. response:	Studying in the middle of lunch?
context: And a pudding dessert to top it off!\Yen\Yen\Over 1,000 yen on lunch? What are you, filthy rich?!\Well, do as you like.\Time to eat.\Mind your manners.\Studying in the middle of lunch? response:	I'm reviewing my exam.
context: Yen\Yen\Over 1,000 yen on lunch? What are you, filthy rich?!\Well, do as you like.\Time to eat.\Mind your manners.\Studying in the middle of lunch?\I'm reviewing my exam. response:	Leave me alone.
context: Yen\Over 1,000 yen on lunch? What are you, filthy rich?!\Well, do as you like.\Time to eat.\Mind your manners.\Studying in the middle of lunch?\I'm reviewing my exam.\Leave me alone. response:	You must be pretty screwed.
context: Over 1,000 yen on lunch? What are you, filthy rich?!\Well, do as you like.\Time to eat.\Mind your manners.\Studying in the middle of lunch?\I'm reviewing my exam.\Leave me alone.\You must be pretty screwed. response:	What did you get?
context: Well, do as you like.\Time to eat.\Mind your manners.\Studying in the middle of lunch?\I'm reviewing my exam.\Leave me alone.\You must be pretty screwed.\What did you get? response:	H-Hey!
context: Time to eat.\Mind your manners.\Studying in the middle of lunch?\I'm reviewing my exam.\Leave me alone.\You must be pretty screwed.\What did you get?\H-Hey! response:	Let's see, Uesugi Futaro-kun.
context: Mind your manners.\Studying in the middle of lunch?\I'm reviewing my exam.\Leave me alone.\You must be pretty screwed.\What did you get?\H-Hey!\Let's see, Uesugi Futaro-kun. response:	You scored...
context: Studying in the middle of lunch?\I'm reviewing my exam.\Leave me alone.\You must be pretty screwed.\What did you get?\H-Hey!\Let's see, Uesugi Futaro-kun.\You scored... response:	O-One hundred?!
context: I'm reviewing my exam.\Leave me alone.\You must be pretty screwed.\What did you get?\H-Hey!\Let's see, Uesugi Futaro-kun.\You scored...\O-One hundred?! response:	Is this real?
context: Leave me alone.\You must be pretty screwed.\What did you get?\H-Hey!\Let's see, Uesugi Futaro-kun.\You scored...\O-One hundred?!\Is this real? response:	Oh, man, that's embarrassing.
context: You must be pretty screwed.\What did you get?\H-Hey!\Let's see, Uesugi Futaro-kun.\You scored...\O-One hundred?!\Is this real?\Oh, man, that's embarrassing. response:	You showed me this on purpose!
context: What did you get?\H-Hey!\Let's see, Uesugi Futaro-kun.\You scored...\O-One hundred?!\Is this real?\Oh, man, that's embarrassing.\You showed me this on purpose! response:	I hate to admit it, but I'm not great at studies.
context: H-Hey!\Let's see, Uesugi Futaro-kun.\You scored...\O-One hundred?!\Is this real?\Oh, man, that's embarrassing.\You showed me this on purpose!\I hate to admit it, but I'm not great at studies. response:	I envy you.
context: Let's see, Uesugi Futaro-kun.\You scored...\O-One hundred?!\Is this real?\Oh, man, that's embarrassing.\You showed me this on purpose!\I hate to admit it, but I'm not great at studies.\I envy you. response:	I know!
context: You scored...\O-One hundred?!\Is this real?\Oh, man, that's embarrassing.\You showed me this on purpose!\I hate to admit it, but I'm not great at studies.\I envy you.\I know! response:	Lady Luck brought you to my table! You should help me study!
context: O-One hundred?!\Is this real?\Oh, man, that's embarrassing.\You showed me this on purpose!\I hate to admit it, but I'm not great at studies.\I envy you.\I know!\Lady Luck brought you to my table! You should help me study! response:	Thank you for the meal.
context: Is this real?\Oh, man, that's embarrassing.\You showed me this on purpose!\I hate to admit it, but I'm not great at studies.\I envy you.\I know!\Lady Luck brought you to my table! You should help me study!\Thank you for the meal. response:	You're done eating already?!
context: Oh, man, that's embarrassing.\You showed me this on purpose!\I hate to admit it, but I'm not great at studies.\I envy you.\I know!\Lady Luck brought you to my table! You should help me study!\Thank you for the meal.\You're done eating already?! response:	Are you really full?
context: You showed me this on purpose!\I hate to admit it, but I'm not great at studies.\I envy you.\I know!\Lady Luck brought you to my table! You should help me study!\Thank you for the meal.\You're done eating already?!\Are you really full? response:	Shall I share some of mine?
context: I hate to admit it, but I'm not great at studies.\I envy you.\I know!\Lady Luck brought you to my table! You should help me study!\Thank you for the meal.\You're done eating already?!\Are you really full?\Shall I share some of mine? response:	If anything, you ordered way too much.
context: I envy you.\I know!\Lady Luck brought you to my table! You should help me study!\Thank you for the meal.\You're done eating already?!\Are you really full?\Shall I share some of mine?\If anything, you ordered way too much. response:	You'll gain weight.
context: I know!\Lady Luck brought you to my table! You should help me study!\Thank you for the meal.\You're done eating already?!\Are you really full?\Shall I share some of mine?\If anything, you ordered way too much.\You'll gain weight. response:	Gain...
context: Lady Luck brought you to my table! You should help me study!\Thank you for the meal.\You're done eating already?!\Are you really full?\Shall I share some of mine?\If anything, you ordered way too much.\You'll gain weight.\Gain... response:	I've never met anyone so insensitive!
context: Thank you for the meal.\You're done eating already?!\Are you really full?\Shall I share some of mine?\If anything, you ordered way too much.\You'll gain weight.\Gain...\I've never met anyone so insensitive! response:	I'm not giving you anything!
context: You're done eating already?!\Are you really full?\Shall I share some of mine?\If anything, you ordered way too much.\You'll gain weight.\Gain...\I've never met anyone so insensitive!\I'm not giving you anything! response:	Uesugi Raiha
context: Are you really full?\Shall I share some of mine?\If anything, you ordered way too much.\You'll gain weight.\Gain...\I've never met anyone so insensitive!\I'm not giving you anything!\Uesugi Raiha response:	Are you eating alone again? Call me o
context: Shall I share some of mine?\If anything, you ordered way too much.\You'll gain weight.\Gain...\I've never met anyone so insensitive!\I'm not giving you anything!\Uesugi Raiha\Are you eating alone again? Call me o response:	We can clear our debt?
context: If anything, you ordered way too much.\You'll gain weight.\Gain...\I've never met anyone so insensitive!\I'm not giving you anything!\Uesugi Raiha\Are you eating alone again? Call me o\We can clear our debt? response:	Dad found a good part-time job.
context: You'll gain weight.\Gain...\I've never met anyone so insensitive!\I'm not giving you anything!\Uesugi Raiha\Are you eating alone again? Call me o\We can clear our debt?\Dad found a good part-time job. response:	A rich family moved in just recently,
context: Gain...\I've never met anyone so insensitive!\I'm not giving you anything!\Uesugi Raiha\Are you eating alone again? Call me o\We can clear our debt?\Dad found a good part-time job.\A rich family moved in just recently, response:	and they're looking for a tutor for their daughter.
context: I've never met anyone so insensitive!\I'm not giving you anything!\Uesugi Raiha\Are you eating alone again? Call me o\We can clear our debt?\Dad found a good part-time job.\A rich family moved in just recently,\and they're looking for a tutor for their daughter. response:	A tutor?
context: I'm not giving you anything!\Uesugi Raiha\Are you eating alone again? Call me o\We can clear our debt?\Dad found a good part-time job.\A rich family moved in just recently,\and they're looking for a tutor for their daughter.\A tutor? response:	A fun, homely workplace.
context: Uesugi Raiha\Are you eating alone again? Call me o\We can clear our debt?\Dad found a good part-time job.\A rich family moved in just recently,\and they're looking for a tutor for their daughter.\A tutor?\A fun, homely workplace. response:	And they're paying five times the market price.
context: Are you eating alone again? Call me o\We can clear our debt?\Dad found a good part-time job.\A rich family moved in just recently,\and they're looking for a tutor for their daughter.\A tutor?\A fun, homely workplace.\And they're paying five times the market price. response:	Uh, that sounds really sketchy.
context: We can clear our debt?\Dad found a good part-time job.\A rich family moved in just recently,\and they're looking for a tutor for their daughter.\A tutor?\A fun, homely workplace.\And they're paying five times the market price.\Uh, that sounds really sketchy. response:	I heard people can get by on just one kidney.
context: Dad found a good part-time job.\A rich family moved in just recently,\and they're looking for a tutor for their daughter.\A tutor?\A fun, homely workplace.\And they're paying five times the market price.\Uh, that sounds really sketchy.\I heard people can get by on just one kidney. response:	Y-You're telling me to give one up?!
context: A rich family moved in just recently,\and they're looking for a tutor for their daughter.\A tutor?\A fun, homely workplace.\And they're paying five times the market price.\Uh, that sounds really sketchy.\I heard people can get by on just one kidney.\Y-You're telling me to give one up?! response:	I'm kidding.
context: and they're looking for a tutor for their daughter.\A tutor?\A fun, homely workplace.\And they're paying five times the market price.\Uh, that sounds really sketchy.\I heard people can get by on just one kidney.\Y-You're telling me to give one up?!\I'm kidding. response:	But now you can eat a bellyful,
context: A tutor?\A fun, homely workplace.\And they're paying five times the market price.\Uh, that sounds really sketchy.\I heard people can get by on just one kidney.\Y-You're telling me to give one up?!\I'm kidding.\But now you can eat a bellyful, response:	Onii-chan.
context: A fun, homely workplace.\And they're paying five times the market price.\Uh, that sounds really sketchy.\I heard people can get by on just one kidney.\Y-You're telling me to give one up?!\I'm kidding.\But now you can eat a bellyful,\Onii-chan. response:	So what's this daughter like?
context: And they're paying five times the market price.\Uh, that sounds really sketchy.\I heard people can get by on just one kidney.\Y-You're telling me to give one up?!\I'm kidding.\But now you can eat a bellyful,\Onii-chan.\So what's this daughter like? response:	She's in high school.
context: Uh, that sounds really sketchy.\I heard people can get by on just one kidney.\Y-You're telling me to give one up?!\I'm kidding.\But now you can eat a bellyful,\Onii-chan.\So what's this daughter like?\She's in high school. response:	They said she's transferring to your school.
context: I heard people can get by on just one kidney.\Y-You're telling me to give one up?!\I'm kidding.\But now you can eat a bellyful,\Onii-chan.\So what's this daughter like?\She's in high school.\They said she's transferring to your school. response:	Her name is, uh, Nakano...
context: Y-You're telling me to give one up?!\I'm kidding.\But now you can eat a bellyful,\Onii-chan.\So what's this daughter like?\She's in high school.\They said she's transferring to your school.\Her name is, uh, Nakano... response:	Nakano Itsuki.
context: I'm kidding.\But now you can eat a bellyful,\Onii-chan.\So what's this daughter like?\She's in high school.\They said she's transferring to your school.\Her name is, uh, Nakano...\Nakano Itsuki. response:	Pleased to meet you.
context: But now you can eat a bellyful,\Onii-chan.\So what's this daughter like?\She's in high school.\They said she's transferring to your school.\Her name is, uh, Nakano...\Nakano Itsuki.\Pleased to meet you. response:	I know this girl!
context: Onii-chan.\So what's this daughter like?\She's in high school.\They said she's transferring to your school.\Her name is, uh, Nakano...\Nakano Itsuki.\Pleased to meet you.\I know this girl! response:	The transfer student's a girl?
context: So what's this daughter like?\She's in high school.\They said she's transferring to your school.\Her name is, uh, Nakano...\Nakano Itsuki.\Pleased to meet you.\I know this girl!\The transfer student's a girl? response:	She's actually cute.
context: She's in high school.\They said she's transferring to your school.\Her name is, uh, Nakano...\Nakano Itsuki.\Pleased to meet you.\I know this girl!\The transfer student's a girl?\She's actually cute. response:	That uniform's from Kurobara Girls' School, isn't it?
context: They said she's transferring to your school.\Her name is, uh, Nakano...\Nakano Itsuki.\Pleased to meet you.\I know this girl!\The transfer student's a girl?\She's actually cute.\That uniform's from Kurobara Girls' School, isn't it? response:	Seriously? She must be rich as hell!
context: Her name is, uh, Nakano...\Nakano Itsuki.\Pleased to meet you.\I know this girl!\The transfer student's a girl?\She's actually cute.\That uniform's from Kurobara Girls' School, isn't it?\Seriously? She must be rich as hell! response:	A rich transfer student?
context: Nakano Itsuki.\Pleased to meet you.\I know this girl!\The transfer student's a girl?\She's actually cute.\That uniform's from Kurobara Girls' School, isn't it?\Seriously? She must be rich as hell!\A rich transfer student? response:	So she's the one?
context: Pleased to meet you.\I know this girl!\The transfer student's a girl?\She's actually cute.\That uniform's from Kurobara Girls' School, isn't it?\Seriously? She must be rich as hell!\A rich transfer student?\So she's the one? response:	H-Hey.
context: I know this girl!\The transfer student's a girl?\She's actually cute.\That uniform's from Kurobara Girls' School, isn't it?\Seriously? She must be rich as hell!\A rich transfer student?\So she's the one?\H-Hey. response:	Nice to meet you.
context: The transfer student's a girl?\She's actually cute.\That uniform's from Kurobara Girls' School, isn't it?\Seriously? She must be rich as hell!\A rich transfer student?\So she's the one?\H-Hey.\Nice to meet you. response:	U-Uh oh.
context: She's actually cute.\That uniform's from Kurobara Girls' School, isn't it?\Seriously? She must be rich as hell!\A rich transfer student?\So she's the one?\H-Hey.\Nice to meet you.\U-Uh oh. response:	Here you go. Barbecue beef combo without the beef.
context: That uniform's from Kurobara Girls' School, isn't it?\Seriously? She must be rich as hell!\A rich transfer student?\So she's the one?\H-Hey.\Nice to meet you.\U-Uh oh.\Here you go. Barbecue beef combo without the beef. response:	I messed up yesterday,
context: Seriously? She must be rich as hell!\A rich transfer student?\So she's the one?\H-Hey.\Nice to meet you.\U-Uh oh.\Here you go. Barbecue beef combo without the beef.\I messed up yesterday, response:	but if that transfer student rejects me,
context: A rich transfer student?\So she's the one?\H-Hey.\Nice to meet you.\U-Uh oh.\Here you go. Barbecue beef combo without the beef.\I messed up yesterday,\but if that transfer student rejects me, response:	I lose my tutoring opportunity.
context: So she's the one?\H-Hey.\Nice to meet you.\U-Uh oh.\Here you go. Barbecue beef combo without the beef.\I messed up yesterday,\but if that transfer student rejects me,\I lose my tutoring opportunity. response:	I have to get back on her good side.
context: H-Hey.\Nice to meet you.\U-Uh oh.\Here you go. Barbecue beef combo without the beef.\I messed up yesterday,\but if that transfer student rejects me,\I lose my tutoring opportunity.\I have to get back on her good side. response:	I'm back. I wanted to sit beside you again.
context: Nice to meet you.\U-Uh oh.\Here you go. Barbecue beef combo without the beef.\I messed up yesterday,\but if that transfer student rejects me,\I lose my tutoring opportunity.\I have to get back on her good side.\I'm back. I wanted to sit beside you again. response:	Of course, not just for lunch, but for studying, too.
context: U-Uh oh.\Here you go. Barbecue beef combo without the beef.\I messed up yesterday,\but if that transfer student rejects me,\I lose my tutoring opportunity.\I have to get back on her good side.\I'm back. I wanted to sit beside you again.\Of course, not just for lunch, but for studying, too. response:	Oh, my!
context: Here you go. Barbecue beef combo without the beef.\I messed up yesterday,\but if that transfer student rejects me,\I lose my tutoring opportunity.\I have to get back on her good side.\I'm back. I wanted to sit beside you again.\Of course, not just for lunch, but for studying, too.\Oh, my! response:	Perfect.
context: I messed up yesterday,\but if that transfer student rejects me,\I lose my tutoring opportunity.\I have to get back on her good side.\I'm back. I wanted to sit beside you again.\Of course, not just for lunch, but for studying, too.\Oh, my!\Perfect. response:	Thanks for waiting.
context: but if that transfer student rejects me,\I lose my tutoring opportunity.\I have to get back on her good side.\I'm back. I wanted to sit beside you again.\Of course, not just for lunch, but for studying, too.\Oh, my!\Perfect.\Thanks for waiting. response:	She's eating with her friends.
context: I lose my tutoring opportunity.\I have to get back on her good side.\I'm back. I wanted to sit beside you again.\Of course, not just for lunch, but for studying, too.\Oh, my!\Perfect.\Thanks for waiting.\She's eating with her friends. response:	I'm sorry, but this table is full.
context: I have to get back on her good side.\I'm back. I wanted to sit beside you again.\Of course, not just for lunch, but for studying, too.\Oh, my!\Perfect.\Thanks for waiting.\She's eating with her friends.\I'm sorry, but this table is full. response:	Hey, you. Leaving just like that?
context: I'm back. I wanted to sit beside you again.\Of course, not just for lunch, but for studying, too.\Oh, my!\Perfect.\Thanks for waiting.\She's eating with her friends.\I'm sorry, but this table is full.\Hey, you. Leaving just like that? response:	You're after Itsuki-chan, aren't you?
context: Of course, not just for lunch, but for studying, too.\Oh, my!\Perfect.\Thanks for waiting.\She's eating with her friends.\I'm sorry, but this table is full.\Hey, you. Leaving just like that?\You're after Itsuki-chan, aren't you? response:	I'm not after her.
context: Oh, my!\Perfect.\Thanks for waiting.\She's eating with her friends.\I'm sorry, but this table is full.\Hey, you. Leaving just like that?\You're after Itsuki-chan, aren't you?\I'm not after her. response:	What? So it is Itsuki-chan?
context: Perfect.\Thanks for waiting.\She's eating with her friends.\I'm sorry, but this table is full.\Hey, you. Leaving just like that?\You're after Itsuki-chan, aren't you?\I'm not after her.\What? So it is Itsuki-chan? response:	What was it about her that got you?
context: Thanks for waiting.\She's eating with her friends.\I'm sorry, but this table is full.\Hey, you. Leaving just like that?\You're after Itsuki-chan, aren't you?\I'm not after her.\What? So it is Itsuki-chan?\What was it about her that got you? response:	How proper she is? You do seem like you'd be into that.
context: She's eating with her friends.\I'm sorry, but this table is full.\Hey, you. Leaving just like that?\You're after Itsuki-chan, aren't you?\I'm not after her.\What? So it is Itsuki-chan?\What was it about her that got you?\How proper she is? You do seem like you'd be into that. response:	I know, I'll go get her.
context: I'm sorry, but this table is full.\Hey, you. Leaving just like that?\You're after Itsuki-chan, aren't you?\I'm not after her.\What? So it is Itsuki-chan?\What was it about her that got you?\How proper she is? You do seem like you'd be into that.\I know, I'll go get her. response:	Wait.
context: Hey, you. Leaving just like that?\You're after Itsuki-chan, aren't you?\I'm not after her.\What? So it is Itsuki-chan?\What was it about her that got you?\How proper she is? You do seem like you'd be into that.\I know, I'll go get her.\Wait. response:	I don't need your help.
context: You're after Itsuki-chan, aren't you?\I'm not after her.\What? So it is Itsuki-chan?\What was it about her that got you?\How proper she is? You do seem like you'd be into that.\I know, I'll go get her.\Wait.\I don't need your help. response:	My problems are my own to figure out.
context: I'm not after her.\What? So it is Itsuki-chan?\What was it about her that got you?\How proper she is? You do seem like you'd be into that.\I know, I'll go get her.\Wait.\I don't need your help.\My problems are my own to figure out. response:	That's pretty manly, coming from a studyholic.
context: What? So it is Itsuki-chan?\What was it about her that got you?\How proper she is? You do seem like you'd be into that.\I know, I'll go get her.\Wait.\I don't need your help.\My problems are my own to figure out.\That's pretty manly, coming from a studyholic. response:	You can come to your Big Sis Ichika if you ever need help.
context: What was it about her that got you?\How proper she is? You do seem like you'd be into that.\I know, I'll go get her.\Wait.\I don't need your help.\My problems are my own to figure out.\That's pretty manly, coming from a studyholic.\You can come to your Big Sis Ichika if you ever need help. response:	I bet this is going to be fun.
context: How proper she is? You do seem like you'd be into that.\I know, I'll go get her.\Wait.\I don't need your help.\My problems are my own to figure out.\That's pretty manly, coming from a studyholic.\You can come to your Big Sis Ichika if you ever need help.\I bet this is going to be fun. response:	Big Sis? What?
context: I know, I'll go get her.\Wait.\I don't need your help.\My problems are my own to figure out.\That's pretty manly, coming from a studyholic.\You can come to your Big Sis Ichika if you ever need help.\I bet this is going to be fun.\Big Sis? What? response:	We're in the same year.
context: Wait.\I don't need your help.\My problems are my own to figure out.\That's pretty manly, coming from a studyholic.\You can come to your Big Sis Ichika if you ever need help.\I bet this is going to be fun.\Big Sis? What?\We're in the same year. response:	I think.
context: I don't need your help.\My problems are my own to figure out.\That's pretty manly, coming from a studyholic.\You can come to your Big Sis Ichika if you ever need help.\I bet this is going to be fun.\Big Sis? What?\We're in the same year.\I think. response:	This is bad, though.
context: My problems are my own to figure out.\That's pretty manly, coming from a studyholic.\You can come to your Big Sis Ichika if you ever need help.\I bet this is going to be fun.\Big Sis? What?\We're in the same year.\I think.\This is bad, though. response:	I'm meeting her as her tutor today, after school.
context: That's pretty manly, coming from a studyholic.\You can come to your Big Sis Ichika if you ever need help.\I bet this is going to be fun.\Big Sis? What?\We're in the same year.\I think.\This is bad, though.\I'm meeting her as her tutor today, after school. response:	Uesugi-san.
context: You can come to your Big Sis Ichika if you ever need help.\I bet this is going to be fun.\Big Sis? What?\We're in the same year.\I think.\This is bad, though.\I'm meeting her as her tutor today, after school.\Uesugi-san. response:	I must fix this by then.
context: I bet this is going to be fun.\Big Sis? What?\We're in the same year.\I think.\This is bad, though.\I'm meeting her as her tutor today, after school.\Uesugi-san.\I must fix this by then. response:	Uesugi-san!
context: Big Sis? What?\We're in the same year.\I think.\This is bad, though.\I'm meeting her as her tutor today, after school.\Uesugi-san.\I must fix this by then.\Uesugi-san! response:	Uesugi-san!
context: We're in the same year.\I think.\This is bad, though.\I'm meeting her as her tutor today, after school.\Uesugi-san.\I must fix this by then.\Uesugi-san!\Uesugi-san! response:	You finally looked up.
context: I think.\This is bad, though.\I'm meeting her as her tutor today, after school.\Uesugi-san.\I must fix this by then.\Uesugi-san!\Uesugi-san!\You finally looked up. response:	Wh-Wh-Who are you?
context: This is bad, though.\I'm meeting her as her tutor today, after school.\Uesugi-san.\I must fix this by then.\Uesugi-san!\Uesugi-san!\You finally looked up.\Wh-Wh-Who are you? response:	Wh-Why do you know my name?
context: I'm meeting her as her tutor today, after school.\Uesugi-san.\I must fix this by then.\Uesugi-san!\Uesugi-san!\You finally looked up.\Wh-Wh-Who are you?\Wh-Why do you know my name? response:	That's an excellent question.
context: Uesugi-san.\I must fix this by then.\Uesugi-san!\Uesugi-san!\You finally looked up.\Wh-Wh-Who are you?\Wh-Why do you know my name?\That's an excellent question. response:	Did you happen to lose an exam paper with a perfect score?
context: I must fix this by then.\Uesugi-san!\Uesugi-san!\You finally looked up.\Wh-Wh-Who are you?\Wh-Why do you know my name?\That's an excellent question.\Did you happen to lose an exam paper with a perfect score? response:	Or was it this one with a zero?
context: Uesugi-san!\Uesugi-san!\You finally looked up.\Wh-Wh-Who are you?\Wh-Why do you know my name?\That's an excellent question.\Did you happen to lose an exam paper with a perfect score?\Or was it this one with a zero? response:	My exam paper? Why do you have it?
context: Uesugi-san!\You finally looked up.\Wh-Wh-Who are you?\Wh-Why do you know my name?\That's an excellent question.\Did you happen to lose an exam paper with a perfect score?\Or was it this one with a zero?\My exam paper? Why do you have it? response:	Well, you see...
context: You finally looked up.\Wh-Wh-Who are you?\Wh-Why do you know my name?\That's an excellent question.\Did you happen to lose an exam paper with a perfect score?\Or was it this one with a zero?\My exam paper? Why do you have it?\Well, you see... response:	Back then,
context: Wh-Wh-Who are you?\Wh-Why do you know my name?\That's an excellent question.\Did you happen to lose an exam paper with a perfect score?\Or was it this one with a zero?\My exam paper? Why do you have it?\Well, you see...\Back then, response:	that happened,
context: Wh-Why do you know my name?\That's an excellent question.\Did you happen to lose an exam paper with a perfect score?\Or was it this one with a zero?\My exam paper? Why do you have it?\Well, you see...\Back then,\that happened, response:	I noticed...
context: That's an excellent question.\Did you happen to lose an exam paper with a perfect score?\Or was it this one with a zero?\My exam paper? Why do you have it?\Well, you see...\Back then,\that happened,\I noticed... response:	And now, here we are.
context: Did you happen to lose an exam paper with a perfect score?\Or was it this one with a zero?\My exam paper? Why do you have it?\Well, you see...\Back then,\that happened,\I noticed...\And now, here we are. response:	So, which one is it?
context: Or was it this one with a zero?\My exam paper? Why do you have it?\Well, you see...\Back then,\that happened,\I noticed...\And now, here we are.\So, which one is it? response:	The right.
context: My exam paper? Why do you have it?\Well, you see...\Back then,\that happened,\I noticed...\And now, here we are.\So, which one is it?\The right. response:	Wow, you're so honest.
context: Well, you see...\Back then,\that happened,\I noticed...\And now, here we are.\So, which one is it?\The right.\Wow, you're so honest. response:	I shall grant you both.
context: Back then,\that happened,\I noticed...\And now, here we are.\So, which one is it?\The right.\Wow, you're so honest.\I shall grant you both. response:	I don't need it.
context: that happened,\I noticed...\And now, here we are.\So, which one is it?\The right.\Wow, you're so honest.\I shall grant you both.\I don't need it. response:	And who even scored a zero?
context: I noticed...\And now, here we are.\So, which one is it?\The right.\Wow, you're so honest.\I shall grant you both.\I don't need it.\And who even scored a zero? response:	I did.
context: And now, here we are.\So, which one is it?\The right.\Wow, you're so honest.\I shall grant you both.\I don't need it.\And who even scored a zero?\I did. response:	And you felt like giving it to me?
context: So, which one is it?\The right.\Wow, you're so honest.\I shall grant you both.\I don't need it.\And who even scored a zero?\I did.\And you felt like giving it to me? response:	My first impression of you was that you're a gloomy loner,
context: The right.\Wow, you're so honest.\I shall grant you both.\I don't need it.\And who even scored a zero?\I did.\And you felt like giving it to me?\My first impression of you was that you're a gloomy loner, response:	but I'll also add genius to that.
context: Wow, you're so honest.\I shall grant you both.\I don't need it.\And who even scored a zero?\I did.\And you felt like giving it to me?\My first impression of you was that you're a gloomy loner,\but I'll also add genius to that. response:	That was fast.
context: I shall grant you both.\I don't need it.\And who even scored a zero?\I did.\And you felt like giving it to me?\My first impression of you was that you're a gloomy loner,\but I'll also add genius to that.\That was fast. response:	Will you stop following me?!
context: I don't need it.\And who even scored a zero?\I did.\And you felt like giving it to me?\My first impression of you was that you're a gloomy loner,\but I'll also add genius to that.\That was fast.\Will you stop following me?! response:	You still haven't thanked me.
context: And who even scored a zero?\I did.\And you felt like giving it to me?\My first impression of you was that you're a gloomy loner,\but I'll also add genius to that.\That was fast.\Will you stop following me?!\You still haven't thanked me. response:	When someone picks something up for you, you say thank you.
context: I did.\And you felt like giving it to me?\My first impression of you was that you're a gloomy loner,\but I'll also add genius to that.\That was fast.\Will you stop following me?!\You still haven't thanked me.\When someone picks something up for you, you say thank you. response:	How could you not know this? Aren't you a genius?
context: And you felt like giving it to me?\My first impression of you was that you're a gloomy loner,\but I'll also add genius to that.\That was fast.\Will you stop following me?!\You still haven't thanked me.\When someone picks something up for you, you say thank you.\How could you not know this? Aren't you a genius? response:	I happened to find this.
context: My first impression of you was that you're a gloomy loner,\but I'll also add genius to that.\That was fast.\Will you stop following me?!\You still haven't thanked me.\When someone picks something up for you, you say thank you.\How could you not know this? Aren't you a genius?\I happened to find this. response:	Now we're even.
context: but I'll also add genius to that.\That was fast.\Will you stop following me?!\You still haven't thanked me.\When someone picks something up for you, you say thank you.\How could you not know this? Aren't you a genius?\I happened to find this.\Now we're even. response:	Ah.
context: That was fast.\Will you stop following me?!\You still haven't thanked me.\When someone picks something up for you, you say thank you.\How could you not know this? Aren't you a genius?\I happened to find this.\Now we're even.\Ah. response:	Thank you.
context: Will you stop following me?!\You still haven't thanked me.\When someone picks something up for you, you say thank you.\How could you not know this? Aren't you a genius?\I happened to find this.\Now we're even.\Ah.\Thank you. response:	She actually went and thanked me.
context: You still haven't thanked me.\When someone picks something up for you, you say thank you.\How could you not know this? Aren't you a genius?\I happened to find this.\Now we're even.\Ah.\Thank you.\She actually went and thanked me. response:	I thought she'd be alone on her way home.
context: When someone picks something up for you, you say thank you.\How could you not know this? Aren't you a genius?\I happened to find this.\Now we're even.\Ah.\Thank you.\She actually went and thanked me.\I thought she'd be alone on her way home. response:	Ohtagawa
context: How could you not know this? Aren't you a genius?\I happened to find this.\Now we're even.\Ah.\Thank you.\She actually went and thanked me.\I thought she'd be alone on her way home.\Ohtagawa response:	I think you're eating too much, Itsuki.
context: I happened to find this.\Now we're even.\Ah.\Thank you.\She actually went and thanked me.\I thought she'd be alone on her way home.\Ohtagawa\I think you're eating too much, Itsuki. response:	Am I?
context: Now we're even.\Ah.\Thank you.\She actually went and thanked me.\I thought she'd be alone on her way home.\Ohtagawa\I think you're eating too much, Itsuki.\Am I? response:	This is still my second one.
context: Ah.\Thank you.\She actually went and thanked me.\I thought she'd be alone on her way home.\Ohtagawa\I think you're eating too much, Itsuki.\Am I?\This is still my second one. response:	You meat bun monster!
context: Thank you.\She actually went and thanked me.\I thought she'd be alone on her way home.\Ohtagawa\I think you're eating too much, Itsuki.\Am I?\This is still my second one.\You meat bun monster! response:	S-Stop it!
context: She actually went and thanked me.\I thought she'd be alone on her way home.\Ohtagawa\I think you're eating too much, Itsuki.\Am I?\This is still my second one.\You meat bun monster!\S-Stop it! response:	You won't be popular with guys!
context: I thought she'd be alone on her way home.\Ohtagawa\I think you're eating too much, Itsuki.\Am I?\This is still my second one.\You meat bun monster!\S-Stop it!\You won't be popular with guys! response:	None of your business!
context: Ohtagawa\I think you're eating too much, Itsuki.\Am I?\This is still my second one.\You meat bun monster!\S-Stop it!\You won't be popular with guys!\None of your business! response:	I can't get a chance to apologize.
context: I think you're eating too much, Itsuki.\Am I?\This is still my second one.\You meat bun monster!\S-Stop it!\You won't be popular with guys!\None of your business!\I can't get a chance to apologize. response:	Are you having fun by yourself?
context: Am I?\This is still my second one.\You meat bun monster!\S-Stop it!\You won't be popular with guys!\None of your business!\I can't get a chance to apologize.\Are you having fun by yourself? response:	I-It's not bad.
context: This is still my second one.\You meat bun monster!\S-Stop it!\You won't be popular with guys!\None of your business!\I can't get a chance to apologize.\Are you having fun by yourself?\I-It's not bad. response:	This is my hobby.
context: You meat bun monster!\S-Stop it!\You won't be popular with guys!\None of your business!\I can't get a chance to apologize.\Are you having fun by yourself?\I-It's not bad.\This is my hobby. response:	I see.
context: S-Stop it!\You won't be popular with guys!\None of your business!\I can't get a chance to apologize.\Are you having fun by yourself?\I-It's not bad.\This is my hobby.\I see. response:	Staring at high school girls is your hobby?
context: You won't be popular with guys!\None of your business!\I can't get a chance to apologize.\Are you having fun by yourself?\I-It's not bad.\This is my hobby.\I see.\Staring at high school girls is your hobby? response:	Calling in support.
context: None of your business!\I can't get a chance to apologize.\Are you having fun by yourself?\I-It's not bad.\This is my hobby.\I see.\Staring at high school girls is your hobby?\Calling in support. response:	Please don't report me.
context: I can't get a chance to apologize.\Are you having fun by yourself?\I-It's not bad.\This is my hobby.\I see.\Staring at high school girls is your hobby?\Calling in support.\Please don't report me. response:	Also, don't tell your friend Itsuki-chan.
context: Are you having fun by yourself?\I-It's not bad.\This is my hobby.\I see.\Staring at high school girls is your hobby?\Calling in support.\Please don't report me.\Also, don't tell your friend Itsuki-chan. response:	Fine.
context: I-It's not bad.\This is my hobby.\I see.\Staring at high school girls is your hobby?\Calling in support.\Please don't report me.\Also, don't tell your friend Itsuki-chan.\Fine. response:	But...
context: This is my hobby.\I see.\Staring at high school girls is your hobby?\Calling in support.\Please don't report me.\Also, don't tell your friend Itsuki-chan.\Fine.\But... response:	She's not my friend.
context: I see.\Staring at high school girls is your hobby?\Calling in support.\Please don't report me.\Also, don't tell your friend Itsuki-chan.\Fine.\But...\She's not my friend. response:	I-Is this the place?
context: Staring at high school girls is your hobby?\Calling in support.\Please don't report me.\Also, don't tell your friend Itsuki-chan.\Fine.\But...\She's not my friend.\I-Is this the place? response:	She's legit rich.
context: Calling in support.\Please don't report me.\Also, don't tell your friend Itsuki-chan.\Fine.\But...\She's not my friend.\I-Is this the place?\She's legit rich. response:	This is the right address, I think.
context: Please don't report me.\Also, don't tell your friend Itsuki-chan.\Fine.\But...\She's not my friend.\I-Is this the place?\She's legit rich.\This is the right address, I think. response:	What are you, a stalker?
context: Also, don't tell your friend Itsuki-chan.\Fine.\But...\She's not my friend.\I-Is this the place?\She's legit rich.\This is the right address, I think.\What are you, a stalker? response:	You can talk to me if you want something.
context: Fine.\But...\She's not my friend.\I-Is this the place?\She's legit rich.\This is the right address, I think.\What are you, a stalker?\You can talk to me if you want something. response:	I won't get anywhere asking you two.
context: But...\She's not my friend.\I-Is this the place?\She's legit rich.\This is the right address, I think.\What are you, a stalker?\You can talk to me if you want something.\I won't get anywhere asking you two. response:	You're so persistent.
context: She's not my friend.\I-Is this the place?\She's legit rich.\This is the right address, I think.\What are you, a stalker?\You can talk to me if you want something.\I won't get anywhere asking you two.\You're so persistent. response:	People don't like you, do they?
context: I-Is this the place?\She's legit rich.\This is the right address, I think.\What are you, a stalker?\You can talk to me if you want something.\I won't get anywhere asking you two.\You're so persistent.\People don't like you, do they? response:	Go home already.
context: She's legit rich.\This is the right address, I think.\What are you, a stalker?\You can talk to me if you want something.\I won't get anywhere asking you two.\You're so persistent.\People don't like you, do they?\Go home already. response:	Go home?
context: This is the right address, I think.\What are you, a stalker?\You can talk to me if you want something.\I won't get anywhere asking you two.\You're so persistent.\People don't like you, do they?\Go home already.\Go home? response:	But this is where I live.
context: What are you, a stalker?\You can talk to me if you want something.\I won't get anywhere asking you two.\You're so persistent.\People don't like you, do they?\Go home already.\Go home?\But this is where I live. response:	R-Really?
context: You can talk to me if you want something.\I won't get anywhere asking you two.\You're so persistent.\People don't like you, do they?\Go home already.\Go home?\But this is where I live.\R-Really? response:	Sorry!
context: I won't get anywhere asking you two.\You're so persistent.\People don't like you, do they?\Go home already.\Go home?\But this is where I live.\R-Really?\Sorry! response:	Barbecue beef without barbecue.
context: You're so persistent.\People don't like you, do they?\Go home already.\Go home?\But this is where I live.\R-Really?\Sorry!\Barbecue beef without barbecue. response:	Are you on a diet?
context: People don't like you, do they?\Go home already.\Go home?\But this is where I live.\R-Really?\Sorry!\Barbecue beef without barbecue.\Are you on a diet? response:	You!
context: Go home already.\Go home?\But this is where I live.\R-Really?\Sorry!\Barbecue beef without barbecue.\Are you on a diet?\You! response:	I knew it!
context: Go home?\But this is where I live.\R-Really?\Sorry!\Barbecue beef without barbecue.\Are you on a diet?\You!\I knew it! response:	There she is.
context: But this is where I live.\R-Really?\Sorry!\Barbecue beef without barbecue.\Are you on a diet?\You!\I knew it!\There she is. response:	This is my last chance to talk to her.
context: R-Really?\Sorry!\Barbecue beef without barbecue.\Are you on a diet?\You!\I knew it!\There she is.\This is my last chance to talk to her. response:	Please don't close on me!
context: Sorry!\Barbecue beef without barbecue.\Are you on a diet?\You!\I knew it!\There she is.\This is my last chance to talk to her.\Please don't close on me! response:	This is all her fault!
context: Barbecue beef without barbecue.\Are you on a diet?\You!\I knew it!\There she is.\This is my last chance to talk to her.\Please don't close on me!\This is all her fault! response:	That I have to bear the discomfort of having to suck up...
context: Are you on a diet?\You!\I knew it!\There she is.\This is my last chance to talk to her.\Please don't close on me!\This is all her fault!\That I have to bear the discomfort of having to suck up... response:	That I have to be drenched in sweat on my way home from school...
context: You!\I knew it!\There she is.\This is my last chance to talk to her.\Please don't close on me!\This is all her fault!\That I have to bear the discomfort of having to suck up...\That I have to be drenched in sweat on my way home from school... response:	That those weirdos keep messing with me...
context: I knew it!\There she is.\This is my last chance to talk to her.\Please don't close on me!\This is all her fault!\That I have to bear the discomfort of having to suck up...\That I have to be drenched in sweat on my way home from school...\That those weirdos keep messing with me... response:	It's all...
context: There she is.\This is my last chance to talk to her.\Please don't close on me!\This is all her fault!\That I have to bear the discomfort of having to suck up...\That I have to be drenched in sweat on my way home from school...\That those weirdos keep messing with me...\It's all... response:	It's all her...
context: This is my last chance to talk to her.\Please don't close on me!\This is all her fault!\That I have to bear the discomfort of having to suck up...\That I have to be drenched in sweat on my way home from school...\That those weirdos keep messing with me...\It's all...\It's all her... response:	I-It's you.
context: Please don't close on me!\This is all her fault!\That I have to bear the discomfort of having to suck up...\That I have to be drenched in sweat on my way home from school...\That those weirdos keep messing with me...\It's all...\It's all her...\I-It's you. response:	What is it?
context: This is all her fault!\That I have to bear the discomfort of having to suck up...\That I have to be drenched in sweat on my way home from school...\That those weirdos keep messing with me...\It's all...\It's all her...\I-It's you.\What is it? response:	Do you need something from me?
context: That I have to bear the discomfort of having to suck up...\That I have to be drenched in sweat on my way home from school...\That those weirdos keep messing with me...\It's all...\It's all her...\I-It's you.\What is it?\Do you need something from me? response:	A-About yesterday...
context: That I have to be drenched in sweat on my way home from school...\That those weirdos keep messing with me...\It's all...\It's all her...\I-It's you.\What is it?\Do you need something from me?\A-About yesterday... response:	Huh? Say what?
context: That those weirdos keep messing with me...\It's all...\It's all her...\I-It's you.\What is it?\Do you need something from me?\A-About yesterday...\Huh? Say what? response:	What are you doing here, anyway?
context: It's all...\It's all her...\I-It's you.\What is it?\Do you need something from me?\A-About yesterday...\Huh? Say what?\What are you doing here, anyway? response:	About yesterday, uh...
context: It's all her...\I-It's you.\What is it?\Do you need something from me?\A-About yesterday...\Huh? Say what?\What are you doing here, anyway?\About yesterday, uh... response:	I-I'm...
context: I-It's you.\What is it?\Do you need something from me?\A-About yesterday...\Huh? Say what?\What are you doing here, anyway?\About yesterday, uh...\I-I'm... response:	Are we done here?
context: What is it?\Do you need something from me?\A-About yesterday...\Huh? Say what?\What are you doing here, anyway?\About yesterday, uh...\I-I'm...\Are we done here? response:	No, wait.
context: Do you need something from me?\A-About yesterday...\Huh? Say what?\What are you doing here, anyway?\About yesterday, uh...\I-I'm...\Are we done here?\No, wait. response:	What exactly are you trying to do?
context: A-About yesterday...\Huh? Say what?\What are you doing here, anyway?\About yesterday, uh...\I-I'm...\Are we done here?\No, wait.\What exactly are you trying to do? response:	I have a tutor coming soon.
context: Huh? Say what?\What are you doing here, anyway?\About yesterday, uh...\I-I'm...\Are we done here?\No, wait.\What exactly are you trying to do?\I have a tutor coming soon. response:	That's me.
context: What are you doing here, anyway?\About yesterday, uh...\I-I'm...\Are we done here?\No, wait.\What exactly are you trying to do?\I have a tutor coming soon.\That's me. response:	What?
context: About yesterday, uh...\I-I'm...\Are we done here?\No, wait.\What exactly are you trying to do?\I have a tutor coming soon.\That's me.\What? response:	I'm the tutor.
context: I-I'm...\Are we done here?\No, wait.\What exactly are you trying to do?\I have a tutor coming soon.\That's me.\What?\I'm the tutor. response:	Ack!
context: Are we done here?\No, wait.\What exactly are you trying to do?\I have a tutor coming soon.\That's me.\What?\I'm the tutor.\Ack! response:	Ack!
context: No, wait.\What exactly are you trying to do?\I have a tutor coming soon.\That's me.\What?\I'm the tutor.\Ack!\Ack! response:	I-I absolutely refuse!
context: What exactly are you trying to do?\I have a tutor coming soon.\That's me.\What?\I'm the tutor.\Ack!\Ack!\I-I absolutely refuse! response:	I don't like it, either.
context: I have a tutor coming soon.\That's me.\What?\I'm the tutor.\Ack!\Ack!\I-I absolutely refuse!\I don't like it, either. response:	I like this less than you do.
context: That's me.\What?\I'm the tutor.\Ack!\Ack!\I-I absolutely refuse!\I don't like it, either.\I like this less than you do. response:	But...
context: What?\I'm the tutor.\Ack!\Ack!\I-I absolutely refuse!\I don't like it, either.\I like this less than you do.\But... response:	I can't give up, either.
context: I'm the tutor.\Ack!\Ack!\I-I absolutely refuse!\I don't like it, either.\I like this less than you do.\But...\I can't give up, either. response:	I was completely in the wrong yesterday.
context: Ack!\Ack!\I-I absolutely refuse!\I don't like it, either.\I like this less than you do.\But...\I can't give up, either.\I was completely in the wrong yesterday. response:	I apologize.
context: Ack!\I-I absolutely refuse!\I don't like it, either.\I like this less than you do.\But...\I can't give up, either.\I was completely in the wrong yesterday.\I apologize. response:	Going forward, I'm your partner.
context: I-I absolutely refuse!\I don't like it, either.\I like this less than you do.\But...\I can't give up, either.\I was completely in the wrong yesterday.\I apologize.\Going forward, I'm your partner. response:	No... I can't.
context: I don't like it, either.\I like this less than you do.\But...\I can't give up, either.\I was completely in the wrong yesterday.\I apologize.\Going forward, I'm your partner.\No... I can't. response:	This guy is our tutor?
context: I like this less than you do.\But...\I can't give up, either.\I was completely in the wrong yesterday.\I apologize.\Going forward, I'm your partner.\No... I can't.\This guy is our tutor? response:	Our?
context: But...\I can't give up, either.\I was completely in the wrong yesterday.\I apologize.\Going forward, I'm your partner.\No... I can't.\This guy is our tutor?\Our? response:	That dude in front of our condo was so creepy.
context: I can't give up, either.\I was completely in the wrong yesterday.\I apologize.\Going forward, I'm your partner.\No... I can't.\This guy is our tutor?\Our?\That dude in front of our condo was so creepy. response:	That sounds bad.
context: I was completely in the wrong yesterday.\I apologize.\Going forward, I'm your partner.\No... I can't.\This guy is our tutor?\Our?\That dude in front of our condo was so creepy.\That sounds bad. response:	Hey, it's the honor roll kid.
context: I apologize.\Going forward, I'm your partner.\No... I can't.\This guy is our tutor?\Our?\That dude in front of our condo was so creepy.\That sounds bad.\Hey, it's the honor roll kid. response:	It's him! The stalker!
context: Going forward, I'm your partner.\No... I can't.\This guy is our tutor?\Our?\That dude in front of our condo was so creepy.\That sounds bad.\Hey, it's the honor roll kid.\It's him! The stalker! response:	Uesugi-san is a stalker?!
context: No... I can't.\This guy is our tutor?\Our?\That dude in front of our condo was so creepy.\That sounds bad.\Hey, it's the honor roll kid.\It's him! The stalker!\Uesugi-san is a stalker?! response:	You're getting ahead of yourself.
context: This guy is our tutor?\Our?\That dude in front of our condo was so creepy.\That sounds bad.\Hey, it's the honor roll kid.\It's him! The stalker!\Uesugi-san is a stalker?!\You're getting ahead of yourself. response:	Wh-Why are they...
context: Our?\That dude in front of our condo was so creepy.\That sounds bad.\Hey, it's the honor roll kid.\It's him! The stalker!\Uesugi-san is a stalker?!\You're getting ahead of yourself.\Wh-Why are they... response:	Because we live here, obviously.
context: That dude in front of our condo was so creepy.\That sounds bad.\Hey, it's the honor roll kid.\It's him! The stalker!\Uesugi-san is a stalker?!\You're getting ahead of yourself.\Wh-Why are they...\Because we live here, obviously. response:	So the five of you school friends share an apartment, huh?
context: That sounds bad.\Hey, it's the honor roll kid.\It's him! The stalker!\Uesugi-san is a stalker?!\You're getting ahead of yourself.\Wh-Why are they...\Because we live here, obviously.\So the five of you school friends share an apartment, huh? response:	My brain, having been put under a sudden, heavy load
context: Hey, it's the honor roll kid.\It's him! The stalker!\Uesugi-san is a stalker?!\You're getting ahead of yourself.\Wh-Why are they...\Because we live here, obviously.\So the five of you school friends share an apartment, huh?\My brain, having been put under a sudden, heavy load response:	and overclocked past its manufacturer limit, reached a certain conclusion.
context: It's him! The stalker!\Uesugi-san is a stalker?!\You're getting ahead of yourself.\Wh-Why are they...\Because we live here, obviously.\So the five of you school friends share an apartment, huh?\My brain, having been put under a sudden, heavy load\and overclocked past its manufacturer limit, reached a certain conclusion. response:	I must be dreaming.
context: Uesugi-san is a stalker?!\You're getting ahead of yourself.\Wh-Why are they...\Because we live here, obviously.\So the five of you school friends share an apartment, huh?\My brain, having been put under a sudden, heavy load\and overclocked past its manufacturer limit, reached a certain conclusion.\I must be dreaming. response:	This has to be a dream.
context: You're getting ahead of yourself.\Wh-Why are they...\Because we live here, obviously.\So the five of you school friends share an apartment, huh?\My brain, having been put under a sudden, heavy load\and overclocked past its manufacturer limit, reached a certain conclusion.\I must be dreaming.\This has to be a dream. response:	No, actually.
context: Wh-Why are they...\Because we live here, obviously.\So the five of you school friends share an apartment, huh?\My brain, having been put under a sudden, heavy load\and overclocked past its manufacturer limit, reached a certain conclusion.\I must be dreaming.\This has to be a dream.\No, actually. response:	We're...
context: Because we live here, obviously.\So the five of you school friends share an apartment, huh?\My brain, having been put under a sudden, heavy load\and overclocked past its manufacturer limit, reached a certain conclusion.\I must be dreaming.\This has to be a dream.\No, actually.\We're... response:	quintuplets.
context: So the five of you school friends share an apartment, huh?\My brain, having been put under a sudden, heavy load\and overclocked past its manufacturer limit, reached a certain conclusion.\I must be dreaming.\This has to be a dream.\No, actually.\We're...\quintuplets. response:	I'm Uesugi Futaro, and I'm going to be your tutor starting today.
context: My brain, having been put under a sudden, heavy load\and overclocked past its manufacturer limit, reached a certain conclusion.\I must be dreaming.\This has to be a dream.\No, actually.\We're...\quintuplets.\I'm Uesugi Futaro, and I'm going to be your tutor starting today. response:	I hope we can all have fun studying...
context: and overclocked past its manufacturer limit, reached a certain conclusion.\I must be dreaming.\This has to be a dream.\No, actually.\We're...\quintuplets.\I'm Uesugi Futaro, and I'm going to be your tutor starting today.\I hope we can all have fun studying... response:	Why?
context: I must be dreaming.\This has to be a dream.\No, actually.\We're...\quintuplets.\I'm Uesugi Futaro, and I'm going to be your tutor starting today.\I hope we can all have fun studying...\Why? response:	Why is there no one here?!
context: This has to be a dream.\No, actually.\We're...\quintuplets.\I'm Uesugi Futaro, and I'm going to be your tutor starting today.\I hope we can all have fun studying...\Why?\Why is there no one here?! response:	Here! Here!
context: No, actually.\We're...\quintuplets.\I'm Uesugi Futaro, and I'm going to be your tutor starting today.\I hope we can all have fun studying...\Why?\Why is there no one here?!\Here! Here! response:	I'm here!
context: We're...\quintuplets.\I'm Uesugi Futaro, and I'm going to be your tutor starting today.\I hope we can all have fun studying...\Why?\Why is there no one here?!\Here! Here!\I'm here! response:	Um...
context: quintuplets.\I'm Uesugi Futaro, and I'm going to be your tutor starting today.\I hope we can all have fun studying...\Why?\Why is there no one here?!\Here! Here!\I'm here!\Um... response:	Yotsuba, was it? The one who got a zero?
context: I'm Uesugi Futaro, and I'm going to be your tutor starting today.\I hope we can all have fun studying...\Why?\Why is there no one here?!\Here! Here!\I'm here!\Um...\Yotsuba, was it? The one who got a zero? response:	Could you try furrowing your eyebrows?
context: I hope we can all have fun studying...\Why?\Why is there no one here?!\Here! Here!\I'm here!\Um...\Yotsuba, was it? The one who got a zero?\Could you try furrowing your eyebrows? response:	L-Like this?
context: Why?\Why is there no one here?!\Here! Here!\I'm here!\Um...\Yotsuba, was it? The one who got a zero?\Could you try furrowing your eyebrows?\L-Like this? response:	You really are quintuplets, huh?
context: Why is there no one here?!\Here! Here!\I'm here!\Um...\Yotsuba, was it? The one who got a zero?\Could you try furrowing your eyebrows?\L-Like this?\You really are quintuplets, huh? response:	And why are you here?
context: Here! Here!\I'm here!\Um...\Yotsuba, was it? The one who got a zero?\Could you try furrowing your eyebrows?\L-Like this?\You really are quintuplets, huh?\And why are you here? response:	For your lessons, obviously.
context: I'm here!\Um...\Yotsuba, was it? The one who got a zero?\Could you try furrowing your eyebrows?\L-Like this?\You really are quintuplets, huh?\And why are you here?\For your lessons, obviously. response:	Yotsuba...
context: Um...\Yotsuba, was it? The one who got a zero?\Could you try furrowing your eyebrows?\L-Like this?\You really are quintuplets, huh?\And why are you here?\For your lessons, obviously.\Yotsuba... response:	Can I hug you?
context: Yotsuba, was it? The one who got a zero?\Could you try furrowing your eyebrows?\L-Like this?\You really are quintuplets, huh?\And why are you here?\For your lessons, obviously.\Yotsuba...\Can I hug you? response:	Okay, let's go get the rest of them!
context: Could you try furrowing your eyebrows?\L-Like this?\You really are quintuplets, huh?\And why are you here?\For your lessons, obviously.\Yotsuba...\Can I hug you?\Okay, let's go get the rest of them! response:	Our rooms, from the front, are...
context: L-Like this?\You really are quintuplets, huh?\And why are you here?\For your lessons, obviously.\Yotsuba...\Can I hug you?\Okay, let's go get the rest of them!\Our rooms, from the front, are... response:	Itsuki, me, and then Miku, Nino, and Ichika.
context: You really are quintuplets, huh?\And why are you here?\For your lessons, obviously.\Yotsuba...\Can I hug you?\Okay, let's go get the rest of them!\Our rooms, from the front, are...\Itsuki, me, and then Miku, Nino, and Ichika. response:	I have to start by gathering the five of you?
context: And why are you here?\For your lessons, obviously.\Yotsuba...\Can I hug you?\Okay, let's go get the rest of them!\Our rooms, from the front, are...\Itsuki, me, and then Miku, Nino, and Ichika.\I have to start by gathering the five of you? response:	It'll be fine.
context: For your lessons, obviously.\Yotsuba...\Can I hug you?\Okay, let's go get the rest of them!\Our rooms, from the front, are...\Itsuki, me, and then Miku, Nino, and Ichika.\I have to start by gathering the five of you?\It'll be fine. response:	Itsuki is quite studious.
context: Yotsuba...\Can I hug you?\Okay, let's go get the rest of them!\Our rooms, from the front, are...\Itsuki, me, and then Miku, Nino, and Ichika.\I have to start by gathering the five of you?\It'll be fine.\Itsuki is quite studious. response:	She'll help us out, unless you really upset her.
context: Can I hug you?\Okay, let's go get the rest of them!\Our rooms, from the front, are...\Itsuki, me, and then Miku, Nino, and Ichika.\I have to start by gathering the five of you?\It'll be fine.\Itsuki is quite studious.\She'll help us out, unless you really upset her. response:	No way.
context: Okay, let's go get the rest of them!\Our rooms, from the front, are...\Itsuki, me, and then Miku, Nino, and Ichika.\I have to start by gathering the five of you?\It'll be fine.\Itsuki is quite studious.\She'll help us out, unless you really upset her.\No way. response:	Why you? You're in my class.
context: Our rooms, from the front, are...\Itsuki, me, and then Miku, Nino, and Ichika.\I have to start by gathering the five of you?\It'll be fine.\Itsuki is quite studious.\She'll help us out, unless you really upset her.\No way.\Why you? You're in my class. response:	Is there not even one proper tutor in this town?
context: Itsuki, me, and then Miku, Nino, and Ichika.\I have to start by gathering the five of you?\It'll be fine.\Itsuki is quite studious.\She'll help us out, unless you really upset her.\No way.\Why you? You're in my class.\Is there not even one proper tutor in this town? response:	Come on, you said you wanted me to help you study yesterday.
context: I have to start by gathering the five of you?\It'll be fine.\Itsuki is quite studious.\She'll help us out, unless you really upset her.\No way.\Why you? You're in my class.\Is there not even one proper tutor in this town?\Come on, you said you wanted me to help you study yesterday. response:	It was a lapse in judgment.
context: It'll be fine.\Itsuki is quite studious.\She'll help us out, unless you really upset her.\No way.\Why you? You're in my class.\Is there not even one proper tutor in this town?\Come on, you said you wanted me to help you study yesterday.\It was a lapse in judgment. response:	Forget about it.
context: Itsuki is quite studious.\She'll help us out, unless you really upset her.\No way.\Why you? You're in my class.\Is there not even one proper tutor in this town?\Come on, you said you wanted me to help you study yesterday.\It was a lapse in judgment.\Forget about it. response:	With five of us here, there's bound to be one who's like that.
context: She'll help us out, unless you really upset her.\No way.\Why you? You're in my class.\Is there not even one proper tutor in this town?\Come on, you said you wanted me to help you study yesterday.\It was a lapse in judgment.\Forget about it.\With five of us here, there's bound to be one who's like that. response:	Miku's the smartest of all of us.
context: No way.\Why you? You're in my class.\Is there not even one proper tutor in this town?\Come on, you said you wanted me to help you study yesterday.\It was a lapse in judgment.\Forget about it.\With five of us here, there's bound to be one who's like that.\Miku's the smartest of all of us. response:	She might get along with you.
context: Why you? You're in my class.\Is there not even one proper tutor in this town?\Come on, you said you wanted me to help you study yesterday.\It was a lapse in judgment.\Forget about it.\With five of us here, there's bound to be one who's like that.\Miku's the smartest of all of us.\She might get along with you. response:	No.
context: Is there not even one proper tutor in this town?\Come on, you said you wanted me to help you study yesterday.\It was a lapse in judgment.\Forget about it.\With five of us here, there's bound to be one who's like that.\Miku's the smartest of all of us.\She might get along with you.\No. response:	Why you? You're in our grade.
context: Come on, you said you wanted me to help you study yesterday.\It was a lapse in judgment.\Forget about it.\With five of us here, there's bound to be one who's like that.\Miku's the smartest of all of us.\She might get along with you.\No.\Why you? You're in our grade. response:	Is there not even one...
context: It was a lapse in judgment.\Forget about it.\With five of us here, there's bound to be one who's like that.\Miku's the smartest of all of us.\She might get along with you.\No.\Why you? You're in our grade.\Is there not even one... response:	Say no more. I heard that already.
context: Forget about it.\With five of us here, there's bound to be one who's like that.\Miku's the smartest of all of us.\She might get along with you.\No.\Why you? You're in our grade.\Is there not even one...\Say no more. I heard that already. response:	Sh-Shall we move on?
context: With five of us here, there's bound to be one who's like that.\Miku's the smartest of all of us.\She might get along with you.\No.\Why you? You're in our grade.\Is there not even one...\Say no more. I heard that already.\Sh-Shall we move on? response:	Nino's really good at socializing.
context: Miku's the smartest of all of us.\She might get along with you.\No.\Why you? You're in our grade.\Is there not even one...\Say no more. I heard that already.\Sh-Shall we move on?\Nino's really good at socializing. response:	I bet she'll hit it off with you.
context: She might get along with you.\No.\Why you? You're in our grade.\Is there not even one...\Say no more. I heard that already.\Sh-Shall we move on?\Nino's really good at socializing.\I bet she'll hit it off with you. response:	M-Maybe she's not in.
context: No.\Why you? You're in our grade.\Is there not even one...\Say no more. I heard that already.\Sh-Shall we move on?\Nino's really good at socializing.\I bet she'll hit it off with you.\M-Maybe she's not in. response:	D-Don't worry!
context: Why you? You're in our grade.\Is there not even one...\Say no more. I heard that already.\Sh-Shall we move on?\Nino's really good at socializing.\I bet she'll hit it off with you.\M-Maybe she's not in.\D-Don't worry! response:	We still have Ichika!
context: Is there not even one...\Say no more. I heard that already.\Sh-Shall we move on?\Nino's really good at socializing.\I bet she'll hit it off with you.\M-Maybe she's not in.\D-Don't worry!\We still have Ichika! response:	Ichika is...
context: Say no more. I heard that already.\Sh-Shall we move on?\Nino's really good at socializing.\I bet she'll hit it off with you.\M-Maybe she's not in.\D-Don't worry!\We still have Ichika!\Ichika is... response:	Why the silence?
context: Sh-Shall we move on?\Nino's really good at socializing.\I bet she'll hit it off with you.\M-Maybe she's not in.\D-Don't worry!\We still have Ichika!\Ichika is...\Why the silence? response:	Please stay calm, okay?
context: Nino's really good at socializing.\I bet she'll hit it off with you.\M-Maybe she's not in.\D-Don't worry!\We still have Ichika!\Ichika is...\Why the silence?\Please stay calm, okay? response:	Wh-What's with this room?
context: I bet she'll hit it off with you.\M-Maybe she's not in.\D-Don't worry!\We still have Ichika!\Ichika is...\Why the silence?\Please stay calm, okay?\Wh-What's with this room? response:	Is someone really living in this dump?
context: M-Maybe she's not in.\D-Don't worry!\We still have Ichika!\Ichika is...\Why the silence?\Please stay calm, okay?\Wh-What's with this room?\Is someone really living in this dump? response:	I wish you wouldn't talk about my room like it's some uncivilized land.
context: D-Don't worry!\We still have Ichika!\Ichika is...\Why the silence?\Please stay calm, okay?\Wh-What's with this room?\Is someone really living in this dump?\I wish you wouldn't talk about my room like it's some uncivilized land. response:	Jeez, you made a huge mess again.
context: We still have Ichika!\Ichika is...\Why the silence?\Please stay calm, okay?\Wh-What's with this room?\Is someone really living in this dump?\I wish you wouldn't talk about my room like it's some uncivilized land.\Jeez, you made a huge mess again. response:	I never thought you'd be our tutor.
context: Ichika is...\Why the silence?\Please stay calm, okay?\Wh-What's with this room?\Is someone really living in this dump?\I wish you wouldn't talk about my room like it's some uncivilized land.\Jeez, you made a huge mess again.\I never thought you'd be our tutor. response:	So that's why you were after Itsuki-chan.
context: Why the silence?\Please stay calm, okay?\Wh-What's with this room?\Is someone really living in this dump?\I wish you wouldn't talk about my room like it's some uncivilized land.\Jeez, you made a huge mess again.\I never thought you'd be our tutor.\So that's why you were after Itsuki-chan. response:	Never mind that.
context: Please stay calm, okay?\Wh-What's with this room?\Is someone really living in this dump?\I wish you wouldn't talk about my room like it's some uncivilized land.\Jeez, you made a huge mess again.\I never thought you'd be our tutor.\So that's why you were after Itsuki-chan.\Never mind that. response:	We're going to the living room.
context: Wh-What's with this room?\Is someone really living in this dump?\I wish you wouldn't talk about my room like it's some uncivilized land.\Jeez, you made a huge mess again.\I never thought you'd be our tutor.\So that's why you were after Itsuki-chan.\Never mind that.\We're going to the living room. response:	Wait, no! Don't do that!
context: Is someone really living in this dump?\I wish you wouldn't talk about my room like it's some uncivilized land.\Jeez, you made a huge mess again.\I never thought you'd be our tutor.\So that's why you were after Itsuki-chan.\Never mind that.\We're going to the living room.\Wait, no! Don't do that! response:	I feel shy. I'm not wearing any clothes.
context: I wish you wouldn't talk about my room like it's some uncivilized land.\Jeez, you made a huge mess again.\I never thought you'd be our tutor.\So that's why you were after Itsuki-chan.\Never mind that.\We're going to the living room.\Wait, no! Don't do that!\I feel shy. I'm not wearing any clothes. response:	Wh-Why not?!
context: Jeez, you made a huge mess again.\I never thought you'd be our tutor.\So that's why you were after Itsuki-chan.\Never mind that.\We're going to the living room.\Wait, no! Don't do that!\I feel shy. I'm not wearing any clothes.\Wh-Why not?! response:	Yotsuba,
context: I never thought you'd be our tutor.\So that's why you were after Itsuki-chan.\Never mind that.\We're going to the living room.\Wait, no! Don't do that!\I feel shy. I'm not wearing any clothes.\Wh-Why not?!\Yotsuba, response:	could you grab me some clothes from around there?
context: So that's why you were after Itsuki-chan.\Never mind that.\We're going to the living room.\Wait, no! Don't do that!\I feel shy. I'm not wearing any clothes.\Wh-Why not?!\Yotsuba,\could you grab me some clothes from around there? response:	Huh? Let me see...
context: Never mind that.\We're going to the living room.\Wait, no! Don't do that!\I feel shy. I'm not wearing any clothes.\Wh-Why not?!\Yotsuba,\could you grab me some clothes from around there?\Huh? Let me see... response:	When's the last time she studied at this desk?
context: We're going to the living room.\Wait, no! Don't do that!\I feel shy. I'm not wearing any clothes.\Wh-Why not?!\Yotsuba,\could you grab me some clothes from around there?\Huh? Let me see...\When's the last time she studied at this desk? response:	Come on, study this, study that...
context: Wait, no! Don't do that!\I feel shy. I'm not wearing any clothes.\Wh-Why not?!\Yotsuba,\could you grab me some clothes from around there?\Huh? Let me see...\When's the last time she studied at this desk?\Come on, study this, study that... response:	You're in a girl's room. Is that really what you want to focus on?
context: I feel shy. I'm not wearing any clothes.\Wh-Why not?!\Yotsuba,\could you grab me some clothes from around there?\Huh? Let me see...\When's the last time she studied at this desk?\Come on, study this, study that...\You're in a girl's room. Is that really what you want to focus on? response:	Found one.
context: Wh-Why not?!\Yotsuba,\could you grab me some clothes from around there?\Huh? Let me see...\When's the last time she studied at this desk?\Come on, study this, study that...\You're in a girl's room. Is that really what you want to focus on?\Found one. response:	Just get changed and come to the living room, please.
context: Yotsuba,\could you grab me some clothes from around there?\Huh? Let me see...\When's the last time she studied at this desk?\Come on, study this, study that...\You're in a girl's room. Is that really what you want to focus on?\Found one.\Just get changed and come to the living room, please. response:	Damn it.
context: could you grab me some clothes from around there?\Huh? Let me see...\When's the last time she studied at this desk?\Come on, study this, study that...\You're in a girl's room. Is that really what you want to focus on?\Found one.\Just get changed and come to the living room, please.\Damn it. response:	Futaro, was it?
context: Huh? Let me see...\When's the last time she studied at this desk?\Come on, study this, study that...\You're in a girl's room. Is that really what you want to focus on?\Found one.\Just get changed and come to the living room, please.\Damn it.\Futaro, was it? response:	I need to ask you something.
context: When's the last time she studied at this desk?\Come on, study this, study that...\You're in a girl's room. Is that really what you want to focus on?\Found one.\Just get changed and come to the living room, please.\Damn it.\Futaro, was it?\I need to ask you something. response:	Part of my gym clothes is missing.
context: Come on, study this, study that...\You're in a girl's room. Is that really what you want to focus on?\Found one.\Just get changed and come to the living room, please.\Damn it.\Futaro, was it?\I need to ask you something.\Part of my gym clothes is missing. response:	A red sweatshirt.
context: You're in a girl's room. Is that really what you want to focus on?\Found one.\Just get changed and come to the living room, please.\Damn it.\Futaro, was it?\I need to ask you something.\Part of my gym clothes is missing.\A red sweatshirt. response:	I see.
context: Found one.\Just get changed and come to the living room, please.\Damn it.\Futaro, was it?\I need to ask you something.\Part of my gym clothes is missing.\A red sweatshirt.\I see. response:	I haven't seen it.
context: Just get changed and come to the living room, please.\Damn it.\Futaro, was it?\I need to ask you something.\Part of my gym clothes is missing.\A red sweatshirt.\I see.\I haven't seen it. response:	It was here a minute ago.
context: Damn it.\Futaro, was it?\I need to ask you something.\Part of my gym clothes is missing.\A red sweatshirt.\I see.\I haven't seen it.\It was here a minute ago. response:	Until you got here.
context: Futaro, was it?\I need to ask you something.\Part of my gym clothes is missing.\A red sweatshirt.\I see.\I haven't seen it.\It was here a minute ago.\Until you got here. response:	You...
context: I need to ask you something.\Part of my gym clothes is missing.\A red sweatshirt.\I see.\I haven't seen it.\It was here a minute ago.\Until you got here.\You... response:	Didn't take it!
context: Part of my gym clothes is missing.\A red sweatshirt.\I see.\I haven't seen it.\It was here a minute ago.\Until you got here.\You...\Didn't take it! response:	Hey.
context: A red sweatshirt.\I see.\I haven't seen it.\It was here a minute ago.\Until you got here.\You...\Didn't take it!\Hey. response:	I made too many cookies.
context: I see.\I haven't seen it.\It was here a minute ago.\Until you got here.\You...\Didn't take it!\Hey.\I made too many cookies. response:	Want some?
context: I haven't seen it.\It was here a minute ago.\Until you got here.\You...\Didn't take it!\Hey.\I made too many cookies.\Want some? response:	Nakano Mi
context: It was here a minute ago.\Until you got here.\You...\Didn't take it!\Hey.\I made too many cookies.\Want some?\Nakano Mi response:	There, now I have four of you.
context: Until you got here.\You...\Didn't take it!\Hey.\I made too many cookies.\Want some?\Nakano Mi\There, now I have four of you. response:	Okay, let's start studying.
context: You...\Didn't take it!\Hey.\I made too many cookies.\Want some?\Nakano Mi\There, now I have four of you.\Okay, let's start studying. response:	Yum!
context: Didn't take it!\Hey.\I made too many cookies.\Want some?\Nakano Mi\There, now I have four of you.\Okay, let's start studying.\Yum! response:	What flavor are these?
context: Hey.\I made too many cookies.\Want some?\Nakano Mi\There, now I have four of you.\Okay, let's start studying.\Yum!\What flavor are these? response:	Why are you wearing my sweatshirt?
context: I made too many cookies.\Want some?\Nakano Mi\There, now I have four of you.\Okay, let's start studying.\Yum!\What flavor are these?\Why are you wearing my sweatshirt? response:	I didn't want to get dirty baking.
context: Want some?\Nakano Mi\There, now I have four of you.\Okay, let's start studying.\Yum!\What flavor are these?\Why are you wearing my sweatshirt?\I didn't want to get dirty baking. response:	Take it off now.
context: Nakano Mi\There, now I have four of you.\Okay, let's start studying.\Yum!\What flavor are these?\Why are you wearing my sweatshirt?\I didn't want to get dirty baking.\Take it off now. response:	Hey, stop that!
context: There, now I have four of you.\Okay, let's start studying.\Yum!\What flavor are these?\Why are you wearing my sweatshirt?\I didn't want to get dirty baking.\Take it off now.\Hey, stop that! response:	Give it back.
context: Okay, let's start studying.\Yum!\What flavor are these?\Why are you wearing my sweatshirt?\I didn't want to get dirty baking.\Take it off now.\Hey, stop that!\Give it back. response:	Later! I'll give it back later!
context: Yum!\What flavor are these?\Why are you wearing my sweatshirt?\I didn't want to get dirty baking.\Take it off now.\Hey, stop that!\Give it back.\Later! I'll give it back later! response:	Not to worry, Uesugi-san.
context: What flavor are these?\Why are you wearing my sweatshirt?\I didn't want to get dirty baking.\Take it off now.\Hey, stop that!\Give it back.\Later! I'll give it back later!\Not to worry, Uesugi-san. response:	I'm studying.
context: Why are you wearing my sweatshirt?\I didn't want to get dirty baking.\Take it off now.\Hey, stop that!\Give it back.\Later! I'll give it back later!\Not to worry, Uesugi-san.\I'm studying. response:	Hey, let's go hang out somewhere. It's Saturday.
context: I didn't want to get dirty baking.\Take it off now.\Hey, stop that!\Give it back.\Later! I'll give it back later!\Not to worry, Uesugi-san.\I'm studying.\Hey, let's go hang out somewhere. It's Saturday. response:	Oh, was there a package for me?
context: Take it off now.\Hey, stop that!\Give it back.\Later! I'll give it back later!\Not to worry, Uesugi-san.\I'm studying.\Hey, let's go hang out somewhere. It's Saturday.\Oh, was there a package for me? response:	These girls are hopeless.
context: Hey, stop that!\Give it back.\Later! I'll give it back later!\Not to worry, Uesugi-san.\I'm studying.\Hey, let's go hang out somewhere. It's Saturday.\Oh, was there a package for me?\These girls are hopeless. response:	Do you not like cookies?
context: Give it back.\Later! I'll give it back later!\Not to worry, Uesugi-san.\I'm studying.\Hey, let's go hang out somewhere. It's Saturday.\Oh, was there a package for me?\These girls are hopeless.\Do you not like cookies? response:	No, I'm just not in the mood for them.
context: Later! I'll give it back later!\Not to worry, Uesugi-san.\I'm studying.\Hey, let's go hang out somewhere. It's Saturday.\Oh, was there a package for me?\These girls are hopeless.\Do you not like cookies?\No, I'm just not in the mood for them. response:	You don't need to be so wary. I didn't poison the cookies.
context: Not to worry, Uesugi-san.\I'm studying.\Hey, let's go hang out somewhere. It's Saturday.\Oh, was there a package for me?\These girls are hopeless.\Do you not like cookies?\No, I'm just not in the mood for them.\You don't need to be so wary. I didn't poison the cookies. response:	I wouldn't mind studying if you have some.
context: I'm studying.\Hey, let's go hang out somewhere. It's Saturday.\Oh, was there a package for me?\These girls are hopeless.\Do you not like cookies?\No, I'm just not in the mood for them.\You don't need to be so wary. I didn't poison the cookies.\I wouldn't mind studying if you have some. response:	He's going at them.
context: Hey, let's go hang out somewhere. It's Saturday.\Oh, was there a package for me?\These girls are hopeless.\Do you not like cookies?\No, I'm just not in the mood for them.\You don't need to be so wary. I didn't poison the cookies.\I wouldn't mind studying if you have some.\He's going at them. response:	Are they good?
context: Oh, was there a package for me?\These girls are hopeless.\Do you not like cookies?\No, I'm just not in the mood for them.\You don't need to be so wary. I didn't poison the cookies.\I wouldn't mind studying if you have some.\He's going at them.\Are they good? response:	Yeah, they're good.
context: These girls are hopeless.\Do you not like cookies?\No, I'm just not in the mood for them.\You don't need to be so wary. I didn't poison the cookies.\I wouldn't mind studying if you have some.\He's going at them.\Are they good?\Yeah, they're good. response:	I'm so glad.
context: Do you not like cookies?\No, I'm just not in the mood for them.\You don't need to be so wary. I didn't poison the cookies.\I wouldn't mind studying if you have some.\He's going at them.\Are they good?\Yeah, they're good.\I'm so glad. response:	Oh, right. The thing is...
context: No, I'm just not in the mood for them.\You don't need to be so wary. I didn't poison the cookies.\I wouldn't mind studying if you have some.\He's going at them.\Are they good?\Yeah, they're good.\I'm so glad.\Oh, right. The thing is... response:	We don't need a tutor, honestly.
context: You don't need to be so wary. I didn't poison the cookies.\I wouldn't mind studying if you have some.\He's going at them.\Are they good?\Yeah, they're good.\I'm so glad.\Oh, right. The thing is...\We don't need a tutor, honestly. response:	Just kidding.
context: I wouldn't mind studying if you have some.\He's going at them.\Are they good?\Yeah, they're good.\I'm so glad.\Oh, right. The thing is...\We don't need a tutor, honestly.\Just kidding. response:	Here, water.
context: He's going at them.\Are they good?\Yeah, they're good.\I'm so glad.\Oh, right. The thing is...\We don't need a tutor, honestly.\Just kidding.\Here, water. response:	Th-Thanks.
context: Are they good?\Yeah, they're good.\I'm so glad.\Oh, right. The thing is...\We don't need a tutor, honestly.\Just kidding.\Here, water.\Th-Thanks. response:	Damn it...
context: Yeah, they're good.\I'm so glad.\Oh, right. The thing is...\We don't need a tutor, honestly.\Just kidding.\Here, water.\Th-Thanks.\Damn it... response:	I'm not surprised by the way they're reacting,
context: I'm so glad.\Oh, right. The thing is...\We don't need a tutor, honestly.\Just kidding.\Here, water.\Th-Thanks.\Damn it...\I'm not surprised by the way they're reacting, response:	but I need to get them to graduate.
context: Oh, right. The thing is...\We don't need a tutor, honestly.\Just kidding.\Here, water.\Th-Thanks.\Damn it...\I'm not surprised by the way they're reacting,\but I need to get them to graduate. response:	There's no other way for me.
context: We don't need a tutor, honestly.\Just kidding.\Here, water.\Th-Thanks.\Damn it...\I'm not surprised by the way they're reacting,\but I need to get them to graduate.\There's no other way for me. response:	Bye-bye.
context: Just kidding.\Here, water.\Th-Thanks.\Damn it...\I'm not surprised by the way they're reacting,\but I need to get them to graduate.\There's no other way for me.\Bye-bye. response:	Sir.
context: Here, water.\Th-Thanks.\Damn it...\I'm not surprised by the way they're reacting,\but I need to get them to graduate.\There's no other way for me.\Bye-bye.\Sir. response:	Sir, we're here.
context: Th-Thanks.\Damn it...\I'm not surprised by the way they're reacting,\but I need to get them to graduate.\There's no other way for me.\Bye-bye.\Sir.\Sir, we're here. response:	Where am I?
context: Damn it...\I'm not surprised by the way they're reacting,\but I need to get them to graduate.\There's no other way for me.\Bye-bye.\Sir.\Sir, we're here.\Where am I? response:	Where?
context: I'm not surprised by the way they're reacting,\but I need to get them to graduate.\There's no other way for me.\Bye-bye.\Sir.\Sir, we're here.\Where am I?\Where? response:	This is where you live, is it not?
context: but I need to get them to graduate.\There's no other way for me.\Bye-bye.\Sir.\Sir, we're here.\Where am I?\Where?\This is where you live, is it not? response:	H-How?!
context: There's no other way for me.\Bye-bye.\Sir.\Sir, we're here.\Where am I?\Where?\This is where you live, is it not?\H-How?! response:	She did this!
context: Bye-bye.\Sir.\Sir, we're here.\Where am I?\Where?\This is where you live, is it not?\H-How?!\She did this! response:	That'll be 4,800 yen.
context: Sir.\Sir, we're here.\Where am I?\Where?\This is where you live, is it not?\H-How?!\She did this!\That'll be 4,800 yen. response:	Money?!
context: Sir, we're here.\Where am I?\Where?\This is where you live, is it not?\H-How?!\She did this!\That'll be 4,800 yen.\Money?! response:	That's so much!
context: Where am I?\Where?\This is where you live, is it not?\H-How?!\She did this!\That'll be 4,800 yen.\Money?!\That's so much! response:	By card.
context: Where?\This is where you live, is it not?\H-How?!\She did this!\That'll be 4,800 yen.\Money?!\That's so much!\By card. response:	Thank you.
context: This is where you live, is it not?\H-How?!\She did this!\That'll be 4,800 yen.\Money?!\That's so much!\By card.\Thank you. response:	Itsuki.
context: H-How?!\She did this!\That'll be 4,800 yen.\Money?!\That's so much!\By card.\Thank you.\Itsuki. response:	I checked your student handbook for your address.
context: She did this!\That'll be 4,800 yen.\Money?!\That's so much!\By card.\Thank you.\Itsuki.\I checked your student handbook for your address. response:	D-Did you look at the photo?
context: That'll be 4,800 yen.\Money?!\That's so much!\By card.\Thank you.\Itsuki.\I checked your student handbook for your address.\D-Did you look at the photo? response:	What are you talking about?
context: Money?!\That's so much!\By card.\Thank you.\Itsuki.\I checked your student handbook for your address.\D-Did you look at the photo?\What are you talking about? response:	Anyway, they really pulled a fast one on you, huh?
context: That's so much!\By card.\Thank you.\Itsuki.\I checked your student handbook for your address.\D-Did you look at the photo?\What are you talking about?\Anyway, they really pulled a fast one on you, huh? response:	If you've learned your lesson, you'll give up on tutoring us.
context: By card.\Thank you.\Itsuki.\I checked your student handbook for your address.\D-Did you look at the photo?\What are you talking about?\Anyway, they really pulled a fast one on you, huh?\If you've learned your lesson, you'll give up on tutoring us. response:	I can't do that.
context: Thank you.\Itsuki.\I checked your student handbook for your address.\D-Did you look at the photo?\What are you talking about?\Anyway, they really pulled a fast one on you, huh?\If you've learned your lesson, you'll give up on tutoring us.\I can't do that. response:	Why are you so persistent?
context: Itsuki.\I checked your student handbook for your address.\D-Did you look at the photo?\What are you talking about?\Anyway, they really pulled a fast one on you, huh?\If you've learned your lesson, you'll give up on tutoring us.\I can't do that.\Why are you so persistent? response:	I knew it was you, Onii-chan.
context: I checked your student handbook for your address.\D-Did you look at the photo?\What are you talking about?\Anyway, they really pulled a fast one on you, huh?\If you've learned your lesson, you'll give up on tutoring us.\I can't do that.\Why are you so persistent?\I knew it was you, Onii-chan. response:	Raiha.
context: D-Did you look at the photo?\What are you talking about?\Anyway, they really pulled a fast one on you, huh?\If you've learned your lesson, you'll give up on tutoring us.\I can't do that.\Why are you so persistent?\I knew it was you, Onii-chan.\Raiha. response:	Dinner's...
context: What are you talking about?\Anyway, they really pulled a fast one on you, huh?\If you've learned your lesson, you'll give up on tutoring us.\I can't do that.\Why are you so persistent?\I knew it was you, Onii-chan.\Raiha.\Dinner's... response:	Is this your student?!
context: Anyway, they really pulled a fast one on you, huh?\If you've learned your lesson, you'll give up on tutoring us.\I can't do that.\Why are you so persistent?\I knew it was you, Onii-chan.\Raiha.\Dinner's...\Is this your student?! response:	Sh-She's nobody.
context: If you've learned your lesson, you'll give up on tutoring us.\I can't do that.\Why are you so persistent?\I knew it was you, Onii-chan.\Raiha.\Dinner's...\Is this your student?!\Sh-She's nobody. response:	Let's go.
context: I can't do that.\Why are you so persistent?\I knew it was you, Onii-chan.\Raiha.\Dinner's...\Is this your student?!\Sh-She's nobody.\Let's go. response:	You're lying.
context: Why are you so persistent?\I knew it was you, Onii-chan.\Raiha.\Dinner's...\Is this your student?!\Sh-She's nobody.\Let's go.\You're lying. response:	Would you like to have dinner at our place?
context: I knew it was you, Onii-chan.\Raiha.\Dinner's...\Is this your student?!\Sh-She's nobody.\Let's go.\You're lying.\Would you like to have dinner at our place? response:	R-Raiha...
context: Raiha.\Dinner's...\Is this your student?!\Sh-She's nobody.\Let's go.\You're lying.\Would you like to have dinner at our place?\R-Raiha... response:	But...
context: Dinner's...\Is this your student?!\Sh-She's nobody.\Let's go.\You're lying.\Would you like to have dinner at our place?\R-Raiha...\But... response:	Do you not want to?
context: Is this your student?!\Sh-She's nobody.\Let's go.\You're lying.\Would you like to have dinner at our place?\R-Raiha...\But...\Do you not want to? response:	Here we go.
context: Sh-She's nobody.\Let's go.\You're lying.\Would you like to have dinner at our place?\R-Raiha...\But...\Do you not want to?\Here we go. response:	The Uesugi Family's special curry and rolled egg.
context: Let's go.\You're lying.\Would you like to have dinner at our place?\R-Raiha...\But...\Do you not want to?\Here we go.\The Uesugi Family's special curry and rolled egg. response:	I hope you like it.
context: You're lying.\Would you like to have dinner at our place?\R-Raiha...\But...\Do you not want to?\Here we go.\The Uesugi Family's special curry and rolled egg.\I hope you like it. response:	It looks delicious.
context: Would you like to have dinner at our place?\R-Raiha...\But...\Do you not want to?\Here we go.\The Uesugi Family's special curry and rolled egg.\I hope you like it.\It looks delicious. response:	I doubt a rich girl can appreciate the food of us common folk.
context: R-Raiha...\But...\Do you not want to?\Here we go.\The Uesugi Family's special curry and rolled egg.\I hope you like it.\It looks delicious.\I doubt a rich girl can appreciate the food of us common folk. response:	Hey!
context: But...\Do you not want to?\Here we go.\The Uesugi Family's special curry and rolled egg.\I hope you like it.\It looks delicious.\I doubt a rich girl can appreciate the food of us common folk.\Hey! response:	Ow!
context: Do you not want to?\Here we go.\The Uesugi Family's special curry and rolled egg.\I hope you like it.\It looks delicious.\I doubt a rich girl can appreciate the food of us common folk.\Hey!\Ow! response:	Cut that out.
context: Here we go.\The Uesugi Family's special curry and rolled egg.\I hope you like it.\It looks delicious.\I doubt a rich girl can appreciate the food of us common folk.\Hey!\Ow!\Cut that out. response:	That's why you aren't as popular as I am.
context: The Uesugi Family's special curry and rolled egg.\I hope you like it.\It looks delicious.\I doubt a rich girl can appreciate the food of us common folk.\Hey!\Ow!\Cut that out.\That's why you aren't as popular as I am. response:	Dad...
context: I hope you like it.\It looks delicious.\I doubt a rich girl can appreciate the food of us common folk.\Hey!\Ow!\Cut that out.\That's why you aren't as popular as I am.\Dad... response:	I never thought you'd bring home a girl, though.
context: It looks delicious.\I doubt a rich girl can appreciate the food of us common folk.\Hey!\Ow!\Cut that out.\That's why you aren't as popular as I am.\Dad...\I never thought you'd bring home a girl, though. response:	Let's eat.
context: I doubt a rich girl can appreciate the food of us common folk.\Hey!\Ow!\Cut that out.\That's why you aren't as popular as I am.\Dad...\I never thought you'd bring home a girl, though.\Let's eat. response:	Oh, yeah, Onii-chan.
context: Hey!\Ow!\Cut that out.\That's why you aren't as popular as I am.\Dad...\I never thought you'd bring home a girl, though.\Let's eat.\Oh, yeah, Onii-chan. response:	Did you get your tutoring done?
context: Ow!\Cut that out.\That's why you aren't as popular as I am.\Dad...\I never thought you'd bring home a girl, though.\Let's eat.\Oh, yeah, Onii-chan.\Did you get your tutoring done? response:	About that...
context: Cut that out.\That's why you aren't as popular as I am.\Dad...\I never thought you'd bring home a girl, though.\Let's eat.\Oh, yeah, Onii-chan.\Did you get your tutoring done?\About that... response:	O-Of course. It's all good.
context: That's why you aren't as popular as I am.\Dad...\I never thought you'd bring home a girl, though.\Let's eat.\Oh, yeah, Onii-chan.\Did you get your tutoring done?\About that...\O-Of course. It's all good. response:	Wh-What?!
context: Dad...\I never thought you'd bring home a girl, though.\Let's eat.\Oh, yeah, Onii-chan.\Did you get your tutoring done?\About that...\O-Of course. It's all good.\Wh-What?! response:	Just play along. You'll make Raiha sad.
context: I never thought you'd bring home a girl, though.\Let's eat.\Oh, yeah, Onii-chan.\Did you get your tutoring done?\About that...\O-Of course. It's all good.\Wh-What?!\Just play along. You'll make Raiha sad. response:	What's wrong?
context: Let's eat.\Oh, yeah, Onii-chan.\Did you get your tutoring done?\About that...\O-Of course. It's all good.\Wh-What?!\Just play along. You'll make Raiha sad.\What's wrong? response:	No, it's nothing.
context: Oh, yeah, Onii-chan.\Did you get your tutoring done?\About that...\O-Of course. It's all good.\Wh-What?!\Just play along. You'll make Raiha sad.\What's wrong?\No, it's nothing. response:	Y-Yes.
context: Did you get your tutoring done?\About that...\O-Of course. It's all good.\Wh-What?!\Just play along. You'll make Raiha sad.\What's wrong?\No, it's nothing.\Y-Yes. response:	I'm glad, though.
context: About that...\O-Of course. It's all good.\Wh-What?!\Just play along. You'll make Raiha sad.\What's wrong?\No, it's nothing.\Y-Yes.\I'm glad, though. response:	We can finally deal with our debt problem.
context: O-Of course. It's all good.\Wh-What?!\Just play along. You'll make Raiha sad.\What's wrong?\No, it's nothing.\Y-Yes.\I'm glad, though.\We can finally deal with our debt problem. response:	We have a guest, Raiha.
context: Wh-What?!\Just play along. You'll make Raiha sad.\What's wrong?\No, it's nothing.\Y-Yes.\I'm glad, though.\We can finally deal with our debt problem.\We have a guest, Raiha. response:	Oh, sorry.
context: Just play along. You'll make Raiha sad.\What's wrong?\No, it's nothing.\Y-Yes.\I'm glad, though.\We can finally deal with our debt problem.\We have a guest, Raiha.\Oh, sorry. response:	Thank you for having me.
context: What's wrong?\No, it's nothing.\Y-Yes.\I'm glad, though.\We can finally deal with our debt problem.\We have a guest, Raiha.\Oh, sorry.\Thank you for having me. response:	Sure.
context: No, it's nothing.\Y-Yes.\I'm glad, though.\We can finally deal with our debt problem.\We have a guest, Raiha.\Oh, sorry.\Thank you for having me.\Sure. response:	Thanks for the dinner, Raiha-chan.
context: Y-Yes.\I'm glad, though.\We can finally deal with our debt problem.\We have a guest, Raiha.\Oh, sorry.\Thank you for having me.\Sure.\Thanks for the dinner, Raiha-chan. response:	Itsuki-san...
context: I'm glad, though.\We can finally deal with our debt problem.\We have a guest, Raiha.\Oh, sorry.\Thank you for having me.\Sure.\Thanks for the dinner, Raiha-chan.\Itsuki-san... response:	Y-Yes?
context: We can finally deal with our debt problem.\We have a guest, Raiha.\Oh, sorry.\Thank you for having me.\Sure.\Thanks for the dinner, Raiha-chan.\Itsuki-san...\Y-Yes? response:	My brother's a crappy, egoistic low-life, but...
context: We have a guest, Raiha.\Oh, sorry.\Thank you for having me.\Sure.\Thanks for the dinner, Raiha-chan.\Itsuki-san...\Y-Yes?\My brother's a crappy, egoistic low-life, but... response:	R-Raiha?
context: Oh, sorry.\Thank you for having me.\Sure.\Thanks for the dinner, Raiha-chan.\Itsuki-san...\Y-Yes?\My brother's a crappy, egoistic low-life, but...\R-Raiha? response:	But he's got lots of good qualities, too.
context: Thank you for having me.\Sure.\Thanks for the dinner, Raiha-chan.\Itsuki-san...\Y-Yes?\My brother's a crappy, egoistic low-life, but...\R-Raiha?\But he's got lots of good qualities, too. response:	So, um...
context: Sure.\Thanks for the dinner, Raiha-chan.\Itsuki-san...\Y-Yes?\My brother's a crappy, egoistic low-life, but...\R-Raiha?\But he's got lots of good qualities, too.\So, um... response:	Would you have dinner with us again?
context: Thanks for the dinner, Raiha-chan.\Itsuki-san...\Y-Yes?\My brother's a crappy, egoistic low-life, but...\R-Raiha?\But he's got lots of good qualities, too.\So, um...\Would you have dinner with us again? response:	Of course.
context: Itsuki-san...\Y-Yes?\My brother's a crappy, egoistic low-life, but...\R-Raiha?\But he's got lots of good qualities, too.\So, um...\Would you have dinner with us again?\Of course. response:	Using my brain makes me hungry.
context: Y-Yes?\My brother's a crappy, egoistic low-life, but...\R-Raiha?\But he's got lots of good qualities, too.\So, um...\Would you have dinner with us again?\Of course.\Using my brain makes me hungry. response:	I hope you'll treat me again.
context: My brother's a crappy, egoistic low-life, but...\R-Raiha?\But he's got lots of good qualities, too.\So, um...\Would you have dinner with us again?\Of course.\Using my brain makes me hungry.\I hope you'll treat me again. response:	Don't get the wrong idea.
context: R-Raiha?\But he's got lots of good qualities, too.\So, um...\Would you have dinner with us again?\Of course.\Using my brain makes me hungry.\I hope you'll treat me again.\Don't get the wrong idea. response:	I have an idea of your circumstances now,
context: But he's got lots of good qualities, too.\So, um...\Would you have dinner with us again?\Of course.\Using my brain makes me hungry.\I hope you'll treat me again.\Don't get the wrong idea.\I have an idea of your circumstances now, response:	but I can't help you.
context: So, um...\Would you have dinner with us again?\Of course.\Using my brain makes me hungry.\I hope you'll treat me again.\Don't get the wrong idea.\I have an idea of your circumstances now,\but I can't help you. response:	That so?
context: Would you have dinner with us again?\Of course.\Using my brain makes me hungry.\I hope you'll treat me again.\Don't get the wrong idea.\I have an idea of your circumstances now,\but I can't help you.\That so? response:	I'll study, but I won't ask for your tutelage.
context: Of course.\Using my brain makes me hungry.\I hope you'll treat me again.\Don't get the wrong idea.\I have an idea of your circumstances now,\but I can't help you.\That so?\I'll study, but I won't ask for your tutelage. response:	I'll pull it off without your assistance.
context: Using my brain makes me hungry.\I hope you'll treat me again.\Don't get the wrong idea.\I have an idea of your circumstances now,\but I can't help you.\That so?\I'll study, but I won't ask for your tutelage.\I'll pull it off without your assistance. response:	So if you want to tutor us, suit yourself.
context: I hope you'll treat me again.\Don't get the wrong idea.\I have an idea of your circumstances now,\but I can't help you.\That so?\I'll study, but I won't ask for your tutelage.\I'll pull it off without your assistance.\So if you want to tutor us, suit yourself. response:	What did you just say?
context: Don't get the wrong idea.\I have an idea of your circumstances now,\but I can't help you.\That so?\I'll study, but I won't ask for your tutelage.\I'll pull it off without your assistance.\So if you want to tutor us, suit yourself.\What did you just say? response:	I said, suit yourself.
context: I have an idea of your circumstances now,\but I can't help you.\That so?\I'll study, but I won't ask for your tutelage.\I'll pull it off without your assistance.\So if you want to tutor us, suit yourself.\What did you just say?\I said, suit yourself. response:	R-Really?
context: but I can't help you.\That so?\I'll study, but I won't ask for your tutelage.\I'll pull it off without your assistance.\So if you want to tutor us, suit yourself.\What did you just say?\I said, suit yourself.\R-Really? response:	That's all I have to do?
context: That so?\I'll study, but I won't ask for your tutelage.\I'll pull it off without your assistance.\So if you want to tutor us, suit yourself.\What did you just say?\I said, suit yourself.\R-Really?\That's all I have to do? response:	You're the best, Itsuki!
context: I'll study, but I won't ask for your tutelage.\I'll pull it off without your assistance.\So if you want to tutor us, suit yourself.\What did you just say?\I said, suit yourself.\R-Really?\That's all I have to do?\You're the best, Itsuki! response:	What?
context: I'll pull it off without your assistance.\So if you want to tutor us, suit yourself.\What did you just say?\I said, suit yourself.\R-Really?\That's all I have to do?\You're the best, Itsuki!\What? response:	I'll be there precisely at noon tomorrow.
context: So if you want to tutor us, suit yourself.\What did you just say?\I said, suit yourself.\R-Really?\That's all I have to do?\You're the best, Itsuki!\What?\I'll be there precisely at noon tomorrow. response:	Gather the other four for me.
context: What did you just say?\I said, suit yourself.\R-Really?\That's all I have to do?\You're the best, Itsuki!\What?\I'll be there precisely at noon tomorrow.\Gather the other four for me. response:	Right.
context: I said, suit yourself.\R-Really?\That's all I have to do?\You're the best, Itsuki!\What?\I'll be there precisely at noon tomorrow.\Gather the other four for me.\Right. response:	That's right.
context: R-Really?\That's all I have to do?\You're the best, Itsuki!\What?\I'll be there precisely at noon tomorrow.\Gather the other four for me.\Right.\That's right. response:	My job is to help all five of them graduate.
context: That's all I have to do?\You're the best, Itsuki!\What?\I'll be there precisely at noon tomorrow.\Gather the other four for me.\Right.\That's right.\My job is to help all five of them graduate. response:	I don't need to actually deal with all five of them.
context: You're the best, Itsuki!\What?\I'll be there precisely at noon tomorrow.\Gather the other four for me.\Right.\That's right.\My job is to help all five of them graduate.\I don't need to actually deal with all five of them. response:	I just need to teach the ones that are in danger of failing.
context: What?\I'll be there precisely at noon tomorrow.\Gather the other four for me.\Right.\That's right.\My job is to help all five of them graduate.\I don't need to actually deal with all five of them.\I just need to teach the ones that are in danger of failing. response:	I wonder if Futaro knows.
context: I'll be there precisely at noon tomorrow.\Gather the other four for me.\Right.\That's right.\My job is to help all five of them graduate.\I don't need to actually deal with all five of them.\I just need to teach the ones that are in danger of failing.\I wonder if Futaro knows. response:	I doubt he knows...
context: Gather the other four for me.\Right.\That's right.\My job is to help all five of them graduate.\I don't need to actually deal with all five of them.\I just need to teach the ones that are in danger of failing.\I wonder if Futaro knows.\I doubt he knows... response:	that we transferred here because all five of us nearly failed.
context: Right.\That's right.\My job is to help all five of them graduate.\I don't need to actually deal with all five of them.\I just need to teach the ones that are in danger of failing.\I wonder if Futaro knows.\I doubt he knows...\that we transferred here because all five of us nearly failed. response:	The unbelievable day... Hehe.
context: That's right.\My job is to help all five of them graduate.\I don't need to actually deal with all five of them.\I just need to teach the ones that are in danger of failing.\I wonder if Futaro knows.\I doubt he knows...\that we transferred here because all five of us nearly failed.\The unbelievable day... Hehe. response:	You mean the day you met us, right?
context: My job is to help all five of them graduate.\I don't need to actually deal with all five of them.\I just need to teach the ones that are in danger of failing.\I wonder if Futaro knows.\I doubt he knows...\that we transferred here because all five of us nearly failed.\The unbelievable day... Hehe.\You mean the day you met us, right? response:	It didn't seem like it at the time.
context: I don't need to actually deal with all five of them.\I just need to teach the ones that are in danger of failing.\I wonder if Futaro knows.\I doubt he knows...\that we transferred here because all five of us nearly failed.\The unbelievable day... Hehe.\You mean the day you met us, right?\It didn't seem like it at the time. response:	Yeah, you're right.
context: I just need to teach the ones that are in danger of failing.\I wonder if Futaro knows.\I doubt he knows...\that we transferred here because all five of us nearly failed.\The unbelievable day... Hehe.\You mean the day you met us, right?\It didn't seem like it at the time.\Yeah, you're right. response:	All these years later, I still relive that moment in my sleep...
context: I wonder if Futaro knows.\I doubt he knows...\that we transferred here because all five of us nearly failed.\The unbelievable day... Hehe.\You mean the day you met us, right?\It didn't seem like it at the time.\Yeah, you're right.\All these years later, I still relive that moment in my sleep... response:	It was unbelievable.
context: I doubt he knows...\that we transferred here because all five of us nearly failed.\The unbelievable day... Hehe.\You mean the day you met us, right?\It didn't seem like it at the time.\Yeah, you're right.\All these years later, I still relive that moment in my sleep...\It was unbelievable. response:	An absolute nightmare.
context: that we transferred here because all five of us nearly failed.\The unbelievable day... Hehe.\You mean the day you met us, right?\It didn't seem like it at the time.\Yeah, you're right.\All these years later, I still relive that moment in my sleep...\It was unbelievable.\An absolute nightmare. response:	Next Time on The Quintessential Quintuplets
context: The unbelievable day... Hehe.\You mean the day you met us, right?\It didn't seem like it at the time.\Yeah, you're right.\All these years later, I still relive that moment in my sleep...\It was unbelievable.\An absolute nightmare.\Next Time on The Quintessential Quintuplets response:	Quintuplets Trivia!
context: You mean the day you met us, right?\It didn't seem like it at the time.\Yeah, you're right.\All these years later, I still relive that moment in my sleep...\It was unbelievable.\An absolute nightmare.\Next Time on The Quintessential Quintuplets\Quintuplets Trivia! response:	Our weights total up to 250 kilos!
context: It didn't seem like it at the time.\Yeah, you're right.\All these years later, I still relive that moment in my sleep...\It was unbelievable.\An absolute nightmare.\Next Time on The Quintessential Quintuplets\Quintuplets Trivia!\Our weights total up to 250 kilos! response:	Wow, it's neatly divisible by five!
context: Yeah, you're right.\All these years later, I still relive that moment in my sleep...\It was unbelievable.\An absolute nightmare.\Next Time on The Quintessential Quintuplets\Quintuplets Trivia!\Our weights total up to 250 kilos!\Wow, it's neatly divisible by five! response:	50 kilos each! The average, healthy weight for a girl!
context: All these years later, I still relive that moment in my sleep...\It was unbelievable.\An absolute nightmare.\Next Time on The Quintessential Quintuplets\Quintuplets Trivia!\Our weights total up to 250 kilos!\Wow, it's neatly divisible by five!\50 kilos each! The average, healthy weight for a girl! response:	Let's go with that, okay?
context: It was unbelievable.\An absolute nightmare.\Next Time on The Quintessential Quintuplets\Quintuplets Trivia!\Our weights total up to 250 kilos!\Wow, it's neatly divisible by five!\50 kilos each! The average, healthy weight for a girl!\Let's go with that, okay? response:	Uh, but...
context: An absolute nightmare.\Next Time on The Quintessential Quintuplets\Quintuplets Trivia!\Our weights total up to 250 kilos!\Wow, it's neatly divisible by five!\50 kilos each! The average, healthy weight for a girl!\Let's go with that, okay?\Uh, but... response:	Let's go with that, okay?
context: Next Time on The Quintessential Quintuplets\Quintuplets Trivia!\Our weights total up to 250 kilos!\Wow, it's neatly divisible by five!\50 kilos each! The average, healthy weight for a girl!\Let's go with that, okay?\Uh, but...\Let's go with that, okay? response:	Okay...