context: How many years has it been since I last stepped on this soil? response:	Oh, my God,
context: How many years has it been since I last stepped on this soil?\Oh, my God, response:	Chrona...
context: How many years has it been since I last stepped on this soil?\Oh, my God,\Chrona... response:	It's alright.
context: How many years has it been since I last stepped on this soil?\Oh, my God,\Chrona...\It's alright. response:	So...
context: How many years has it been since I last stepped on this soil?\Oh, my God,\Chrona...\It's alright.\So... response:	I wonder how things are...
context: How many years has it been since I last stepped on this soil?\Oh, my God,\Chrona...\It's alright.\So...\I wonder how things are... response:	Seriously...
context: How many years has it been since I last stepped on this soil?\Oh, my God,\Chrona...\It's alright.\So...\I wonder how things are...\Seriously... response:	Concerning the Devil Sword...
context: How many years has it been since I last stepped on this soil?\Oh, my God,\Chrona...\It's alright.\So...\I wonder how things are...\Seriously...\Concerning the Devil Sword... response:	Hmm...
context: Oh, my God,\Chrona...\It's alright.\So...\I wonder how things are...\Seriously...\Concerning the Devil Sword...\Hmm... response:	Right now, we let her attend school so we could keep an eye on her,
context: Chrona...\It's alright.\So...\I wonder how things are...\Seriously...\Concerning the Devil Sword...\Hmm...\Right now, we let her attend school so we could keep an eye on her, response:	Hmm...
context: It's alright.\So...\I wonder how things are...\Seriously...\Concerning the Devil Sword...\Hmm...\Right now, we let her attend school so we could keep an eye on her,\Hmm... response:	I guess so... Hmm...
context: So...\I wonder how things are...\Seriously...\Concerning the Devil Sword...\Hmm...\Right now, we let her attend school so we could keep an eye on her,\Hmm...\I guess so... Hmm... response:	Are you worried about something?
context: I wonder how things are...\Seriously...\Concerning the Devil Sword...\Hmm...\Right now, we let her attend school so we could keep an eye on her,\Hmm...\I guess so... Hmm...\Are you worried about something? response:	Hmm...
context: Seriously...\Concerning the Devil Sword...\Hmm...\Right now, we let her attend school so we could keep an eye on her,\Hmm...\I guess so... Hmm...\Are you worried about something?\Hmm... response:	Well, there is something that's sort of mysterious...
context: Concerning the Devil Sword...\Hmm...\Right now, we let her attend school so we could keep an eye on her,\Hmm...\I guess so... Hmm...\Are you worried about something?\Hmm...\Well, there is something that's sort of mysterious... response:	Something mysterious?
context: Hmm...\Right now, we let her attend school so we could keep an eye on her,\Hmm...\I guess so... Hmm...\Are you worried about something?\Hmm...\Well, there is something that's sort of mysterious...\Something mysterious? response:	That Devil Sword...
context: Right now, we let her attend school so we could keep an eye on her,\Hmm...\I guess so... Hmm...\Are you worried about something?\Hmm...\Well, there is something that's sort of mysterious...\Something mysterious?\That Devil Sword... response:	It probably ate a considerable amount of human souls, right?
context: Hmm...\I guess so... Hmm...\Are you worried about something?\Hmm...\Well, there is something that's sort of mysterious...\Something mysterious?\That Devil Sword...\It probably ate a considerable amount of human souls, right? response:	I thought she should be progressing into a Kishin.
context: I guess so... Hmm...\Are you worried about something?\Hmm...\Well, there is something that's sort of mysterious...\Something mysterious?\That Devil Sword...\It probably ate a considerable amount of human souls, right?\I thought she should be progressing into a Kishin. response:	But it seems that this isn't the case.
context: Are you worried about something?\Hmm...\Well, there is something that's sort of mysterious...\Something mysterious?\That Devil Sword...\It probably ate a considerable amount of human souls, right?\I thought she should be progressing into a Kishin.\But it seems that this isn't the case. response:	What does this mean?
context: Hmm...\Well, there is something that's sort of mysterious...\Something mysterious?\That Devil Sword...\It probably ate a considerable amount of human souls, right?\I thought she should be progressing into a Kishin.\But it seems that this isn't the case.\What does this mean? response:	I'm not sure of the reason myself.
context: Well, there is something that's sort of mysterious...\Something mysterious?\That Devil Sword...\It probably ate a considerable amount of human souls, right?\I thought she should be progressing into a Kishin.\But it seems that this isn't the case.\What does this mean?\I'm not sure of the reason myself. response:	Maybe there was a purifying effect, for some reason?
context: Something mysterious?\That Devil Sword...\It probably ate a considerable amount of human souls, right?\I thought she should be progressing into a Kishin.\But it seems that this isn't the case.\What does this mean?\I'm not sure of the reason myself.\Maybe there was a purifying effect, for some reason? response:	What do you think, Sid-kun?
context: That Devil Sword...\It probably ate a considerable amount of human souls, right?\I thought she should be progressing into a Kishin.\But it seems that this isn't the case.\What does this mean?\I'm not sure of the reason myself.\Maybe there was a purifying effect, for some reason?\What do you think, Sid-kun? response:	I'm not entirely sure.
context: It probably ate a considerable amount of human souls, right?\I thought she should be progressing into a Kishin.\But it seems that this isn't the case.\What does this mean?\I'm not sure of the reason myself.\Maybe there was a purifying effect, for some reason?\What do you think, Sid-kun?\I'm not entirely sure. response:	But the Devil Sword, in truth, should have known what she was doing.
context: I thought she should be progressing into a Kishin.\But it seems that this isn't the case.\What does this mean?\I'm not sure of the reason myself.\Maybe there was a purifying effect, for some reason?\What do you think, Sid-kun?\I'm not entirely sure.\But the Devil Sword, in truth, should have known what she was doing. response:	Even though she is only a child who was instructed by a witch,
context: But it seems that this isn't the case.\What does this mean?\I'm not sure of the reason myself.\Maybe there was a purifying effect, for some reason?\What do you think, Sid-kun?\I'm not entirely sure.\But the Devil Sword, in truth, should have known what she was doing.\Even though she is only a child who was instructed by a witch, response:	What should we do?
context: What does this mean?\I'm not sure of the reason myself.\Maybe there was a purifying effect, for some reason?\What do you think, Sid-kun?\I'm not entirely sure.\But the Devil Sword, in truth, should have known what she was doing.\Even though she is only a child who was instructed by a witch,\What should we do? response:	Hmm...
context: I'm not sure of the reason myself.\Maybe there was a purifying effect, for some reason?\What do you think, Sid-kun?\I'm not entirely sure.\But the Devil Sword, in truth, should have known what she was doing.\Even though she is only a child who was instructed by a witch,\What should we do?\Hmm... response:	Hmm...?
context: Maybe there was a purifying effect, for some reason?\What do you think, Sid-kun?\I'm not entirely sure.\But the Devil Sword, in truth, should have known what she was doing.\Even though she is only a child who was instructed by a witch,\What should we do?\Hmm...\Hmm...? response:	I don't know, so let it be!
context: What do you think, Sid-kun?\I'm not entirely sure.\But the Devil Sword, in truth, should have known what she was doing.\Even though she is only a child who was instructed by a witch,\What should we do?\Hmm...\Hmm...?\I don't know, so let it be! response:	Assemble, Death Scythes!
context: I'm not entirely sure.\But the Devil Sword, in truth, should have known what she was doing.\Even though she is only a child who was instructed by a witch,\What should we do?\Hmm...\Hmm...?\I don't know, so let it be!\Assemble, Death Scythes! response:	Preventing Papa's Reassignment?!
context: But the Devil Sword, in truth, should have known what she was doing.\Even though she is only a child who was instructed by a witch,\What should we do?\Hmm...\Hmm...?\I don't know, so let it be!\Assemble, Death Scythes!\Preventing Papa's Reassignment?! response:	Wait. What are you doing?
context: Even though she is only a child who was instructed by a witch,\What should we do?\Hmm...\Hmm...?\I don't know, so let it be!\Assemble, Death Scythes!\Preventing Papa's Reassignment?!\Wait. What are you doing? response:	It's fine.
context: What should we do?\Hmm...\Hmm...?\I don't know, so let it be!\Assemble, Death Scythes!\Preventing Papa's Reassignment?!\Wait. What are you doing?\It's fine. response:	No, it's not fine!
context: Hmm...\Hmm...?\I don't know, so let it be!\Assemble, Death Scythes!\Preventing Papa's Reassignment?!\Wait. What are you doing?\It's fine.\No, it's not fine! response:	Didn't Shinigami-sama tell us to restrain ourselves to allow our wounds to heal?
context: Hmm...?\I don't know, so let it be!\Assemble, Death Scythes!\Preventing Papa's Reassignment?!\Wait. What are you doing?\It's fine.\No, it's not fine!\Didn't Shinigami-sama tell us to restrain ourselves to allow our wounds to heal? response:	You know... If you always choose to stay home,
context: I don't know, so let it be!\Assemble, Death Scythes!\Preventing Papa's Reassignment?!\Wait. What are you doing?\It's fine.\No, it's not fine!\Didn't Shinigami-sama tell us to restrain ourselves to allow our wounds to heal?\You know... If you always choose to stay home, response:	No, they won't!
context: Assemble, Death Scythes!\Preventing Papa's Reassignment?!\Wait. What are you doing?\It's fine.\No, it's not fine!\Didn't Shinigami-sama tell us to restrain ourselves to allow our wounds to heal?\You know... If you always choose to stay home,\No, they won't! response:	It's okay, so let's go.
context: Preventing Papa's Reassignment?!\Wait. What are you doing?\It's fine.\No, it's not fine!\Didn't Shinigami-sama tell us to restrain ourselves to allow our wounds to heal?\You know... If you always choose to stay home,\No, they won't!\It's okay, so let's go. response:	Go where?
context: Wait. What are you doing?\It's fine.\No, it's not fine!\Didn't Shinigami-sama tell us to restrain ourselves to allow our wounds to heal?\You know... If you always choose to stay home,\No, they won't!\It's okay, so let's go.\Go where? response:	To place that will be a change of pace.
context: It's fine.\No, it's not fine!\Didn't Shinigami-sama tell us to restrain ourselves to allow our wounds to heal?\You know... If you always choose to stay home,\No, they won't!\It's okay, so let's go.\Go where?\To place that will be a change of pace. response:	Huh?
context: No, it's not fine!\Didn't Shinigami-sama tell us to restrain ourselves to allow our wounds to heal?\You know... If you always choose to stay home,\No, they won't!\It's okay, so let's go.\Go where?\To place that will be a change of pace.\Huh? response:	Yo!
context: Didn't Shinigami-sama tell us to restrain ourselves to allow our wounds to heal?\You know... If you always choose to stay home,\No, they won't!\It's okay, so let's go.\Go where?\To place that will be a change of pace.\Huh?\Yo! response:	So, Sid-kun,
context: You know... If you always choose to stay home,\No, they won't!\It's okay, so let's go.\Go where?\To place that will be a change of pace.\Huh?\Yo!\So, Sid-kun, response:	Yes.
context: No, they won't!\It's okay, so let's go.\Go where?\To place that will be a change of pace.\Huh?\Yo!\So, Sid-kun,\Yes. response:	Justin seems to have just arrived.
context: It's okay, so let's go.\Go where?\To place that will be a change of pace.\Huh?\Yo!\So, Sid-kun,\Yes.\Justin seems to have just arrived. response:	With him, and the two that arrived earlier, that makes four of them.
context: Go where?\To place that will be a change of pace.\Huh?\Yo!\So, Sid-kun,\Yes.\Justin seems to have just arrived.\With him, and the two that arrived earlier, that makes four of them. response:	So, then... what happened to the other four?
context: To place that will be a change of pace.\Huh?\Yo!\So, Sid-kun,\Yes.\Justin seems to have just arrived.\With him, and the two that arrived earlier, that makes four of them.\So, then... what happened to the other four? response:	So, then... what happened to the other four?
context: Huh?\Yo!\So, Sid-kun,\Yes.\Justin seems to have just arrived.\With him, and the two that arrived earlier, that makes four of them.\So, then... what happened to the other four?\So, then... what happened to the other four? response:	The representatives in Europe and in West Asia are on missions, so they couldn't come.
context: Yo!\So, Sid-kun,\Yes.\Justin seems to have just arrived.\With him, and the two that arrived earlier, that makes four of them.\So, then... what happened to the other four?\So, then... what happened to the other four?\The representatives in Europe and in West Asia are on missions, so they couldn't come. response:	That's tough...
context: So, Sid-kun,\Yes.\Justin seems to have just arrived.\With him, and the two that arrived earlier, that makes four of them.\So, then... what happened to the other four?\So, then... what happened to the other four?\The representatives in Europe and in West Asia are on missions, so they couldn't come.\That's tough... response:	What about South America's representative, then?
context: Yes.\Justin seems to have just arrived.\With him, and the two that arrived earlier, that makes four of them.\So, then... what happened to the other four?\So, then... what happened to the other four?\The representatives in Europe and in West Asia are on missions, so they couldn't come.\That's tough...\What about South America's representative, then? response:	Sounds like a barking dog, so we can't communicate with words.
context: Justin seems to have just arrived.\With him, and the two that arrived earlier, that makes four of them.\So, then... what happened to the other four?\So, then... what happened to the other four?\The representatives in Europe and in West Asia are on missions, so they couldn't come.\That's tough...\What about South America's representative, then?\Sounds like a barking dog, so we can't communicate with words. response:	And Africa?
context: With him, and the two that arrived earlier, that makes four of them.\So, then... what happened to the other four?\So, then... what happened to the other four?\The representatives in Europe and in West Asia are on missions, so they couldn't come.\That's tough...\What about South America's representative, then?\Sounds like a barking dog, so we can't communicate with words.\And Africa? response:	Blocked our contacts.
context: So, then... what happened to the other four?\So, then... what happened to the other four?\The representatives in Europe and in West Asia are on missions, so they couldn't come.\That's tough...\What about South America's representative, then?\Sounds like a barking dog, so we can't communicate with words.\And Africa?\Blocked our contacts. response:	Well, at least half of them assembled, isn't that great?
context: So, then... what happened to the other four?\The representatives in Europe and in West Asia are on missions, so they couldn't come.\That's tough...\What about South America's representative, then?\Sounds like a barking dog, so we can't communicate with words.\And Africa?\Blocked our contacts.\Well, at least half of them assembled, isn't that great? response:	No more...
context: The representatives in Europe and in West Asia are on missions, so they couldn't come.\That's tough...\What about South America's representative, then?\Sounds like a barking dog, so we can't communicate with words.\And Africa?\Blocked our contacts.\Well, at least half of them assembled, isn't that great?\No more... response:	I hate this! Hate it!
context: That's tough...\What about South America's representative, then?\Sounds like a barking dog, so we can't communicate with words.\And Africa?\Blocked our contacts.\Well, at least half of them assembled, isn't that great?\No more...\I hate this! Hate it! response:	What's wrong?
context: What about South America's representative, then?\Sounds like a barking dog, so we can't communicate with words.\And Africa?\Blocked our contacts.\Well, at least half of them assembled, isn't that great?\No more...\I hate this! Hate it!\What's wrong? response:	Right now, I shouldn't be here...
context: Sounds like a barking dog, so we can't communicate with words.\And Africa?\Blocked our contacts.\Well, at least half of them assembled, isn't that great?\No more...\I hate this! Hate it!\What's wrong?\Right now, I shouldn't be here... response:	I can't stay in a place like this.
context: And Africa?\Blocked our contacts.\Well, at least half of them assembled, isn't that great?\No more...\I hate this! Hate it!\What's wrong?\Right now, I shouldn't be here...\I can't stay in a place like this. response:	What are you saying?
context: Blocked our contacts.\Well, at least half of them assembled, isn't that great?\No more...\I hate this! Hate it!\What's wrong?\Right now, I shouldn't be here...\I can't stay in a place like this.\What are you saying? response:	The Kishin resurrected, you know.
context: Well, at least half of them assembled, isn't that great?\No more...\I hate this! Hate it!\What's wrong?\Right now, I shouldn't be here...\I can't stay in a place like this.\What are you saying?\The Kishin resurrected, you know. response:	Can there be anything more important?
context: No more...\I hate this! Hate it!\What's wrong?\Right now, I shouldn't be here...\I can't stay in a place like this.\What are you saying?\The Kishin resurrected, you know.\Can there be anything more important? response:	Azusa, you're still young, so you wouldn't understand.
context: I hate this! Hate it!\What's wrong?\Right now, I shouldn't be here...\I can't stay in a place like this.\What are you saying?\The Kishin resurrected, you know.\Can there be anything more important?\Azusa, you're still young, so you wouldn't understand. response:	I wanted to marry and immediately retire, but I'm still single.
context: What's wrong?\Right now, I shouldn't be here...\I can't stay in a place like this.\What are you saying?\The Kishin resurrected, you know.\Can there be anything more important?\Azusa, you're still young, so you wouldn't understand.\I wanted to marry and immediately retire, but I'm still single. response:	Don't you think that's strange?
context: Right now, I shouldn't be here...\I can't stay in a place like this.\What are you saying?\The Kishin resurrected, you know.\Can there be anything more important?\Azusa, you're still young, so you wouldn't understand.\I wanted to marry and immediately retire, but I'm still single.\Don't you think that's strange? response:	I think you're great.
context: I can't stay in a place like this.\What are you saying?\The Kishin resurrected, you know.\Can there be anything more important?\Azusa, you're still young, so you wouldn't understand.\I wanted to marry and immediately retire, but I'm still single.\Don't you think that's strange?\I think you're great. response:	I completely commit myself to them, but, in the end, we always break up.
context: What are you saying?\The Kishin resurrected, you know.\Can there be anything more important?\Azusa, you're still young, so you wouldn't understand.\I wanted to marry and immediately retire, but I'm still single.\Don't you think that's strange?\I think you're great.\I completely commit myself to them, but, in the end, we always break up. response:	When men think of commitment, they feel pressured and want to run away.
context: The Kishin resurrected, you know.\Can there be anything more important?\Azusa, you're still young, so you wouldn't understand.\I wanted to marry and immediately retire, but I'm still single.\Don't you think that's strange?\I think you're great.\I completely commit myself to them, but, in the end, we always break up.\When men think of commitment, they feel pressured and want to run away. response:	You don't understand the power of love!
context: Can there be anything more important?\Azusa, you're still young, so you wouldn't understand.\I wanted to marry and immediately retire, but I'm still single.\Don't you think that's strange?\I think you're great.\I completely commit myself to them, but, in the end, we always break up.\When men think of commitment, they feel pressured and want to run away.\You don't understand the power of love! response:	Marie-senpai, you don't understand the power of your punches.
context: Azusa, you're still young, so you wouldn't understand.\I wanted to marry and immediately retire, but I'm still single.\Don't you think that's strange?\I think you're great.\I completely commit myself to them, but, in the end, we always break up.\When men think of commitment, they feel pressured and want to run away.\You don't understand the power of love!\Marie-senpai, you don't understand the power of your punches. response:	S-Sorry...
context: I wanted to marry and immediately retire, but I'm still single.\Don't you think that's strange?\I think you're great.\I completely commit myself to them, but, in the end, we always break up.\When men think of commitment, they feel pressured and want to run away.\You don't understand the power of love!\Marie-senpai, you don't understand the power of your punches.\S-Sorry... response:	In any case, the idea that marriage is a woman's happiness is outdated.
context: Don't you think that's strange?\I think you're great.\I completely commit myself to them, but, in the end, we always break up.\When men think of commitment, they feel pressured and want to run away.\You don't understand the power of love!\Marie-senpai, you don't understand the power of your punches.\S-Sorry...\In any case, the idea that marriage is a woman's happiness is outdated. response:	What is it?
context: I think you're great.\I completely commit myself to them, but, in the end, we always break up.\When men think of commitment, they feel pressured and want to run away.\You don't understand the power of love!\Marie-senpai, you don't understand the power of your punches.\S-Sorry...\In any case, the idea that marriage is a woman's happiness is outdated.\What is it? response:	I'm... going to marry the toilet.
context: I completely commit myself to them, but, in the end, we always break up.\When men think of commitment, they feel pressured and want to run away.\You don't understand the power of love!\Marie-senpai, you don't understand the power of your punches.\S-Sorry...\In any case, the idea that marriage is a woman's happiness is outdated.\What is it?\I'm... going to marry the toilet. response:	I'm... going to marry the toilet.
context: When men think of commitment, they feel pressured and want to run away.\You don't understand the power of love!\Marie-senpai, you don't understand the power of your punches.\S-Sorry...\In any case, the idea that marriage is a woman's happiness is outdated.\What is it?\I'm... going to marry the toilet.\I'm... going to marry the toilet. response:	Don't you see? The toilet will accept anything I do!
context: You don't understand the power of love!\Marie-senpai, you don't understand the power of your punches.\S-Sorry...\In any case, the idea that marriage is a woman's happiness is outdated.\What is it?\I'm... going to marry the toilet.\I'm... going to marry the toilet.\Don't you see? The toilet will accept anything I do! response:	It's my ideal companion!
context: Marie-senpai, you don't understand the power of your punches.\S-Sorry...\In any case, the idea that marriage is a woman's happiness is outdated.\What is it?\I'm... going to marry the toilet.\I'm... going to marry the toilet.\Don't you see? The toilet will accept anything I do!\It's my ideal companion! response:	I know it's a women's toilet, but doesn't it annoy you that the seat is up?
context: S-Sorry...\In any case, the idea that marriage is a woman's happiness is outdated.\What is it?\I'm... going to marry the toilet.\I'm... going to marry the toilet.\Don't you see? The toilet will accept anything I do!\It's my ideal companion!\I know it's a women's toilet, but doesn't it annoy you that the seat is up? response:	I can deal with something like that.
context: In any case, the idea that marriage is a woman's happiness is outdated.\What is it?\I'm... going to marry the toilet.\I'm... going to marry the toilet.\Don't you see? The toilet will accept anything I do!\It's my ideal companion!\I know it's a women's toilet, but doesn't it annoy you that the seat is up?\I can deal with something like that. response:	Not good. If I don't stop Marie-san...!
context: What is it?\I'm... going to marry the toilet.\I'm... going to marry the toilet.\Don't you see? The toilet will accept anything I do!\It's my ideal companion!\I know it's a women's toilet, but doesn't it annoy you that the seat is up?\I can deal with something like that.\Not good. If I don't stop Marie-san...! response:	T-There will be times when even it won't handle the pressure and won't be able to breathe.
context: I'm... going to marry the toilet.\I'm... going to marry the toilet.\Don't you see? The toilet will accept anything I do!\It's my ideal companion!\I know it's a women's toilet, but doesn't it annoy you that the seat is up?\I can deal with something like that.\Not good. If I don't stop Marie-san...!\T-There will be times when even it won't handle the pressure and won't be able to breathe. response:	It might hide from you, Marie-san, and even leak behind your back.
context: I'm... going to marry the toilet.\Don't you see? The toilet will accept anything I do!\It's my ideal companion!\I know it's a women's toilet, but doesn't it annoy you that the seat is up?\I can deal with something like that.\Not good. If I don't stop Marie-san...!\T-There will be times when even it won't handle the pressure and won't be able to breathe.\It might hide from you, Marie-san, and even leak behind your back. response:	H-How indecent.
context: Don't you see? The toilet will accept anything I do!\It's my ideal companion!\I know it's a women's toilet, but doesn't it annoy you that the seat is up?\I can deal with something like that.\Not good. If I don't stop Marie-san...!\T-There will be times when even it won't handle the pressure and won't be able to breathe.\It might hide from you, Marie-san, and even leak behind your back.\H-How indecent. response:	Unforgivable.
context: It's my ideal companion!\I know it's a women's toilet, but doesn't it annoy you that the seat is up?\I can deal with something like that.\Not good. If I don't stop Marie-san...!\T-There will be times when even it won't handle the pressure and won't be able to breathe.\It might hide from you, Marie-san, and even leak behind your back.\H-How indecent.\Unforgivable. response:	You cheating bastard!
context: I know it's a women's toilet, but doesn't it annoy you that the seat is up?\I can deal with something like that.\Not good. If I don't stop Marie-san...!\T-There will be times when even it won't handle the pressure and won't be able to breathe.\It might hide from you, Marie-san, and even leak behind your back.\H-How indecent.\Unforgivable.\You cheating bastard! response:	Anyway, let's go to where Shinigami-sama is.
context: I can deal with something like that.\Not good. If I don't stop Marie-san...!\T-There will be times when even it won't handle the pressure and won't be able to breathe.\It might hide from you, Marie-san, and even leak behind your back.\H-How indecent.\Unforgivable.\You cheating bastard!\Anyway, let's go to where Shinigami-sama is. response:	As expected of the Crushing Weapon...
context: Not good. If I don't stop Marie-san...!\T-There will be times when even it won't handle the pressure and won't be able to breathe.\It might hide from you, Marie-san, and even leak behind your back.\H-How indecent.\Unforgivable.\You cheating bastard!\Anyway, let's go to where Shinigami-sama is.\As expected of the Crushing Weapon... response:	You're still very capable.
context: T-There will be times when even it won't handle the pressure and won't be able to breathe.\It might hide from you, Marie-san, and even leak behind your back.\H-How indecent.\Unforgivable.\You cheating bastard!\Anyway, let's go to where Shinigami-sama is.\As expected of the Crushing Weapon...\You're still very capable. response:	Want something?
context: It might hide from you, Marie-san, and even leak behind your back.\H-How indecent.\Unforgivable.\You cheating bastard!\Anyway, let's go to where Shinigami-sama is.\As expected of the Crushing Weapon...\You're still very capable.\Want something? response:	Yeah... We have to go to where Shinigami-sama is.
context: H-How indecent.\Unforgivable.\You cheating bastard!\Anyway, let's go to where Shinigami-sama is.\As expected of the Crushing Weapon...\You're still very capable.\Want something?\Yeah... We have to go to where Shinigami-sama is. response:	I'm not going.
context: Unforgivable.\You cheating bastard!\Anyway, let's go to where Shinigami-sama is.\As expected of the Crushing Weapon...\You're still very capable.\Want something?\Yeah... We have to go to where Shinigami-sama is.\I'm not going. response:	Why not?
context: You cheating bastard!\Anyway, let's go to where Shinigami-sama is.\As expected of the Crushing Weapon...\You're still very capable.\Want something?\Yeah... We have to go to where Shinigami-sama is.\I'm not going.\Why not? response:	Say, Stein,
context: Anyway, let's go to where Shinigami-sama is.\As expected of the Crushing Weapon...\You're still very capable.\Want something?\Yeah... We have to go to where Shinigami-sama is.\I'm not going.\Why not?\Say, Stein, response:	Since the Kishin was revived, he probably wants to plan some counter-measures.
context: As expected of the Crushing Weapon...\You're still very capable.\Want something?\Yeah... We have to go to where Shinigami-sama is.\I'm not going.\Why not?\Say, Stein,\Since the Kishin was revived, he probably wants to plan some counter-measures. response:	No, you're wrong. He definitely wants to relocate me.
context: You're still very capable.\Want something?\Yeah... We have to go to where Shinigami-sama is.\I'm not going.\Why not?\Say, Stein,\Since the Kishin was revived, he probably wants to plan some counter-measures.\No, you're wrong. He definitely wants to relocate me. response:	It's a demotion, a demotion!
context: Want something?\Yeah... We have to go to where Shinigami-sama is.\I'm not going.\Why not?\Say, Stein,\Since the Kishin was revived, he probably wants to plan some counter-measures.\No, you're wrong. He definitely wants to relocate me.\It's a demotion, a demotion! response:	You think so?
context: Yeah... We have to go to where Shinigami-sama is.\I'm not going.\Why not?\Say, Stein,\Since the Kishin was revived, he probably wants to plan some counter-measures.\No, you're wrong. He definitely wants to relocate me.\It's a demotion, a demotion!\You think so? response:	Don't you think so, too?
context: I'm not going.\Why not?\Say, Stein,\Since the Kishin was revived, he probably wants to plan some counter-measures.\No, you're wrong. He definitely wants to relocate me.\It's a demotion, a demotion!\You think so?\Don't you think so, too? response:	If I didn't leave Shinigami's side, he could have used me to stop the Kishin!
context: Why not?\Say, Stein,\Since the Kishin was revived, he probably wants to plan some counter-measures.\No, you're wrong. He definitely wants to relocate me.\It's a demotion, a demotion!\You think so?\Don't you think so, too?\If I didn't leave Shinigami's side, he could have used me to stop the Kishin! response:	So, you're trying to score some points by polishing the candle stands?
context: Say, Stein,\Since the Kishin was revived, he probably wants to plan some counter-measures.\No, you're wrong. He definitely wants to relocate me.\It's a demotion, a demotion!\You think so?\Don't you think so, too?\If I didn't leave Shinigami's side, he could have used me to stop the Kishin!\So, you're trying to score some points by polishing the candle stands? response:	Something wrong with that?
context: Since the Kishin was revived, he probably wants to plan some counter-measures.\No, you're wrong. He definitely wants to relocate me.\It's a demotion, a demotion!\You think so?\Don't you think so, too?\If I didn't leave Shinigami's side, he could have used me to stop the Kishin!\So, you're trying to score some points by polishing the candle stands?\Something wrong with that? response:	You're an idiot...
context: No, you're wrong. He definitely wants to relocate me.\It's a demotion, a demotion!\You think so?\Don't you think so, too?\If I didn't leave Shinigami's side, he could have used me to stop the Kishin!\So, you're trying to score some points by polishing the candle stands?\Something wrong with that?\You're an idiot... response:	So what if I'm desperate?
context: It's a demotion, a demotion!\You think so?\Don't you think so, too?\If I didn't leave Shinigami's side, he could have used me to stop the Kishin!\So, you're trying to score some points by polishing the candle stands?\Something wrong with that?\You're an idiot...\So what if I'm desperate? response:	My ex-wife already has Maka's acknowledgment.
context: You think so?\Don't you think so, too?\If I didn't leave Shinigami's side, he could have used me to stop the Kishin!\So, you're trying to score some points by polishing the candle stands?\Something wrong with that?\You're an idiot...\So what if I'm desperate?\My ex-wife already has Maka's acknowledgment. response:	If the distance between us gets any bigger, she won't feel like Papa exists at all!
context: Don't you think so, too?\If I didn't leave Shinigami's side, he could have used me to stop the Kishin!\So, you're trying to score some points by polishing the candle stands?\Something wrong with that?\You're an idiot...\So what if I'm desperate?\My ex-wife already has Maka's acknowledgment.\If the distance between us gets any bigger, she won't feel like Papa exists at all! response:	She already feels that way.
context: If I didn't leave Shinigami's side, he could have used me to stop the Kishin!\So, you're trying to score some points by polishing the candle stands?\Something wrong with that?\You're an idiot...\So what if I'm desperate?\My ex-wife already has Maka's acknowledgment.\If the distance between us gets any bigger, she won't feel like Papa exists at all!\She already feels that way. response:	You must be desperate since you rolled up your tuxedo sleeves.
context: So, you're trying to score some points by polishing the candle stands?\Something wrong with that?\You're an idiot...\So what if I'm desperate?\My ex-wife already has Maka's acknowledgment.\If the distance between us gets any bigger, she won't feel like Papa exists at all!\She already feels that way.\You must be desperate since you rolled up your tuxedo sleeves. response:	That's right!
context: Something wrong with that?\You're an idiot...\So what if I'm desperate?\My ex-wife already has Maka's acknowledgment.\If the distance between us gets any bigger, she won't feel like Papa exists at all!\She already feels that way.\You must be desperate since you rolled up your tuxedo sleeves.\That's right! response:	I'm going to roll them up even further by 10 cm.
context: You're an idiot...\So what if I'm desperate?\My ex-wife already has Maka's acknowledgment.\If the distance between us gets any bigger, she won't feel like Papa exists at all!\She already feels that way.\You must be desperate since you rolled up your tuxedo sleeves.\That's right!\I'm going to roll them up even further by 10 cm. response:	Oh.
context: So what if I'm desperate?\My ex-wife already has Maka's acknowledgment.\If the distance between us gets any bigger, she won't feel like Papa exists at all!\She already feels that way.\You must be desperate since you rolled up your tuxedo sleeves.\That's right!\I'm going to roll them up even further by 10 cm.\Oh. response:	It's Stein-san. Marie-san's first love.
context: My ex-wife already has Maka's acknowledgment.\If the distance between us gets any bigger, she won't feel like Papa exists at all!\She already feels that way.\You must be desperate since you rolled up your tuxedo sleeves.\That's right!\I'm going to roll them up even further by 10 cm.\Oh.\It's Stein-san. Marie-san's first love. response:	That was a long time ago.
context: If the distance between us gets any bigger, she won't feel like Papa exists at all!\She already feels that way.\You must be desperate since you rolled up your tuxedo sleeves.\That's right!\I'm going to roll them up even further by 10 cm.\Oh.\It's Stein-san. Marie-san's first love.\That was a long time ago. response:	Huh?
context: She already feels that way.\You must be desperate since you rolled up your tuxedo sleeves.\That's right!\I'm going to roll them up even further by 10 cm.\Oh.\It's Stein-san. Marie-san's first love.\That was a long time ago.\Huh? response:	It's been a while!
context: You must be desperate since you rolled up your tuxedo sleeves.\That's right!\I'm going to roll them up even further by 10 cm.\Oh.\It's Stein-san. Marie-san's first love.\That was a long time ago.\Huh?\It's been a while! response:	Good afternoon.
context: That's right!\I'm going to roll them up even further by 10 cm.\Oh.\It's Stein-san. Marie-san's first love.\That was a long time ago.\Huh?\It's been a while!\Good afternoon. response:	Oh...!
context: I'm going to roll them up even further by 10 cm.\Oh.\It's Stein-san. Marie-san's first love.\That was a long time ago.\Huh?\It's been a while!\Good afternoon.\Oh...! response:	She came!
context: Oh.\It's Stein-san. Marie-san's first love.\That was a long time ago.\Huh?\It's been a while!\Good afternoon.\Oh...!\She came! response:	The King of Counsel Chairmen!
context: It's Stein-san. Marie-san's first love.\That was a long time ago.\Huh?\It's been a while!\Good afternoon.\Oh...!\She came!\The King of Counsel Chairmen! response:	She was pretty annoying back then, huh?
context: That was a long time ago.\Huh?\It's been a while!\Good afternoon.\Oh...!\She came!\The King of Counsel Chairmen!\She was pretty annoying back then, huh? response:	Every time I wanted to cut up a random passerby, she would fuss about it.
context: Huh?\It's been a while!\Good afternoon.\Oh...!\She came!\The King of Counsel Chairmen!\She was pretty annoying back then, huh?\Every time I wanted to cut up a random passerby, she would fuss about it. response:	Well, she should have.
context: It's been a while!\Good afternoon.\Oh...!\She came!\The King of Counsel Chairmen!\She was pretty annoying back then, huh?\Every time I wanted to cut up a random passerby, she would fuss about it.\Well, she should have. response:	Isn't the Kishin's resurrection your fault, Senpai?
context: Good afternoon.\Oh...!\She came!\The King of Counsel Chairmen!\She was pretty annoying back then, huh?\Every time I wanted to cut up a random passerby, she would fuss about it.\Well, she should have.\Isn't the Kishin's resurrection your fault, Senpai? response:	N-No, stop that! Don't say that in front of Shinigami-sama!
context: Oh...!\She came!\The King of Counsel Chairmen!\She was pretty annoying back then, huh?\Every time I wanted to cut up a random passerby, she would fuss about it.\Well, she should have.\Isn't the Kishin's resurrection your fault, Senpai?\N-No, stop that! Don't say that in front of Shinigami-sama! response:	What do you think?
context: She came!\The King of Counsel Chairmen!\She was pretty annoying back then, huh?\Every time I wanted to cut up a random passerby, she would fuss about it.\Well, she should have.\Isn't the Kishin's resurrection your fault, Senpai?\N-No, stop that! Don't say that in front of Shinigami-sama!\What do you think? response:	I'll just honestly say what I think is true.
context: The King of Counsel Chairmen!\She was pretty annoying back then, huh?\Every time I wanted to cut up a random passerby, she would fuss about it.\Well, she should have.\Isn't the Kishin's resurrection your fault, Senpai?\N-No, stop that! Don't say that in front of Shinigami-sama!\What do you think?\I'll just honestly say what I think is true. response:	Oh yeah, Marie.
context: She was pretty annoying back then, huh?\Every time I wanted to cut up a random passerby, she would fuss about it.\Well, she should have.\Isn't the Kishin's resurrection your fault, Senpai?\N-No, stop that! Don't say that in front of Shinigami-sama!\What do you think?\I'll just honestly say what I think is true.\Oh yeah, Marie. response:	Didn't you say you would immediately retire after becoming a Death Scythe?
context: Every time I wanted to cut up a random passerby, she would fuss about it.\Well, she should have.\Isn't the Kishin's resurrection your fault, Senpai?\N-No, stop that! Don't say that in front of Shinigami-sama!\What do you think?\I'll just honestly say what I think is true.\Oh yeah, Marie.\Didn't you say you would immediately retire after becoming a Death Scythe? response:	Please, stop saying that...
context: Well, she should have.\Isn't the Kishin's resurrection your fault, Senpai?\N-No, stop that! Don't say that in front of Shinigami-sama!\What do you think?\I'll just honestly say what I think is true.\Oh yeah, Marie.\Didn't you say you would immediately retire after becoming a Death Scythe?\Please, stop saying that... response:	Okay!
context: Isn't the Kishin's resurrection your fault, Senpai?\N-No, stop that! Don't say that in front of Shinigami-sama!\What do you think?\I'll just honestly say what I think is true.\Oh yeah, Marie.\Didn't you say you would immediately retire after becoming a Death Scythe?\Please, stop saying that...\Okay! response:	Stop murmuring amongst yourselves. Shinigami-sama's waiting for us.
context: N-No, stop that! Don't say that in front of Shinigami-sama!\What do you think?\I'll just honestly say what I think is true.\Oh yeah, Marie.\Didn't you say you would immediately retire after becoming a Death Scythe?\Please, stop saying that...\Okay!\Stop murmuring amongst yourselves. Shinigami-sama's waiting for us. response:	Line up!
context: What do you think?\I'll just honestly say what I think is true.\Oh yeah, Marie.\Didn't you say you would immediately retire after becoming a Death Scythe?\Please, stop saying that...\Okay!\Stop murmuring amongst yourselves. Shinigami-sama's waiting for us.\Line up! response:	Face forward!
context: I'll just honestly say what I think is true.\Oh yeah, Marie.\Didn't you say you would immediately retire after becoming a Death Scythe?\Please, stop saying that...\Okay!\Stop murmuring amongst yourselves. Shinigami-sama's waiting for us.\Line up!\Face forward! response:	She's still the same...
context: Oh yeah, Marie.\Didn't you say you would immediately retire after becoming a Death Scythe?\Please, stop saying that...\Okay!\Stop murmuring amongst yourselves. Shinigami-sama's waiting for us.\Line up!\Face forward!\She's still the same... response:	Oh! God!
context: Didn't you say you would immediately retire after becoming a Death Scythe?\Please, stop saying that...\Okay!\Stop murmuring amongst yourselves. Shinigami-sama's waiting for us.\Line up!\Face forward!\She's still the same...\Oh! God! response:	Why won't you say anything to me?
context: Please, stop saying that...\Okay!\Stop murmuring amongst yourselves. Shinigami-sama's waiting for us.\Line up!\Face forward!\She's still the same...\Oh! God!\Why won't you say anything to me? response:	Well...
context: Okay!\Stop murmuring amongst yourselves. Shinigami-sama's waiting for us.\Line up!\Face forward!\She's still the same...\Oh! God!\Why won't you say anything to me?\Well... response:	Ah... How can this be?
context: Stop murmuring amongst yourselves. Shinigami-sama's waiting for us.\Line up!\Face forward!\She's still the same...\Oh! God!\Why won't you say anything to me?\Well...\Ah... How can this be? response:	I can't hear your voice!
context: Line up!\Face forward!\She's still the same...\Oh! God!\Why won't you say anything to me?\Well...\Ah... How can this be?\I can't hear your voice! response:	No... that's because...
context: Face forward!\She's still the same...\Oh! God!\Why won't you say anything to me?\Well...\Ah... How can this be?\I can't hear your voice!\No... that's because... response:	No... that's because...
context: She's still the same...\Oh! God!\Why won't you say anything to me?\Well...\Ah... How can this be?\I can't hear your voice!\No... that's because...\No... that's because... response:	Take your earphones off!
context: Oh! God!\Why won't you say anything to me?\Well...\Ah... How can this be?\I can't hear your voice!\No... that's because...\No... that's because...\Take your earphones off! response:	It's been a long time.
context: Why won't you say anything to me?\Well...\Ah... How can this be?\I can't hear your voice!\No... that's because...\No... that's because...\Take your earphones off!\It's been a long time. response:	I, Justin, am in your command.
context: Well...\Ah... How can this be?\I can't hear your voice!\No... that's because...\No... that's because...\Take your earphones off!\It's been a long time.\I, Justin, am in your command. response:	Hello! And thank you for journeying all the way here!
context: Ah... How can this be?\I can't hear your voice!\No... that's because...\No... that's because...\Take your earphones off!\It's been a long time.\I, Justin, am in your command.\Hello! And thank you for journeying all the way here! response:	Well, I think everyone knows the reason why I gathered you all in Shibusen.
context: I can't hear your voice!\No... that's because...\No... that's because...\Take your earphones off!\It's been a long time.\I, Justin, am in your command.\Hello! And thank you for journeying all the way here!\Well, I think everyone knows the reason why I gathered you all in Shibusen. response:	Don't transfer me! Don't transfer me!
context: No... that's because...\No... that's because...\Take your earphones off!\It's been a long time.\I, Justin, am in your command.\Hello! And thank you for journeying all the way here!\Well, I think everyone knows the reason why I gathered you all in Shibusen.\Don't transfer me! Don't transfer me! response:	Don't transfer me! Don't transfer me!
context: No... that's because...\Take your earphones off!\It's been a long time.\I, Justin, am in your command.\Hello! And thank you for journeying all the way here!\Well, I think everyone knows the reason why I gathered you all in Shibusen.\Don't transfer me! Don't transfer me!\Don't transfer me! Don't transfer me! response:	The Kishin Asura's resurrection.
context: Take your earphones off!\It's been a long time.\I, Justin, am in your command.\Hello! And thank you for journeying all the way here!\Well, I think everyone knows the reason why I gathered you all in Shibusen.\Don't transfer me! Don't transfer me!\Don't transfer me! Don't transfer me!\The Kishin Asura's resurrection. response:	We need to have a discussion on this.
context: It's been a long time.\I, Justin, am in your command.\Hello! And thank you for journeying all the way here!\Well, I think everyone knows the reason why I gathered you all in Shibusen.\Don't transfer me! Don't transfer me!\Don't transfer me! Don't transfer me!\The Kishin Asura's resurrection.\We need to have a discussion on this. response:	Even though Asura is completely insane, he's still a coward, so I don't think he will be active for a while.
context: I, Justin, am in your command.\Hello! And thank you for journeying all the way here!\Well, I think everyone knows the reason why I gathered you all in Shibusen.\Don't transfer me! Don't transfer me!\Don't transfer me! Don't transfer me!\The Kishin Asura's resurrection.\We need to have a discussion on this.\Even though Asura is completely insane, he's still a coward, so I don't think he will be active for a while. response:	So, the urgent matter is not to track Asura's movements,
context: Hello! And thank you for journeying all the way here!\Well, I think everyone knows the reason why I gathered you all in Shibusen.\Don't transfer me! Don't transfer me!\Don't transfer me! Don't transfer me!\The Kishin Asura's resurrection.\We need to have a discussion on this.\Even though Asura is completely insane, he's still a coward, so I don't think he will be active for a while.\So, the urgent matter is not to track Asura's movements, response:	Stein-kun, please explain the circumstances.
context: Well, I think everyone knows the reason why I gathered you all in Shibusen.\Don't transfer me! Don't transfer me!\Don't transfer me! Don't transfer me!\The Kishin Asura's resurrection.\We need to have a discussion on this.\Even though Asura is completely insane, he's still a coward, so I don't think he will be active for a while.\So, the urgent matter is not to track Asura's movements,\Stein-kun, please explain the circumstances. response:	Yes.
context: Don't transfer me! Don't transfer me!\Don't transfer me! Don't transfer me!\The Kishin Asura's resurrection.\We need to have a discussion on this.\Even though Asura is completely insane, he's still a coward, so I don't think he will be active for a while.\So, the urgent matter is not to track Asura's movements,\Stein-kun, please explain the circumstances.\Yes. response:	The Wavelength of Madness... Is it right to think of it as Asura's soul wavelength?
context: Don't transfer me! Don't transfer me!\The Kishin Asura's resurrection.\We need to have a discussion on this.\Even though Asura is completely insane, he's still a coward, so I don't think he will be active for a while.\So, the urgent matter is not to track Asura's movements,\Stein-kun, please explain the circumstances.\Yes.\The Wavelength of Madness... Is it right to think of it as Asura's soul wavelength? response:	Yes, that's right. But this wavelength is on the level of a god.
context: The Kishin Asura's resurrection.\We need to have a discussion on this.\Even though Asura is completely insane, he's still a coward, so I don't think he will be active for a while.\So, the urgent matter is not to track Asura's movements,\Stein-kun, please explain the circumstances.\Yes.\The Wavelength of Madness... Is it right to think of it as Asura's soul wavelength?\Yes, that's right. But this wavelength is on the level of a god. response:	What effect does this Wavelength of Madness have?
context: We need to have a discussion on this.\Even though Asura is completely insane, he's still a coward, so I don't think he will be active for a while.\So, the urgent matter is not to track Asura's movements,\Stein-kun, please explain the circumstances.\Yes.\The Wavelength of Madness... Is it right to think of it as Asura's soul wavelength?\Yes, that's right. But this wavelength is on the level of a god.\What effect does this Wavelength of Madness have? response:	Every human has a bit of madness within himself.
context: Even though Asura is completely insane, he's still a coward, so I don't think he will be active for a while.\So, the urgent matter is not to track Asura's movements,\Stein-kun, please explain the circumstances.\Yes.\The Wavelength of Madness... Is it right to think of it as Asura's soul wavelength?\Yes, that's right. But this wavelength is on the level of a god.\What effect does this Wavelength of Madness have?\Every human has a bit of madness within himself. response:	Especially me...
context: So, the urgent matter is not to track Asura's movements,\Stein-kun, please explain the circumstances.\Yes.\The Wavelength of Madness... Is it right to think of it as Asura's soul wavelength?\Yes, that's right. But this wavelength is on the level of a god.\What effect does this Wavelength of Madness have?\Every human has a bit of madness within himself.\Especially me... response:	Asura's Wavelength of Madness forces out the madness that resides within a human's soul.
context: Stein-kun, please explain the circumstances.\Yes.\The Wavelength of Madness... Is it right to think of it as Asura's soul wavelength?\Yes, that's right. But this wavelength is on the level of a god.\What effect does this Wavelength of Madness have?\Every human has a bit of madness within himself.\Especially me...\Asura's Wavelength of Madness forces out the madness that resides within a human's soul. response:	Madness is contagious.
context: Yes.\The Wavelength of Madness... Is it right to think of it as Asura's soul wavelength?\Yes, that's right. But this wavelength is on the level of a god.\What effect does this Wavelength of Madness have?\Every human has a bit of madness within himself.\Especially me...\Asura's Wavelength of Madness forces out the madness that resides within a human's soul.\Madness is contagious. response:	This is true.
context: The Wavelength of Madness... Is it right to think of it as Asura's soul wavelength?\Yes, that's right. But this wavelength is on the level of a god.\What effect does this Wavelength of Madness have?\Every human has a bit of madness within himself.\Especially me...\Asura's Wavelength of Madness forces out the madness that resides within a human's soul.\Madness is contagious.\This is true. response:	The moment that Asura resurrected, I felt it strongly.
context: Yes, that's right. But this wavelength is on the level of a god.\What effect does this Wavelength of Madness have?\Every human has a bit of madness within himself.\Especially me...\Asura's Wavelength of Madness forces out the madness that resides within a human's soul.\Madness is contagious.\This is true.\The moment that Asura resurrected, I felt it strongly. response:	The spreading of madness.
context: What effect does this Wavelength of Madness have?\Every human has a bit of madness within himself.\Especially me...\Asura's Wavelength of Madness forces out the madness that resides within a human's soul.\Madness is contagious.\This is true.\The moment that Asura resurrected, I felt it strongly.\The spreading of madness. response:	And you're saying anyone can be affected?
context: Every human has a bit of madness within himself.\Especially me...\Asura's Wavelength of Madness forces out the madness that resides within a human's soul.\Madness is contagious.\This is true.\The moment that Asura resurrected, I felt it strongly.\The spreading of madness.\And you're saying anyone can be affected? response:	No.
context: Especially me...\Asura's Wavelength of Madness forces out the madness that resides within a human's soul.\Madness is contagious.\This is true.\The moment that Asura resurrected, I felt it strongly.\The spreading of madness.\And you're saying anyone can be affected?\No. response:	I think that people like Justin-kun have a lower chance of being affected.
context: Asura's Wavelength of Madness forces out the madness that resides within a human's soul.\Madness is contagious.\This is true.\The moment that Asura resurrected, I felt it strongly.\The spreading of madness.\And you're saying anyone can be affected?\No.\I think that people like Justin-kun have a lower chance of being affected. response:	Also, I don't think there would be an outbreak of madness among ordinary humans.
context: Madness is contagious.\This is true.\The moment that Asura resurrected, I felt it strongly.\The spreading of madness.\And you're saying anyone can be affected?\No.\I think that people like Justin-kun have a lower chance of being affected.\Also, I don't think there would be an outbreak of madness among ordinary humans. response:	Then, what's the issue?
context: This is true.\The moment that Asura resurrected, I felt it strongly.\The spreading of madness.\And you're saying anyone can be affected?\No.\I think that people like Justin-kun have a lower chance of being affected.\Also, I don't think there would be an outbreak of madness among ordinary humans.\Then, what's the issue? response:	On evil people, they will power up.
context: The moment that Asura resurrected, I felt it strongly.\The spreading of madness.\And you're saying anyone can be affected?\No.\I think that people like Justin-kun have a lower chance of being affected.\Also, I don't think there would be an outbreak of madness among ordinary humans.\Then, what's the issue?\On evil people, they will power up. response:	That's right.
context: The spreading of madness.\And you're saying anyone can be affected?\No.\I think that people like Justin-kun have a lower chance of being affected.\Also, I don't think there would be an outbreak of madness among ordinary humans.\Then, what's the issue?\On evil people, they will power up.\That's right. response:	Looking at someone in the face while saying that it's unpleasant...
context: And you're saying anyone can be affected?\No.\I think that people like Justin-kun have a lower chance of being affected.\Also, I don't think there would be an outbreak of madness among ordinary humans.\Then, what's the issue?\On evil people, they will power up.\That's right.\Looking at someone in the face while saying that it's unpleasant... response:	Makes me want to cut you up all of a sudden...
context: No.\I think that people like Justin-kun have a lower chance of being affected.\Also, I don't think there would be an outbreak of madness among ordinary humans.\Then, what's the issue?\On evil people, they will power up.\That's right.\Looking at someone in the face while saying that it's unpleasant...\Makes me want to cut you up all of a sudden... response:	And...?
context: I think that people like Justin-kun have a lower chance of being affected.\Also, I don't think there would be an outbreak of madness among ordinary humans.\Then, what's the issue?\On evil people, they will power up.\That's right.\Looking at someone in the face while saying that it's unpleasant...\Makes me want to cut you up all of a sudden...\And...? response:	The Wavelength of Madness also causes sleeping witches to awaken.
context: Also, I don't think there would be an outbreak of madness among ordinary humans.\Then, what's the issue?\On evil people, they will power up.\That's right.\Looking at someone in the face while saying that it's unpleasant...\Makes me want to cut you up all of a sudden...\And...?\The Wavelength of Madness also causes sleeping witches to awaken. response:	And it doesn't just affect people either.
context: Then, what's the issue?\On evil people, they will power up.\That's right.\Looking at someone in the face while saying that it's unpleasant...\Makes me want to cut you up all of a sudden...\And...?\The Wavelength of Madness also causes sleeping witches to awaken.\And it doesn't just affect people either. response:	Natural catastrophes, abnormal weather and any terror you can think of.
context: On evil people, they will power up.\That's right.\Looking at someone in the face while saying that it's unpleasant...\Makes me want to cut you up all of a sudden...\And...?\The Wavelength of Madness also causes sleeping witches to awaken.\And it doesn't just affect people either.\Natural catastrophes, abnormal weather and any terror you can think of. response:	So dormant enemies will start to move?
context: That's right.\Looking at someone in the face while saying that it's unpleasant...\Makes me want to cut you up all of a sudden...\And...?\The Wavelength of Madness also causes sleeping witches to awaken.\And it doesn't just affect people either.\Natural catastrophes, abnormal weather and any terror you can think of.\So dormant enemies will start to move? response:	The situation became like this because of the mistakes of these two.
context: Looking at someone in the face while saying that it's unpleasant...\Makes me want to cut you up all of a sudden...\And...?\The Wavelength of Madness also causes sleeping witches to awaken.\And it doesn't just affect people either.\Natural catastrophes, abnormal weather and any terror you can think of.\So dormant enemies will start to move?\The situation became like this because of the mistakes of these two. response:	Shinigami-sama, how do you intend to correct this?
context: Makes me want to cut you up all of a sudden...\And...?\The Wavelength of Madness also causes sleeping witches to awaken.\And it doesn't just affect people either.\Natural catastrophes, abnormal weather and any terror you can think of.\So dormant enemies will start to move?\The situation became like this because of the mistakes of these two.\Shinigami-sama, how do you intend to correct this? response:	Y-You!
context: And...?\The Wavelength of Madness also causes sleeping witches to awaken.\And it doesn't just affect people either.\Natural catastrophes, abnormal weather and any terror you can think of.\So dormant enemies will start to move?\The situation became like this because of the mistakes of these two.\Shinigami-sama, how do you intend to correct this?\Y-You! response:	You're right...
context: The Wavelength of Madness also causes sleeping witches to awaken.\And it doesn't just affect people either.\Natural catastrophes, abnormal weather and any terror you can think of.\So dormant enemies will start to move?\The situation became like this because of the mistakes of these two.\Shinigami-sama, how do you intend to correct this?\Y-You!\You're right... response:	Don't transfer me! Anything but that!
context: And it doesn't just affect people either.\Natural catastrophes, abnormal weather and any terror you can think of.\So dormant enemies will start to move?\The situation became like this because of the mistakes of these two.\Shinigami-sama, how do you intend to correct this?\Y-You!\You're right...\Don't transfer me! Anything but that! response:	Actually, I was thinking of doing some reassignments.
context: Natural catastrophes, abnormal weather and any terror you can think of.\So dormant enemies will start to move?\The situation became like this because of the mistakes of these two.\Shinigami-sama, how do you intend to correct this?\Y-You!\You're right...\Don't transfer me! Anything but that!\Actually, I was thinking of doing some reassignments. response:	What?!
context: So dormant enemies will start to move?\The situation became like this because of the mistakes of these two.\Shinigami-sama, how do you intend to correct this?\Y-You!\You're right...\Don't transfer me! Anything but that!\Actually, I was thinking of doing some reassignments.\What?! response:	A happy life with my child...
context: The situation became like this because of the mistakes of these two.\Shinigami-sama, how do you intend to correct this?\Y-You!\You're right...\Don't transfer me! Anything but that!\Actually, I was thinking of doing some reassignments.\What?!\A happy life with my child... response:	I can't see it anymore... I can't see the future!
context: Shinigami-sama, how do you intend to correct this?\Y-You!\You're right...\Don't transfer me! Anything but that!\Actually, I was thinking of doing some reassignments.\What?!\A happy life with my child...\I can't see it anymore... I can't see the future! response:	I can't see it anymore... I can't see the future!
context: Y-You!\You're right...\Don't transfer me! Anything but that!\Actually, I was thinking of doing some reassignments.\What?!\A happy life with my child...\I can't see it anymore... I can't see the future!\I can't see it anymore... I can't see the future! response:	What do I tell Maka? I don't want to see Maka's sad face.
context: You're right...\Don't transfer me! Anything but that!\Actually, I was thinking of doing some reassignments.\What?!\A happy life with my child...\I can't see it anymore... I can't see the future!\I can't see it anymore... I can't see the future!\What do I tell Maka? I don't want to see Maka's sad face. response:	No, no.
context: Don't transfer me! Anything but that!\Actually, I was thinking of doing some reassignments.\What?!\A happy life with my child...\I can't see it anymore... I can't see the future!\I can't see it anymore... I can't see the future!\What do I tell Maka? I don't want to see Maka's sad face.\No, no. response:	Spirit-kun will continue to be my Weapon.
context: Actually, I was thinking of doing some reassignments.\What?!\A happy life with my child...\I can't see it anymore... I can't see the future!\I can't see it anymore... I can't see the future!\What do I tell Maka? I don't want to see Maka's sad face.\No, no.\Spirit-kun will continue to be my Weapon. response:	A guy like me? Is that okay?!
context: What?!\A happy life with my child...\I can't see it anymore... I can't see the future!\I can't see it anymore... I can't see the future!\What do I tell Maka? I don't want to see Maka's sad face.\No, no.\Spirit-kun will continue to be my Weapon.\A guy like me? Is that okay?! response:	Among the Death Scythes, only you can truly be called a Death Scythe.
context: A happy life with my child...\I can't see it anymore... I can't see the future!\I can't see it anymore... I can't see the future!\What do I tell Maka? I don't want to see Maka's sad face.\No, no.\Spirit-kun will continue to be my Weapon.\A guy like me? Is that okay?!\Among the Death Scythes, only you can truly be called a Death Scythe. response:	Be more proud of yourself.
context: I can't see it anymore... I can't see the future!\I can't see it anymore... I can't see the future!\What do I tell Maka? I don't want to see Maka's sad face.\No, no.\Spirit-kun will continue to be my Weapon.\A guy like me? Is that okay?!\Among the Death Scythes, only you can truly be called a Death Scythe.\Be more proud of yourself. response:	Oh, God, such benevolent words!
context: I can't see it anymore... I can't see the future!\What do I tell Maka? I don't want to see Maka's sad face.\No, no.\Spirit-kun will continue to be my Weapon.\A guy like me? Is that okay?!\Among the Death Scythes, only you can truly be called a Death Scythe.\Be more proud of yourself.\Oh, God, such benevolent words! response:	In exchange, though you were Stein-kun's Temporary Weapon and traveled freely,
context: What do I tell Maka? I don't want to see Maka's sad face.\No, no.\Spirit-kun will continue to be my Weapon.\A guy like me? Is that okay?!\Among the Death Scythes, only you can truly be called a Death Scythe.\Be more proud of yourself.\Oh, God, such benevolent words!\In exchange, though you were Stein-kun's Temporary Weapon and traveled freely, response:	With pleasure!
context: No, no.\Spirit-kun will continue to be my Weapon.\A guy like me? Is that okay?!\Among the Death Scythes, only you can truly be called a Death Scythe.\Be more proud of yourself.\Oh, God, such benevolent words!\In exchange, though you were Stein-kun's Temporary Weapon and traveled freely,\With pleasure! response:	Also, to strengthen Shibusen, I want to have another Death Scythe remain here.
context: Spirit-kun will continue to be my Weapon.\A guy like me? Is that okay?!\Among the Death Scythes, only you can truly be called a Death Scythe.\Be more proud of yourself.\Oh, God, such benevolent words!\In exchange, though you were Stein-kun's Temporary Weapon and traveled freely,\With pleasure!\Also, to strengthen Shibusen, I want to have another Death Scythe remain here. response:	Marie-chan, I want you to be Stein-kun's partner.
context: A guy like me? Is that okay?!\Among the Death Scythes, only you can truly be called a Death Scythe.\Be more proud of yourself.\Oh, God, such benevolent words!\In exchange, though you were Stein-kun's Temporary Weapon and traveled freely,\With pleasure!\Also, to strengthen Shibusen, I want to have another Death Scythe remain here.\Marie-chan, I want you to be Stein-kun's partner. response:	Huh? Me?
context: Among the Death Scythes, only you can truly be called a Death Scythe.\Be more proud of yourself.\Oh, God, such benevolent words!\In exchange, though you were Stein-kun's Temporary Weapon and traveled freely,\With pleasure!\Also, to strengthen Shibusen, I want to have another Death Scythe remain here.\Marie-chan, I want you to be Stein-kun's partner.\Huh? Me? response:	No way...
context: Be more proud of yourself.\Oh, God, such benevolent words!\In exchange, though you were Stein-kun's Temporary Weapon and traveled freely,\With pleasure!\Also, to strengthen Shibusen, I want to have another Death Scythe remain here.\Marie-chan, I want you to be Stein-kun's partner.\Huh? Me?\No way... response:	Please, wait! I don't feel like working!
context: Oh, God, such benevolent words!\In exchange, though you were Stein-kun's Temporary Weapon and traveled freely,\With pleasure!\Also, to strengthen Shibusen, I want to have another Death Scythe remain here.\Marie-chan, I want you to be Stein-kun's partner.\Huh? Me?\No way...\Please, wait! I don't feel like working! response:	I chose to be the representative of Oceania because I knew how peaceful it is working there.
context: In exchange, though you were Stein-kun's Temporary Weapon and traveled freely,\With pleasure!\Also, to strengthen Shibusen, I want to have another Death Scythe remain here.\Marie-chan, I want you to be Stein-kun's partner.\Huh? Me?\No way...\Please, wait! I don't feel like working!\I chose to be the representative of Oceania because I knew how peaceful it is working there. response:	If I work in Shibusen, I'll become so busy I'll never get married...
context: With pleasure!\Also, to strengthen Shibusen, I want to have another Death Scythe remain here.\Marie-chan, I want you to be Stein-kun's partner.\Huh? Me?\No way...\Please, wait! I don't feel like working!\I chose to be the representative of Oceania because I knew how peaceful it is working there.\If I work in Shibusen, I'll become so busy I'll never get married... response:	Don't worry.
context: Also, to strengthen Shibusen, I want to have another Death Scythe remain here.\Marie-chan, I want you to be Stein-kun's partner.\Huh? Me?\No way...\Please, wait! I don't feel like working!\I chose to be the representative of Oceania because I knew how peaceful it is working there.\If I work in Shibusen, I'll become so busy I'll never get married...\Don't worry. response:	You're the type of person that becomes enthusiastic after a while.
context: Marie-chan, I want you to be Stein-kun's partner.\Huh? Me?\No way...\Please, wait! I don't feel like working!\I chose to be the representative of Oceania because I knew how peaceful it is working there.\If I work in Shibusen, I'll become so busy I'll never get married...\Don't worry.\You're the type of person that becomes enthusiastic after a while. response:	Please, don't say that...
context: Huh? Me?\No way...\Please, wait! I don't feel like working!\I chose to be the representative of Oceania because I knew how peaceful it is working there.\If I work in Shibusen, I'll become so busy I'll never get married...\Don't worry.\You're the type of person that becomes enthusiastic after a while.\Please, don't say that... response:	Shinigami-sama, what should I do?
context: No way...\Please, wait! I don't feel like working!\I chose to be the representative of Oceania because I knew how peaceful it is working there.\If I work in Shibusen, I'll become so busy I'll never get married...\Don't worry.\You're the type of person that becomes enthusiastic after a while.\Please, don't say that...\Shinigami-sama, what should I do? response:	Azusa-chan, please use your broad vision to track down Asura.
context: Please, wait! I don't feel like working!\I chose to be the representative of Oceania because I knew how peaceful it is working there.\If I work in Shibusen, I'll become so busy I'll never get married...\Don't worry.\You're the type of person that becomes enthusiastic after a while.\Please, don't say that...\Shinigami-sama, what should I do?\Azusa-chan, please use your broad vision to track down Asura. response:	Also, please take up the role of Oceania's representative by replacing Marie-chan.
context: I chose to be the representative of Oceania because I knew how peaceful it is working there.\If I work in Shibusen, I'll become so busy I'll never get married...\Don't worry.\You're the type of person that becomes enthusiastic after a while.\Please, don't say that...\Shinigami-sama, what should I do?\Azusa-chan, please use your broad vision to track down Asura.\Also, please take up the role of Oceania's representative by replacing Marie-chan. response:	Yes.
context: If I work in Shibusen, I'll become so busy I'll never get married...\Don't worry.\You're the type of person that becomes enthusiastic after a while.\Please, don't say that...\Shinigami-sama, what should I do?\Azusa-chan, please use your broad vision to track down Asura.\Also, please take up the role of Oceania's representative by replacing Marie-chan.\Yes. response:	As for Justin-kun...
context: Don't worry.\You're the type of person that becomes enthusiastic after a while.\Please, don't say that...\Shinigami-sama, what should I do?\Azusa-chan, please use your broad vision to track down Asura.\Also, please take up the role of Oceania's representative by replacing Marie-chan.\Yes.\As for Justin-kun... response:	Justin-kun?
context: You're the type of person that becomes enthusiastic after a while.\Please, don't say that...\Shinigami-sama, what should I do?\Azusa-chan, please use your broad vision to track down Asura.\Also, please take up the role of Oceania's representative by replacing Marie-chan.\Yes.\As for Justin-kun...\Justin-kun? response:	Anyway, Justin will stay on reserve!
context: Please, don't say that...\Shinigami-sama, what should I do?\Azusa-chan, please use your broad vision to track down Asura.\Also, please take up the role of Oceania's representative by replacing Marie-chan.\Yes.\As for Justin-kun...\Justin-kun?\Anyway, Justin will stay on reserve! response:	Even though Shibusen must change a bit from now on,
context: Shinigami-sama, what should I do?\Azusa-chan, please use your broad vision to track down Asura.\Also, please take up the role of Oceania's representative by replacing Marie-chan.\Yes.\As for Justin-kun...\Justin-kun?\Anyway, Justin will stay on reserve!\Even though Shibusen must change a bit from now on, response:	With that, you're dismissed.
context: Azusa-chan, please use your broad vision to track down Asura.\Also, please take up the role of Oceania's representative by replacing Marie-chan.\Yes.\As for Justin-kun...\Justin-kun?\Anyway, Justin will stay on reserve!\Even though Shibusen must change a bit from now on,\With that, you're dismissed. response:	Ah, wait a moment, Spirit-kun.
context: Also, please take up the role of Oceania's representative by replacing Marie-chan.\Yes.\As for Justin-kun...\Justin-kun?\Anyway, Justin will stay on reserve!\Even though Shibusen must change a bit from now on,\With that, you're dismissed.\Ah, wait a moment, Spirit-kun. response:	Huh? What is it?
context: Yes.\As for Justin-kun...\Justin-kun?\Anyway, Justin will stay on reserve!\Even though Shibusen must change a bit from now on,\With that, you're dismissed.\Ah, wait a moment, Spirit-kun.\Huh? What is it? response:	There's something I need to talk to you about.
context: As for Justin-kun...\Justin-kun?\Anyway, Justin will stay on reserve!\Even though Shibusen must change a bit from now on,\With that, you're dismissed.\Ah, wait a moment, Spirit-kun.\Huh? What is it?\There's something I need to talk to you about. response:	Number one: Marie Mjolnir.
context: Justin-kun?\Anyway, Justin will stay on reserve!\Even though Shibusen must change a bit from now on,\With that, you're dismissed.\Ah, wait a moment, Spirit-kun.\Huh? What is it?\There's something I need to talk to you about.\Number one: Marie Mjolnir. response:	I punch Azusa!
context: Anyway, Justin will stay on reserve!\Even though Shibusen must change a bit from now on,\With that, you're dismissed.\Ah, wait a moment, Spirit-kun.\Huh? What is it?\There's something I need to talk to you about.\Number one: Marie Mjolnir.\I punch Azusa! response:	Number two: Marie Mjolnir.
context: Even though Shibusen must change a bit from now on,\With that, you're dismissed.\Ah, wait a moment, Spirit-kun.\Huh? What is it?\There's something I need to talk to you about.\Number one: Marie Mjolnir.\I punch Azusa!\Number two: Marie Mjolnir. response:	I cry because I'm sad.
context: With that, you're dismissed.\Ah, wait a moment, Spirit-kun.\Huh? What is it?\There's something I need to talk to you about.\Number one: Marie Mjolnir.\I punch Azusa!\Number two: Marie Mjolnir.\I cry because I'm sad. response:	Number three: Marie Mjolnir.
context: Ah, wait a moment, Spirit-kun.\Huh? What is it?\There's something I need to talk to you about.\Number one: Marie Mjolnir.\I punch Azusa!\Number two: Marie Mjolnir.\I cry because I'm sad.\Number three: Marie Mjolnir. response:	I face forward.
context: Huh? What is it?\There's something I need to talk to you about.\Number one: Marie Mjolnir.\I punch Azusa!\Number two: Marie Mjolnir.\I cry because I'm sad.\Number three: Marie Mjolnir.\I face forward. response:	Number four: Marie Mjolnir.
context: There's something I need to talk to you about.\Number one: Marie Mjolnir.\I punch Azusa!\Number two: Marie Mjolnir.\I cry because I'm sad.\Number three: Marie Mjolnir.\I face forward.\Number four: Marie Mjolnir. response:	I unclog the toilet!
context: Number one: Marie Mjolnir.\I punch Azusa!\Number two: Marie Mjolnir.\I cry because I'm sad.\Number three: Marie Mjolnir.\I face forward.\Number four: Marie Mjolnir.\I unclog the toilet! response:	Number five: Marie Mjolnir.
context: I punch Azusa!\Number two: Marie Mjolnir.\I cry because I'm sad.\Number three: Marie Mjolnir.\I face forward.\Number four: Marie Mjolnir.\I unclog the toilet!\Number five: Marie Mjolnir. response:	I marry the toilet!
context: Number two: Marie Mjolnir.\I cry because I'm sad.\Number three: Marie Mjolnir.\I face forward.\Number four: Marie Mjolnir.\I unclog the toilet!\Number five: Marie Mjolnir.\I marry the toilet! response:	Number six: Marie Mjolnir.
context: I cry because I'm sad.\Number three: Marie Mjolnir.\I face forward.\Number four: Marie Mjolnir.\I unclog the toilet!\Number five: Marie Mjolnir.\I marry the toilet!\Number six: Marie Mjolnir. response:	I prevent the toilet from cheating.
context: Number three: Marie Mjolnir.\I face forward.\Number four: Marie Mjolnir.\I unclog the toilet!\Number five: Marie Mjolnir.\I marry the toilet!\Number six: Marie Mjolnir.\I prevent the toilet from cheating. response:	Number seven: Marie Mjolnir.
context: I face forward.\Number four: Marie Mjolnir.\I unclog the toilet!\Number five: Marie Mjolnir.\I marry the toilet!\Number six: Marie Mjolnir.\I prevent the toilet from cheating.\Number seven: Marie Mjolnir. response:	I punch Azusa!
context: Number four: Marie Mjolnir.\I unclog the toilet!\Number five: Marie Mjolnir.\I marry the toilet!\Number six: Marie Mjolnir.\I prevent the toilet from cheating.\Number seven: Marie Mjolnir.\I punch Azusa! response:	Why?!
context: I unclog the toilet!\Number five: Marie Mjolnir.\I marry the toilet!\Number six: Marie Mjolnir.\I prevent the toilet from cheating.\Number seven: Marie Mjolnir.\I punch Azusa!\Why?! response:	Alright! Let's play basketball!
context: Number five: Marie Mjolnir.\I marry the toilet!\Number six: Marie Mjolnir.\I prevent the toilet from cheating.\Number seven: Marie Mjolnir.\I punch Azusa!\Why?!\Alright! Let's play basketball! response:	Okay!
context: I marry the toilet!\Number six: Marie Mjolnir.\I prevent the toilet from cheating.\Number seven: Marie Mjolnir.\I punch Azusa!\Why?!\Alright! Let's play basketball!\Okay! response:	Oi, Maka! Come play basketball!
context: Number six: Marie Mjolnir.\I prevent the toilet from cheating.\Number seven: Marie Mjolnir.\I punch Azusa!\Why?!\Alright! Let's play basketball!\Okay!\Oi, Maka! Come play basketball! response:	Why? Didn't you say that I could sit out and read?
context: I prevent the toilet from cheating.\Number seven: Marie Mjolnir.\I punch Azusa!\Why?!\Alright! Let's play basketball!\Okay!\Oi, Maka! Come play basketball!\Why? Didn't you say that I could sit out and read? response:	That's why I tagged along.
context: Number seven: Marie Mjolnir.\I punch Azusa!\Why?!\Alright! Let's play basketball!\Okay!\Oi, Maka! Come play basketball!\Why? Didn't you say that I could sit out and read?\That's why I tagged along. response:	That was a lie.
context: I punch Azusa!\Why?!\Alright! Let's play basketball!\Okay!\Oi, Maka! Come play basketball!\Why? Didn't you say that I could sit out and read?\That's why I tagged along.\That was a lie. response:	I had no choice, because suddenly Liz didn't want to come.
context: Why?!\Alright! Let's play basketball!\Okay!\Oi, Maka! Come play basketball!\Why? Didn't you say that I could sit out and read?\That's why I tagged along.\That was a lie.\I had no choice, because suddenly Liz didn't want to come. response:	I don't know the rules of basketball.
context: Alright! Let's play basketball!\Okay!\Oi, Maka! Come play basketball!\Why? Didn't you say that I could sit out and read?\That's why I tagged along.\That was a lie.\I had no choice, because suddenly Liz didn't want to come.\I don't know the rules of basketball. response:	Here, hold your hair down.
context: Okay!\Oi, Maka! Come play basketball!\Why? Didn't you say that I could sit out and read?\That's why I tagged along.\That was a lie.\I had no choice, because suddenly Liz didn't want to come.\I don't know the rules of basketball.\Here, hold your hair down. response:	Anyway, the teams look fine like this.
context: Oi, Maka! Come play basketball!\Why? Didn't you say that I could sit out and read?\That's why I tagged along.\That was a lie.\I had no choice, because suddenly Liz didn't want to come.\I don't know the rules of basketball.\Here, hold your hair down.\Anyway, the teams look fine like this. response:	Kid-kun, why didn't Liz come?
context: Why? Didn't you say that I could sit out and read?\That's why I tagged along.\That was a lie.\I had no choice, because suddenly Liz didn't want to come.\I don't know the rules of basketball.\Here, hold your hair down.\Anyway, the teams look fine like this.\Kid-kun, why didn't Liz come? response:	She said she didn't want to break a nail.
context: That's why I tagged along.\That was a lie.\I had no choice, because suddenly Liz didn't want to come.\I don't know the rules of basketball.\Here, hold your hair down.\Anyway, the teams look fine like this.\Kid-kun, why didn't Liz come?\She said she didn't want to break a nail. response:	Just playing basketball is boring.
context: That was a lie.\I had no choice, because suddenly Liz didn't want to come.\I don't know the rules of basketball.\Here, hold your hair down.\Anyway, the teams look fine like this.\Kid-kun, why didn't Liz come?\She said she didn't want to break a nail.\Just playing basketball is boring. response:	How about a penalty game for the captain of the losing team?
context: I had no choice, because suddenly Liz didn't want to come.\I don't know the rules of basketball.\Here, hold your hair down.\Anyway, the teams look fine like this.\Kid-kun, why didn't Liz come?\She said she didn't want to break a nail.\Just playing basketball is boring.\How about a penalty game for the captain of the losing team? response:	Oh, that's fine by me. I accept your challenge!
context: I don't know the rules of basketball.\Here, hold your hair down.\Anyway, the teams look fine like this.\Kid-kun, why didn't Liz come?\She said she didn't want to break a nail.\Just playing basketball is boring.\How about a penalty game for the captain of the losing team?\Oh, that's fine by me. I accept your challenge! response:	If we lose, you get to move the picture frames in Kid's house by 2 cm.
context: Here, hold your hair down.\Anyway, the teams look fine like this.\Kid-kun, why didn't Liz come?\She said she didn't want to break a nail.\Just playing basketball is boring.\How about a penalty game for the captain of the losing team?\Oh, that's fine by me. I accept your challenge!\If we lose, you get to move the picture frames in Kid's house by 2 cm. response:	O-Oi!
context: Anyway, the teams look fine like this.\Kid-kun, why didn't Liz come?\She said she didn't want to break a nail.\Just playing basketball is boring.\How about a penalty game for the captain of the losing team?\Oh, that's fine by me. I accept your challenge!\If we lose, you get to move the picture frames in Kid's house by 2 cm.\O-Oi! response:	That would be interesting!
context: Kid-kun, why didn't Liz come?\She said she didn't want to break a nail.\Just playing basketball is boring.\How about a penalty game for the captain of the losing team?\Oh, that's fine by me. I accept your challenge!\If we lose, you get to move the picture frames in Kid's house by 2 cm.\O-Oi!\That would be interesting! response:	Then... If we lose, Captain Maka will go on a one-day date with her Papa.
context: She said she didn't want to break a nail.\Just playing basketball is boring.\How about a penalty game for the captain of the losing team?\Oh, that's fine by me. I accept your challenge!\If we lose, you get to move the picture frames in Kid's house by 2 cm.\O-Oi!\That would be interesting!\Then... If we lose, Captain Maka will go on a one-day date with her Papa. response:	Huh?!
context: Just playing basketball is boring.\How about a penalty game for the captain of the losing team?\Oh, that's fine by me. I accept your challenge!\If we lose, you get to move the picture frames in Kid's house by 2 cm.\O-Oi!\That would be interesting!\Then... If we lose, Captain Maka will go on a one-day date with her Papa.\Huh?! response:	Wait a second. I don't understand the meaning of this.
context: How about a penalty game for the captain of the losing team?\Oh, that's fine by me. I accept your challenge!\If we lose, you get to move the picture frames in Kid's house by 2 cm.\O-Oi!\That would be interesting!\Then... If we lose, Captain Maka will go on a one-day date with her Papa.\Huh?!\Wait a second. I don't understand the meaning of this. response:	Aren't you the captain, Black Star? You want to be the captain, don't you?
context: Oh, that's fine by me. I accept your challenge!\If we lose, you get to move the picture frames in Kid's house by 2 cm.\O-Oi!\That would be interesting!\Then... If we lose, Captain Maka will go on a one-day date with her Papa.\Huh?!\Wait a second. I don't understand the meaning of this.\Aren't you the captain, Black Star? You want to be the captain, don't you? response:	I know! But I feel bad because I forced you to come!
context: If we lose, you get to move the picture frames in Kid's house by 2 cm.\O-Oi!\That would be interesting!\Then... If we lose, Captain Maka will go on a one-day date with her Papa.\Huh?!\Wait a second. I don't understand the meaning of this.\Aren't you the captain, Black Star? You want to be the captain, don't you?\I know! But I feel bad because I forced you to come! response:	Even though it's painful, you can have the position of captain! I'm already in tears.
context: O-Oi!\That would be interesting!\Then... If we lose, Captain Maka will go on a one-day date with her Papa.\Huh?!\Wait a second. I don't understand the meaning of this.\Aren't you the captain, Black Star? You want to be the captain, don't you?\I know! But I feel bad because I forced you to come!\Even though it's painful, you can have the position of captain! I'm already in tears. response:	Dont get conscientious at a time like this...
context: That would be interesting!\Then... If we lose, Captain Maka will go on a one-day date with her Papa.\Huh?!\Wait a second. I don't understand the meaning of this.\Aren't you the captain, Black Star? You want to be the captain, don't you?\I know! But I feel bad because I forced you to come!\Even though it's painful, you can have the position of captain! I'm already in tears.\Dont get conscientious at a time like this... response:	You're wearing the captain's cap, anyway.
context: Then... If we lose, Captain Maka will go on a one-day date with her Papa.\Huh?!\Wait a second. I don't understand the meaning of this.\Aren't you the captain, Black Star? You want to be the captain, don't you?\I know! But I feel bad because I forced you to come!\Even though it's painful, you can have the position of captain! I'm already in tears.\Dont get conscientious at a time like this...\You're wearing the captain's cap, anyway. response:	Eh? Is that what this is?
context: Huh?!\Wait a second. I don't understand the meaning of this.\Aren't you the captain, Black Star? You want to be the captain, don't you?\I know! But I feel bad because I forced you to come!\Even though it's painful, you can have the position of captain! I'm already in tears.\Dont get conscientious at a time like this...\You're wearing the captain's cap, anyway.\Eh? Is that what this is? response:	Damn it! I want to be the captain!
context: Wait a second. I don't understand the meaning of this.\Aren't you the captain, Black Star? You want to be the captain, don't you?\I know! But I feel bad because I forced you to come!\Even though it's painful, you can have the position of captain! I'm already in tears.\Dont get conscientious at a time like this...\You're wearing the captain's cap, anyway.\Eh? Is that what this is?\Damn it! I want to be the captain! response:	Then switch with me!
context: Aren't you the captain, Black Star? You want to be the captain, don't you?\I know! But I feel bad because I forced you to come!\Even though it's painful, you can have the position of captain! I'm already in tears.\Dont get conscientious at a time like this...\You're wearing the captain's cap, anyway.\Eh? Is that what this is?\Damn it! I want to be the captain!\Then switch with me! response:	We're starting!
context: I know! But I feel bad because I forced you to come!\Even though it's painful, you can have the position of captain! I'm already in tears.\Dont get conscientious at a time like this...\You're wearing the captain's cap, anyway.\Eh? Is that what this is?\Damn it! I want to be the captain!\Then switch with me!\We're starting! response:	Here!
context: Even though it's painful, you can have the position of captain! I'm already in tears.\Dont get conscientious at a time like this...\You're wearing the captain's cap, anyway.\Eh? Is that what this is?\Damn it! I want to be the captain!\Then switch with me!\We're starting!\Here! response:	Huh?
context: Dont get conscientious at a time like this...\You're wearing the captain's cap, anyway.\Eh? Is that what this is?\Damn it! I want to be the captain!\Then switch with me!\We're starting!\Here!\Huh? response:	Why did Soul, the opponent, pass the ball to us?
context: You're wearing the captain's cap, anyway.\Eh? Is that what this is?\Damn it! I want to be the captain!\Then switch with me!\We're starting!\Here!\Huh?\Why did Soul, the opponent, pass the ball to us? response:	Here.
context: Eh? Is that what this is?\Damn it! I want to be the captain!\Then switch with me!\We're starting!\Here!\Huh?\Why did Soul, the opponent, pass the ball to us?\Here. response:	Ok.
context: Damn it! I want to be the captain!\Then switch with me!\We're starting!\Here!\Huh?\Why did Soul, the opponent, pass the ball to us?\Here.\Ok. response:	Huh? Why did he throw it back?
context: Then switch with me!\We're starting!\Here!\Huh?\Why did Soul, the opponent, pass the ball to us?\Here.\Ok.\Huh? Why did he throw it back? response:	Alright. Let's go.
context: We're starting!\Here!\Huh?\Why did Soul, the opponent, pass the ball to us?\Here.\Ok.\Huh? Why did he throw it back?\Alright. Let's go. response:	Patty! Captain Maka!
context: Here!\Huh?\Why did Soul, the opponent, pass the ball to us?\Here.\Ok.\Huh? Why did he throw it back?\Alright. Let's go.\Patty! Captain Maka! response:	Defend the zone.
context: Huh?\Why did Soul, the opponent, pass the ball to us?\Here.\Ok.\Huh? Why did he throw it back?\Alright. Let's go.\Patty! Captain Maka!\Defend the zone. response:	Okay!
context: Why did Soul, the opponent, pass the ball to us?\Here.\Ok.\Huh? Why did he throw it back?\Alright. Let's go.\Patty! Captain Maka!\Defend the zone.\Okay! response:	What's a zone? Teach me the rules...
context: Here.\Ok.\Huh? Why did he throw it back?\Alright. Let's go.\Patty! Captain Maka!\Defend the zone.\Okay!\What's a zone? Teach me the rules... response:	Why did it start? Stop, stop!
context: Ok.\Huh? Why did he throw it back?\Alright. Let's go.\Patty! Captain Maka!\Defend the zone.\Okay!\What's a zone? Teach me the rules...\Why did it start? Stop, stop! response:	There's no chance I'd find a marriage partner in a place with only kids around.
context: Huh? Why did he throw it back?\Alright. Let's go.\Patty! Captain Maka!\Defend the zone.\Okay!\What's a zone? Teach me the rules...\Why did it start? Stop, stop!\There's no chance I'd find a marriage partner in a place with only kids around. response:	Oh, nice shot.
context: Alright. Let's go.\Patty! Captain Maka!\Defend the zone.\Okay!\What's a zone? Teach me the rules...\Why did it start? Stop, stop!\There's no chance I'd find a marriage partner in a place with only kids around.\Oh, nice shot. response:	Those kids are students from Shibusen?
context: Patty! Captain Maka!\Defend the zone.\Okay!\What's a zone? Teach me the rules...\Why did it start? Stop, stop!\There's no chance I'd find a marriage partner in a place with only kids around.\Oh, nice shot.\Those kids are students from Shibusen? response:	Yeah.
context: Defend the zone.\Okay!\What's a zone? Teach me the rules...\Why did it start? Stop, stop!\There's no chance I'd find a marriage partner in a place with only kids around.\Oh, nice shot.\Those kids are students from Shibusen?\Yeah. response:	And from tomorrow onwards they will be your students.
context: Okay!\What's a zone? Teach me the rules...\Why did it start? Stop, stop!\There's no chance I'd find a marriage partner in a place with only kids around.\Oh, nice shot.\Those kids are students from Shibusen?\Yeah.\And from tomorrow onwards they will be your students. response:	Maka fouled. Double dribble.
context: What's a zone? Teach me the rules...\Why did it start? Stop, stop!\There's no chance I'd find a marriage partner in a place with only kids around.\Oh, nice shot.\Those kids are students from Shibusen?\Yeah.\And from tomorrow onwards they will be your students.\Maka fouled. Double dribble. response:	Give me a break, Captain...
context: Why did it start? Stop, stop!\There's no chance I'd find a marriage partner in a place with only kids around.\Oh, nice shot.\Those kids are students from Shibusen?\Yeah.\And from tomorrow onwards they will be your students.\Maka fouled. Double dribble.\Give me a break, Captain... response:	Huh? What's a double dribble?
context: There's no chance I'd find a marriage partner in a place with only kids around.\Oh, nice shot.\Those kids are students from Shibusen?\Yeah.\And from tomorrow onwards they will be your students.\Maka fouled. Double dribble.\Give me a break, Captain...\Huh? What's a double dribble? response:	It sounds sort of cool though...
context: Oh, nice shot.\Those kids are students from Shibusen?\Yeah.\And from tomorrow onwards they will be your students.\Maka fouled. Double dribble.\Give me a break, Captain...\Huh? What's a double dribble?\It sounds sort of cool though... response:	Alright! Though I don't have a lover, I'll work one more time before I get married.
context: Those kids are students from Shibusen?\Yeah.\And from tomorrow onwards they will be your students.\Maka fouled. Double dribble.\Give me a break, Captain...\Huh? What's a double dribble?\It sounds sort of cool though...\Alright! Though I don't have a lover, I'll work one more time before I get married. response:	Oh yeah, it's kind of on short notice,
context: Yeah.\And from tomorrow onwards they will be your students.\Maka fouled. Double dribble.\Give me a break, Captain...\Huh? What's a double dribble?\It sounds sort of cool though...\Alright! Though I don't have a lover, I'll work one more time before I get married.\Oh yeah, it's kind of on short notice, response:	That's okay with me, but I don't know if you'll be cut up or not.
context: And from tomorrow onwards they will be your students.\Maka fouled. Double dribble.\Give me a break, Captain...\Huh? What's a double dribble?\It sounds sort of cool though...\Alright! Though I don't have a lover, I'll work one more time before I get married.\Oh yeah, it's kind of on short notice,\That's okay with me, but I don't know if you'll be cut up or not. response:	Well, I'm trusting you.
context: Maka fouled. Double dribble.\Give me a break, Captain...\Huh? What's a double dribble?\It sounds sort of cool though...\Alright! Though I don't have a lover, I'll work one more time before I get married.\Oh yeah, it's kind of on short notice,\That's okay with me, but I don't know if you'll be cut up or not.\Well, I'm trusting you. response:	What do you need from me?
context: Give me a break, Captain...\Huh? What's a double dribble?\It sounds sort of cool though...\Alright! Though I don't have a lover, I'll work one more time before I get married.\Oh yeah, it's kind of on short notice,\That's okay with me, but I don't know if you'll be cut up or not.\Well, I'm trusting you.\What do you need from me? response:	Actually, it's about Stein-kun...
context: Huh? What's a double dribble?\It sounds sort of cool though...\Alright! Though I don't have a lover, I'll work one more time before I get married.\Oh yeah, it's kind of on short notice,\That's okay with me, but I don't know if you'll be cut up or not.\Well, I'm trusting you.\What do you need from me?\Actually, it's about Stein-kun... response:	It looks like he already noticed it himself,
context: It sounds sort of cool though...\Alright! Though I don't have a lover, I'll work one more time before I get married.\Oh yeah, it's kind of on short notice,\That's okay with me, but I don't know if you'll be cut up or not.\Well, I'm trusting you.\What do you need from me?\Actually, it's about Stein-kun...\It looks like he already noticed it himself, response:	So then, Marie...
context: Alright! Though I don't have a lover, I'll work one more time before I get married.\Oh yeah, it's kind of on short notice,\That's okay with me, but I don't know if you'll be cut up or not.\Well, I'm trusting you.\What do you need from me?\Actually, it's about Stein-kun...\It looks like he already noticed it himself,\So then, Marie... response:	Marie-chan's soul wavelength should have a positive effect on Stein's soul.
context: Oh yeah, it's kind of on short notice,\That's okay with me, but I don't know if you'll be cut up or not.\Well, I'm trusting you.\What do you need from me?\Actually, it's about Stein-kun...\It looks like he already noticed it himself,\So then, Marie...\Marie-chan's soul wavelength should have a positive effect on Stein's soul. response:	So, Spirit-kun, will you help me keep an eye on Stein-kun?
context: That's okay with me, but I don't know if you'll be cut up or not.\Well, I'm trusting you.\What do you need from me?\Actually, it's about Stein-kun...\It looks like he already noticed it himself,\So then, Marie...\Marie-chan's soul wavelength should have a positive effect on Stein's soul.\So, Spirit-kun, will you help me keep an eye on Stein-kun? response:	So, Spirit-kun, will you help me keep an eye on Stein-kun?
context: Well, I'm trusting you.\What do you need from me?\Actually, it's about Stein-kun...\It looks like he already noticed it himself,\So then, Marie...\Marie-chan's soul wavelength should have a positive effect on Stein's soul.\So, Spirit-kun, will you help me keep an eye on Stein-kun?\So, Spirit-kun, will you help me keep an eye on Stein-kun? response:	Yes.
context: What do you need from me?\Actually, it's about Stein-kun...\It looks like he already noticed it himself,\So then, Marie...\Marie-chan's soul wavelength should have a positive effect on Stein's soul.\So, Spirit-kun, will you help me keep an eye on Stein-kun?\So, Spirit-kun, will you help me keep an eye on Stein-kun?\Yes. response:	Sheesh.
context: Actually, it's about Stein-kun...\It looks like he already noticed it himself,\So then, Marie...\Marie-chan's soul wavelength should have a positive effect on Stein's soul.\So, Spirit-kun, will you help me keep an eye on Stein-kun?\So, Spirit-kun, will you help me keep an eye on Stein-kun?\Yes.\Sheesh. response:	No matter when, you'll always be the Kouhai I have to look after, huh.
context: It looks like he already noticed it himself,\So then, Marie...\Marie-chan's soul wavelength should have a positive effect on Stein's soul.\So, Spirit-kun, will you help me keep an eye on Stein-kun?\So, Spirit-kun, will you help me keep an eye on Stein-kun?\Yes.\Sheesh.\No matter when, you'll always be the Kouhai I have to look after, huh. response:	Hey.
context: So then, Marie...\Marie-chan's soul wavelength should have a positive effect on Stein's soul.\So, Spirit-kun, will you help me keep an eye on Stein-kun?\So, Spirit-kun, will you help me keep an eye on Stein-kun?\Yes.\Sheesh.\No matter when, you'll always be the Kouhai I have to look after, huh.\Hey. response:	Ah, Spirit-san.
context: Marie-chan's soul wavelength should have a positive effect on Stein's soul.\So, Spirit-kun, will you help me keep an eye on Stein-kun?\So, Spirit-kun, will you help me keep an eye on Stein-kun?\Yes.\Sheesh.\No matter when, you'll always be the Kouhai I have to look after, huh.\Hey.\Ah, Spirit-san. response:	Pass it here! Pass it here!
context: So, Spirit-kun, will you help me keep an eye on Stein-kun?\So, Spirit-kun, will you help me keep an eye on Stein-kun?\Yes.\Sheesh.\No matter when, you'll always be the Kouhai I have to look after, huh.\Hey.\Ah, Spirit-san.\Pass it here! Pass it here! response:	What are those guys doing? Even though they were told to say at home...
context: So, Spirit-kun, will you help me keep an eye on Stein-kun?\Yes.\Sheesh.\No matter when, you'll always be the Kouhai I have to look after, huh.\Hey.\Ah, Spirit-san.\Pass it here! Pass it here!\What are those guys doing? Even though they were told to say at home... response:	Isn't it great that the kids are taking it easy?
context: Yes.\Sheesh.\No matter when, you'll always be the Kouhai I have to look after, huh.\Hey.\Ah, Spirit-san.\Pass it here! Pass it here!\What are those guys doing? Even though they were told to say at home...\Isn't it great that the kids are taking it easy? response:	It's not that they're taking it easy...
context: Sheesh.\No matter when, you'll always be the Kouhai I have to look after, huh.\Hey.\Ah, Spirit-san.\Pass it here! Pass it here!\What are those guys doing? Even though they were told to say at home...\Isn't it great that the kids are taking it easy?\It's not that they're taking it easy... response:	Because of that abnormal experience,
context: No matter when, you'll always be the Kouhai I have to look after, huh.\Hey.\Ah, Spirit-san.\Pass it here! Pass it here!\What are those guys doing? Even though they were told to say at home...\Isn't it great that the kids are taking it easy?\It's not that they're taking it easy...\Because of that abnormal experience, response:	Game set!
context: Hey.\Ah, Spirit-san.\Pass it here! Pass it here!\What are those guys doing? Even though they were told to say at home...\Isn't it great that the kids are taking it easy?\It's not that they're taking it easy...\Because of that abnormal experience,\Game set! response:	20 to 4. It's Maka's team's defeat!
context: Ah, Spirit-san.\Pass it here! Pass it here!\What are those guys doing? Even though they were told to say at home...\Isn't it great that the kids are taking it easy?\It's not that they're taking it easy...\Because of that abnormal experience,\Game set!\20 to 4. It's Maka's team's defeat! response:	Even until the very end, I couldn't understand the rules.
context: Pass it here! Pass it here!\What are those guys doing? Even though they were told to say at home...\Isn't it great that the kids are taking it easy?\It's not that they're taking it easy...\Because of that abnormal experience,\Game set!\20 to 4. It's Maka's team's defeat!\Even until the very end, I couldn't understand the rules. response:	I'm saved.
context: What are those guys doing? Even though they were told to say at home...\Isn't it great that the kids are taking it easy?\It's not that they're taking it easy...\Because of that abnormal experience,\Game set!\20 to 4. It's Maka's team's defeat!\Even until the very end, I couldn't understand the rules.\I'm saved. response:	Let's just pretend there was no penalty...
context: Isn't it great that the kids are taking it easy?\It's not that they're taking it easy...\Because of that abnormal experience,\Game set!\20 to 4. It's Maka's team's defeat!\Even until the very end, I couldn't understand the rules.\I'm saved.\Let's just pretend there was no penalty... response:	Penalty game! Penalty game!
context: It's not that they're taking it easy...\Because of that abnormal experience,\Game set!\20 to 4. It's Maka's team's defeat!\Even until the very end, I couldn't understand the rules.\I'm saved.\Let's just pretend there was no penalty...\Penalty game! Penalty game! response:	Penalty game! Penalty game!
context: Because of that abnormal experience,\Game set!\20 to 4. It's Maka's team's defeat!\Even until the very end, I couldn't understand the rules.\I'm saved.\Let's just pretend there was no penalty...\Penalty game! Penalty game!\Penalty game! Penalty game! response:	Penalty game! Penalty game!
context: Game set!\20 to 4. It's Maka's team's defeat!\Even until the very end, I couldn't understand the rules.\I'm saved.\Let's just pretend there was no penalty...\Penalty game! Penalty game!\Penalty game! Penalty game!\Penalty game! Penalty game! response:	Penalty game! Penalty game!
context: 20 to 4. It's Maka's team's defeat!\Even until the very end, I couldn't understand the rules.\I'm saved.\Let's just pretend there was no penalty...\Penalty game! Penalty game!\Penalty game! Penalty game!\Penalty game! Penalty game!\Penalty game! Penalty game! response:	Penalty game! Penalty game!
context: Even until the very end, I couldn't understand the rules.\I'm saved.\Let's just pretend there was no penalty...\Penalty game! Penalty game!\Penalty game! Penalty game!\Penalty game! Penalty game!\Penalty game! Penalty game!\Penalty game! Penalty game! response:	Penalty game! Penalty game!
context: I'm saved.\Let's just pretend there was no penalty...\Penalty game! Penalty game!\Penalty game! Penalty game!\Penalty game! Penalty game!\Penalty game! Penalty game!\Penalty game! Penalty game!\Penalty game! Penalty game! response:	Even with the underground battle, I don't think it will affect their normal daily life.
context: Let's just pretend there was no penalty...\Penalty game! Penalty game!\Penalty game! Penalty game!\Penalty game! Penalty game!\Penalty game! Penalty game!\Penalty game! Penalty game!\Penalty game! Penalty game!\Even with the underground battle, I don't think it will affect their normal daily life. response:	Sheesh...
context: Penalty game! Penalty game!\Penalty game! Penalty game!\Penalty game! Penalty game!\Penalty game! Penalty game!\Penalty game! Penalty game!\Penalty game! Penalty game!\Even with the underground battle, I don't think it will affect their normal daily life.\Sheesh... response:	You don't even have a normal daily life.
context: Penalty game! Penalty game!\Penalty game! Penalty game!\Penalty game! Penalty game!\Penalty game! Penalty game!\Penalty game! Penalty game!\Even with the underground battle, I don't think it will affect their normal daily life.\Sheesh...\You don't even have a normal daily life. response:	Eh? Maka, what's up?
context: Penalty game! Penalty game!\Penalty game! Penalty game!\Penalty game! Penalty game!\Penalty game! Penalty game!\Even with the underground battle, I don't think it will affect their normal daily life.\Sheesh...\You don't even have a normal daily life.\Eh? Maka, what's up? response:	Err... Well, Papa.
context: Penalty game! Penalty game!\Penalty game! Penalty game!\Penalty game! Penalty game!\Even with the underground battle, I don't think it will affect their normal daily life.\Sheesh...\You don't even have a normal daily life.\Eh? Maka, what's up?\Err... Well, Papa. response:	T-This Sunday, do you want to... go on a date?
context: Penalty game! Penalty game!\Penalty game! Penalty game!\Even with the underground battle, I don't think it will affect their normal daily life.\Sheesh...\You don't even have a normal daily life.\Eh? Maka, what's up?\Err... Well, Papa.\T-This Sunday, do you want to... go on a date? response:	T-This Sunday, do you want to... go on a date?
context: Penalty game! Penalty game!\Even with the underground battle, I don't think it will affect their normal daily life.\Sheesh...\You don't even have a normal daily life.\Eh? Maka, what's up?\Err... Well, Papa.\T-This Sunday, do you want to... go on a date?\T-This Sunday, do you want to... go on a date? response:	When I thought I was going to be relocated somewhere...
context: Even with the underground battle, I don't think it will affect their normal daily life.\Sheesh...\You don't even have a normal daily life.\Eh? Maka, what's up?\Err... Well, Papa.\T-This Sunday, do you want to... go on a date?\T-This Sunday, do you want to... go on a date?\When I thought I was going to be relocated somewhere... response:	Papa, strawberry or banana, which is better?
context: Sheesh...\You don't even have a normal daily life.\Eh? Maka, what's up?\Err... Well, Papa.\T-This Sunday, do you want to... go on a date?\T-This Sunday, do you want to... go on a date?\When I thought I was going to be relocated somewhere...\Papa, strawberry or banana, which is better? response:	Say, Papa, which one suits me more?
context: You don't even have a normal daily life.\Eh? Maka, what's up?\Err... Well, Papa.\T-This Sunday, do you want to... go on a date?\T-This Sunday, do you want to... go on a date?\When I thought I was going to be relocated somewhere...\Papa, strawberry or banana, which is better?\Say, Papa, which one suits me more? response:	It's getting chilly.
context: Eh? Maka, what's up?\Err... Well, Papa.\T-This Sunday, do you want to... go on a date?\T-This Sunday, do you want to... go on a date?\When I thought I was going to be relocated somewhere...\Papa, strawberry or banana, which is better?\Say, Papa, which one suits me more?\It's getting chilly. response:	Thanks, Papa. It's warm.
context: Err... Well, Papa.\T-This Sunday, do you want to... go on a date?\T-This Sunday, do you want to... go on a date?\When I thought I was going to be relocated somewhere...\Papa, strawberry or banana, which is better?\Say, Papa, which one suits me more?\It's getting chilly.\Thanks, Papa. It's warm. response:	I-I never expected such an abnormal day to jump on me like this!
context: T-This Sunday, do you want to... go on a date?\T-This Sunday, do you want to... go on a date?\When I thought I was going to be relocated somewhere...\Papa, strawberry or banana, which is better?\Say, Papa, which one suits me more?\It's getting chilly.\Thanks, Papa. It's warm.\I-I never expected such an abnormal day to jump on me like this! response:	Papa?
context: T-This Sunday, do you want to... go on a date?\When I thought I was going to be relocated somewhere...\Papa, strawberry or banana, which is better?\Say, Papa, which one suits me more?\It's getting chilly.\Thanks, Papa. It's warm.\I-I never expected such an abnormal day to jump on me like this!\Papa? response:	Wait, Papa? Are you okay?
context: When I thought I was going to be relocated somewhere...\Papa, strawberry or banana, which is better?\Say, Papa, which one suits me more?\It's getting chilly.\Thanks, Papa. It's warm.\I-I never expected such an abnormal day to jump on me like this!\Papa?\Wait, Papa? Are you okay? response:	Sorry. I'm just too happy.
context: Papa, strawberry or banana, which is better?\Say, Papa, which one suits me more?\It's getting chilly.\Thanks, Papa. It's warm.\I-I never expected such an abnormal day to jump on me like this!\Papa?\Wait, Papa? Are you okay?\Sorry. I'm just too happy. response:	Wait here. I'll get the stomach medicine.
context: Say, Papa, which one suits me more?\It's getting chilly.\Thanks, Papa. It's warm.\I-I never expected such an abnormal day to jump on me like this!\Papa?\Wait, Papa? Are you okay?\Sorry. I'm just too happy.\Wait here. I'll get the stomach medicine. response:	It's okay, I'm fine!
context: It's getting chilly.\Thanks, Papa. It's warm.\I-I never expected such an abnormal day to jump on me like this!\Papa?\Wait, Papa? Are you okay?\Sorry. I'm just too happy.\Wait here. I'll get the stomach medicine.\It's okay, I'm fine! response:	How shameful of me...
context: Thanks, Papa. It's warm.\I-I never expected such an abnormal day to jump on me like this!\Papa?\Wait, Papa? Are you okay?\Sorry. I'm just too happy.\Wait here. I'll get the stomach medicine.\It's okay, I'm fine!\How shameful of me... response:	He's vomiting happiness?
context: I-I never expected such an abnormal day to jump on me like this!\Papa?\Wait, Papa? Are you okay?\Sorry. I'm just too happy.\Wait here. I'll get the stomach medicine.\It's okay, I'm fine!\How shameful of me...\He's vomiting happiness? response:	Even I won't be able to understand that.
context: Papa?\Wait, Papa? Are you okay?\Sorry. I'm just too happy.\Wait here. I'll get the stomach medicine.\It's okay, I'm fine!\How shameful of me...\He's vomiting happiness?\Even I won't be able to understand that. response:	Shinigami-sama.
context: Wait, Papa? Are you okay?\Sorry. I'm just too happy.\Wait here. I'll get the stomach medicine.\It's okay, I'm fine!\How shameful of me...\He's vomiting happiness?\Even I won't be able to understand that.\Shinigami-sama. response:	About your decision on the Devil Sword... What are we going to do?
context: Sorry. I'm just too happy.\Wait here. I'll get the stomach medicine.\It's okay, I'm fine!\How shameful of me...\He's vomiting happiness?\Even I won't be able to understand that.\Shinigami-sama.\About your decision on the Devil Sword... What are we going to do? response:	Well, I think we should let her attend school at Shibusen!
context: Wait here. I'll get the stomach medicine.\It's okay, I'm fine!\How shameful of me...\He's vomiting happiness?\Even I won't be able to understand that.\Shinigami-sama.\About your decision on the Devil Sword... What are we going to do?\Well, I think we should let her attend school at Shibusen! response:	Are you serious?
context: It's okay, I'm fine!\How shameful of me...\He's vomiting happiness?\Even I won't be able to understand that.\Shinigami-sama.\About your decision on the Devil Sword... What are we going to do?\Well, I think we should let her attend school at Shibusen!\Are you serious? response:	Yes, I'm serious.
context: How shameful of me...\He's vomiting happiness?\Even I won't be able to understand that.\Shinigami-sama.\About your decision on the Devil Sword... What are we going to do?\Well, I think we should let her attend school at Shibusen!\Are you serious?\Yes, I'm serious. response:	I'm not going to joke about this.
context: He's vomiting happiness?\Even I won't be able to understand that.\Shinigami-sama.\About your decision on the Devil Sword... What are we going to do?\Well, I think we should let her attend school at Shibusen!\Are you serious?\Yes, I'm serious.\I'm not going to joke about this. response:	That kid does have problems.
context: Even I won't be able to understand that.\Shinigami-sama.\About your decision on the Devil Sword... What are we going to do?\Well, I think we should let her attend school at Shibusen!\Are you serious?\Yes, I'm serious.\I'm not going to joke about this.\That kid does have problems. response:	But, if we can give her some proper guidance, she'll become a fighting force of Shibusen.
context: Shinigami-sama.\About your decision on the Devil Sword... What are we going to do?\Well, I think we should let her attend school at Shibusen!\Are you serious?\Yes, I'm serious.\I'm not going to joke about this.\That kid does have problems.\But, if we can give her some proper guidance, she'll become a fighting force of Shibusen. response:	But, what if she's not yet in the condition to attend Shibusen?
context: About your decision on the Devil Sword... What are we going to do?\Well, I think we should let her attend school at Shibusen!\Are you serious?\Yes, I'm serious.\I'm not going to joke about this.\That kid does have problems.\But, if we can give her some proper guidance, she'll become a fighting force of Shibusen.\But, what if she's not yet in the condition to attend Shibusen? response:	You're right...
context: Well, I think we should let her attend school at Shibusen!\Are you serious?\Yes, I'm serious.\I'm not going to joke about this.\That kid does have problems.\But, if we can give her some proper guidance, she'll become a fighting force of Shibusen.\But, what if she's not yet in the condition to attend Shibusen?\You're right... response:	In that case, starting tomorrow,
context: Are you serious?\Yes, I'm serious.\I'm not going to joke about this.\That kid does have problems.\But, if we can give her some proper guidance, she'll become a fighting force of Shibusen.\But, what if she's not yet in the condition to attend Shibusen?\You're right...\In that case, starting tomorrow, response:	Number eight: Marie Mjolnir.
context: Yes, I'm serious.\I'm not going to joke about this.\That kid does have problems.\But, if we can give her some proper guidance, she'll become a fighting force of Shibusen.\But, what if she's not yet in the condition to attend Shibusen?\You're right...\In that case, starting tomorrow,\Number eight: Marie Mjolnir. response:	I punch Azusa.
context: I'm not going to joke about this.\That kid does have problems.\But, if we can give her some proper guidance, she'll become a fighting force of Shibusen.\But, what if she's not yet in the condition to attend Shibusen?\You're right...\In that case, starting tomorrow,\Number eight: Marie Mjolnir.\I punch Azusa. response:	Number nine: Marie Mjolnir.
context: That kid does have problems.\But, if we can give her some proper guidance, she'll become a fighting force of Shibusen.\But, what if she's not yet in the condition to attend Shibusen?\You're right...\In that case, starting tomorrow,\Number eight: Marie Mjolnir.\I punch Azusa.\Number nine: Marie Mjolnir. response:	I punch Azusa!
context: But, if we can give her some proper guidance, she'll become a fighting force of Shibusen.\But, what if she's not yet in the condition to attend Shibusen?\You're right...\In that case, starting tomorrow,\Number eight: Marie Mjolnir.\I punch Azusa.\Number nine: Marie Mjolnir.\I punch Azusa! response:	Number ten: Marie Mjolnir.
context: But, what if she's not yet in the condition to attend Shibusen?\You're right...\In that case, starting tomorrow,\Number eight: Marie Mjolnir.\I punch Azusa.\Number nine: Marie Mjolnir.\I punch Azusa!\Number ten: Marie Mjolnir. response:	I feel like sleeping already.
context: You're right...\In that case, starting tomorrow,\Number eight: Marie Mjolnir.\I punch Azusa.\Number nine: Marie Mjolnir.\I punch Azusa!\Number ten: Marie Mjolnir.\I feel like sleeping already. response:	Let's go! Marie Mjolnir Top-Ten Battles!
context: In that case, starting tomorrow,\Number eight: Marie Mjolnir.\I punch Azusa.\Number nine: Marie Mjolnir.\I punch Azusa!\Number ten: Marie Mjolnir.\I feel like sleeping already.\Let's go! Marie Mjolnir Top-Ten Battles! response:	Were you introduced to my charming points?
context: Number eight: Marie Mjolnir.\I punch Azusa.\Number nine: Marie Mjolnir.\I punch Azusa!\Number ten: Marie Mjolnir.\I feel like sleeping already.\Let's go! Marie Mjolnir Top-Ten Battles!\Were you introduced to my charming points? response:	I think what you introduced to people was your ridiculous strength.
context: I punch Azusa.\Number nine: Marie Mjolnir.\I punch Azusa!\Number ten: Marie Mjolnir.\I feel like sleeping already.\Let's go! Marie Mjolnir Top-Ten Battles!\Were you introduced to my charming points?\I think what you introduced to people was your ridiculous strength. response:	From now on, I think I'll use my adult charms to appeal with a bang!
context: Number nine: Marie Mjolnir.\I punch Azusa!\Number ten: Marie Mjolnir.\I feel like sleeping already.\Let's go! Marie Mjolnir Top-Ten Battles!\Were you introduced to my charming points?\I think what you introduced to people was your ridiculous strength.\From now on, I think I'll use my adult charms to appeal with a bang! response:	You mean you'll punch me with a bang...
context: I punch Azusa!\Number ten: Marie Mjolnir.\I feel like sleeping already.\Let's go! Marie Mjolnir Top-Ten Battles!\Were you introduced to my charming points?\I think what you introduced to people was your ridiculous strength.\From now on, I think I'll use my adult charms to appeal with a bang!\You mean you'll punch me with a bang... response:	That's just one aspect -
context: Number ten: Marie Mjolnir.\I feel like sleeping already.\Let's go! Marie Mjolnir Top-Ten Battles!\Were you introduced to my charming points?\I think what you introduced to people was your ridiculous strength.\From now on, I think I'll use my adult charms to appeal with a bang!\You mean you'll punch me with a bang...\That's just one aspect - response:	No, it's too late.
context: I feel like sleeping already.\Let's go! Marie Mjolnir Top-Ten Battles!\Were you introduced to my charming points?\I think what you introduced to people was your ridiculous strength.\From now on, I think I'll use my adult charms to appeal with a bang!\You mean you'll punch me with a bang...\That's just one aspect -\No, it's too late. response:	Senpai, you have been branded as a character with enormous strength.
context: Let's go! Marie Mjolnir Top-Ten Battles!\Were you introduced to my charming points?\I think what you introduced to people was your ridiculous strength.\From now on, I think I'll use my adult charms to appeal with a bang!\You mean you'll punch me with a bang...\That's just one aspect -\No, it's too late.\Senpai, you have been branded as a character with enormous strength. response:	Just because of that, Senpai will -
context: Were you introduced to my charming points?\I think what you introduced to people was your ridiculous strength.\From now on, I think I'll use my adult charms to appeal with a bang!\You mean you'll punch me with a bang...\That's just one aspect -\No, it's too late.\Senpai, you have been branded as a character with enormous strength.\Just because of that, Senpai will - response:	Punch Azusa!