context: The Scale Festival starts tomorrow, huh? response:	Everyone is really excited.
context: The Scale Festival starts tomorrow, huh?\Everyone is really excited. response:	It's our first festival in Akihabara, after all.
context: The Scale Festival starts tomorrow, huh?\Everyone is really excited.\It's our first festival in Akihabara, after all. response:	Since the festival was approved,
context: The Scale Festival starts tomorrow, huh?\Everyone is really excited.\It's our first festival in Akihabara, after all.\Since the festival was approved, response:	many guilds have been making special items for the event.
context: The Scale Festival starts tomorrow, huh?\Everyone is really excited.\It's our first festival in Akihabara, after all.\Since the festival was approved,\many guilds have been making special items for the event. response:	So it seems.
context: The Scale Festival starts tomorrow, huh?\Everyone is really excited.\It's our first festival in Akihabara, after all.\Since the festival was approved,\many guilds have been making special items for the event.\So it seems. response:	Licensed by the Round Table Princess Figures (Wood Carved)
context: The Scale Festival starts tomorrow, huh?\Everyone is really excited.\It's our first festival in Akihabara, after all.\Since the festival was approved,\many guilds have been making special items for the event.\So it seems.\Licensed by the Round Table Princess Figures (Wood Carved) response:	Only 40 of Each Design! 500 Gold
context: The Scale Festival starts tomorrow, huh?\Everyone is really excited.\It's our first festival in Akihabara, after all.\Since the festival was approved,\many guilds have been making special items for the event.\So it seems.\Licensed by the Round Table Princess Figures (Wood Carved)\Only 40 of Each Design! 500 Gold response:	Just hearing there's a festival makes a lot of people want to do something.
context: Everyone is really excited.\It's our first festival in Akihabara, after all.\Since the festival was approved,\many guilds have been making special items for the event.\So it seems.\Licensed by the Round Table Princess Figures (Wood Carved)\Only 40 of Each Design! 500 Gold\Just hearing there's a festival makes a lot of people want to do something. response:	Decorations?
context: It's our first festival in Akihabara, after all.\Since the festival was approved,\many guilds have been making special items for the event.\So it seems.\Licensed by the Round Table Princess Figures (Wood Carved)\Only 40 of Each Design! 500 Gold\Just hearing there's a festival makes a lot of people want to do something.\Decorations? response:	You've got quite a lot there.
context: Since the festival was approved,\many guilds have been making special items for the event.\So it seems.\Licensed by the Round Table Princess Figures (Wood Carved)\Only 40 of Each Design! 500 Gold\Just hearing there's a festival makes a lot of people want to do something.\Decorations?\You've got quite a lot there. response:	They won't even fit in my magic bag.
context: many guilds have been making special items for the event.\So it seems.\Licensed by the Round Table Princess Figures (Wood Carved)\Only 40 of Each Design! 500 Gold\Just hearing there's a festival makes a lot of people want to do something.\Decorations?\You've got quite a lot there.\They won't even fit in my magic bag. response:	The Crescent Moon Alliance will be selling winter clothes?
context: So it seems.\Licensed by the Round Table Princess Figures (Wood Carved)\Only 40 of Each Design! 500 Gold\Just hearing there's a festival makes a lot of people want to do something.\Decorations?\You've got quite a lot there.\They won't even fit in my magic bag.\The Crescent Moon Alliance will be selling winter clothes? response:	We're having a fashion show, as well.
context: Licensed by the Round Table Princess Figures (Wood Carved)\Only 40 of Each Design! 500 Gold\Just hearing there's a festival makes a lot of people want to do something.\Decorations?\You've got quite a lot there.\They won't even fit in my magic bag.\The Crescent Moon Alliance will be selling winter clothes?\We're having a fashion show, as well. response:	That sounds nice.
context: Only 40 of Each Design! 500 Gold\Just hearing there's a festival makes a lot of people want to do something.\Decorations?\You've got quite a lot there.\They won't even fit in my magic bag.\The Crescent Moon Alliance will be selling winter clothes?\We're having a fashion show, as well.\That sounds nice. response:	It starts tomorrow, so we're doing the final touches today.
context: Just hearing there's a festival makes a lot of people want to do something.\Decorations?\You've got quite a lot there.\They won't even fit in my magic bag.\The Crescent Moon Alliance will be selling winter clothes?\We're having a fashion show, as well.\That sounds nice.\It starts tomorrow, so we're doing the final touches today. response:	Don't work too hard.
context: Decorations?\You've got quite a lot there.\They won't even fit in my magic bag.\The Crescent Moon Alliance will be selling winter clothes?\We're having a fashion show, as well.\That sounds nice.\It starts tomorrow, so we're doing the final touches today.\Don't work too hard. response:	I heard Crescent Moon Burgers will be making their return.
context: You've got quite a lot there.\They won't even fit in my magic bag.\The Crescent Moon Alliance will be selling winter clothes?\We're having a fashion show, as well.\That sounds nice.\It starts tomorrow, so we're doing the final touches today.\Don't work too hard.\I heard Crescent Moon Burgers will be making their return. response:	That's right.
context: They won't even fit in my magic bag.\The Crescent Moon Alliance will be selling winter clothes?\We're having a fashion show, as well.\That sounds nice.\It starts tomorrow, so we're doing the final touches today.\Don't work too hard.\I heard Crescent Moon Burgers will be making their return.\That's right. response:	So, what will you be doing during the festival?
context: The Crescent Moon Alliance will be selling winter clothes?\We're having a fashion show, as well.\That sounds nice.\It starts tomorrow, so we're doing the final touches today.\Don't work too hard.\I heard Crescent Moon Burgers will be making their return.\That's right.\So, what will you be doing during the festival? response:	I'll be going around and enjoying all the different shops.
context: We're having a fashion show, as well.\That sounds nice.\It starts tomorrow, so we're doing the final touches today.\Don't work too hard.\I heard Crescent Moon Burgers will be making their return.\That's right.\So, what will you be doing during the festival?\I'll be going around and enjoying all the different shops. response:	I will eat...
context: That sounds nice.\It starts tomorrow, so we're doing the final touches today.\Don't work too hard.\I heard Crescent Moon Burgers will be making their return.\That's right.\So, what will you be doing during the festival?\I'll be going around and enjoying all the different shops.\I will eat... response:	And eat some more!
context: It starts tomorrow, so we're doing the final touches today.\Don't work too hard.\I heard Crescent Moon Burgers will be making their return.\That's right.\So, what will you be doing during the festival?\I'll be going around and enjoying all the different shops.\I will eat...\And eat some more! response:	And Akatsuki and the others?
context: Don't work too hard.\I heard Crescent Moon Burgers will be making their return.\That's right.\So, what will you be doing during the festival?\I'll be going around and enjoying all the different shops.\I will eat...\And eat some more!\And Akatsuki and the others? response:	Come to think of it, I didn't hear.
context: I heard Crescent Moon Burgers will be making their return.\That's right.\So, what will you be doing during the festival?\I'll be going around and enjoying all the different shops.\I will eat...\And eat some more!\And Akatsuki and the others?\Come to think of it, I didn't hear. response:	What'll the girls be doing?
context: That's right.\So, what will you be doing during the festival?\I'll be going around and enjoying all the different shops.\I will eat...\And eat some more!\And Akatsuki and the others?\Come to think of it, I didn't hear.\What'll the girls be doing? response:	Here, take one!
context: So, what will you be doing during the festival?\I'll be going around and enjoying all the different shops.\I will eat...\And eat some more!\And Akatsuki and the others?\Come to think of it, I didn't hear.\What'll the girls be doing?\Here, take one! response:	Please come as a couple!
context: I'll be going around and enjoying all the different shops.\I will eat...\And eat some more!\And Akatsuki and the others?\Come to think of it, I didn't hear.\What'll the girls be doing?\Here, take one!\Please come as a couple! response:	I have to invite Shiroe!
context: I will eat...\And eat some more!\And Akatsuki and the others?\Come to think of it, I didn't hear.\What'll the girls be doing?\Here, take one!\Please come as a couple!\I have to invite Shiroe! response:	All-You-Can-Eat Cake Buffet Come as a couple, and get in free!!
context: And eat some more!\And Akatsuki and the others?\Come to think of it, I didn't hear.\What'll the girls be doing?\Here, take one!\Please come as a couple!\I have to invite Shiroe!\All-You-Can-Eat Cake Buffet Come as a couple, and get in free!! response:	I've only made it this far because of you.
context: And Akatsuki and the others?\Come to think of it, I didn't hear.\What'll the girls be doing?\Here, take one!\Please come as a couple!\I have to invite Shiroe!\All-You-Can-Eat Cake Buffet Come as a couple, and get in free!!\I've only made it this far because of you. response:	It's true.
context: Come to think of it, I didn't hear.\What'll the girls be doing?\Here, take one!\Please come as a couple!\I have to invite Shiroe!\All-You-Can-Eat Cake Buffet Come as a couple, and get in free!!\I've only made it this far because of you.\It's true. response:	All-You-Can-Eat Cake Buffet Come as a couple, and get in free!!
context: What'll the girls be doing?\Here, take one!\Please come as a couple!\I have to invite Shiroe!\All-You-Can-Eat Cake Buffet Come as a couple, and get in free!!\I've only made it this far because of you.\It's true.\All-You-Can-Eat Cake Buffet Come as a couple, and get in free!! response:	I'm done with this!
context: Here, take one!\Please come as a couple!\I have to invite Shiroe!\All-You-Can-Eat Cake Buffet Come as a couple, and get in free!!\I've only made it this far because of you.\It's true.\All-You-Can-Eat Cake Buffet Come as a couple, and get in free!!\I'm done with this! response:	Swallow and Young Starling
context: Please come as a couple!\I have to invite Shiroe!\All-You-Can-Eat Cake Buffet Come as a couple, and get in free!!\I've only made it this far because of you.\It's true.\All-You-Can-Eat Cake Buffet Come as a couple, and get in free!!\I'm done with this!\Swallow and Young Starling response:	Swallow and Young Starling.
context: I have to invite Shiroe!\All-You-Can-Eat Cake Buffet Come as a couple, and get in free!!\I've only made it this far because of you.\It's true.\All-You-Can-Eat Cake Buffet Come as a couple, and get in free!!\I'm done with this!\Swallow and Young Starling\Swallow and Young Starling. response:	Shiroe...
context: All-You-Can-Eat Cake Buffet Come as a couple, and get in free!!\I've only made it this far because of you.\It's true.\All-You-Can-Eat Cake Buffet Come as a couple, and get in free!!\I'm done with this!\Swallow and Young Starling\Swallow and Young Starling.\Shiroe... response:	Shutting yourself up in here again?
context: I've only made it this far because of you.\It's true.\All-You-Can-Eat Cake Buffet Come as a couple, and get in free!!\I'm done with this!\Swallow and Young Starling\Swallow and Young Starling.\Shiroe...\Shutting yourself up in here again? response:	Handling the Round Table's paperwork, investigating this world...
context: It's true.\All-You-Can-Eat Cake Buffet Come as a couple, and get in free!!\I'm done with this!\Swallow and Young Starling\Swallow and Young Starling.\Shiroe...\Shutting yourself up in here again?\Handling the Round Table's paperwork, investigating this world... response:	Are you eating enough?
context: All-You-Can-Eat Cake Buffet Come as a couple, and get in free!!\I'm done with this!\Swallow and Young Starling\Swallow and Young Starling.\Shiroe...\Shutting yourself up in here again?\Handling the Round Table's paperwork, investigating this world...\Are you eating enough? response:	Sleeping enough?
context: I'm done with this!\Swallow and Young Starling\Swallow and Young Starling.\Shiroe...\Shutting yourself up in here again?\Handling the Round Table's paperwork, investigating this world...\Are you eating enough?\Sleeping enough? response:	Yes and yes.
context: Swallow and Young Starling\Swallow and Young Starling.\Shiroe...\Shutting yourself up in here again?\Handling the Round Table's paperwork, investigating this world...\Are you eating enough?\Sleeping enough?\Yes and yes. response:	I ate two hours ago, and I took a fifteen-minute nap.
context: Swallow and Young Starling.\Shiroe...\Shutting yourself up in here again?\Handling the Round Table's paperwork, investigating this world...\Are you eating enough?\Sleeping enough?\Yes and yes.\I ate two hours ago, and I took a fifteen-minute nap. response:	That's fine, then!
context: Shiroe...\Shutting yourself up in here again?\Handling the Round Table's paperwork, investigating this world...\Are you eating enough?\Sleeping enough?\Yes and yes.\I ate two hours ago, and I took a fifteen-minute nap.\That's fine, then! response:	Here is what you requested.
context: Shutting yourself up in here again?\Handling the Round Table's paperwork, investigating this world...\Are you eating enough?\Sleeping enough?\Yes and yes.\I ate two hours ago, and I took a fifteen-minute nap.\That's fine, then!\Here is what you requested. response:	Oh, thanks...
context: Handling the Round Table's paperwork, investigating this world...\Are you eating enough?\Sleeping enough?\Yes and yes.\I ate two hours ago, and I took a fifteen-minute nap.\That's fine, then!\Here is what you requested.\Oh, thanks... response:	You didn't need to bring it.
context: Are you eating enough?\Sleeping enough?\Yes and yes.\I ate two hours ago, and I took a fifteen-minute nap.\That's fine, then!\Here is what you requested.\Oh, thanks...\You didn't need to bring it. response:	If you had just sent a message, I would've come to get it.
context: Sleeping enough?\Yes and yes.\I ate two hours ago, and I took a fifteen-minute nap.\That's fine, then!\Here is what you requested.\Oh, thanks...\You didn't need to bring it.\If you had just sent a message, I would've come to get it. response:	So you say, but would you really have come?
context: Yes and yes.\I ate two hours ago, and I took a fifteen-minute nap.\That's fine, then!\Here is what you requested.\Oh, thanks...\You didn't need to bring it.\If you had just sent a message, I would've come to get it.\So you say, but would you really have come? response:	I've heard you've been locked in here for ages,
context: I ate two hours ago, and I took a fifteen-minute nap.\That's fine, then!\Here is what you requested.\Oh, thanks...\You didn't need to bring it.\If you had just sent a message, I would've come to get it.\So you say, but would you really have come?\I've heard you've been locked in here for ages, response:	so I wanted to check on you, too.
context: That's fine, then!\Here is what you requested.\Oh, thanks...\You didn't need to bring it.\If you had just sent a message, I would've come to get it.\So you say, but would you really have come?\I've heard you've been locked in here for ages,\so I wanted to check on you, too. response:	Thanks.
context: Here is what you requested.\Oh, thanks...\You didn't need to bring it.\If you had just sent a message, I would've come to get it.\So you say, but would you really have come?\I've heard you've been locked in here for ages,\so I wanted to check on you, too.\Thanks. response:	How's the Scale Festival looking?
context: Oh, thanks...\You didn't need to bring it.\If you had just sent a message, I would've come to get it.\So you say, but would you really have come?\I've heard you've been locked in here for ages,\so I wanted to check on you, too.\Thanks.\How's the Scale Festival looking? response:	Karashin's going all-out.
context: You didn't need to bring it.\If you had just sent a message, I would've come to get it.\So you say, but would you really have come?\I've heard you've been locked in here for ages,\so I wanted to check on you, too.\Thanks.\How's the Scale Festival looking?\Karashin's going all-out. response:	He's really taken charge of the event.
context: If you had just sent a message, I would've come to get it.\So you say, but would you really have come?\I've heard you've been locked in here for ages,\so I wanted to check on you, too.\Thanks.\How's the Scale Festival looking?\Karashin's going all-out.\He's really taken charge of the event. response:	He does good work.
context: So you say, but would you really have come?\I've heard you've been locked in here for ages,\so I wanted to check on you, too.\Thanks.\How's the Scale Festival looking?\Karashin's going all-out.\He's really taken charge of the event.\He does good work. response:	You should take a break for these next three days.
context: I've heard you've been locked in here for ages,\so I wanted to check on you, too.\Thanks.\How's the Scale Festival looking?\Karashin's going all-out.\He's really taken charge of the event.\He does good work.\You should take a break for these next three days. response:	Yeah...
context: so I wanted to check on you, too.\Thanks.\How's the Scale Festival looking?\Karashin's going all-out.\He's really taken charge of the event.\He does good work.\You should take a break for these next three days.\Yeah... response:	During the festival, it'll be pretty noisy,
context: Thanks.\How's the Scale Festival looking?\Karashin's going all-out.\He's really taken charge of the event.\He does good work.\You should take a break for these next three days.\Yeah...\During the festival, it'll be pretty noisy, response:	so I probably won't be able to concentrate...
context: How's the Scale Festival looking?\Karashin's going all-out.\He's really taken charge of the event.\He does good work.\You should take a break for these next three days.\Yeah...\During the festival, it'll be pretty noisy,\so I probably won't be able to concentrate... response:	That isn't why!
context: Karashin's going all-out.\He's really taken charge of the event.\He does good work.\You should take a break for these next three days.\Yeah...\During the festival, it'll be pretty noisy,\so I probably won't be able to concentrate...\That isn't why! response:	This is a good chance for you to become closer to your guildmates.
context: He's really taken charge of the event.\He does good work.\You should take a break for these next three days.\Yeah...\During the festival, it'll be pretty noisy,\so I probably won't be able to concentrate...\That isn't why!\This is a good chance for you to become closer to your guildmates. response:	And...
context: He does good work.\You should take a break for these next three days.\Yeah...\During the festival, it'll be pretty noisy,\so I probably won't be able to concentrate...\That isn't why!\This is a good chance for you to become closer to your guildmates.\And... response:	Log Horizon is one of the Round Table guilds.
context: You should take a break for these next three days.\Yeah...\During the festival, it'll be pretty noisy,\so I probably won't be able to concentrate...\That isn't why!\This is a good chance for you to become closer to your guildmates.\And...\Log Horizon is one of the Round Table guilds. response:	You'll be out there, making the event fun, right?
context: Yeah...\During the festival, it'll be pretty noisy,\so I probably won't be able to concentrate...\That isn't why!\This is a good chance for you to become closer to your guildmates.\And...\Log Horizon is one of the Round Table guilds.\You'll be out there, making the event fun, right? response:	I'll try.
context: During the festival, it'll be pretty noisy,\so I probably won't be able to concentrate...\That isn't why!\This is a good chance for you to become closer to your guildmates.\And...\Log Horizon is one of the Round Table guilds.\You'll be out there, making the event fun, right?\I'll try. response:	You'd better!
context: so I probably won't be able to concentrate...\That isn't why!\This is a good chance for you to become closer to your guildmates.\And...\Log Horizon is one of the Round Table guilds.\You'll be out there, making the event fun, right?\I'll try.\You'd better! response:	Right!
context: That isn't why!\This is a good chance for you to become closer to your guildmates.\And...\Log Horizon is one of the Round Table guilds.\You'll be out there, making the event fun, right?\I'll try.\You'd better!\Right! response:	Akatsuki and Minori are so cute, too.
context: This is a good chance for you to become closer to your guildmates.\And...\Log Horizon is one of the Round Table guilds.\You'll be out there, making the event fun, right?\I'll try.\You'd better!\Right!\Akatsuki and Minori are so cute, too. response:	I'm so excited already!
context: And...\Log Horizon is one of the Round Table guilds.\You'll be out there, making the event fun, right?\I'll try.\You'd better!\Right!\Akatsuki and Minori are so cute, too.\I'm so excited already! response:	What's that?
context: Log Horizon is one of the Round Table guilds.\You'll be out there, making the event fun, right?\I'll try.\You'd better!\Right!\Akatsuki and Minori are so cute, too.\I'm so excited already!\What's that? response:	An Akatsuki doll that Akatsuki gave me!
context: You'll be out there, making the event fun, right?\I'll try.\You'd better!\Right!\Akatsuki and Minori are so cute, too.\I'm so excited already!\What's that?\An Akatsuki doll that Akatsuki gave me! response:	A voodoo doll?
context: I'll try.\You'd better!\Right!\Akatsuki and Minori are so cute, too.\I'm so excited already!\What's that?\An Akatsuki doll that Akatsuki gave me!\A voodoo doll? response:	Truly, as long as I have my fantasies, I barely even need to eat!
context: You'd better!\Right!\Akatsuki and Minori are so cute, too.\I'm so excited already!\What's that?\An Akatsuki doll that Akatsuki gave me!\A voodoo doll?\Truly, as long as I have my fantasies, I barely even need to eat! response:	They say that man does not live by bread alone.
context: Right!\Akatsuki and Minori are so cute, too.\I'm so excited already!\What's that?\An Akatsuki doll that Akatsuki gave me!\A voodoo doll?\Truly, as long as I have my fantasies, I barely even need to eat!\They say that man does not live by bread alone. response:	But with bread and fantasies, you can get over almost anything!
context: Akatsuki and Minori are so cute, too.\I'm so excited already!\What's that?\An Akatsuki doll that Akatsuki gave me!\A voodoo doll?\Truly, as long as I have my fantasies, I barely even need to eat!\They say that man does not live by bread alone.\But with bread and fantasies, you can get over almost anything! response:	God almighty!
context: I'm so excited already!\What's that?\An Akatsuki doll that Akatsuki gave me!\A voodoo doll?\Truly, as long as I have my fantasies, I barely even need to eat!\They say that man does not live by bread alone.\But with bread and fantasies, you can get over almost anything!\God almighty! response:	You're just playing around, aren't you?
context: What's that?\An Akatsuki doll that Akatsuki gave me!\A voodoo doll?\Truly, as long as I have my fantasies, I barely even need to eat!\They say that man does not live by bread alone.\But with bread and fantasies, you can get over almost anything!\God almighty!\You're just playing around, aren't you? response:	She's right... During the festival, it'll be hard to do much.
context: An Akatsuki doll that Akatsuki gave me!\A voodoo doll?\Truly, as long as I have my fantasies, I barely even need to eat!\They say that man does not live by bread alone.\But with bread and fantasies, you can get over almost anything!\God almighty!\You're just playing around, aren't you?\She's right... During the festival, it'll be hard to do much. response:	When reports come in, I'll have to do some fancy footwork,
context: A voodoo doll?\Truly, as long as I have my fantasies, I barely even need to eat!\They say that man does not live by bread alone.\But with bread and fantasies, you can get over almost anything!\God almighty!\You're just playing around, aren't you?\She's right... During the festival, it'll be hard to do much.\When reports come in, I'll have to do some fancy footwork, response:	so I'll end up waiting, anyway.
context: Truly, as long as I have my fantasies, I barely even need to eat!\They say that man does not live by bread alone.\But with bread and fantasies, you can get over almost anything!\God almighty!\You're just playing around, aren't you?\She's right... During the festival, it'll be hard to do much.\When reports come in, I'll have to do some fancy footwork,\so I'll end up waiting, anyway. response:	Since then, nothing has happened in Minami...
context: They say that man does not live by bread alone.\But with bread and fantasies, you can get over almost anything!\God almighty!\You're just playing around, aren't you?\She's right... During the festival, it'll be hard to do much.\When reports come in, I'll have to do some fancy footwork,\so I'll end up waiting, anyway.\Since then, nothing has happened in Minami... response:	M-My lord...
context: But with bread and fantasies, you can get over almost anything!\God almighty!\You're just playing around, aren't you?\She's right... During the festival, it'll be hard to do much.\When reports come in, I'll have to do some fancy footwork,\so I'll end up waiting, anyway.\Since then, nothing has happened in Minami...\M-My lord... response:	Has something happened?
context: God almighty!\You're just playing around, aren't you?\She's right... During the festival, it'll be hard to do much.\When reports come in, I'll have to do some fancy footwork,\so I'll end up waiting, anyway.\Since then, nothing has happened in Minami...\M-My lord...\Has something happened? response:	No... Well...
context: You're just playing around, aren't you?\She's right... During the festival, it'll be hard to do much.\When reports come in, I'll have to do some fancy footwork,\so I'll end up waiting, anyway.\Since then, nothing has happened in Minami...\M-My lord...\Has something happened?\No... Well... response:	You want a red bean bun?
context: She's right... During the festival, it'll be hard to do much.\When reports come in, I'll have to do some fancy footwork,\so I'll end up waiting, anyway.\Since then, nothing has happened in Minami...\M-My lord...\Has something happened?\No... Well...\You want a red bean bun? response:	Red Bean Buns
context: When reports come in, I'll have to do some fancy footwork,\so I'll end up waiting, anyway.\Since then, nothing has happened in Minami...\M-My lord...\Has something happened?\No... Well...\You want a red bean bun?\Red Bean Buns response:	Eh?
context: so I'll end up waiting, anyway.\Since then, nothing has happened in Minami...\M-My lord...\Has something happened?\No... Well...\You want a red bean bun?\Red Bean Buns\Eh? response:	Great weather today!
context: Since then, nothing has happened in Minami...\M-My lord...\Has something happened?\No... Well...\You want a red bean bun?\Red Bean Buns\Eh?\Great weather today! response:	It feels like forever since I was outside.
context: M-My lord...\Has something happened?\No... Well...\You want a red bean bun?\Red Bean Buns\Eh?\Great weather today!\It feels like forever since I was outside. response:	This is for you.
context: Has something happened?\No... Well...\You want a red bean bun?\Red Bean Buns\Eh?\Great weather today!\It feels like forever since I was outside.\This is for you. response:	You're sure?
context: No... Well...\You want a red bean bun?\Red Bean Buns\Eh?\Great weather today!\It feels like forever since I was outside.\This is for you.\You're sure? response:	In this world, red bean buns are expensive.
context: You want a red bean bun?\Red Bean Buns\Eh?\Great weather today!\It feels like forever since I was outside.\This is for you.\You're sure?\In this world, red bean buns are expensive. response:	I want you to eat them.
context: Red Bean Buns\Eh?\Great weather today!\It feels like forever since I was outside.\This is for you.\You're sure?\In this world, red bean buns are expensive.\I want you to eat them. response:	Thank you.
context: Eh?\Great weather today!\It feels like forever since I was outside.\This is for you.\You're sure?\In this world, red bean buns are expensive.\I want you to eat them.\Thank you. response:	Delicious...
context: Great weather today!\It feels like forever since I was outside.\This is for you.\You're sure?\In this world, red bean buns are expensive.\I want you to eat them.\Thank you.\Delicious... response:	It's been a long time since I've had one.
context: It feels like forever since I was outside.\This is for you.\You're sure?\In this world, red bean buns are expensive.\I want you to eat them.\Thank you.\Delicious...\It's been a long time since I've had one. response:	Wh-What?
context: This is for you.\You're sure?\In this world, red bean buns are expensive.\I want you to eat them.\Thank you.\Delicious...\It's been a long time since I've had one.\Wh-What? response:	There's bean paste on your mouth.
context: You're sure?\In this world, red bean buns are expensive.\I want you to eat them.\Thank you.\Delicious...\It's been a long time since I've had one.\Wh-What?\There's bean paste on your mouth. response:	Oh, thanks.
context: In this world, red bean buns are expensive.\I want you to eat them.\Thank you.\Delicious...\It's been a long time since I've had one.\Wh-What?\There's bean paste on your mouth.\Oh, thanks. response:	Lately, you've looked pale.
context: I want you to eat them.\Thank you.\Delicious...\It's been a long time since I've had one.\Wh-What?\There's bean paste on your mouth.\Oh, thanks.\Lately, you've looked pale. response:	That isn't true.
context: Thank you.\Delicious...\It's been a long time since I've had one.\Wh-What?\There's bean paste on your mouth.\Oh, thanks.\Lately, you've looked pale.\That isn't true. response:	Really?
context: Delicious...\It's been a long time since I've had one.\Wh-What?\There's bean paste on your mouth.\Oh, thanks.\Lately, you've looked pale.\That isn't true.\Really? response:	M-My lord...
context: It's been a long time since I've had one.\Wh-What?\There's bean paste on your mouth.\Oh, thanks.\Lately, you've looked pale.\That isn't true.\Really?\M-My lord... response:	What's gotten into you?
context: Wh-What?\There's bean paste on your mouth.\Oh, thanks.\Lately, you've looked pale.\That isn't true.\Really?\M-My lord...\What's gotten into you? response:	What are you going to do during the festival?
context: There's bean paste on your mouth.\Oh, thanks.\Lately, you've looked pale.\That isn't true.\Really?\M-My lord...\What's gotten into you?\What are you going to do during the festival? response:	The festival?
context: Oh, thanks.\Lately, you've looked pale.\That isn't true.\Really?\M-My lord...\What's gotten into you?\What are you going to do during the festival?\The festival? response:	Oh, I'll probably have to help with things.
context: Lately, you've looked pale.\That isn't true.\Really?\M-My lord...\What's gotten into you?\What are you going to do during the festival?\The festival?\Oh, I'll probably have to help with things. response:	Henrietta asked me to.
context: That isn't true.\Really?\M-My lord...\What's gotten into you?\What are you going to do during the festival?\The festival?\Oh, I'll probably have to help with things.\Henrietta asked me to. response:	I see...
context: Really?\M-My lord...\What's gotten into you?\What are you going to do during the festival?\The festival?\Oh, I'll probably have to help with things.\Henrietta asked me to.\I see... response:	No, I mean...
context: M-My lord...\What's gotten into you?\What are you going to do during the festival?\The festival?\Oh, I'll probably have to help with things.\Henrietta asked me to.\I see...\No, I mean... response:	My lord, do you like c-c-ca...
context: What's gotten into you?\What are you going to do during the festival?\The festival?\Oh, I'll probably have to help with things.\Henrietta asked me to.\I see...\No, I mean...\My lord, do you like c-c-ca... response:	All-You-Can-Eat Cake Buffet Come as a couple, and get in free!!
context: What are you going to do during the festival?\The festival?\Oh, I'll probably have to help with things.\Henrietta asked me to.\I see...\No, I mean...\My lord, do you like c-c-ca...\All-You-Can-Eat Cake Buffet Come as a couple, and get in free!! response:	Voila!
context: The festival?\Oh, I'll probably have to help with things.\Henrietta asked me to.\I see...\No, I mean...\My lord, do you like c-c-ca...\All-You-Can-Eat Cake Buffet Come as a couple, and get in free!!\Voila! response:	What is that?
context: Oh, I'll probably have to help with things.\Henrietta asked me to.\I see...\No, I mean...\My lord, do you like c-c-ca...\All-You-Can-Eat Cake Buffet Come as a couple, and get in free!!\Voila!\What is that? response:	So, about the Scale Festival tomorrow...
context: Henrietta asked me to.\I see...\No, I mean...\My lord, do you like c-c-ca...\All-You-Can-Eat Cake Buffet Come as a couple, and get in free!!\Voila!\What is that?\So, about the Scale Festival tomorrow... response:	Would you go to this with me?
context: I see...\No, I mean...\My lord, do you like c-c-ca...\All-You-Can-Eat Cake Buffet Come as a couple, and get in free!!\Voila!\What is that?\So, about the Scale Festival tomorrow...\Would you go to this with me? response:	A cake buffet?
context: No, I mean...\My lord, do you like c-c-ca...\All-You-Can-Eat Cake Buffet Come as a couple, and get in free!!\Voila!\What is that?\So, about the Scale Festival tomorrow...\Would you go to this with me?\A cake buffet? response:	You enjoy sweets, don't you?
context: My lord, do you like c-c-ca...\All-You-Can-Eat Cake Buffet Come as a couple, and get in free!!\Voila!\What is that?\So, about the Scale Festival tomorrow...\Would you go to this with me?\A cake buffet?\You enjoy sweets, don't you? response:	From the way he eats his red bean buns, that would seem to be true.
context: All-You-Can-Eat Cake Buffet Come as a couple, and get in free!!\Voila!\What is that?\So, about the Scale Festival tomorrow...\Would you go to this with me?\A cake buffet?\You enjoy sweets, don't you?\From the way he eats his red bean buns, that would seem to be true. response:	I certainly don't dislike them...
context: Voila!\What is that?\So, about the Scale Festival tomorrow...\Would you go to this with me?\A cake buffet?\You enjoy sweets, don't you?\From the way he eats his red bean buns, that would seem to be true.\I certainly don't dislike them... response:	Let us go, my lord.
context: What is that?\So, about the Scale Festival tomorrow...\Would you go to this with me?\A cake buffet?\You enjoy sweets, don't you?\From the way he eats his red bean buns, that would seem to be true.\I certainly don't dislike them...\Let us go, my lord. response:	If we go as a couple, it's free!
context: So, about the Scale Festival tomorrow...\Would you go to this with me?\A cake buffet?\You enjoy sweets, don't you?\From the way he eats his red bean buns, that would seem to be true.\I certainly don't dislike them...\Let us go, my lord.\If we go as a couple, it's free! response:	It's free! Totally free!
context: Would you go to this with me?\A cake buffet?\You enjoy sweets, don't you?\From the way he eats his red bean buns, that would seem to be true.\I certainly don't dislike them...\Let us go, my lord.\If we go as a couple, it's free!\It's free! Totally free! response:	Let's go!
context: A cake buffet?\You enjoy sweets, don't you?\From the way he eats his red bean buns, that would seem to be true.\I certainly don't dislike them...\Let us go, my lord.\If we go as a couple, it's free!\It's free! Totally free!\Let's go! response:	Um...
context: You enjoy sweets, don't you?\From the way he eats his red bean buns, that would seem to be true.\I certainly don't dislike them...\Let us go, my lord.\If we go as a couple, it's free!\It's free! Totally free!\Let's go!\Um... response:	Shiroe!
context: From the way he eats his red bean buns, that would seem to be true.\I certainly don't dislike them...\Let us go, my lord.\If we go as a couple, it's free!\It's free! Totally free!\Let's go!\Um...\Shiroe! response:	My lord!
context: I certainly don't dislike them...\Let us go, my lord.\If we go as a couple, it's free!\It's free! Totally free!\Let's go!\Um...\Shiroe!\My lord! response:	This is a problem.
context: Let us go, my lord.\If we go as a couple, it's free!\It's free! Totally free!\Let's go!\Um...\Shiroe!\My lord!\This is a problem. response:	What should I do?
context: If we go as a couple, it's free!\It's free! Totally free!\Let's go!\Um...\Shiroe!\My lord!\This is a problem.\What should I do? response:	I know.
context: It's free! Totally free!\Let's go!\Um...\Shiroe!\My lord!\This is a problem.\What should I do?\I know. response:	Maybe not this...
context: Let's go!\Um...\Shiroe!\My lord!\This is a problem.\What should I do?\I know.\Maybe not this... response:	Minori!
context: Um...\Shiroe!\My lord!\This is a problem.\What should I do?\I know.\Maybe not this...\Minori! response:	There's a pre-festival dance tonight.
context: Shiroe!\My lord!\This is a problem.\What should I do?\I know.\Maybe not this...\Minori!\There's a pre-festival dance tonight. response:	Wanna come with...
context: My lord!\This is a problem.\What should I do?\I know.\Maybe not this...\Minori!\There's a pre-festival dance tonight.\Wanna come with... response:	Uh, what are you doing?
context: This is a problem.\What should I do?\I know.\Maybe not this...\Minori!\There's a pre-festival dance tonight.\Wanna come with...\Uh, what are you doing? response:	I'll be going out with Shiroe tomorrow,
context: What should I do?\I know.\Maybe not this...\Minori!\There's a pre-festival dance tonight.\Wanna come with...\Uh, what are you doing?\I'll be going out with Shiroe tomorrow, response:	but I'm not sure what to wear.
context: I know.\Maybe not this...\Minori!\There's a pre-festival dance tonight.\Wanna come with...\Uh, what are you doing?\I'll be going out with Shiroe tomorrow,\but I'm not sure what to wear. response:	Going out?
context: Maybe not this...\Minori!\There's a pre-festival dance tonight.\Wanna come with...\Uh, what are you doing?\I'll be going out with Shiroe tomorrow,\but I'm not sure what to wear.\Going out? response:	With Shiroe, the shut-in?!
context: Minori!\There's a pre-festival dance tonight.\Wanna come with...\Uh, what are you doing?\I'll be going out with Shiroe tomorrow,\but I'm not sure what to wear.\Going out?\With Shiroe, the shut-in?! response:	I don't think I've seen him outside for a week.
context: There's a pre-festival dance tonight.\Wanna come with...\Uh, what are you doing?\I'll be going out with Shiroe tomorrow,\but I'm not sure what to wear.\Going out?\With Shiroe, the shut-in?!\I don't think I've seen him outside for a week. response:	So, where are you going?
context: Wanna come with...\Uh, what are you doing?\I'll be going out with Shiroe tomorrow,\but I'm not sure what to wear.\Going out?\With Shiroe, the shut-in?!\I don't think I've seen him outside for a week.\So, where are you going? response:	A cake buffet.
context: Uh, what are you doing?\I'll be going out with Shiroe tomorrow,\but I'm not sure what to wear.\Going out?\With Shiroe, the shut-in?!\I don't think I've seen him outside for a week.\So, where are you going?\A cake buffet. response:	Shiroe, eating cake?
context: I'll be going out with Shiroe tomorrow,\but I'm not sure what to wear.\Going out?\With Shiroe, the shut-in?!\I don't think I've seen him outside for a week.\So, where are you going?\A cake buffet.\Shiroe, eating cake? response:	Why?
context: but I'm not sure what to wear.\Going out?\With Shiroe, the shut-in?!\I don't think I've seen him outside for a week.\So, where are you going?\A cake buffet.\Shiroe, eating cake?\Why? response:	Well, if you win this contest,
context: Going out?\With Shiroe, the shut-in?!\I don't think I've seen him outside for a week.\So, where are you going?\A cake buffet.\Shiroe, eating cake?\Why?\Well, if you win this contest, response:	you get two tickets to the Twilight Banquet with Princess Lenessia on the second day.
context: With Shiroe, the shut-in?!\I don't think I've seen him outside for a week.\So, where are you going?\A cake buffet.\Shiroe, eating cake?\Why?\Well, if you win this contest,\you get two tickets to the Twilight Banquet with Princess Lenessia on the second day. response:	Participants compete to see who can eat the most slices! The top two teams advance to the final battle!
context: I don't think I've seen him outside for a week.\So, where are you going?\A cake buffet.\Shiroe, eating cake?\Why?\Well, if you win this contest,\you get two tickets to the Twilight Banquet with Princess Lenessia on the second day.\Participants compete to see who can eat the most slices! The top two teams advance to the final battle! response:	No one trusts Shiroe. They say they don't know what he's thinking...
context: So, where are you going?\A cake buffet.\Shiroe, eating cake?\Why?\Well, if you win this contest,\you get two tickets to the Twilight Banquet with Princess Lenessia on the second day.\Participants compete to see who can eat the most slices! The top two teams advance to the final battle!\No one trusts Shiroe. They say they don't know what he's thinking... response:	But he's actually really nice.
context: A cake buffet.\Shiroe, eating cake?\Why?\Well, if you win this contest,\you get two tickets to the Twilight Banquet with Princess Lenessia on the second day.\Participants compete to see who can eat the most slices! The top two teams advance to the final battle!\No one trusts Shiroe. They say they don't know what he's thinking...\But he's actually really nice. response:	I'm sad that they don't understand him.
context: Shiroe, eating cake?\Why?\Well, if you win this contest,\you get two tickets to the Twilight Banquet with Princess Lenessia on the second day.\Participants compete to see who can eat the most slices! The top two teams advance to the final battle!\No one trusts Shiroe. They say they don't know what he's thinking...\But he's actually really nice.\I'm sad that they don't understand him. response:	I want them all to know more about him.
context: Why?\Well, if you win this contest,\you get two tickets to the Twilight Banquet with Princess Lenessia on the second day.\Participants compete to see who can eat the most slices! The top two teams advance to the final battle!\No one trusts Shiroe. They say they don't know what he's thinking...\But he's actually really nice.\I'm sad that they don't understand him.\I want them all to know more about him. response:	I understand!
context: Well, if you win this contest,\you get two tickets to the Twilight Banquet with Princess Lenessia on the second day.\Participants compete to see who can eat the most slices! The top two teams advance to the final battle!\No one trusts Shiroe. They say they don't know what he's thinking...\But he's actually really nice.\I'm sad that they don't understand him.\I want them all to know more about him.\I understand! response:	Okay! Got it!
context: you get two tickets to the Twilight Banquet with Princess Lenessia on the second day.\Participants compete to see who can eat the most slices! The top two teams advance to the final battle!\No one trusts Shiroe. They say they don't know what he's thinking...\But he's actually really nice.\I'm sad that they don't understand him.\I want them all to know more about him.\I understand!\Okay! Got it! response:	I'll help you!
context: Participants compete to see who can eat the most slices! The top two teams advance to the final battle!\No one trusts Shiroe. They say they don't know what he's thinking...\But he's actually really nice.\I'm sad that they don't understand him.\I want them all to know more about him.\I understand!\Okay! Got it!\I'll help you! response:	I'll coordinate your outfit!
context: No one trusts Shiroe. They say they don't know what he's thinking...\But he's actually really nice.\I'm sad that they don't understand him.\I want them all to know more about him.\I understand!\Okay! Got it!\I'll help you!\I'll coordinate your outfit! response:	Really? Thanks!
context: But he's actually really nice.\I'm sad that they don't understand him.\I want them all to know more about him.\I understand!\Okay! Got it!\I'll help you!\I'll coordinate your outfit!\Really? Thanks! response:	Why does Minori have to put pressure on me?
context: I'm sad that they don't understand him.\I want them all to know more about him.\I understand!\Okay! Got it!\I'll help you!\I'll coordinate your outfit!\Really? Thanks!\Why does Minori have to put pressure on me? response:	My rival is a middle-schooler?
context: I want them all to know more about him.\I understand!\Okay! Got it!\I'll help you!\I'll coordinate your outfit!\Really? Thanks!\Why does Minori have to put pressure on me?\My rival is a middle-schooler? response:	Even if he does normally treat me like a kid, this doesn't seem fair...
context: I understand!\Okay! Got it!\I'll help you!\I'll coordinate your outfit!\Really? Thanks!\Why does Minori have to put pressure on me?\My rival is a middle-schooler?\Even if he does normally treat me like a kid, this doesn't seem fair... response:	Is it my lord's fault for treating me as a kid?
context: Okay! Got it!\I'll help you!\I'll coordinate your outfit!\Really? Thanks!\Why does Minori have to put pressure on me?\My rival is a middle-schooler?\Even if he does normally treat me like a kid, this doesn't seem fair...\Is it my lord's fault for treating me as a kid? response:	Is it?
context: I'll help you!\I'll coordinate your outfit!\Really? Thanks!\Why does Minori have to put pressure on me?\My rival is a middle-schooler?\Even if he does normally treat me like a kid, this doesn't seem fair...\Is it my lord's fault for treating me as a kid?\Is it? response:	But...
context: I'll coordinate your outfit!\Really? Thanks!\Why does Minori have to put pressure on me?\My rival is a middle-schooler?\Even if he does normally treat me like a kid, this doesn't seem fair...\Is it my lord's fault for treating me as a kid?\Is it?\But... response:	My lord didn't judge me based on my appearance or level.
context: Really? Thanks!\Why does Minori have to put pressure on me?\My rival is a middle-schooler?\Even if he does normally treat me like a kid, this doesn't seem fair...\Is it my lord's fault for treating me as a kid?\Is it?\But...\My lord didn't judge me based on my appearance or level. response:	He accepted me for who I am...
context: Why does Minori have to put pressure on me?\My rival is a middle-schooler?\Even if he does normally treat me like a kid, this doesn't seem fair...\Is it my lord's fault for treating me as a kid?\Is it?\But...\My lord didn't judge me based on my appearance or level.\He accepted me for who I am... response:	My lord said he'd attend the buffet with both Minori and me.
context: My rival is a middle-schooler?\Even if he does normally treat me like a kid, this doesn't seem fair...\Is it my lord's fault for treating me as a kid?\Is it?\But...\My lord didn't judge me based on my appearance or level.\He accepted me for who I am...\My lord said he'd attend the buffet with both Minori and me. response:	But it's supposed to be a couple, so we'll probably be alone...
context: Even if he does normally treat me like a kid, this doesn't seem fair...\Is it my lord's fault for treating me as a kid?\Is it?\But...\My lord didn't judge me based on my appearance or level.\He accepted me for who I am...\My lord said he'd attend the buffet with both Minori and me.\But it's supposed to be a couple, so we'll probably be alone... response:	Is this situation...
context: Is it my lord's fault for treating me as a kid?\Is it?\But...\My lord didn't judge me based on my appearance or level.\He accepted me for who I am...\My lord said he'd attend the buffet with both Minori and me.\But it's supposed to be a couple, so we'll probably be alone...\Is this situation... response:	Impossible...
context: Is it?\But...\My lord didn't judge me based on my appearance or level.\He accepted me for who I am...\My lord said he'd attend the buffet with both Minori and me.\But it's supposed to be a couple, so we'll probably be alone...\Is this situation...\Impossible... response:	Impossible!
context: But...\My lord didn't judge me based on my appearance or level.\He accepted me for who I am...\My lord said he'd attend the buffet with both Minori and me.\But it's supposed to be a couple, so we'll probably be alone...\Is this situation...\Impossible...\Impossible! response:	And what will I wear?!
context: My lord didn't judge me based on my appearance or level.\He accepted me for who I am...\My lord said he'd attend the buffet with both Minori and me.\But it's supposed to be a couple, so we'll probably be alone...\Is this situation...\Impossible...\Impossible!\And what will I wear?! response:	What do you suppose is going on?
context: He accepted me for who I am...\My lord said he'd attend the buffet with both Minori and me.\But it's supposed to be a couple, so we'll probably be alone...\Is this situation...\Impossible...\Impossible!\And what will I wear?!\What do you suppose is going on? response:	It's getting lively around here.
context: My lord said he'd attend the buffet with both Minori and me.\But it's supposed to be a couple, so we'll probably be alone...\Is this situation...\Impossible...\Impossible!\And what will I wear?!\What do you suppose is going on?\It's getting lively around here. response:	I have no cute clothes.
context: But it's supposed to be a couple, so we'll probably be alone...\Is this situation...\Impossible...\Impossible!\And what will I wear?!\What do you suppose is going on?\It's getting lively around here.\I have no cute clothes. response:	What am I going to wear?
context: Is this situation...\Impossible...\Impossible!\And what will I wear?!\What do you suppose is going on?\It's getting lively around here.\I have no cute clothes.\What am I going to wear? response:	Oh, I'll ask someone to help me.
context: Impossible...\Impossible!\And what will I wear?!\What do you suppose is going on?\It's getting lively around here.\I have no cute clothes.\What am I going to wear?\Oh, I'll ask someone to help me. response:	What's happened?
context: Impossible!\And what will I wear?!\What do you suppose is going on?\It's getting lively around here.\I have no cute clothes.\What am I going to wear?\Oh, I'll ask someone to help me.\What's happened? response:	I felt it...
context: And what will I wear?!\What do you suppose is going on?\It's getting lively around here.\I have no cute clothes.\What am I going to wear?\Oh, I'll ask someone to help me.\What's happened?\I felt it... response:	Akatsuki needs my help!
context: What do you suppose is going on?\It's getting lively around here.\I have no cute clothes.\What am I going to wear?\Oh, I'll ask someone to help me.\What's happened?\I felt it...\Akatsuki needs my help! response:	Akatsuki!
context: It's getting lively around here.\I have no cute clothes.\What am I going to wear?\Oh, I'll ask someone to help me.\What's happened?\I felt it...\Akatsuki needs my help!\Akatsuki! response:	I'll pick something myself...
context: I have no cute clothes.\What am I going to wear?\Oh, I'll ask someone to help me.\What's happened?\I felt it...\Akatsuki needs my help!\Akatsuki!\I'll pick something myself... response:	Crafting Guild Council Office Knock First!!
context: What am I going to wear?\Oh, I'll ask someone to help me.\What's happened?\I felt it...\Akatsuki needs my help!\Akatsuki!\I'll pick something myself...\Crafting Guild Council Office Knock First!! response:	No, no...
context: Oh, I'll ask someone to help me.\What's happened?\I felt it...\Akatsuki needs my help!\Akatsuki!\I'll pick something myself...\Crafting Guild Council Office Knock First!!\No, no... response:	That's going to be expensive.
context: What's happened?\I felt it...\Akatsuki needs my help!\Akatsuki!\I'll pick something myself...\Crafting Guild Council Office Knock First!!\No, no...\That's going to be expensive. response:	No, I'm afraid not.
context: I felt it...\Akatsuki needs my help!\Akatsuki!\I'll pick something myself...\Crafting Guild Council Office Knock First!!\No, no...\That's going to be expensive.\No, I'm afraid not. response:	The Council doesn't play favorites.
context: Akatsuki needs my help!\Akatsuki!\I'll pick something myself...\Crafting Guild Council Office Knock First!!\No, no...\That's going to be expensive.\No, I'm afraid not.\The Council doesn't play favorites. response:	Your location is determined by lottery.
context: Akatsuki!\I'll pick something myself...\Crafting Guild Council Office Knock First!!\No, no...\That's going to be expensive.\No, I'm afraid not.\The Council doesn't play favorites.\Your location is determined by lottery. response:	We must adhere to that.
context: I'll pick something myself...\Crafting Guild Council Office Knock First!!\No, no...\That's going to be expensive.\No, I'm afraid not.\The Council doesn't play favorites.\Your location is determined by lottery.\We must adhere to that. response:	Hey, you're doing all that yourself?
context: Crafting Guild Council Office Knock First!!\No, no...\That's going to be expensive.\No, I'm afraid not.\The Council doesn't play favorites.\Your location is determined by lottery.\We must adhere to that.\Hey, you're doing all that yourself? response:	I don't have a choice.
context: No, no...\That's going to be expensive.\No, I'm afraid not.\The Council doesn't play favorites.\Your location is determined by lottery.\We must adhere to that.\Hey, you're doing all that yourself?\I don't have a choice. response:	This place is like a business congress.
context: That's going to be expensive.\No, I'm afraid not.\The Council doesn't play favorites.\Your location is determined by lottery.\We must adhere to that.\Hey, you're doing all that yourself?\I don't have a choice.\This place is like a business congress. response:	Then, are these all...
context: No, I'm afraid not.\The Council doesn't play favorites.\Your location is determined by lottery.\We must adhere to that.\Hey, you're doing all that yourself?\I don't have a choice.\This place is like a business congress.\Then, are these all... response:	I asked everyone to submit them
context: The Council doesn't play favorites.\Your location is determined by lottery.\We must adhere to that.\Hey, you're doing all that yourself?\I don't have a choice.\This place is like a business congress.\Then, are these all...\I asked everyone to submit them response:	so I could check for any dangerous items.
context: Your location is determined by lottery.\We must adhere to that.\Hey, you're doing all that yourself?\I don't have a choice.\This place is like a business congress.\Then, are these all...\I asked everyone to submit them\so I could check for any dangerous items. response:	It's a terrifying amount.
context: We must adhere to that.\Hey, you're doing all that yourself?\I don't have a choice.\This place is like a business congress.\Then, are these all...\I asked everyone to submit them\so I could check for any dangerous items.\It's a terrifying amount. response:	Isn't it?
context: Hey, you're doing all that yourself?\I don't have a choice.\This place is like a business congress.\Then, are these all...\I asked everyone to submit them\so I could check for any dangerous items.\It's a terrifying amount.\Isn't it? response:	The People of the Land's merchants are also coming.
context: I don't have a choice.\This place is like a business congress.\Then, are these all...\I asked everyone to submit them\so I could check for any dangerous items.\It's a terrifying amount.\Isn't it?\The People of the Land's merchants are also coming. response:	I'm getting the sense that the festival is a lot bigger than it should be.
context: This place is like a business congress.\Then, are these all...\I asked everyone to submit them\so I could check for any dangerous items.\It's a terrifying amount.\Isn't it?\The People of the Land's merchants are also coming.\I'm getting the sense that the festival is a lot bigger than it should be. response:	The next few days are gonna be hell...
context: Then, are these all...\I asked everyone to submit them\so I could check for any dangerous items.\It's a terrifying amount.\Isn't it?\The People of the Land's merchants are also coming.\I'm getting the sense that the festival is a lot bigger than it should be.\The next few days are gonna be hell... response:	Huh?
context: I asked everyone to submit them\so I could check for any dangerous items.\It's a terrifying amount.\Isn't it?\The People of the Land's merchants are also coming.\I'm getting the sense that the festival is a lot bigger than it should be.\The next few days are gonna be hell...\Huh? response:	When did you get here?
context: so I could check for any dangerous items.\It's a terrifying amount.\Isn't it?\The People of the Land's merchants are also coming.\I'm getting the sense that the festival is a lot bigger than it should be.\The next few days are gonna be hell...\Huh?\When did you get here? response:	Please help.
context: It's a terrifying amount.\Isn't it?\The People of the Land's merchants are also coming.\I'm getting the sense that the festival is a lot bigger than it should be.\The next few days are gonna be hell...\Huh?\When did you get here?\Please help. response:	This is rare.
context: Isn't it?\The People of the Land's merchants are also coming.\I'm getting the sense that the festival is a lot bigger than it should be.\The next few days are gonna be hell...\Huh?\When did you get here?\Please help.\This is rare. response:	Are you alone?
context: The People of the Land's merchants are also coming.\I'm getting the sense that the festival is a lot bigger than it should be.\The next few days are gonna be hell...\Huh?\When did you get here?\Please help.\This is rare.\Are you alone? response:	What's wrong?
context: I'm getting the sense that the festival is a lot bigger than it should be.\The next few days are gonna be hell...\Huh?\When did you get here?\Please help.\This is rare.\Are you alone?\What's wrong? response:	Huh?
context: The next few days are gonna be hell...\Huh?\When did you get here?\Please help.\This is rare.\Are you alone?\What's wrong?\Huh? response:	Shiroe, of Log Horizon...
context: Huh?\When did you get here?\Please help.\This is rare.\Are you alone?\What's wrong?\Huh?\Shiroe, of Log Horizon... response:	And two others?
context: When did you get here?\Please help.\This is rare.\Are you alone?\What's wrong?\Huh?\Shiroe, of Log Horizon...\And two others? response:	Yes.
context: Please help.\This is rare.\Are you alone?\What's wrong?\Huh?\Shiroe, of Log Horizon...\And two others?\Yes. response:	Sorry to ask this of you...
context: This is rare.\Are you alone?\What's wrong?\Huh?\Shiroe, of Log Horizon...\And two others?\Yes.\Sorry to ask this of you... response:	Oh, if that's the case, I understand.
context: Are you alone?\What's wrong?\Huh?\Shiroe, of Log Horizon...\And two others?\Yes.\Sorry to ask this of you...\Oh, if that's the case, I understand. response:	I'm sure this will be difficult for you...
context: What's wrong?\Huh?\Shiroe, of Log Horizon...\And two others?\Yes.\Sorry to ask this of you...\Oh, if that's the case, I understand.\I'm sure this will be difficult for you... response:	But good luck!
context: Huh?\Shiroe, of Log Horizon...\And two others?\Yes.\Sorry to ask this of you...\Oh, if that's the case, I understand.\I'm sure this will be difficult for you...\But good luck! response:	What did she mean?
context: Shiroe, of Log Horizon...\And two others?\Yes.\Sorry to ask this of you...\Oh, if that's the case, I understand.\I'm sure this will be difficult for you...\But good luck!\What did she mean? response:	It really is all couples...
context: And two others?\Yes.\Sorry to ask this of you...\Oh, if that's the case, I understand.\I'm sure this will be difficult for you...\But good luck!\What did she mean?\It really is all couples... response:	Let's eat!
context: Yes.\Sorry to ask this of you...\Oh, if that's the case, I understand.\I'm sure this will be difficult for you...\But good luck!\What did she mean?\It really is all couples...\Let's eat! response:	I'm glad all three of us could get in together.
context: Sorry to ask this of you...\Oh, if that's the case, I understand.\I'm sure this will be difficult for you...\But good luck!\What did she mean?\It really is all couples...\Let's eat!\I'm glad all three of us could get in together. response:	What? All three of us?
context: Oh, if that's the case, I understand.\I'm sure this will be difficult for you...\But good luck!\What did she mean?\It really is all couples...\Let's eat!\I'm glad all three of us could get in together.\What? All three of us? response:	Yes.
context: I'm sure this will be difficult for you...\But good luck!\What did she mean?\It really is all couples...\Let's eat!\I'm glad all three of us could get in together.\What? All three of us?\Yes. response:	I just got permission from Kanako, the organizer.
context: But good luck!\What did she mean?\It really is all couples...\Let's eat!\I'm glad all three of us could get in together.\What? All three of us?\Yes.\I just got permission from Kanako, the organizer. response:	We'll have to eat twelve to enter as a trio, but I think we can do it.
context: What did she mean?\It really is all couples...\Let's eat!\I'm glad all three of us could get in together.\What? All three of us?\Yes.\I just got permission from Kanako, the organizer.\We'll have to eat twelve to enter as a trio, but I think we can do it. response:	Okay.
context: It really is all couples...\Let's eat!\I'm glad all three of us could get in together.\What? All three of us?\Yes.\I just got permission from Kanako, the organizer.\We'll have to eat twelve to enter as a trio, but I think we can do it.\Okay. response:	Let's win, and go to the finals!
context: Let's eat!\I'm glad all three of us could get in together.\What? All three of us?\Yes.\I just got permission from Kanako, the organizer.\We'll have to eat twelve to enter as a trio, but I think we can do it.\Okay.\Let's win, and go to the finals! response:	Right, Akatsuki?
context: I'm glad all three of us could get in together.\What? All three of us?\Yes.\I just got permission from Kanako, the organizer.\We'll have to eat twelve to enter as a trio, but I think we can do it.\Okay.\Let's win, and go to the finals!\Right, Akatsuki? response:	Yes.
context: What? All three of us?\Yes.\I just got permission from Kanako, the organizer.\We'll have to eat twelve to enter as a trio, but I think we can do it.\Okay.\Let's win, and go to the finals!\Right, Akatsuki?\Yes. response:	To be honest, I don't think I could've eaten here twice.
context: Yes.\I just got permission from Kanako, the organizer.\We'll have to eat twelve to enter as a trio, but I think we can do it.\Okay.\Let's win, and go to the finals!\Right, Akatsuki?\Yes.\To be honest, I don't think I could've eaten here twice. response:	But...
context: I just got permission from Kanako, the organizer.\We'll have to eat twelve to enter as a trio, but I think we can do it.\Okay.\Let's win, and go to the finals!\Right, Akatsuki?\Yes.\To be honest, I don't think I could've eaten here twice.\But... response:	What is this feeling? Pressure?
context: We'll have to eat twelve to enter as a trio, but I think we can do it.\Okay.\Let's win, and go to the finals!\Right, Akatsuki?\Yes.\To be honest, I don't think I could've eaten here twice.\But...\What is this feeling? Pressure? response:	That's a wonderful kimono, Akatsuki.
context: Okay.\Let's win, and go to the finals!\Right, Akatsuki?\Yes.\To be honest, I don't think I could've eaten here twice.\But...\What is this feeling? Pressure?\That's a wonderful kimono, Akatsuki. response:	It's rare to see you in a kimono.
context: Let's win, and go to the finals!\Right, Akatsuki?\Yes.\To be honest, I don't think I could've eaten here twice.\But...\What is this feeling? Pressure?\That's a wonderful kimono, Akatsuki.\It's rare to see you in a kimono. response:	What's up?
context: Right, Akatsuki?\Yes.\To be honest, I don't think I could've eaten here twice.\But...\What is this feeling? Pressure?\That's a wonderful kimono, Akatsuki.\It's rare to see you in a kimono.\What's up? response:	Th-This is...
context: Yes.\To be honest, I don't think I could've eaten here twice.\But...\What is this feeling? Pressure?\That's a wonderful kimono, Akatsuki.\It's rare to see you in a kimono.\What's up?\Th-This is... response:	A guild called Kimono Komachi made it for me...
context: To be honest, I don't think I could've eaten here twice.\But...\What is this feeling? Pressure?\That's a wonderful kimono, Akatsuki.\It's rare to see you in a kimono.\What's up?\Th-This is...\A guild called Kimono Komachi made it for me... response:	Does it look okay?
context: But...\What is this feeling? Pressure?\That's a wonderful kimono, Akatsuki.\It's rare to see you in a kimono.\What's up?\Th-This is...\A guild called Kimono Komachi made it for me...\Does it look okay? response:	It's a gr
context: What is this feeling? Pressure?\That's a wonderful kimono, Akatsuki.\It's rare to see you in a kimono.\What's up?\Th-This is...\A guild called Kimono Komachi made it for me...\Does it look okay?\It's a gr response:	It is not for graduation.
context: That's a wonderful kimono, Akatsuki.\It's rare to see you in a kimono.\What's up?\Th-This is...\A guild called Kimono Komachi made it for me...\Does it look okay?\It's a gr\It is not for graduation. response:	It is for fashion.
context: It's rare to see you in a kimono.\What's up?\Th-This is...\A guild called Kimono Komachi made it for me...\Does it look okay?\It's a gr\It is not for graduation.\It is for fashion. response:	Gr
context: What's up?\Th-This is...\A guild called Kimono Komachi made it for me...\Does it look okay?\It's a gr\It is not for graduation.\It is for fashion.\Gr response:	It's graceful, and really nice. Yeah.
context: Th-This is...\A guild called Kimono Komachi made it for me...\Does it look okay?\It's a gr\It is not for graduation.\It is for fashion.\Gr\It's graceful, and really nice. Yeah. response:	R-Really?
context: A guild called Kimono Komachi made it for me...\Does it look okay?\It's a gr\It is not for graduation.\It is for fashion.\Gr\It's graceful, and really nice. Yeah.\R-Really? response:	Yes, it's very cute.
context: Does it look okay?\It's a gr\It is not for graduation.\It is for fashion.\Gr\It's graceful, and really nice. Yeah.\R-Really?\Yes, it's very cute. response:	You look good, too, Minori.
context: It's a gr\It is not for graduation.\It is for fashion.\Gr\It's graceful, and really nice. Yeah.\R-Really?\Yes, it's very cute.\You look good, too, Minori. response:	Thank you.
context: It is not for graduation.\It is for fashion.\Gr\It's graceful, and really nice. Yeah.\R-Really?\Yes, it's very cute.\You look good, too, Minori.\Thank you. response:	Isuzu chose this for me.
context: It is for fashion.\Gr\It's graceful, and really nice. Yeah.\R-Really?\Yes, it's very cute.\You look good, too, Minori.\Thank you.\Isuzu chose this for me. response:	Really?
context: Gr\It's graceful, and really nice. Yeah.\R-Really?\Yes, it's very cute.\You look good, too, Minori.\Thank you.\Isuzu chose this for me.\Really? response:	Yes, she took me to a bunch of stores.
context: It's graceful, and really nice. Yeah.\R-Really?\Yes, it's very cute.\You look good, too, Minori.\Thank you.\Isuzu chose this for me.\Really?\Yes, she took me to a bunch of stores. response:	Why don't you come with us sometime?
context: R-Really?\Yes, it's very cute.\You look good, too, Minori.\Thank you.\Isuzu chose this for me.\Really?\Yes, she took me to a bunch of stores.\Why don't you come with us sometime? response:	Okay.
context: Yes, it's very cute.\You look good, too, Minori.\Thank you.\Isuzu chose this for me.\Really?\Yes, she took me to a bunch of stores.\Why don't you come with us sometime?\Okay. response:	Isuzu knows a lot about clothes.
context: You look good, too, Minori.\Thank you.\Isuzu chose this for me.\Really?\Yes, she took me to a bunch of stores.\Why don't you come with us sometime?\Okay.\Isuzu knows a lot about clothes. response:	I was surprised.
context: Thank you.\Isuzu chose this for me.\Really?\Yes, she took me to a bunch of stores.\Why don't you come with us sometime?\Okay.\Isuzu knows a lot about clothes.\I was surprised. response:	That looks so good!
context: Isuzu chose this for me.\Really?\Yes, she took me to a bunch of stores.\Why don't you come with us sometime?\Okay.\Isuzu knows a lot about clothes.\I was surprised.\That looks so good! response:	My lord! My lord!
context: Really?\Yes, she took me to a bunch of stores.\Why don't you come with us sometime?\Okay.\Isuzu knows a lot about clothes.\I was surprised.\That looks so good!\My lord! My lord! response:	I have high hopes for this!
context: Yes, she took me to a bunch of stores.\Why don't you come with us sometime?\Okay.\Isuzu knows a lot about clothes.\I was surprised.\That looks so good!\My lord! My lord!\I have high hopes for this! response:	Aren't they pretty?
context: Why don't you come with us sometime?\Okay.\Isuzu knows a lot about clothes.\I was surprised.\That looks so good!\My lord! My lord!\I have high hopes for this!\Aren't they pretty? response:	Isn't this exciting?
context: Okay.\Isuzu knows a lot about clothes.\I was surprised.\That looks so good!\My lord! My lord!\I have high hopes for this!\Aren't they pretty?\Isn't this exciting? response:	Yeah, I think I could eat four of those.
context: Isuzu knows a lot about clothes.\I was surprised.\That looks so good!\My lord! My lord!\I have high hopes for this!\Aren't they pretty?\Isn't this exciting?\Yeah, I think I could eat four of those. response:	Here you go!
context: I was surprised.\That looks so good!\My lord! My lord!\I have high hopes for this!\Aren't they pretty?\Isn't this exciting?\Yeah, I think I could eat four of those.\Here you go! response:	Eh? Huh?
context: That looks so good!\My lord! My lord!\I have high hopes for this!\Aren't they pretty?\Isn't this exciting?\Yeah, I think I could eat four of those.\Here you go!\Eh? Huh? response:	Here, enjoy!
context: My lord! My lord!\I have high hopes for this!\Aren't they pretty?\Isn't this exciting?\Yeah, I think I could eat four of those.\Here you go!\Eh? Huh?\Here, enjoy! response:	Enjoy? But those are whole cakes!
context: I have high hopes for this!\Aren't they pretty?\Isn't this exciting?\Yeah, I think I could eat four of those.\Here you go!\Eh? Huh?\Here, enjoy!\Enjoy? But those are whole cakes! response:	It's a little present from my guild!
context: Aren't they pretty?\Isn't this exciting?\Yeah, I think I could eat four of those.\Here you go!\Eh? Huh?\Here, enjoy!\Enjoy? But those are whole cakes!\It's a little present from my guild! response:	Present?
context: Isn't this exciting?\Yeah, I think I could eat four of those.\Here you go!\Eh? Huh?\Here, enjoy!\Enjoy? But those are whole cakes!\It's a little present from my guild!\Present? response:	Um...
context: Yeah, I think I could eat four of those.\Here you go!\Eh? Huh?\Here, enjoy!\Enjoy? But those are whole cakes!\It's a little present from my guild!\Present?\Um... response:	Let's start with one.
context: Here you go!\Eh? Huh?\Here, enjoy!\Enjoy? But those are whole cakes!\It's a little present from my guild!\Present?\Um...\Let's start with one. response:	Yeah.
context: Eh? Huh?\Here, enjoy!\Enjoy? But those are whole cakes!\It's a little present from my guild!\Present?\Um...\Let's start with one.\Yeah. response:	Let's eat.
context: Here, enjoy!\Enjoy? But those are whole cakes!\It's a little present from my guild!\Present?\Um...\Let's start with one.\Yeah.\Let's eat. response:	It's great...
context: Enjoy? But those are whole cakes!\It's a little present from my guild!\Present?\Um...\Let's start with one.\Yeah.\Let's eat.\It's great... response:	Really, my lord? You like it?
context: It's a little present from my guild!\Present?\Um...\Let's start with one.\Yeah.\Let's eat.\It's great...\Really, my lord? You like it? response:	What are you doing?
context: Present?\Um...\Let's start with one.\Yeah.\Let's eat.\It's great...\Really, my lord? You like it?\What are you doing? response:	Serving my lord.
context: Um...\Let's start with one.\Yeah.\Let's eat.\It's great...\Really, my lord? You like it?\What are you doing?\Serving my lord. response:	Serving me? That's a whole cake!
context: Let's start with one.\Yeah.\Let's eat.\It's great...\Really, my lord? You like it?\What are you doing?\Serving my lord.\Serving me? That's a whole cake! response:	I'll cut it up.
context: Yeah.\Let's eat.\It's great...\Really, my lord? You like it?\What are you doing?\Serving my lord.\Serving me? That's a whole cake!\I'll cut it up. response:	That isn't the issue.
context: Let's eat.\It's great...\Really, my lord? You like it?\What are you doing?\Serving my lord.\Serving me? That's a whole cake!\I'll cut it up.\That isn't the issue. response:	It's not fair that you got to bring two!
context: It's great...\Really, my lord? You like it?\What are you doing?\Serving my lord.\Serving me? That's a whole cake!\I'll cut it up.\That isn't the issue.\It's not fair that you got to bring two! response:	Unbelievable.
context: Really, my lord? You like it?\What are you doing?\Serving my lord.\Serving me? That's a whole cake!\I'll cut it up.\That isn't the issue.\It's not fair that you got to bring two!\Unbelievable. response:	Crap... Is that how this looks?
context: What are you doing?\Serving my lord.\Serving me? That's a whole cake!\I'll cut it up.\That isn't the issue.\It's not fair that you got to bring two!\Unbelievable.\Crap... Is that how this looks? response:	Is he trying to show off?
context: Serving my lord.\Serving me? That's a whole cake!\I'll cut it up.\That isn't the issue.\It's not fair that you got to bring two!\Unbelievable.\Crap... Is that how this looks?\Is he trying to show off? response:	Die.
context: Serving me? That's a whole cake!\I'll cut it up.\That isn't the issue.\It's not fair that you got to bring two!\Unbelievable.\Crap... Is that how this looks?\Is he trying to show off?\Die. response:	This isn't good... I'll get them both involved.
context: I'll cut it up.\That isn't the issue.\It's not fair that you got to bring two!\Unbelievable.\Crap... Is that how this looks?\Is he trying to show off?\Die.\This isn't good... I'll get them both involved. response:	I hope his glasses break.
context: That isn't the issue.\It's not fair that you got to bring two!\Unbelievable.\Crap... Is that how this looks?\Is he trying to show off?\Die.\This isn't good... I'll get them both involved.\I hope his glasses break. response:	I need to avoid making a fuss.
context: It's not fair that you got to bring two!\Unbelievable.\Crap... Is that how this looks?\Is he trying to show off?\Die.\This isn't good... I'll get them both involved.\I hope his glasses break.\I need to avoid making a fuss. response:	Minimize damage and retreat.
context: Unbelievable.\Crap... Is that how this looks?\Is he trying to show off?\Die.\This isn't good... I'll get them both involved.\I hope his glasses break.\I need to avoid making a fuss.\Minimize damage and retreat. response:	My lord.
context: Crap... Is that how this looks?\Is he trying to show off?\Die.\This isn't good... I'll get them both involved.\I hope his glasses break.\I need to avoid making a fuss.\Minimize damage and retreat.\My lord. response:	Here.
context: Is he trying to show off?\Die.\This isn't good... I'll get them both involved.\I hope his glasses break.\I need to avoid making a fuss.\Minimize damage and retreat.\My lord.\Here. response:	Am I supposed to eat that?
context: Die.\This isn't good... I'll get them both involved.\I hope his glasses break.\I need to avoid making a fuss.\Minimize damage and retreat.\My lord.\Here.\Am I supposed to eat that? response:	Of course, my lord.
context: This isn't good... I'll get them both involved.\I hope his glasses break.\I need to avoid making a fuss.\Minimize damage and retreat.\My lord.\Here.\Am I supposed to eat that?\Of course, my lord. response:	Say, ah.
context: I hope his glasses break.\I need to avoid making a fuss.\Minimize damage and retreat.\My lord.\Here.\Am I supposed to eat that?\Of course, my lord.\Say, ah. response:	Come on, it'll fall off.
context: I need to avoid making a fuss.\Minimize damage and retreat.\My lord.\Here.\Am I supposed to eat that?\Of course, my lord.\Say, ah.\Come on, it'll fall off. response:	Is it good, my lord?
context: Minimize damage and retreat.\My lord.\Here.\Am I supposed to eat that?\Of course, my lord.\Say, ah.\Come on, it'll fall off.\Is it good, my lord? response:	Mhm.
context: My lord.\Here.\Am I supposed to eat that?\Of course, my lord.\Say, ah.\Come on, it'll fall off.\Is it good, my lord?\Mhm. response:	Shiroe!
context: Here.\Am I supposed to eat that?\Of course, my lord.\Say, ah.\Come on, it'll fall off.\Is it good, my lord?\Mhm.\Shiroe! response:	Say, ah!
context: Am I supposed to eat that?\Of course, my lord.\Say, ah.\Come on, it'll fall off.\Is it good, my lord?\Mhm.\Shiroe!\Say, ah! response:	Try this, too.
context: Of course, my lord.\Say, ah.\Come on, it'll fall off.\Is it good, my lord?\Mhm.\Shiroe!\Say, ah!\Try this, too. response:	Is it good?
context: Say, ah.\Come on, it'll fall off.\Is it good, my lord?\Mhm.\Shiroe!\Say, ah!\Try this, too.\Is it good? response:	Well, yeah, it's good, but...
context: Come on, it'll fall off.\Is it good, my lord?\Mhm.\Shiroe!\Say, ah!\Try this, too.\Is it good?\Well, yeah, it's good, but... response:	I'd rather fight a dozen raid bosses at once!
context: Is it good, my lord?\Mhm.\Shiroe!\Say, ah!\Try this, too.\Is it good?\Well, yeah, it's good, but...\I'd rather fight a dozen raid bosses at once! response:	My lord.
context: Mhm.\Shiroe!\Say, ah!\Try this, too.\Is it good?\Well, yeah, it's good, but...\I'd rather fight a dozen raid bosses at once!\My lord. response:	There's still more.
context: Shiroe!\Say, ah!\Try this, too.\Is it good?\Well, yeah, it's good, but...\I'd rather fight a dozen raid bosses at once!\My lord.\There's still more. response:	Ah...
context: Say, ah!\Try this, too.\Is it good?\Well, yeah, it's good, but...\I'd rather fight a dozen raid bosses at once!\My lord.\There's still more.\Ah... response:	Me, too!
context: Try this, too.\Is it good?\Well, yeah, it's good, but...\I'd rather fight a dozen raid bosses at once!\My lord.\There's still more.\Ah...\Me, too! response:	Ah!
context: Is it good?\Well, yeah, it's good, but...\I'd rather fight a dozen raid bosses at once!\My lord.\There's still more.\Ah...\Me, too!\Ah! response:	Ah!
context: Well, yeah, it's good, but...\I'd rather fight a dozen raid bosses at once!\My lord.\There's still more.\Ah...\Me, too!\Ah!\Ah! response:	Ah!
context: I'd rather fight a dozen raid bosses at once!\My lord.\There's still more.\Ah...\Me, too!\Ah!\Ah!\Ah! response:	Someone help me!
context: My lord.\There's still more.\Ah...\Me, too!\Ah!\Ah!\Ah!\Someone help me! response:	Cafe Kanako
context: There's still more.\Ah...\Me, too!\Ah!\Ah!\Ah!\Someone help me!\Cafe Kanako response:	Thank you!
context: Ah...\Me, too!\Ah!\Ah!\Ah!\Someone help me!\Cafe Kanako\Thank you! response:	Sorry you had to pay.
context: Me, too!\Ah!\Ah!\Ah!\Someone help me!\Cafe Kanako\Thank you!\Sorry you had to pay. response:	We couldn't eat them all.
context: Ah!\Ah!\Ah!\Someone help me!\Cafe Kanako\Thank you!\Sorry you had to pay.\We couldn't eat them all. response:	I had no choice.
context: Ah!\Ah!\Someone help me!\Cafe Kanako\Thank you!\Sorry you had to pay.\We couldn't eat them all.\I had no choice. response:	Will you go home and rest, my lord?
context: Ah!\Someone help me!\Cafe Kanako\Thank you!\Sorry you had to pay.\We couldn't eat them all.\I had no choice.\Will you go home and rest, my lord? response:	I was going to see the rest of the festival, but I think I will...
context: Someone help me!\Cafe Kanako\Thank you!\Sorry you had to pay.\We couldn't eat them all.\I had no choice.\Will you go home and rest, my lord?\I was going to see the rest of the festival, but I think I will... response:	Um... You two go on without me.
context: Cafe Kanako\Thank you!\Sorry you had to pay.\We couldn't eat them all.\I had no choice.\Will you go home and rest, my lord?\I was going to see the rest of the festival, but I think I will...\Um... You two go on without me. response:	I need to make a stop before going back.
context: Thank you!\Sorry you had to pay.\We couldn't eat them all.\I had no choice.\Will you go home and rest, my lord?\I was going to see the rest of the festival, but I think I will...\Um... You two go on without me.\I need to make a stop before going back. response:	Thank you!
context: Sorry you had to pay.\We couldn't eat them all.\I had no choice.\Will you go home and rest, my lord?\I was going to see the rest of the festival, but I think I will...\Um... You two go on without me.\I need to make a stop before going back.\Thank you! response:	Dandelion barley tea is good for digestion, right?
context: We couldn't eat them all.\I had no choice.\Will you go home and rest, my lord?\I was going to see the rest of the festival, but I think I will...\Um... You two go on without me.\I need to make a stop before going back.\Thank you!\Dandelion barley tea is good for digestion, right? response:	I'm sad I couldn't attend the Twilight Banquet,
context: I had no choice.\Will you go home and rest, my lord?\I was going to see the rest of the festival, but I think I will...\Um... You two go on without me.\I need to make a stop before going back.\Thank you!\Dandelion barley tea is good for digestion, right?\I'm sad I couldn't attend the Twilight Banquet, response:	but Shiroe worked hard for me.
context: Will you go home and rest, my lord?\I was going to see the rest of the festival, but I think I will...\Um... You two go on without me.\I need to make a stop before going back.\Thank you!\Dandelion barley tea is good for digestion, right?\I'm sad I couldn't attend the Twilight Banquet,\but Shiroe worked hard for me. response:	I'll have to thank him.
context: I was going to see the rest of the festival, but I think I will...\Um... You two go on without me.\I need to make a stop before going back.\Thank you!\Dandelion barley tea is good for digestion, right?\I'm sad I couldn't attend the Twilight Banquet,\but Shiroe worked hard for me.\I'll have to thank him. response:	It hurts...
context: Um... You two go on without me.\I need to make a stop before going back.\Thank you!\Dandelion barley tea is good for digestion, right?\I'm sad I couldn't attend the Twilight Banquet,\but Shiroe worked hard for me.\I'll have to thank him.\It hurts... response:	Three people eating twelve whole cakes?
context: I need to make a stop before going back.\Thank you!\Dandelion barley tea is good for digestion, right?\I'm sad I couldn't attend the Twilight Banquet,\but Shiroe worked hard for me.\I'll have to thank him.\It hurts...\Three people eating twelve whole cakes? response:	How did she figure that?
context: Thank you!\Dandelion barley tea is good for digestion, right?\I'm sad I couldn't attend the Twilight Banquet,\but Shiroe worked hard for me.\I'll have to thank him.\It hurts...\Three people eating twelve whole cakes?\How did she figure that? response:	Oh, right.
context: Dandelion barley tea is good for digestion, right?\I'm sad I couldn't attend the Twilight Banquet,\but Shiroe worked hard for me.\I'll have to thank him.\It hurts...\Three people eating twelve whole cakes?\How did she figure that?\Oh, right. response:	A cake buffet?
context: I'm sad I couldn't attend the Twilight Banquet,\but Shiroe worked hard for me.\I'll have to thank him.\It hurts...\Three people eating twelve whole cakes?\How did she figure that?\Oh, right.\A cake buffet? response:	It'll probably be there tomorrow. Why not go?
context: but Shiroe worked hard for me.\I'll have to thank him.\It hurts...\Three people eating twelve whole cakes?\How did she figure that?\Oh, right.\A cake buffet?\It'll probably be there tomorrow. Why not go? response:	It'll be free.
context: I'll have to thank him.\It hurts...\Three people eating twelve whole cakes?\How did she figure that?\Oh, right.\A cake buffet?\It'll probably be there tomorrow. Why not go?\It'll be free. response:	That sounds great!
context: It hurts...\Three people eating twelve whole cakes?\How did she figure that?\Oh, right.\A cake buffet?\It'll probably be there tomorrow. Why not go?\It'll be free.\That sounds great! response:	I'll definitely go.
context: Three people eating twelve whole cakes?\How did she figure that?\Oh, right.\A cake buffet?\It'll probably be there tomorrow. Why not go?\It'll be free.\That sounds great!\I'll definitely go. response:	Thanks for the information, Shiro!
context: How did she figure that?\Oh, right.\A cake buffet?\It'll probably be there tomorrow. Why not go?\It'll be free.\That sounds great!\I'll definitely go.\Thanks for the information, Shiro! response:	Sure.
context: Oh, right.\A cake buffet?\It'll probably be there tomorrow. Why not go?\It'll be free.\That sounds great!\I'll definitely go.\Thanks for the information, Shiro!\Sure. response:	I wonder how many whole cakes he'll end up eating...
context: A cake buffet?\It'll probably be there tomorrow. Why not go?\It'll be free.\That sounds great!\I'll definitely go.\Thanks for the information, Shiro!\Sure.\I wonder how many whole cakes he'll end up eating... response:	But all the girls love Soujirou,
context: It'll probably be there tomorrow. Why not go?\It'll be free.\That sounds great!\I'll definitely go.\Thanks for the information, Shiro!\Sure.\I wonder how many whole cakes he'll end up eating...\But all the girls love Soujirou, response:	yet he still does well running his guild.
context: It'll be free.\That sounds great!\I'll definitely go.\Thanks for the information, Shiro!\Sure.\I wonder how many whole cakes he'll end up eating...\But all the girls love Soujirou,\yet he still does well running his guild. response:	Naotsugu or Chief Nyanta seem more like guild masters than I do.
context: That sounds great!\I'll definitely go.\Thanks for the information, Shiro!\Sure.\I wonder how many whole cakes he'll end up eating...\But all the girls love Soujirou,\yet he still does well running his guild.\Naotsugu or Chief Nyanta seem more like guild masters than I do. response:	I don't really have the presence.
context: I'll definitely go.\Thanks for the information, Shiro!\Sure.\I wonder how many whole cakes he'll end up eating...\But all the girls love Soujirou,\yet he still does well running his guild.\Naotsugu or Chief Nyanta seem more like guild masters than I do.\I don't really have the presence. response:	Maybe Henrietta's right, and this would be a good chance.
context: Thanks for the information, Shiro!\Sure.\I wonder how many whole cakes he'll end up eating...\But all the girls love Soujirou,\yet he still does well running his guild.\Naotsugu or Chief Nyanta seem more like guild masters than I do.\I don't really have the presence.\Maybe Henrietta's right, and this would be a good chance. response:	I should make time to spend with everyone.
context: Sure.\I wonder how many whole cakes he'll end up eating...\But all the girls love Soujirou,\yet he still does well running his guild.\Naotsugu or Chief Nyanta seem more like guild masters than I do.\I don't really have the presence.\Maybe Henrietta's right, and this would be a good chance.\I should make time to spend with everyone. response:	My lord.
context: I wonder how many whole cakes he'll end up eating...\But all the girls love Soujirou,\yet he still does well running his guild.\Naotsugu or Chief Nyanta seem more like guild masters than I do.\I don't really have the presence.\Maybe Henrietta's right, and this would be a good chance.\I should make time to spend with everyone.\My lord. response:	When did you get there?!
context: But all the girls love Soujirou,\yet he still does well running his guild.\Naotsugu or Chief Nyanta seem more like guild masters than I do.\I don't really have the presence.\Maybe Henrietta's right, and this would be a good chance.\I should make time to spend with everyone.\My lord.\When did you get there?! response:	Just now.
context: yet he still does well running his guild.\Naotsugu or Chief Nyanta seem more like guild masters than I do.\I don't really have the presence.\Maybe Henrietta's right, and this would be a good chance.\I should make time to spend with everyone.\My lord.\When did you get there?!\Just now. response:	Is something wrong?
context: Naotsugu or Chief Nyanta seem more like guild masters than I do.\I don't really have the presence.\Maybe Henrietta's right, and this would be a good chance.\I should make time to spend with everyone.\My lord.\When did you get there?!\Just now.\Is something wrong? response:	No, nothing...
context: I don't really have the presence.\Maybe Henrietta's right, and this would be a good chance.\I should make time to spend with everyone.\My lord.\When did you get there?!\Just now.\Is something wrong?\No, nothing... response:	The town is even more lively than usual.
context: Maybe Henrietta's right, and this would be a good chance.\I should make time to spend with everyone.\My lord.\When did you get there?!\Just now.\Is something wrong?\No, nothing...\The town is even more lively than usual. response:	It is a festival, after all.
context: I should make time to spend with everyone.\My lord.\When did you get there?!\Just now.\Is something wrong?\No, nothing...\The town is even more lively than usual.\It is a festival, after all. response:	When we first arrived in this world, I never would've imagined it.
context: My lord.\When did you get there?!\Just now.\Is something wrong?\No, nothing...\The town is even more lively than usual.\It is a festival, after all.\When we first arrived in this world, I never would've imagined it. response:	Yeah.
context: When did you get there?!\Just now.\Is something wrong?\No, nothing...\The town is even more lively than usual.\It is a festival, after all.\When we first arrived in this world, I never would've imagined it.\Yeah. response:	You're quiet.
context: Just now.\Is something wrong?\No, nothing...\The town is even more lively than usual.\It is a festival, after all.\When we first arrived in this world, I never would've imagined it.\Yeah.\You're quiet. response:	I'm always quiet.
context: Is something wrong?\No, nothing...\The town is even more lively than usual.\It is a festival, after all.\When we first arrived in this world, I never would've imagined it.\Yeah.\You're quiet.\I'm always quiet. response:	Yeah, but...
context: No, nothing...\The town is even more lively than usual.\It is a festival, after all.\When we first arrived in this world, I never would've imagined it.\Yeah.\You're quiet.\I'm always quiet.\Yeah, but... response:	My lord...
context: The town is even more lively than usual.\It is a festival, after all.\When we first arrived in this world, I never would've imagined it.\Yeah.\You're quiet.\I'm always quiet.\Yeah, but...\My lord... response:	Do you, well...
context: It is a festival, after all.\When we first arrived in this world, I never would've imagined it.\Yeah.\You're quiet.\I'm always quiet.\Yeah, but...\My lord...\Do you, well... response:	Dislike cake?
context: When we first arrived in this world, I never would've imagined it.\Yeah.\You're quiet.\I'm always quiet.\Yeah, but...\My lord...\Do you, well...\Dislike cake? response:	Or did you not have fun?
context: Yeah.\You're quiet.\I'm always quiet.\Yeah, but...\My lord...\Do you, well...\Dislike cake?\Or did you not have fun? response:	That's not true...
context: You're quiet.\I'm always quiet.\Yeah, but...\My lord...\Do you, well...\Dislike cake?\Or did you not have fun?\That's not true... response:	Anyway, I'm sorry we didn't get to the finals.
context: I'm always quiet.\Yeah, but...\My lord...\Do you, well...\Dislike cake?\Or did you not have fun?\That's not true...\Anyway, I'm sorry we didn't get to the finals. response:	That doesn't matter to me.
context: Yeah, but...\My lord...\Do you, well...\Dislike cake?\Or did you not have fun?\That's not true...\Anyway, I'm sorry we didn't get to the finals.\That doesn't matter to me. response:	It was Minori who wanted to go.
context: My lord...\Do you, well...\Dislike cake?\Or did you not have fun?\That's not true...\Anyway, I'm sorry we didn't get to the finals.\That doesn't matter to me.\It was Minori who wanted to go. response:	I see...
context: Do you, well...\Dislike cake?\Or did you not have fun?\That's not true...\Anyway, I'm sorry we didn't get to the finals.\That doesn't matter to me.\It was Minori who wanted to go.\I see... response:	But was that cake okay with you?
context: Dislike cake?\Or did you not have fun?\That's not true...\Anyway, I'm sorry we didn't get to the finals.\That doesn't matter to me.\It was Minori who wanted to go.\I see...\But was that cake okay with you? response:	It felt like I was doing all the eating. Did you have any?
context: Or did you not have fun?\That's not true...\Anyway, I'm sorry we didn't get to the finals.\That doesn't matter to me.\It was Minori who wanted to go.\I see...\But was that cake okay with you?\It felt like I was doing all the eating. Did you have any? response:	I wasn't there for the cake.
context: That's not true...\Anyway, I'm sorry we didn't get to the finals.\That doesn't matter to me.\It was Minori who wanted to go.\I see...\But was that cake okay with you?\It felt like I was doing all the eating. Did you have any?\I wasn't there for the cake. response:	Oh...
context: Anyway, I'm sorry we didn't get to the finals.\That doesn't matter to me.\It was Minori who wanted to go.\I see...\But was that cake okay with you?\It felt like I was doing all the eating. Did you have any?\I wasn't there for the cake.\Oh... response:	It's hard to hold a conversation with you, my lord!
context: That doesn't matter to me.\It was Minori who wanted to go.\I see...\But was that cake okay with you?\It felt like I was doing all the eating. Did you have any?\I wasn't there for the cake.\Oh...\It's hard to hold a conversation with you, my lord! response:	I don't know what to say.
context: It was Minori who wanted to go.\I see...\But was that cake okay with you?\It felt like I was doing all the eating. Did you have any?\I wasn't there for the cake.\Oh...\It's hard to hold a conversation with you, my lord!\I don't know what to say. response:	You just don't talk much.
context: I see...\But was that cake okay with you?\It felt like I was doing all the eating. Did you have any?\I wasn't there for the cake.\Oh...\It's hard to hold a conversation with you, my lord!\I don't know what to say.\You just don't talk much. response:	That isn't true...
context: But was that cake okay with you?\It felt like I was doing all the eating. Did you have any?\I wasn't there for the cake.\Oh...\It's hard to hold a conversation with you, my lord!\I don't know what to say.\You just don't talk much.\That isn't true... response:	I have all sorts of things to discuss.
context: It felt like I was doing all the eating. Did you have any?\I wasn't there for the cake.\Oh...\It's hard to hold a conversation with you, my lord!\I don't know what to say.\You just don't talk much.\That isn't true...\I have all sorts of things to discuss. response:	Then give us something to talk about.
context: I wasn't there for the cake.\Oh...\It's hard to hold a conversation with you, my lord!\I don't know what to say.\You just don't talk much.\That isn't true...\I have all sorts of things to discuss.\Then give us something to talk about. response:	Was that a little harsh?
context: Oh...\It's hard to hold a conversation with you, my lord!\I don't know what to say.\You just don't talk much.\That isn't true...\I have all sorts of things to discuss.\Then give us something to talk about.\Was that a little harsh? response:	Um, I didn't mean... I'm sorry.
context: It's hard to hold a conversation with you, my lord!\I don't know what to say.\You just don't talk much.\That isn't true...\I have all sorts of things to discuss.\Then give us something to talk about.\Was that a little harsh?\Um, I didn't mean... I'm sorry. response:	Er...
context: I don't know what to say.\You just don't talk much.\That isn't true...\I have all sorts of things to discuss.\Then give us something to talk about.\Was that a little harsh?\Um, I didn't mean... I'm sorry.\Er... response:	Wait...
context: You just don't talk much.\That isn't true...\I have all sorts of things to discuss.\Then give us something to talk about.\Was that a little harsh?\Um, I didn't mean... I'm sorry.\Er...\Wait... response:	It's fun to do this.
context: That isn't true...\I have all sorts of things to discuss.\Then give us something to talk about.\Was that a little harsh?\Um, I didn't mean... I'm sorry.\Er...\Wait...\It's fun to do this. response:	Is that really fun?
context: I have all sorts of things to discuss.\Then give us something to talk about.\Was that a little harsh?\Um, I didn't mean... I'm sorry.\Er...\Wait...\It's fun to do this.\Is that really fun? response:	It is.
context: Then give us something to talk about.\Was that a little harsh?\Um, I didn't mean... I'm sorry.\Er...\Wait...\It's fun to do this.\Is that really fun?\It is. response:	Oh...
context: Was that a little harsh?\Um, I didn't mean... I'm sorry.\Er...\Wait...\It's fun to do this.\Is that really fun?\It is.\Oh... response:	Is this part of her lord-and-servant role playing?
context: Um, I didn't mean... I'm sorry.\Er...\Wait...\It's fun to do this.\Is that really fun?\It is.\Oh...\Is this part of her lord-and-servant role playing? response:	This is enough?
context: Er...\Wait...\It's fun to do this.\Is that really fun?\It is.\Oh...\Is this part of her lord-and-servant role playing?\This is enough? response:	Yes...
context: Wait...\It's fun to do this.\Is that really fun?\It is.\Oh...\Is this part of her lord-and-servant role playing?\This is enough?\Yes... response:	I see.
context: It's fun to do this.\Is that really fun?\It is.\Oh...\Is this part of her lord-and-servant role playing?\This is enough?\Yes...\I see. response:	What is this?
context: Is that really fun?\It is.\Oh...\Is this part of her lord-and-servant role playing?\This is enough?\Yes...\I see.\What is this? response:	Why?
context: It is.\Oh...\Is this part of her lord-and-servant role playing?\This is enough?\Yes...\I see.\What is this?\Why? response:	Akatsuki...
context: Oh...\Is this part of her lord-and-servant role playing?\This is enough?\Yes...\I see.\What is this?\Why?\Akatsuki... response:	likes...
context: Is this part of her lord-and-servant role playing?\This is enough?\Yes...\I see.\What is this?\Why?\Akatsuki...\likes... response:	Shiroe!
context: This is enough?\Yes...\I see.\What is this?\Why?\Akatsuki...\likes...\Shiroe! response:	I also...
context: Yes...\I see.\What is this?\Why?\Akatsuki...\likes...\Shiroe!\I also... response:	like him.
context: I see.\What is this?\Why?\Akatsuki...\likes...\Shiroe!\I also...\like him. response:	It isn't fair!
context: What is this?\Why?\Akatsuki...\likes...\Shiroe!\I also...\like him.\It isn't fair! response:	Shiroe is mine!
context: Why?\Akatsuki...\likes...\Shiroe!\I also...\like him.\It isn't fair!\Shiroe is mine! response:	Not fair?
context: Akatsuki...\likes...\Shiroe!\I also...\like him.\It isn't fair!\Shiroe is mine!\Not fair? response:	How could I have said that?
context: likes...\Shiroe!\I also...\like him.\It isn't fair!\Shiroe is mine!\Not fair?\How could I have said that? response:	It hurts...
context: Shiroe!\I also...\like him.\It isn't fair!\Shiroe is mine!\Not fair?\How could I have said that?\It hurts... response:	This isn't...
context: I also...\like him.\It isn't fair!\Shiroe is mine!\Not fair?\How could I have said that?\It hurts...\This isn't... response:	Minori?
context: like him.\It isn't fair!\Shiroe is mine!\Not fair?\How could I have said that?\It hurts...\This isn't...\Minori? response:	What are you doing here?
context: It isn't fair!\Shiroe is mine!\Not fair?\How could I have said that?\It hurts...\This isn't...\Minori?\What are you doing here? response:	Whoa...
context: Shiroe is mine!\Not fair?\How could I have said that?\It hurts...\This isn't...\Minori?\What are you doing here?\Whoa... response:	Look at your face...
context: Not fair?\How could I have said that?\It hurts...\This isn't...\Minori?\What are you doing here?\Whoa...\Look at your face... response:	Tohya!
context: How could I have said that?\It hurts...\This isn't...\Minori?\What are you doing here?\Whoa...\Look at your face...\Tohya! response:	Well? What happened?
context: It hurts...\This isn't...\Minori?\What are you doing here?\Whoa...\Look at your face...\Tohya!\Well? What happened? response:	Listen, Tohya.
context: This isn't...\Minori?\What are you doing here?\Whoa...\Look at your face...\Tohya!\Well? What happened?\Listen, Tohya. response:	think I like Shiroe...
context: Minori?\What are you doing here?\Whoa...\Look at your face...\Tohya!\Well? What happened?\Listen, Tohya.\think I like Shiroe... response:	What?
context: What are you doing here?\Whoa...\Look at your face...\Tohya!\Well? What happened?\Listen, Tohya.\think I like Shiroe...\What? response:	You're just now figuring it out?
context: Whoa...\Look at your face...\Tohya!\Well? What happened?\Listen, Tohya.\think I like Shiroe...\What?\You're just now figuring it out? response:	It was obvious to the rest of us.
context: Look at your face...\Tohya!\Well? What happened?\Listen, Tohya.\think I like Shiroe...\What?\You're just now figuring it out?\It was obvious to the rest of us. response:	No way...
context: Tohya!\Well? What happened?\Listen, Tohya.\think I like Shiroe...\What?\You're just now figuring it out?\It was obvious to the rest of us.\No way... response:	He's nice, and he's caring.
context: Well? What happened?\Listen, Tohya.\think I like Shiroe...\What?\You're just now figuring it out?\It was obvious to the rest of us.\No way...\He's nice, and he's caring. response:	He's like a teacher.
context: Listen, Tohya.\think I like Shiroe...\What?\You're just now figuring it out?\It was obvious to the rest of us.\No way...\He's nice, and he's caring.\He's like a teacher. response:	I can see why you'd admire him.
context: think I like Shiroe...\What?\You're just now figuring it out?\It was obvious to the rest of us.\No way...\He's nice, and he's caring.\He's like a teacher.\I can see why you'd admire him. response:	How could you tell?
context: What?\You're just now figuring it out?\It was obvious to the rest of us.\No way...\He's nice, and he's caring.\He's like a teacher.\I can see why you'd admire him.\How could you tell? response:	Of course I can tell! We're twins!
context: You're just now figuring it out?\It was obvious to the rest of us.\No way...\He's nice, and he's caring.\He's like a teacher.\I can see why you'd admire him.\How could you tell?\Of course I can tell! We're twins! response:	I admire him, too!
context: It was obvious to the rest of us.\No way...\He's nice, and he's caring.\He's like a teacher.\I can see why you'd admire him.\How could you tell?\Of course I can tell! We're twins!\I admire him, too! response:	You like him, too?!
context: No way...\He's nice, and he's caring.\He's like a teacher.\I can see why you'd admire him.\How could you tell?\Of course I can tell! We're twins!\I admire him, too!\You like him, too?! response:	Not like that!
context: He's nice, and he's caring.\He's like a teacher.\I can see why you'd admire him.\How could you tell?\Of course I can tell! We're twins!\I admire him, too!\You like him, too?!\Not like that! response:	This is a problem...
context: He's like a teacher.\I can see why you'd admire him.\How could you tell?\Of course I can tell! We're twins!\I admire him, too!\You like him, too?!\Not like that!\This is a problem... response:	Why?
context: I can see why you'd admire him.\How could you tell?\Of course I can tell! We're twins!\I admire him, too!\You like him, too?!\Not like that!\This is a problem...\Why? response:	Why?
context: How could you tell?\Of course I can tell! We're twins!\I admire him, too!\You like him, too?!\Not like that!\This is a problem...\Why?\Why? response:	I don't think it's a problem.
context: Of course I can tell! We're twins!\I admire him, too!\You like him, too?!\Not like that!\This is a problem...\Why?\Why?\I don't think it's a problem. response:	It's not a problem... You're just hurt, Minori.
context: I admire him, too!\You like him, too?!\Not like that!\This is a problem...\Why?\Why?\I don't think it's a problem.\It's not a problem... You're just hurt, Minori. response:	Is it okay?
context: You like him, too?!\Not like that!\This is a problem...\Why?\Why?\I don't think it's a problem.\It's not a problem... You're just hurt, Minori.\Is it okay? response:	You can't help it, right?
context: Not like that!\This is a problem...\Why?\Why?\I don't think it's a problem.\It's not a problem... You're just hurt, Minori.\Is it okay?\You can't help it, right? response:	You're right...
context: This is a problem...\Why?\Why?\I don't think it's a problem.\It's not a problem... You're just hurt, Minori.\Is it okay?\You can't help it, right?\You're right... response:	It isn't a problem...
context: Why?\Why?\I don't think it's a problem.\It's not a problem... You're just hurt, Minori.\Is it okay?\You can't help it, right?\You're right...\It isn't a problem... response:	It just hurts.
context: Why?\I don't think it's a problem.\It's not a problem... You're just hurt, Minori.\Is it okay?\You can't help it, right?\You're right...\It isn't a problem...\It just hurts. response:	I haven't lost anything, and I haven't done anything.
context: I don't think it's a problem.\It's not a problem... You're just hurt, Minori.\Is it okay?\You can't help it, right?\You're right...\It isn't a problem...\It just hurts.\I haven't lost anything, and I haven't done anything. response:	I haven't done anything yet, have I?
context: It's not a problem... You're just hurt, Minori.\Is it okay?\You can't help it, right?\You're right...\It isn't a problem...\It just hurts.\I haven't lost anything, and I haven't done anything.\I haven't done anything yet, have I? response:	That's true.
context: Is it okay?\You can't help it, right?\You're right...\It isn't a problem...\It just hurts.\I haven't lost anything, and I haven't done anything.\I haven't done anything yet, have I?\That's true. response:	Yeah.
context: You can't help it, right?\You're right...\It isn't a problem...\It just hurts.\I haven't lost anything, and I haven't done anything.\I haven't done anything yet, have I?\That's true.\Yeah. response:	The girl simply admired him.
context: You're right...\It isn't a problem...\It just hurts.\I haven't lost anything, and I haven't done anything.\I haven't done anything yet, have I?\That's true.\Yeah.\The girl simply admired him. response:	She wanted to be like him...
context: It isn't a problem...\It just hurts.\I haven't lost anything, and I haven't done anything.\I haven't done anything yet, have I?\That's true.\Yeah.\The girl simply admired him.\She wanted to be like him... response:	To follow him.
context: It just hurts.\I haven't lost anything, and I haven't done anything.\I haven't done anything yet, have I?\That's true.\Yeah.\The girl simply admired him.\She wanted to be like him...\To follow him. response:	To stand behind him. That was all.
context: I haven't lost anything, and I haven't done anything.\I haven't done anything yet, have I?\That's true.\Yeah.\The girl simply admired him.\She wanted to be like him...\To follow him.\To stand behind him. That was all. response:	But it didn't take long for those feelings to turn to love.
context: I haven't done anything yet, have I?\That's true.\Yeah.\The girl simply admired him.\She wanted to be like him...\To follow him.\To stand behind him. That was all.\But it didn't take long for those feelings to turn to love. response:	Minori is in love with Shiroe.
context: That's true.\Yeah.\The girl simply admired him.\She wanted to be like him...\To follow him.\To stand behind him. That was all.\But it didn't take long for those feelings to turn to love.\Minori is in love with Shiroe. response:	Student of the Mage
context: Yeah.\The girl simply admired him.\She wanted to be like him...\To follow him.\To stand behind him. That was all.\But it didn't take long for those feelings to turn to love.\Minori is in love with Shiroe.\Student of the Mage response:	Next time: Student of the Mage.
context: The girl simply admired him.\She wanted to be like him...\To follow him.\To stand behind him. That was all.\But it didn't take long for those feelings to turn to love.\Minori is in love with Shiroe.\Student of the Mage\Next time: Student of the Mage. response:	We will change the world.