context: A Village Out in the Boonies: Hage response:	Here we go again...
context: A Village Out in the Boonies: Hage\Here we go again... response:	There, there...
context: A Village Out in the Boonies: Hage\Here we go again...\There, there... response:	There you are.
context: A Village Out in the Boonies: Hage\Here we go again...\There, there...\There you are. response:	Those two finally calmed down.
context: A Village Out in the Boonies: Hage\Here we go again...\There, there...\There you are.\Those two finally calmed down. response:	Are they brothers... or perhaps twins?
context: A Village Out in the Boonies: Hage\Here we go again...\There, there...\There you are.\Those two finally calmed down.\Are they brothers... or perhaps twins? response:	No, they're not.
context: A Village Out in the Boonies: Hage\Here we go again...\There, there...\There you are.\Those two finally calmed down.\Are they brothers... or perhaps twins?\No, they're not. response:	This one is rather calm, but this one...
context: A Village Out in the Boonies: Hage\Here we go again...\There, there...\There you are.\Those two finally calmed down.\Are they brothers... or perhaps twins?\No, they're not.\This one is rather calm, but this one... response:	seems like he has a lot of spunk.
context: Here we go again...\There, there...\There you are.\Those two finally calmed down.\Are they brothers... or perhaps twins?\No, they're not.\This one is rather calm, but this one...\seems like he has a lot of spunk. response:	First of all, they don't look a thing alike.
context: There, there...\There you are.\Those two finally calmed down.\Are they brothers... or perhaps twins?\No, they're not.\This one is rather calm, but this one...\seems like he has a lot of spunk.\First of all, they don't look a thing alike. response:	Hm? Yuno...
context: There you are.\Those two finally calmed down.\Are they brothers... or perhaps twins?\No, they're not.\This one is rather calm, but this one...\seems like he has a lot of spunk.\First of all, they don't look a thing alike.\Hm? Yuno... response:	Let's see. And the spunky one over here is
context: Those two finally calmed down.\Are they brothers... or perhaps twins?\No, they're not.\This one is rather calm, but this one...\seems like he has a lot of spunk.\First of all, they don't look a thing alike.\Hm? Yuno...\Let's see. And the spunky one over here is response:	Hey! You're a bit too spunky...
context: Are they brothers... or perhaps twins?\No, they're not.\This one is rather calm, but this one...\seems like he has a lot of spunk.\First of all, they don't look a thing alike.\Hm? Yuno...\Let's see. And the spunky one over here is\Hey! You're a bit too spunky... response:	Asta, eh?
context: No, they're not.\This one is rather calm, but this one...\seems like he has a lot of spunk.\First of all, they don't look a thing alike.\Hm? Yuno...\Let's see. And the spunky one over here is\Hey! You're a bit too spunky...\Asta, eh? response:	Right! You two don't need to worry about a thing anymore.
context: This one is rather calm, but this one...\seems like he has a lot of spunk.\First of all, they don't look a thing alike.\Hm? Yuno...\Let's see. And the spunky one over here is\Hey! You're a bit too spunky...\Asta, eh?\Right! You two don't need to worry about a thing anymore. response:	Starting today, this is your new home...
context: seems like he has a lot of spunk.\First of all, they don't look a thing alike.\Hm? Yuno...\Let's see. And the spunky one over here is\Hey! You're a bit too spunky...\Asta, eh?\Right! You two don't need to worry about a thing anymore.\Starting today, this is your new home... response:	Asta, Yuno.
context: First of all, they don't look a thing alike.\Hm? Yuno...\Let's see. And the spunky one over here is\Hey! You're a bit too spunky...\Asta, eh?\Right! You two don't need to worry about a thing anymore.\Starting today, this is your new home...\Asta, Yuno. response:	15 Years Later
context: Hm? Yuno...\Let's see. And the spunky one over here is\Hey! You're a bit too spunky...\Asta, eh?\Right! You two don't need to worry about a thing anymore.\Starting today, this is your new home...\Asta, Yuno.\15 Years Later response:	Hopefully, we'll have a great harvest this year.
context: Let's see. And the spunky one over here is\Hey! You're a bit too spunky...\Asta, eh?\Right! You two don't need to worry about a thing anymore.\Starting today, this is your new home...\Asta, Yuno.\15 Years Later\Hopefully, we'll have a great harvest this year. response:	Yeah.
context: Hey! You're a bit too spunky...\Asta, eh?\Right! You two don't need to worry about a thing anymore.\Starting today, this is your new home...\Asta, Yuno.\15 Years Later\Hopefully, we'll have a great harvest this year.\Yeah. response:	Hup.
context: Asta, eh?\Right! You two don't need to worry about a thing anymore.\Starting today, this is your new home...\Asta, Yuno.\15 Years Later\Hopefully, we'll have a great harvest this year.\Yeah.\Hup. response:	Sister Lily!
context: Right! You two don't need to worry about a thing anymore.\Starting today, this is your new home...\Asta, Yuno.\15 Years Later\Hopefully, we'll have a great harvest this year.\Yeah.\Hup.\Sister Lily! response:	What the...
context: Starting today, this is your new home...\Asta, Yuno.\15 Years Later\Hopefully, we'll have a great harvest this year.\Yeah.\Hup.\Sister Lily!\What the... response:	Must be that runt from the church again.
context: Asta, Yuno.\15 Years Later\Hopefully, we'll have a great harvest this year.\Yeah.\Hup.\Sister Lily!\What the...\Must be that runt from the church again. response:	I'll become the Wizard King someday and make you happy!
context: 15 Years Later\Hopefully, we'll have a great harvest this year.\Yeah.\Hup.\Sister Lily!\What the...\Must be that runt from the church again.\I'll become the Wizard King someday and make you happy! response:	So please marry me!
context: Hopefully, we'll have a great harvest this year.\Yeah.\Hup.\Sister Lily!\What the...\Must be that runt from the church again.\I'll become the Wizard King someday and make you happy!\So please marry me! response:	I'm sorry, Asta, but I'm everyone's sister.
context: Yeah.\Hup.\Sister Lily!\What the...\Must be that runt from the church again.\I'll become the Wizard King someday and make you happy!\So please marry me!\I'm sorry, Asta, but I'm everyone's sister. response:	Not yet!
context: Hup.\Sister Lily!\What the...\Must be that runt from the church again.\I'll become the Wizard King someday and make you happy!\So please marry me!\I'm sorry, Asta, but I'm everyone's sister.\Not yet! response:	Um... I'm sorry.
context: Sister Lily!\What the...\Must be that runt from the church again.\I'll become the Wizard King someday and make you happy!\So please marry me!\I'm sorry, Asta, but I'm everyone's sister.\Not yet!\Um... I'm sorry. response:	I'm not giving up yet!
context: What the...\Must be that runt from the church again.\I'll become the Wizard King someday and make you happy!\So please marry me!\I'm sorry, Asta, but I'm everyone's sister.\Not yet!\Um... I'm sorry.\I'm not giving up yet! response:	Er, um... But...
context: Must be that runt from the church again.\I'll become the Wizard King someday and make you happy!\So please marry me!\I'm sorry, Asta, but I'm everyone's sister.\Not yet!\Um... I'm sorry.\I'm not giving up yet!\Er, um... But... response:	I'm not giving up!
context: I'll become the Wizard King someday and make you happy!\So please marry me!\I'm sorry, Asta, but I'm everyone's sister.\Not yet!\Um... I'm sorry.\I'm not giving up yet!\Er, um... But...\I'm not giving up! response:	I'm really sorry!
context: So please marry me!\I'm sorry, Asta, but I'm everyone's sister.\Not yet!\Um... I'm sorry.\I'm not giving up yet!\Er, um... But...\I'm not giving up!\I'm really sorry! response:	One more time, Sister Lily!
context: I'm sorry, Asta, but I'm everyone's sister.\Not yet!\Um... I'm sorry.\I'm not giving up yet!\Er, um... But...\I'm not giving up!\I'm really sorry!\One more time, Sister Lily! response:	Stop pestering me!
context: Not yet!\Um... I'm sorry.\I'm not giving up yet!\Er, um... But...\I'm not giving up!\I'm really sorry!\One more time, Sister Lily!\Stop pestering me! response:	Water Creation Magic: Holy Fist of Love!
context: Um... I'm sorry.\I'm not giving up yet!\Er, um... But...\I'm not giving up!\I'm really sorry!\One more time, Sister Lily!\Stop pestering me!\Water Creation Magic: Holy Fist of Love! response:	I-I'm sorry, Asta.
context: I'm not giving up yet!\Er, um... But...\I'm not giving up!\I'm really sorry!\One more time, Sister Lily!\Stop pestering me!\Water Creation Magic: Holy Fist of Love!\I-I'm sorry, Asta. response:	I used magic from my grimoire without thinking...
context: Er, um... But...\I'm not giving up!\I'm really sorry!\One more time, Sister Lily!\Stop pestering me!\Water Creation Magic: Holy Fist of Love!\I-I'm sorry, Asta.\I used magic from my grimoire without thinking... response:	Well done, sister.
context: I'm not giving up!\I'm really sorry!\One more time, Sister Lily!\Stop pestering me!\Water Creation Magic: Holy Fist of Love!\I-I'm sorry, Asta.\I used magic from my grimoire without thinking...\Well done, sister. response:	No mercy whatsoever.
context: I'm really sorry!\One more time, Sister Lily!\Stop pestering me!\Water Creation Magic: Holy Fist of Love!\I-I'm sorry, Asta.\I used magic from my grimoire without thinking...\Well done, sister.\No mercy whatsoever. response:	I-I... It just happened..
context: One more time, Sister Lily!\Stop pestering me!\Water Creation Magic: Holy Fist of Love!\I-I'm sorry, Asta.\I used magic from my grimoire without thinking...\Well done, sister.\No mercy whatsoever.\I-I... It just happened.. response:	I'm not done yet!
context: Stop pestering me!\Water Creation Magic: Holy Fist of Love!\I-I'm sorry, Asta.\I used magic from my grimoire without thinking...\Well done, sister.\No mercy whatsoever.\I-I... It just happened..\I'm not done yet! response:	Sheesh.
context: Water Creation Magic: Holy Fist of Love!\I-I'm sorry, Asta.\I used magic from my grimoire without thinking...\Well done, sister.\No mercy whatsoever.\I-I... It just happened..\I'm not done yet!\Sheesh. response:	How many times does she have to dump you?
context: I-I'm sorry, Asta.\I used magic from my grimoire without thinking...\Well done, sister.\No mercy whatsoever.\I-I... It just happened..\I'm not done yet!\Sheesh.\How many times does she have to dump you? response:	Why are you getting in my way too, Yuno?!
context: I used magic from my grimoire without thinking...\Well done, sister.\No mercy whatsoever.\I-I... It just happened..\I'm not done yet!\Sheesh.\How many times does she have to dump you?\Why are you getting in my way too, Yuno?! response:	Why?
context: Well done, sister.\No mercy whatsoever.\I-I... It just happened..\I'm not done yet!\Sheesh.\How many times does she have to dump you?\Why are you getting in my way too, Yuno?!\Why? response:	Because you're loud, short,
context: No mercy whatsoever.\I-I... It just happened..\I'm not done yet!\Sheesh.\How many times does she have to dump you?\Why are you getting in my way too, Yuno?!\Why?\Because you're loud, short, response:	Loud
context: I-I... It just happened..\I'm not done yet!\Sheesh.\How many times does she have to dump you?\Why are you getting in my way too, Yuno?!\Why?\Because you're loud, short,\Loud response:	Short
context: I'm not done yet!\Sheesh.\How many times does she have to dump you?\Why are you getting in my way too, Yuno?!\Why?\Because you're loud, short,\Loud\Short response:	obnoxious, and immature.
context: Sheesh.\How many times does she have to dump you?\Why are you getting in my way too, Yuno?!\Why?\Because you're loud, short,\Loud\Short\obnoxious, and immature. response:	Obnoxious
context: How many times does she have to dump you?\Why are you getting in my way too, Yuno?!\Why?\Because you're loud, short,\Loud\Short\obnoxious, and immature.\Obnoxious response:	Immature
context: Why are you getting in my way too, Yuno?!\Why?\Because you're loud, short,\Loud\Short\obnoxious, and immature.\Obnoxious\Immature response:	Basically, you're not appealing to women in any way.
context: Why?\Because you're loud, short,\Loud\Short\obnoxious, and immature.\Obnoxious\Immature\Basically, you're not appealing to women in any way. response:	Not appealing
context: Because you're loud, short,\Loud\Short\obnoxious, and immature.\Obnoxious\Immature\Basically, you're not appealing to women in any way.\Not appealing response:	Hey! Is that what you say to someone you've grown up with
context: Loud\Short\obnoxious, and immature.\Obnoxious\Immature\Basically, you're not appealing to women in any way.\Not appealing\Hey! Is that what you say to someone you've grown up with response:	for the past fifteen years, you handsome jerk?!
context: Short\obnoxious, and immature.\Obnoxious\Immature\Basically, you're not appealing to women in any way.\Not appealing\Hey! Is that what you say to someone you've grown up with\for the past fifteen years, you handsome jerk?! response:	Let me give you a hand.
context: obnoxious, and immature.\Obnoxious\Immature\Basically, you're not appealing to women in any way.\Not appealing\Hey! Is that what you say to someone you've grown up with\for the past fifteen years, you handsome jerk?!\Let me give you a hand. response:	Thanks.
context: Obnoxious\Immature\Basically, you're not appealing to women in any way.\Not appealing\Hey! Is that what you say to someone you've grown up with\for the past fifteen years, you handsome jerk?!\Let me give you a hand.\Thanks. response:	Don't ignore me, damn it!
context: Immature\Basically, you're not appealing to women in any way.\Not appealing\Hey! Is that what you say to someone you've grown up with\for the past fifteen years, you handsome jerk?!\Let me give you a hand.\Thanks.\Don't ignore me, damn it! response:	Asta, Sister Lily is a woman of the cloth, so she can't get married.
context: Basically, you're not appealing to women in any way.\Not appealing\Hey! Is that what you say to someone you've grown up with\for the past fifteen years, you handsome jerk?!\Let me give you a hand.\Thanks.\Don't ignore me, damn it!\Asta, Sister Lily is a woman of the cloth, so she can't get married. response:	Also, you're only fifteen, so you can't get married anyway.
context: Not appealing\Hey! Is that what you say to someone you've grown up with\for the past fifteen years, you handsome jerk?!\Let me give you a hand.\Thanks.\Don't ignore me, damn it!\Asta, Sister Lily is a woman of the cloth, so she can't get married.\Also, you're only fifteen, so you can't get married anyway. response:	Shut up! Yuno, you jerk... I oughta...
context: Hey! Is that what you say to someone you've grown up with\for the past fifteen years, you handsome jerk?!\Let me give you a hand.\Thanks.\Don't ignore me, damn it!\Asta, Sister Lily is a woman of the cloth, so she can't get married.\Also, you're only fifteen, so you can't get married anyway.\Shut up! Yuno, you jerk... I oughta... response:	I challenge you to a fight, Yuno!
context: for the past fifteen years, you handsome jerk?!\Let me give you a hand.\Thanks.\Don't ignore me, damn it!\Asta, Sister Lily is a woman of the cloth, so she can't get married.\Also, you're only fifteen, so you can't get married anyway.\Shut up! Yuno, you jerk... I oughta...\I challenge you to a fight, Yuno! response:	And I decline.
context: Let me give you a hand.\Thanks.\Don't ignore me, damn it!\Asta, Sister Lily is a woman of the cloth, so she can't get married.\Also, you're only fifteen, so you can't get married anyway.\Shut up! Yuno, you jerk... I oughta...\I challenge you to a fight, Yuno!\And I decline. response:	Why the hell not?!
context: Thanks.\Don't ignore me, damn it!\Asta, Sister Lily is a woman of the cloth, so she can't get married.\Also, you're only fifteen, so you can't get married anyway.\Shut up! Yuno, you jerk... I oughta...\I challenge you to a fight, Yuno!\And I decline.\Why the hell not?! response:	Because it's a waste of time.
context: Don't ignore me, damn it!\Asta, Sister Lily is a woman of the cloth, so she can't get married.\Also, you're only fifteen, so you can't get married anyway.\Shut up! Yuno, you jerk... I oughta...\I challenge you to a fight, Yuno!\And I decline.\Why the hell not?!\Because it's a waste of time. response:	What'd you say?!
context: Asta, Sister Lily is a woman of the cloth, so she can't get married.\Also, you're only fifteen, so you can't get married anyway.\Shut up! Yuno, you jerk... I oughta...\I challenge you to a fight, Yuno!\And I decline.\Why the hell not?!\Because it's a waste of time.\What'd you say?! response:	Give it a rest, Asta. There's no way you can beat Yuno.
context: Also, you're only fifteen, so you can't get married anyway.\Shut up! Yuno, you jerk... I oughta...\I challenge you to a fight, Yuno!\And I decline.\Why the hell not?!\Because it's a waste of time.\What'd you say?!\Give it a rest, Asta. There's no way you can beat Yuno. response:	Take this...
context: Shut up! Yuno, you jerk... I oughta...\I challenge you to a fight, Yuno!\And I decline.\Why the hell not?!\Because it's a waste of time.\What'd you say?!\Give it a rest, Asta. There's no way you can beat Yuno.\Take this... response:	My ultimate...
context: I challenge you to a fight, Yuno!\And I decline.\Why the hell not?!\Because it's a waste of time.\What'd you say?!\Give it a rest, Asta. There's no way you can beat Yuno.\Take this...\My ultimate... response:	Hold up, Asta.
context: And I decline.\Why the hell not?!\Because it's a waste of time.\What'd you say?!\Give it a rest, Asta. There's no way you can beat Yuno.\Take this...\My ultimate...\Hold up, Asta. response:	Attack!
context: Why the hell not?!\Because it's a waste of time.\What'd you say?!\Give it a rest, Asta. There's no way you can beat Yuno.\Take this...\My ultimate...\Hold up, Asta.\Attack! response:	I mean, you can't even use magic.
context: Because it's a waste of time.\What'd you say?!\Give it a rest, Asta. There's no way you can beat Yuno.\Take this...\My ultimate...\Hold up, Asta.\Attack!\I mean, you can't even use magic. response:	Nothing came out!
context: What'd you say?!\Give it a rest, Asta. There's no way you can beat Yuno.\Take this...\My ultimate...\Hold up, Asta.\Attack!\I mean, you can't even use magic.\Nothing came out! response:	I'm not done yet!
context: Give it a rest, Asta. There's no way you can beat Yuno.\Take this...\My ultimate...\Hold up, Asta.\Attack!\I mean, you can't even use magic.\Nothing came out!\I'm not done yet! response:	You're funny, Asta!
context: Take this...\My ultimate...\Hold up, Asta.\Attack!\I mean, you can't even use magic.\Nothing came out!\I'm not done yet!\You're funny, Asta! response:	You have zero sense.
context: My ultimate...\Hold up, Asta.\Attack!\I mean, you can't even use magic.\Nothing came out!\I'm not done yet!\You're funny, Asta!\You have zero sense. response:	It's hard to believe someone your age can't use magic yet.
context: Hold up, Asta.\Attack!\I mean, you can't even use magic.\Nothing came out!\I'm not done yet!\You're funny, Asta!\You have zero sense.\It's hard to believe someone your age can't use magic yet. response:	The hell's your problem?! How dare you speak to your elders that way?!
context: Attack!\I mean, you can't even use magic.\Nothing came out!\I'm not done yet!\You're funny, Asta!\You have zero sense.\It's hard to believe someone your age can't use magic yet.\The hell's your problem?! How dare you speak to your elders that way?! response:	Shut up.
context: I mean, you can't even use magic.\Nothing came out!\I'm not done yet!\You're funny, Asta!\You have zero sense.\It's hard to believe someone your age can't use magic yet.\The hell's your problem?! How dare you speak to your elders that way?!\Shut up. response:	Magic is everything in this world.
context: Nothing came out!\I'm not done yet!\You're funny, Asta!\You have zero sense.\It's hard to believe someone your age can't use magic yet.\The hell's your problem?! How dare you speak to your elders that way?!\Shut up.\Magic is everything in this world. response:	It's only natural to be able to use magic.
context: I'm not done yet!\You're funny, Asta!\You have zero sense.\It's hard to believe someone your age can't use magic yet.\The hell's your problem?! How dare you speak to your elders that way?!\Shut up.\Magic is everything in this world.\It's only natural to be able to use magic. response:	You're the only one I've ever seen who can't use it, Asta.
context: You're funny, Asta!\You have zero sense.\It's hard to believe someone your age can't use magic yet.\The hell's your problem?! How dare you speak to your elders that way?!\Shut up.\Magic is everything in this world.\It's only natural to be able to use magic.\You're the only one I've ever seen who can't use it, Asta. response:	G-Guess I don't have a choice...
context: You have zero sense.\It's hard to believe someone your age can't use magic yet.\The hell's your problem?! How dare you speak to your elders that way?!\Shut up.\Magic is everything in this world.\It's only natural to be able to use magic.\You're the only one I've ever seen who can't use it, Asta.\G-Guess I don't have a choice... response:	I'll have to show you what I'm really made of...
context: It's hard to believe someone your age can't use magic yet.\The hell's your problem?! How dare you speak to your elders that way?!\Shut up.\Magic is everything in this world.\It's only natural to be able to use magic.\You're the only one I've ever seen who can't use it, Asta.\G-Guess I don't have a choice...\I'll have to show you what I'm really made of... response:	What you're really made of?
context: The hell's your problem?! How dare you speak to your elders that way?!\Shut up.\Magic is everything in this world.\It's only natural to be able to use magic.\You're the only one I've ever seen who can't use it, Asta.\G-Guess I don't have a choice...\I'll have to show you what I'm really made of...\What you're really made of? response:	How you like that?! I know you can't do sit-ups this fast!
context: Shut up.\Magic is everything in this world.\It's only natural to be able to use magic.\You're the only one I've ever seen who can't use it, Asta.\G-Guess I don't have a choice...\I'll have to show you what I'm really made of...\What you're really made of?\How you like that?! I know you can't do sit-ups this fast! response:	What's your point, you idiot?
context: Magic is everything in this world.\It's only natural to be able to use magic.\You're the only one I've ever seen who can't use it, Asta.\G-Guess I don't have a choice...\I'll have to show you what I'm really made of...\What you're really made of?\How you like that?! I know you can't do sit-ups this fast!\What's your point, you idiot? response:	You're funny, Asta!
context: It's only natural to be able to use magic.\You're the only one I've ever seen who can't use it, Asta.\G-Guess I don't have a choice...\I'll have to show you what I'm really made of...\What you're really made of?\How you like that?! I know you can't do sit-ups this fast!\What's your point, you idiot?\You're funny, Asta! response:	Yuno's so cool!
context: You're the only one I've ever seen who can't use it, Asta.\G-Guess I don't have a choice...\I'll have to show you what I'm really made of...\What you're really made of?\How you like that?! I know you can't do sit-ups this fast!\What's your point, you idiot?\You're funny, Asta!\Yuno's so cool! response:	That's Yuno for you.
context: G-Guess I don't have a choice...\I'll have to show you what I'm really made of...\What you're really made of?\How you like that?! I know you can't do sit-ups this fast!\What's your point, you idiot?\You're funny, Asta!\Yuno's so cool!\That's Yuno for you. response:	He's such a great help.
context: I'll have to show you what I'm really made of...\What you're really made of?\How you like that?! I know you can't do sit-ups this fast!\What's your point, you idiot?\You're funny, Asta!\Yuno's so cool!\That's Yuno for you.\He's such a great help. response:	Then leave... the wood-chopping...
context: What you're really made of?\How you like that?! I know you can't do sit-ups this fast!\What's your point, you idiot?\You're funny, Asta!\Yuno's so cool!\That's Yuno for you.\He's such a great help.\Then leave... the wood-chopping... response:	to me!
context: How you like that?! I know you can't do sit-ups this fast!\What's your point, you idiot?\You're funny, Asta!\Yuno's so cool!\That's Yuno for you.\He's such a great help.\Then leave... the wood-chopping...\to me! response:	I still can't believe you two are the same age.
context: What's your point, you idiot?\You're funny, Asta!\Yuno's so cool!\That's Yuno for you.\He's such a great help.\Then leave... the wood-chopping...\to me!\I still can't believe you two are the same age. response:	Yuno is the hope of this church!
context: You're funny, Asta!\Yuno's so cool!\That's Yuno for you.\He's such a great help.\Then leave... the wood-chopping...\to me!\I still can't believe you two are the same age.\Yuno is the hope of this church! response:	I won't be surprised if you end up joining
context: Yuno's so cool!\That's Yuno for you.\He's such a great help.\Then leave... the wood-chopping...\to me!\I still can't believe you two are the same age.\Yuno is the hope of this church!\I won't be surprised if you end up joining response:	the Magic Knights who serve the Wizard King, Yuno!
context: That's Yuno for you.\He's such a great help.\Then leave... the wood-chopping...\to me!\I still can't believe you two are the same age.\Yuno is the hope of this church!\I won't be surprised if you end up joining\the Magic Knights who serve the Wizard King, Yuno! response:	The awarding ceremony is coming up, Asta.
context: He's such a great help.\Then leave... the wood-chopping...\to me!\I still can't believe you two are the same age.\Yuno is the hope of this church!\I won't be surprised if you end up joining\the Magic Knights who serve the Wizard King, Yuno!\The awarding ceremony is coming up, Asta. response:	Once you receive your grimoire,
context: Then leave... the wood-chopping...\to me!\I still can't believe you two are the same age.\Yuno is the hope of this church!\I won't be surprised if you end up joining\the Magic Knights who serve the Wizard King, Yuno!\The awarding ceremony is coming up, Asta.\Once you receive your grimoire, response:	it should trigger something within you, and you should be able to use magic, too.
context: to me!\I still can't believe you two are the same age.\Yuno is the hope of this church!\I won't be surprised if you end up joining\the Magic Knights who serve the Wizard King, Yuno!\The awarding ceremony is coming up, Asta.\Once you receive your grimoire,\it should trigger something within you, and you should be able to use magic, too. response:	Sister...
context: I still can't believe you two are the same age.\Yuno is the hope of this church!\I won't be surprised if you end up joining\the Magic Knights who serve the Wizard King, Yuno!\The awarding ceremony is coming up, Asta.\Once you receive your grimoire,\it should trigger something within you, and you should be able to use magic, too.\Sister... response:	At least, I think so.
context: Yuno is the hope of this church!\I won't be surprised if you end up joining\the Magic Knights who serve the Wizard King, Yuno!\The awarding ceremony is coming up, Asta.\Once you receive your grimoire,\it should trigger something within you, and you should be able to use magic, too.\Sister...\At least, I think so. response:	I'll get my grimoire soon...
context: I won't be surprised if you end up joining\the Magic Knights who serve the Wizard King, Yuno!\The awarding ceremony is coming up, Asta.\Once you receive your grimoire,\it should trigger something within you, and you should be able to use magic, too.\Sister...\At least, I think so.\I'll get my grimoire soon... response:	Finally... Finally!
context: the Magic Knights who serve the Wizard King, Yuno!\The awarding ceremony is coming up, Asta.\Once you receive your grimoire,\it should trigger something within you, and you should be able to use magic, too.\Sister...\At least, I think so.\I'll get my grimoire soon...\Finally... Finally! response:	I'll get a grimoire that's more amazing than anyone else's,
context: The awarding ceremony is coming up, Asta.\Once you receive your grimoire,\it should trigger something within you, and you should be able to use magic, too.\Sister...\At least, I think so.\I'll get my grimoire soon...\Finally... Finally!\I'll get a grimoire that's more amazing than anyone else's, response:	get into the Magic Knights, follow in your footsteps,
context: Once you receive your grimoire,\it should trigger something within you, and you should be able to use magic, too.\Sister...\At least, I think so.\I'll get my grimoire soon...\Finally... Finally!\I'll get a grimoire that's more amazing than anyone else's,\get into the Magic Knights, follow in your footsteps, response:	and become the Wizard King!
context: it should trigger something within you, and you should be able to use magic, too.\Sister...\At least, I think so.\I'll get my grimoire soon...\Finally... Finally!\I'll get a grimoire that's more amazing than anyone else's,\get into the Magic Knights, follow in your footsteps,\and become the Wizard King! response:	There he goes again.
context: Sister...\At least, I think so.\I'll get my grimoire soon...\Finally... Finally!\I'll get a grimoire that's more amazing than anyone else's,\get into the Magic Knights, follow in your footsteps,\and become the Wizard King!\There he goes again. response:	And I'll fix up this shabby, ugly church!
context: At least, I think so.\I'll get my grimoire soon...\Finally... Finally!\I'll get a grimoire that's more amazing than anyone else's,\get into the Magic Knights, follow in your footsteps,\and become the Wizard King!\There he goes again.\And I'll fix up this shabby, ugly church! response:	Well, I'm sorry it's so shabby and ugly!
context: I'll get my grimoire soon...\Finally... Finally!\I'll get a grimoire that's more amazing than anyone else's,\get into the Magic Knights, follow in your footsteps,\and become the Wizard King!\There he goes again.\And I'll fix up this shabby, ugly church!\Well, I'm sorry it's so shabby and ugly! response:	Right, Yuno?
context: Finally... Finally!\I'll get a grimoire that's more amazing than anyone else's,\get into the Magic Knights, follow in your footsteps,\and become the Wizard King!\There he goes again.\And I'll fix up this shabby, ugly church!\Well, I'm sorry it's so shabby and ugly!\Right, Yuno? response:	Right?
context: I'll get a grimoire that's more amazing than anyone else's,\get into the Magic Knights, follow in your footsteps,\and become the Wizard King!\There he goes again.\And I'll fix up this shabby, ugly church!\Well, I'm sorry it's so shabby and ugly!\Right, Yuno?\Right? response:	Just you wait...
context: get into the Magic Knights, follow in your footsteps,\and become the Wizard King!\There he goes again.\And I'll fix up this shabby, ugly church!\Well, I'm sorry it's so shabby and ugly!\Right, Yuno?\Right?\Just you wait... response:	Just you wait, damn it!
context: and become the Wizard King!\There he goes again.\And I'll fix up this shabby, ugly church!\Well, I'm sorry it's so shabby and ugly!\Right, Yuno?\Right?\Just you wait...\Just you wait, damn it! response:	Asta, wait!
context: There he goes again.\And I'll fix up this shabby, ugly church!\Well, I'm sorry it's so shabby and ugly!\Right, Yuno?\Right?\Just you wait...\Just you wait, damn it!\Asta, wait! response:	Is he really older than me?
context: And I'll fix up this shabby, ugly church!\Well, I'm sorry it's so shabby and ugly!\Right, Yuno?\Right?\Just you wait...\Just you wait, damn it!\Asta, wait!\Is he really older than me? response:	Say, Yuno... Couldn't you be a bit nicer to Asta?
context: Well, I'm sorry it's so shabby and ugly!\Right, Yuno?\Right?\Just you wait...\Just you wait, damn it!\Asta, wait!\Is he really older than me?\Say, Yuno... Couldn't you be a bit nicer to Asta? response:	Like you used to be. Remember how you two were always together when you were little?
context: Right, Yuno?\Right?\Just you wait...\Just you wait, damn it!\Asta, wait!\Is he really older than me?\Say, Yuno... Couldn't you be a bit nicer to Asta?\Like you used to be. Remember how you two were always together when you were little? response:	Yuno used to be such a crybaby,
context: Right?\Just you wait...\Just you wait, damn it!\Asta, wait!\Is he really older than me?\Say, Yuno... Couldn't you be a bit nicer to Asta?\Like you used to be. Remember how you two were always together when you were little?\Yuno used to be such a crybaby, response:	but ever since the day he brought Asta back with those terrible injuries,
context: Just you wait...\Just you wait, damn it!\Asta, wait!\Is he really older than me?\Say, Yuno... Couldn't you be a bit nicer to Asta?\Like you used to be. Remember how you two were always together when you were little?\Yuno used to be such a crybaby,\but ever since the day he brought Asta back with those terrible injuries, response:	Yuno hasn't cried at all.
context: Just you wait, damn it!\Asta, wait!\Is he really older than me?\Say, Yuno... Couldn't you be a bit nicer to Asta?\Like you used to be. Remember how you two were always together when you were little?\Yuno used to be such a crybaby,\but ever since the day he brought Asta back with those terrible injuries,\Yuno hasn't cried at all. response:	I can't be nicer to him.
context: Asta, wait!\Is he really older than me?\Say, Yuno... Couldn't you be a bit nicer to Asta?\Like you used to be. Remember how you two were always together when you were little?\Yuno used to be such a crybaby,\but ever since the day he brought Asta back with those terrible injuries,\Yuno hasn't cried at all.\I can't be nicer to him. response:	Come to think of it, Asta has come home covered in mud ever since that day, too.
context: Is he really older than me?\Say, Yuno... Couldn't you be a bit nicer to Asta?\Like you used to be. Remember how you two were always together when you were little?\Yuno used to be such a crybaby,\but ever since the day he brought Asta back with those terrible injuries,\Yuno hasn't cried at all.\I can't be nicer to him.\Come to think of it, Asta has come home covered in mud ever since that day, too. response:	I wonder what he's doing out there...
context: Say, Yuno... Couldn't you be a bit nicer to Asta?\Like you used to be. Remember how you two were always together when you were little?\Yuno used to be such a crybaby,\but ever since the day he brought Asta back with those terrible injuries,\Yuno hasn't cried at all.\I can't be nicer to him.\Come to think of it, Asta has come home covered in mud ever since that day, too.\I wonder what he's doing out there... response:	994... 995, 996,
context: Like you used to be. Remember how you two were always together when you were little?\Yuno used to be such a crybaby,\but ever since the day he brought Asta back with those terrible injuries,\Yuno hasn't cried at all.\I can't be nicer to him.\Come to think of it, Asta has come home covered in mud ever since that day, too.\I wonder what he's doing out there...\994... 995, 996, response:	997, 998, 999... 1,000!
context: Yuno used to be such a crybaby,\but ever since the day he brought Asta back with those terrible injuries,\Yuno hasn't cried at all.\I can't be nicer to him.\Come to think of it, Asta has come home covered in mud ever since that day, too.\I wonder what he's doing out there...\994... 995, 996,\997, 998, 999... 1,000! response:	And now for this moguro leaf juice, which is supposed to be
context: but ever since the day he brought Asta back with those terrible injuries,\Yuno hasn't cried at all.\I can't be nicer to him.\Come to think of it, Asta has come home covered in mud ever since that day, too.\I wonder what he's doing out there...\994... 995, 996,\997, 998, 999... 1,000!\And now for this moguro leaf juice, which is supposed to be response:	good for increasing magical powers!
context: Yuno hasn't cried at all.\I can't be nicer to him.\Come to think of it, Asta has come home covered in mud ever since that day, too.\I wonder what he's doing out there...\994... 995, 996,\997, 998, 999... 1,000!\And now for this moguro leaf juice, which is supposed to be\good for increasing magical powers! response:	I'm going to become the Wizard King.
context: I can't be nicer to him.\Come to think of it, Asta has come home covered in mud ever since that day, too.\I wonder what he's doing out there...\994... 995, 996,\997, 998, 999... 1,000!\And now for this moguro leaf juice, which is supposed to be\good for increasing magical powers!\I'm going to become the Wizard King. response:	That's the one thing I'll never give up on!
context: Come to think of it, Asta has come home covered in mud ever since that day, too.\I wonder what he's doing out there...\994... 995, 996,\997, 998, 999... 1,000!\And now for this moguro leaf juice, which is supposed to be\good for increasing magical powers!\I'm going to become the Wizard King.\That's the one thing I'll never give up on! response:	But before that, I need to build myself up!
context: I wonder what he's doing out there...\994... 995, 996,\997, 998, 999... 1,000!\And now for this moguro leaf juice, which is supposed to be\good for increasing magical powers!\I'm going to become the Wizard King.\That's the one thing I'll never give up on!\But before that, I need to build myself up! response:	March... When firefly dandelion fluff starts to dance through the air.
context: 994... 995, 996,\997, 998, 999... 1,000!\And now for this moguro leaf juice, which is supposed to be\good for increasing magical powers!\I'm going to become the Wizard King.\That's the one thing I'll never give up on!\But before that, I need to build myself up!\March... When firefly dandelion fluff starts to dance through the air. response:	Once a year, all around the Clover Kingdom, all of the 15-year-olds are gathered,
context: 997, 998, 999... 1,000!\And now for this moguro leaf juice, which is supposed to be\good for increasing magical powers!\I'm going to become the Wizard King.\That's the one thing I'll never give up on!\But before that, I need to build myself up!\March... When firefly dandelion fluff starts to dance through the air.\Once a year, all around the Clover Kingdom, all of the 15-year-olds are gathered, response:	Grimoire Tower
context: And now for this moguro leaf juice, which is supposed to be\good for increasing magical powers!\I'm going to become the Wizard King.\That's the one thing I'll never give up on!\But before that, I need to build myself up!\March... When firefly dandelion fluff starts to dance through the air.\Once a year, all around the Clover Kingdom, all of the 15-year-olds are gathered,\Grimoire Tower response:	and an awarding ceremony is held, where they receive
context: good for increasing magical powers!\I'm going to become the Wizard King.\That's the one thing I'll never give up on!\But before that, I need to build myself up!\March... When firefly dandelion fluff starts to dance through the air.\Once a year, all around the Clover Kingdom, all of the 15-year-olds are gathered,\Grimoire Tower\and an awarding ceremony is held, where they receive response:	their own grimoires, which enhance their magical powers.
context: I'm going to become the Wizard King.\That's the one thing I'll never give up on!\But before that, I need to build myself up!\March... When firefly dandelion fluff starts to dance through the air.\Once a year, all around the Clover Kingdom, all of the 15-year-olds are gathered,\Grimoire Tower\and an awarding ceremony is held, where they receive\their own grimoires, which enhance their magical powers. response:	Wow!
context: That's the one thing I'll never give up on!\But before that, I need to build myself up!\March... When firefly dandelion fluff starts to dance through the air.\Once a year, all around the Clover Kingdom, all of the 15-year-olds are gathered,\Grimoire Tower\and an awarding ceremony is held, where they receive\their own grimoires, which enhance their magical powers.\Wow! response:	A-Are all of these grimoires?
context: But before that, I need to build myself up!\March... When firefly dandelion fluff starts to dance through the air.\Once a year, all around the Clover Kingdom, all of the 15-year-olds are gathered,\Grimoire Tower\and an awarding ceremony is held, where they receive\their own grimoires, which enhance their magical powers.\Wow!\A-Are all of these grimoires? response:	Which one is mine?
context: March... When firefly dandelion fluff starts to dance through the air.\Once a year, all around the Clover Kingdom, all of the 15-year-olds are gathered,\Grimoire Tower\and an awarding ceremony is held, where they receive\their own grimoires, which enhance their magical powers.\Wow!\A-Are all of these grimoires?\Which one is mine? response:	Once I get my grimoire, I'm sure I'll be able to use magic, too.
context: Once a year, all around the Clover Kingdom, all of the 15-year-olds are gathered,\Grimoire Tower\and an awarding ceremony is held, where they receive\their own grimoires, which enhance their magical powers.\Wow!\A-Are all of these grimoires?\Which one is mine?\Once I get my grimoire, I'm sure I'll be able to use magic, too. response:	I'll catch up to Yuno in no time!
context: Grimoire Tower\and an awarding ceremony is held, where they receive\their own grimoires, which enhance their magical powers.\Wow!\A-Are all of these grimoires?\Which one is mine?\Once I get my grimoire, I'm sure I'll be able to use magic, too.\I'll catch up to Yuno in no time! response:	Hmph. I guess today's the day I become a full-fledged mage.
context: and an awarding ceremony is held, where they receive\their own grimoires, which enhance their magical powers.\Wow!\A-Are all of these grimoires?\Which one is mine?\Once I get my grimoire, I'm sure I'll be able to use magic, too.\I'll catch up to Yuno in no time!\Hmph. I guess today's the day I become a full-fledged mage. response:	Hey, look over there.
context: their own grimoires, which enhance their magical powers.\Wow!\A-Are all of these grimoires?\Which one is mine?\Once I get my grimoire, I'm sure I'll be able to use magic, too.\I'll catch up to Yuno in no time!\Hmph. I guess today's the day I become a full-fledged mage.\Hey, look over there. response:	Pathetic, isn't it? They shouldn't have to give grimoires to dregs like that.
context: Wow!\A-Are all of these grimoires?\Which one is mine?\Once I get my grimoire, I'm sure I'll be able to use magic, too.\I'll catch up to Yuno in no time!\Hmph. I guess today's the day I become a full-fledged mage.\Hey, look over there.\Pathetic, isn't it? They shouldn't have to give grimoires to dregs like that. response:	You said it.
context: A-Are all of these grimoires?\Which one is mine?\Once I get my grimoire, I'm sure I'll be able to use magic, too.\I'll catch up to Yuno in no time!\Hmph. I guess today's the day I become a full-fledged mage.\Hey, look over there.\Pathetic, isn't it? They shouldn't have to give grimoires to dregs like that.\You said it. response:	Don't tell me they're
context: Which one is mine?\Once I get my grimoire, I'm sure I'll be able to use magic, too.\I'll catch up to Yuno in no time!\Hmph. I guess today's the day I become a full-fledged mage.\Hey, look over there.\Pathetic, isn't it? They shouldn't have to give grimoires to dregs like that.\You said it.\Don't tell me they're response:	actually planning on taking the Magic Knights' entrance exams, too.
context: Once I get my grimoire, I'm sure I'll be able to use magic, too.\I'll catch up to Yuno in no time!\Hmph. I guess today's the day I become a full-fledged mage.\Hey, look over there.\Pathetic, isn't it? They shouldn't have to give grimoires to dregs like that.\You said it.\Don't tell me they're\actually planning on taking the Magic Knights' entrance exams, too. response:	Only nobles born with immense magical power or ties to the royal family ever get in.
context: I'll catch up to Yuno in no time!\Hmph. I guess today's the day I become a full-fledged mage.\Hey, look over there.\Pathetic, isn't it? They shouldn't have to give grimoires to dregs like that.\You said it.\Don't tell me they're\actually planning on taking the Magic Knights' entrance exams, too.\Only nobles born with immense magical power or ties to the royal family ever get in. response:	Besides, I heard that shrimp can't even use magic!
context: Hmph. I guess today's the day I become a full-fledged mage.\Hey, look over there.\Pathetic, isn't it? They shouldn't have to give grimoires to dregs like that.\You said it.\Don't tell me they're\actually planning on taking the Magic Knights' entrance exams, too.\Only nobles born with immense magical power or ties to the royal family ever get in.\Besides, I heard that shrimp can't even use magic! response:	Wow... Then we need to take good care of him.
context: Hey, look over there.\Pathetic, isn't it? They shouldn't have to give grimoires to dregs like that.\You said it.\Don't tell me they're\actually planning on taking the Magic Knights' entrance exams, too.\Only nobles born with immense magical power or ties to the royal family ever get in.\Besides, I heard that shrimp can't even use magic!\Wow... Then we need to take good care of him. response:	He's like a national treasure, since he's probably
context: Pathetic, isn't it? They shouldn't have to give grimoires to dregs like that.\You said it.\Don't tell me they're\actually planning on taking the Magic Knights' entrance exams, too.\Only nobles born with immense magical power or ties to the royal family ever get in.\Besides, I heard that shrimp can't even use magic!\Wow... Then we need to take good care of him.\He's like a national treasure, since he's probably response:	the only one in this whole kingdom who can't use magic.
context: You said it.\Don't tell me they're\actually planning on taking the Magic Knights' entrance exams, too.\Only nobles born with immense magical power or ties to the royal family ever get in.\Besides, I heard that shrimp can't even use magic!\Wow... Then we need to take good care of him.\He's like a national treasure, since he's probably\the only one in this whole kingdom who can't use magic. response:	You all begin a new journey today.
context: Don't tell me they're\actually planning on taking the Magic Knights' entrance exams, too.\Only nobles born with immense magical power or ties to the royal family ever get in.\Besides, I heard that shrimp can't even use magic!\Wow... Then we need to take good care of him.\He's like a national treasure, since he's probably\the only one in this whole kingdom who can't use magic.\You all begin a new journey today. response:	I wish you all faith, hope, and love.
context: actually planning on taking the Magic Knights' entrance exams, too.\Only nobles born with immense magical power or ties to the royal family ever get in.\Besides, I heard that shrimp can't even use magic!\Wow... Then we need to take good care of him.\He's like a national treasure, since he's probably\the only one in this whole kingdom who can't use magic.\You all begin a new journey today.\I wish you all faith, hope, and love. response:	I am the master of this grimoire tower.
context: Only nobles born with immense magical power or ties to the royal family ever get in.\Besides, I heard that shrimp can't even use magic!\Wow... Then we need to take good care of him.\He's like a national treasure, since he's probably\the only one in this whole kingdom who can't use magic.\You all begin a new journey today.\I wish you all faith, hope, and love.\I am the master of this grimoire tower. response:	We've never had a Wizard King from this area,
context: Besides, I heard that shrimp can't even use magic!\Wow... Then we need to take good care of him.\He's like a national treasure, since he's probably\the only one in this whole kingdom who can't use magic.\You all begin a new journey today.\I wish you all faith, hope, and love.\I am the master of this grimoire tower.\We've never had a Wizard King from this area, response:	nor anyone who's actually achieved greatness in the Magic Knights.
context: Wow... Then we need to take good care of him.\He's like a national treasure, since he's probably\the only one in this whole kingdom who can't use magic.\You all begin a new journey today.\I wish you all faith, hope, and love.\I am the master of this grimoire tower.\We've never had a Wizard King from this area,\nor anyone who's actually achieved greatness in the Magic Knights. response:	I sincerely hope that one of you will become the Wizard King someday.
context: He's like a national treasure, since he's probably\the only one in this whole kingdom who can't use magic.\You all begin a new journey today.\I wish you all faith, hope, and love.\I am the master of this grimoire tower.\We've never had a Wizard King from this area,\nor anyone who's actually achieved greatness in the Magic Knights.\I sincerely hope that one of you will become the Wizard King someday. response:	No, really! Seriously!
context: the only one in this whole kingdom who can't use magic.\You all begin a new journey today.\I wish you all faith, hope, and love.\I am the master of this grimoire tower.\We've never had a Wizard King from this area,\nor anyone who's actually achieved greatness in the Magic Knights.\I sincerely hope that one of you will become the Wizard King someday.\No, really! Seriously! response:	Ahem.
context: You all begin a new journey today.\I wish you all faith, hope, and love.\I am the master of this grimoire tower.\We've never had a Wizard King from this area,\nor anyone who's actually achieved greatness in the Magic Knights.\I sincerely hope that one of you will become the Wizard King someday.\No, really! Seriously!\Ahem. response:	Now it's time
context: I wish you all faith, hope, and love.\I am the master of this grimoire tower.\We've never had a Wizard King from this area,\nor anyone who's actually achieved greatness in the Magic Knights.\I sincerely hope that one of you will become the Wizard King someday.\No, really! Seriously!\Ahem.\Now it's time response:	for the awarding... of the grimoires!
context: I am the master of this grimoire tower.\We've never had a Wizard King from this area,\nor anyone who's actually achieved greatness in the Magic Knights.\I sincerely hope that one of you will become the Wizard King someday.\No, really! Seriously!\Ahem.\Now it's time\for the awarding... of the grimoires! response:	This is my grimoire?
context: We've never had a Wizard King from this area,\nor anyone who's actually achieved greatness in the Magic Knights.\I sincerely hope that one of you will become the Wizard King someday.\No, really! Seriously!\Ahem.\Now it's time\for the awarding... of the grimoires!\This is my grimoire? response:	Check it out! Mine's bigger!
context: nor anyone who's actually achieved greatness in the Magic Knights.\I sincerely hope that one of you will become the Wizard King someday.\No, really! Seriously!\Ahem.\Now it's time\for the awarding... of the grimoires!\This is my grimoire?\Check it out! Mine's bigger! response:	Mine's thicker, though.
context: I sincerely hope that one of you will become the Wizard King someday.\No, really! Seriously!\Ahem.\Now it's time\for the awarding... of the grimoires!\This is my grimoire?\Check it out! Mine's bigger!\Mine's thicker, though. response:	All right! Now I can leave this town and go to the city.
context: No, really! Seriously!\Ahem.\Now it's time\for the awarding... of the grimoires!\This is my grimoire?\Check it out! Mine's bigger!\Mine's thicker, though.\All right! Now I can leave this town and go to the city. response:	I'm gonna take over the family business.
context: Ahem.\Now it's time\for the awarding... of the grimoires!\This is my grimoire?\Check it out! Mine's bigger!\Mine's thicker, though.\All right! Now I can leave this town and go to the city.\I'm gonna take over the family business. response:	This is my grimoire?
context: Now it's time\for the awarding... of the grimoires!\This is my grimoire?\Check it out! Mine's bigger!\Mine's thicker, though.\All right! Now I can leave this town and go to the city.\I'm gonna take over the family business.\This is my grimoire? response:	Mine's like...
context: for the awarding... of the grimoires!\This is my grimoire?\Check it out! Mine's bigger!\Mine's thicker, though.\All right! Now I can leave this town and go to the city.\I'm gonna take over the family business.\This is my grimoire?\Mine's like... response:	I'll... think about my future more once my grimoire has more pages filled in.
context: This is my grimoire?\Check it out! Mine's bigger!\Mine's thicker, though.\All right! Now I can leave this town and go to the city.\I'm gonna take over the family business.\This is my grimoire?\Mine's like...\I'll... think about my future more once my grimoire has more pages filled in. response:	We'll be taking the Magic Knights' entrance exams in six months.
context: Check it out! Mine's bigger!\Mine's thicker, though.\All right! Now I can leave this town and go to the city.\I'm gonna take over the family business.\This is my grimoire?\Mine's like...\I'll... think about my future more once my grimoire has more pages filled in.\We'll be taking the Magic Knights' entrance exams in six months. response:	We'll be sure to get in.
context: Mine's thicker, though.\All right! Now I can leave this town and go to the city.\I'm gonna take over the family business.\This is my grimoire?\Mine's like...\I'll... think about my future more once my grimoire has more pages filled in.\We'll be taking the Magic Knights' entrance exams in six months.\We'll be sure to get in. response:	Good, good. I look forward to it.
context: All right! Now I can leave this town and go to the city.\I'm gonna take over the family business.\This is my grimoire?\Mine's like...\I'll... think about my future more once my grimoire has more pages filled in.\We'll be taking the Magic Knights' entrance exams in six months.\We'll be sure to get in.\Good, good. I look forward to it. response:	Um...
context: I'm gonna take over the family business.\This is my grimoire?\Mine's like...\I'll... think about my future more once my grimoire has more pages filled in.\We'll be taking the Magic Knights' entrance exams in six months.\We'll be sure to get in.\Good, good. I look forward to it.\Um... response:	My grimoire's not coming.
context: This is my grimoire?\Mine's like...\I'll... think about my future more once my grimoire has more pages filled in.\We'll be taking the Magic Knights' entrance exams in six months.\We'll be sure to get in.\Good, good. I look forward to it.\Um...\My grimoire's not coming. response:	Um...
context: Mine's like...\I'll... think about my future more once my grimoire has more pages filled in.\We'll be taking the Magic Knights' entrance exams in six months.\We'll be sure to get in.\Good, good. I look forward to it.\Um...\My grimoire's not coming.\Um... response:	My grimoire's not coming.
context: I'll... think about my future more once my grimoire has more pages filled in.\We'll be taking the Magic Knights' entrance exams in six months.\We'll be sure to get in.\Good, good. I look forward to it.\Um...\My grimoire's not coming.\Um...\My grimoire's not coming. response:	Er...
context: We'll be taking the Magic Knights' entrance exams in six months.\We'll be sure to get in.\Good, good. I look forward to it.\Um...\My grimoire's not coming.\Um...\My grimoire's not coming.\Er... response:	Try again next year.
context: We'll be sure to get in.\Good, good. I look forward to it.\Um...\My grimoire's not coming.\Um...\My grimoire's not coming.\Er...\Try again next year. response:	What?!
context: Good, good. I look forward to it.\Um...\My grimoire's not coming.\Um...\My grimoire's not coming.\Er...\Try again next year.\What?! response:	What the heck?!
context: Um...\My grimoire's not coming.\Um...\My grimoire's not coming.\Er...\Try again next year.\What?!\What the heck?! response:	That's actually amazing!
context: My grimoire's not coming.\Um...\My grimoire's not coming.\Er...\Try again next year.\What?!\What the heck?!\That's actually amazing! response:	That's way too funny!
context: Um...\My grimoire's not coming.\Er...\Try again next year.\What?!\What the heck?!\That's actually amazing!\That's way too funny! response:	Seriously?
context: My grimoire's not coming.\Er...\Try again next year.\What?!\What the heck?!\That's actually amazing!\That's way too funny!\Seriously? response:	I can't believe it.
context: Er...\Try again next year.\What?!\What the heck?!\That's actually amazing!\That's way too funny!\Seriously?\I can't believe it. response:	If we competed to see who was most pathetic, we'd be no match for that guy.
context: Try again next year.\What?!\What the heck?!\That's actually amazing!\That's way too funny!\Seriously?\I can't believe it.\If we competed to see who was most pathetic, we'd be no match for that guy. response:	A four-leaf clover...
context: What?!\What the heck?!\That's actually amazing!\That's way too funny!\Seriously?\I can't believe it.\If we competed to see who was most pathetic, we'd be no match for that guy.\A four-leaf clover... response:	A four-leaf? You mean the legendary...
context: What the heck?!\That's actually amazing!\That's way too funny!\Seriously?\I can't believe it.\If we competed to see who was most pathetic, we'd be no match for that guy.\A four-leaf clover...\A four-leaf? You mean the legendary... response:	H-Hey...
context: That's actually amazing!\That's way too funny!\Seriously?\I can't believe it.\If we competed to see who was most pathetic, we'd be no match for that guy.\A four-leaf clover...\A four-leaf? You mean the legendary...\H-Hey... response:	The one that the first Wizard King received?
context: That's way too funny!\Seriously?\I can't believe it.\If we competed to see who was most pathetic, we'd be no match for that guy.\A four-leaf clover...\A four-leaf? You mean the legendary...\H-Hey...\The one that the first Wizard King received? response:	The grimoire said to be filled with immense power and good luck?
context: Seriously?\I can't believe it.\If we competed to see who was most pathetic, we'd be no match for that guy.\A four-leaf clover...\A four-leaf? You mean the legendary...\H-Hey...\The one that the first Wizard King received?\The grimoire said to be filled with immense power and good luck? response:	Him?
context: I can't believe it.\If we competed to see who was most pathetic, we'd be no match for that guy.\A four-leaf clover...\A four-leaf? You mean the legendary...\H-Hey...\The one that the first Wizard King received?\The grimoire said to be filled with immense power and good luck?\Him? response:	That peasant?
context: If we competed to see who was most pathetic, we'd be no match for that guy.\A four-leaf clover...\A four-leaf? You mean the legendary...\H-Hey...\The one that the first Wizard King received?\The grimoire said to be filled with immense power and good luck?\Him?\That peasant? response:	Wow!
context: A four-leaf clover...\A four-leaf? You mean the legendary...\H-Hey...\The one that the first Wizard King received?\The grimoire said to be filled with immense power and good luck?\Him?\That peasant?\Wow! response:	I'm going to become the Wizard King.
context: A four-leaf? You mean the legendary...\H-Hey...\The one that the first Wizard King received?\The grimoire said to be filled with immense power and good luck?\Him?\That peasant?\Wow!\I'm going to become the Wizard King. response:	Awesome!
context: H-Hey...\The one that the first Wizard King received?\The grimoire said to be filled with immense power and good luck?\Him?\That peasant?\Wow!\I'm going to become the Wizard King.\Awesome! response:	He's the shining star of Hage!
context: The one that the first Wizard King received?\The grimoire said to be filled with immense power and good luck?\Him?\That peasant?\Wow!\I'm going to become the Wizard King.\Awesome!\He's the shining star of Hage! response:	You're amazing, Yuno!
context: The grimoire said to be filled with immense power and good luck?\Him?\That peasant?\Wow!\I'm going to become the Wizard King.\Awesome!\He's the shining star of Hage!\You're amazing, Yuno! response:	He's so cool.
context: Him?\That peasant?\Wow!\I'm going to become the Wizard King.\Awesome!\He's the shining star of Hage!\You're amazing, Yuno!\He's so cool. response:	Yuno...
context: That peasant?\Wow!\I'm going to become the Wizard King.\Awesome!\He's the shining star of Hage!\You're amazing, Yuno!\He's so cool.\Yuno... response:	Just you wait.
context: Wow!\I'm going to become the Wizard King.\Awesome!\He's the shining star of Hage!\You're amazing, Yuno!\He's so cool.\Yuno...\Just you wait. response:	I'll catch up to you in no time.
context: I'm going to become the Wizard King.\Awesome!\He's the shining star of Hage!\You're amazing, Yuno!\He's so cool.\Yuno...\Just you wait.\I'll catch up to you in no time. response:	Because I'm your rival!
context: Awesome!\He's the shining star of Hage!\You're amazing, Yuno!\He's so cool.\Yuno...\Just you wait.\I'll catch up to you in no time.\Because I'm your rival! response:	Did he just say rival?
context: He's the shining star of Hage!\You're amazing, Yuno!\He's so cool.\Yuno...\Just you wait.\I'll catch up to you in no time.\Because I'm your rival!\Did he just say rival? response:	He didn't even get a grimoire. What is he thinking?
context: You're amazing, Yuno!\He's so cool.\Yuno...\Just you wait.\I'll catch up to you in no time.\Because I'm your rival!\Did he just say rival?\He didn't even get a grimoire. What is he thinking? response:	Not possible.
context: He's so cool.\Yuno...\Just you wait.\I'll catch up to you in no time.\Because I'm your rival!\Did he just say rival?\He didn't even get a grimoire. What is he thinking?\Not possible. response:	All right, kids! We're heading home to prepare for the feast!
context: Yuno...\Just you wait.\I'll catch up to you in no time.\Because I'm your rival!\Did he just say rival?\He didn't even get a grimoire. What is he thinking?\Not possible.\All right, kids! We're heading home to prepare for the feast! response:	You can each have three tatoes today!
context: Just you wait.\I'll catch up to you in no time.\Because I'm your rival!\Did he just say rival?\He didn't even get a grimoire. What is he thinking?\Not possible.\All right, kids! We're heading home to prepare for the feast!\You can each have three tatoes today! response:	Yay!
context: I'll catch up to you in no time.\Because I'm your rival!\Did he just say rival?\He didn't even get a grimoire. What is he thinking?\Not possible.\All right, kids! We're heading home to prepare for the feast!\You can each have three tatoes today!\Yay! response:	I sure would like to eat something else once in a while.
context: Because I'm your rival!\Did he just say rival?\He didn't even get a grimoire. What is he thinking?\Not possible.\All right, kids! We're heading home to prepare for the feast!\You can each have three tatoes today!\Yay!\I sure would like to eat something else once in a while. response:	What an amazing thing to find in a crummy little town like this.
context: Did he just say rival?\He didn't even get a grimoire. What is he thinking?\Not possible.\All right, kids! We're heading home to prepare for the feast!\You can each have three tatoes today!\Yay!\I sure would like to eat something else once in a while.\What an amazing thing to find in a crummy little town like this. response:	I thought that once I got my grimoire,
context: He didn't even get a grimoire. What is he thinking?\Not possible.\All right, kids! We're heading home to prepare for the feast!\You can each have three tatoes today!\Yay!\I sure would like to eat something else once in a while.\What an amazing thing to find in a crummy little town like this.\I thought that once I got my grimoire, response:	I'd be able to use magic, but...
context: Not possible.\All right, kids! We're heading home to prepare for the feast!\You can each have three tatoes today!\Yay!\I sure would like to eat something else once in a while.\What an amazing thing to find in a crummy little town like this.\I thought that once I got my grimoire,\I'd be able to use magic, but... response:	I never thought I wouldn't even get one.
context: All right, kids! We're heading home to prepare for the feast!\You can each have three tatoes today!\Yay!\I sure would like to eat something else once in a while.\What an amazing thing to find in a crummy little town like this.\I thought that once I got my grimoire,\I'd be able to use magic, but...\I never thought I wouldn't even get one. response:	But... like hell I'm gonna give up!
context: You can each have three tatoes today!\Yay!\I sure would like to eat something else once in a while.\What an amazing thing to find in a crummy little town like this.\I thought that once I got my grimoire,\I'd be able to use magic, but...\I never thought I wouldn't even get one.\But... like hell I'm gonna give up! response:	Don't you dare underestimate me, fate!
context: Yay!\I sure would like to eat something else once in a while.\What an amazing thing to find in a crummy little town like this.\I thought that once I got my grimoire,\I'd be able to use magic, but...\I never thought I wouldn't even get one.\But... like hell I'm gonna give up!\Don't you dare underestimate me, fate! response:	I'll show you!
context: I sure would like to eat something else once in a while.\What an amazing thing to find in a crummy little town like this.\I thought that once I got my grimoire,\I'd be able to use magic, but...\I never thought I wouldn't even get one.\But... like hell I'm gonna give up!\Don't you dare underestimate me, fate!\I'll show you! response:	Even if it takes one, two, ten, or a hundred years!
context: What an amazing thing to find in a crummy little town like this.\I thought that once I got my grimoire,\I'd be able to use magic, but...\I never thought I wouldn't even get one.\But... like hell I'm gonna give up!\Don't you dare underestimate me, fate!\I'll show you!\Even if it takes one, two, ten, or a hundred years! response:	I'll keep working hard until I get my grimoire!
context: I thought that once I got my grimoire,\I'd be able to use magic, but...\I never thought I wouldn't even get one.\But... like hell I'm gonna give up!\Don't you dare underestimate me, fate!\I'll show you!\Even if it takes one, two, ten, or a hundred years!\I'll keep working hard until I get my grimoire! response:	I'll become the Wizard King, and prove to everyone that anyone can be awesome,
context: I'd be able to use magic, but...\I never thought I wouldn't even get one.\But... like hell I'm gonna give up!\Don't you dare underestimate me, fate!\I'll show you!\Even if it takes one, two, ten, or a hundred years!\I'll keep working hard until I get my grimoire!\I'll become the Wizard King, and prove to everyone that anyone can be awesome, response:	even if they're poor or just some orphan!
context: I never thought I wouldn't even get one.\But... like hell I'm gonna give up!\Don't you dare underestimate me, fate!\I'll show you!\Even if it takes one, two, ten, or a hundred years!\I'll keep working hard until I get my grimoire!\I'll become the Wizard King, and prove to everyone that anyone can be awesome,\even if they're poor or just some orphan! response:	You jerk!
context: But... like hell I'm gonna give up!\Don't you dare underestimate me, fate!\I'll show you!\Even if it takes one, two, ten, or a hundred years!\I'll keep working hard until I get my grimoire!\I'll become the Wizard King, and prove to everyone that anyone can be awesome,\even if they're poor or just some orphan!\You jerk! response:	Just you wait, Yuno!
context: Don't you dare underestimate me, fate!\I'll show you!\Even if it takes one, two, ten, or a hundred years!\I'll keep working hard until I get my grimoire!\I'll become the Wizard King, and prove to everyone that anyone can be awesome,\even if they're poor or just some orphan!\You jerk!\Just you wait, Yuno! response:	H-Hey, you don't have to go that far.
context: I'll show you!\Even if it takes one, two, ten, or a hundred years!\I'll keep working hard until I get my grimoire!\I'll become the Wizard King, and prove to everyone that anyone can be awesome,\even if they're poor or just some orphan!\You jerk!\Just you wait, Yuno!\H-Hey, you don't have to go that far. response:	We should've been the stars today.
context: Even if it takes one, two, ten, or a hundred years!\I'll keep working hard until I get my grimoire!\I'll become the Wizard King, and prove to everyone that anyone can be awesome,\even if they're poor or just some orphan!\You jerk!\Just you wait, Yuno!\H-Hey, you don't have to go that far.\We should've been the stars today. response:	And yet... this peasant receives a four-leaf clover?!
context: I'll keep working hard until I get my grimoire!\I'll become the Wizard King, and prove to everyone that anyone can be awesome,\even if they're poor or just some orphan!\You jerk!\Just you wait, Yuno!\H-Hey, you don't have to go that far.\We should've been the stars today.\And yet... this peasant receives a four-leaf clover?! response:	I'll just...
context: I'll become the Wizard King, and prove to everyone that anyone can be awesome,\even if they're poor or just some orphan!\You jerk!\Just you wait, Yuno!\H-Hey, you don't have to go that far.\We should've been the stars today.\And yet... this peasant receives a four-leaf clover?!\I'll just... response:	Hey!
context: even if they're poor or just some orphan!\You jerk!\Just you wait, Yuno!\H-Hey, you don't have to go that far.\We should've been the stars today.\And yet... this peasant receives a four-leaf clover?!\I'll just...\Hey! response:	I'll just have to turn it into ash!
context: You jerk!\Just you wait, Yuno!\H-Hey, you don't have to go that far.\We should've been the stars today.\And yet... this peasant receives a four-leaf clover?!\I'll just...\Hey!\I'll just have to turn it into ash! response:	He held back my flames without even using his grimoire?!
context: Just you wait, Yuno!\H-Hey, you don't have to go that far.\We should've been the stars today.\And yet... this peasant receives a four-leaf clover?!\I'll just...\Hey!\I'll just have to turn it into ash!\He held back my flames without even using his grimoire?! response:	D-Do something!
context: H-Hey, you don't have to go that far.\We should've been the stars today.\And yet... this peasant receives a four-leaf clover?!\I'll just...\Hey!\I'll just have to turn it into ash!\He held back my flames without even using his grimoire?!\D-Do something! response:	But...
context: We should've been the stars today.\And yet... this peasant receives a four-leaf clover?!\I'll just...\Hey!\I'll just have to turn it into ash!\He held back my flames without even using his grimoire?!\D-Do something!\But... response:	Do it!
context: And yet... this peasant receives a four-leaf clover?!\I'll just...\Hey!\I'll just have to turn it into ash!\He held back my flames without even using his grimoire?!\D-Do something!\But...\Do it! response:	I can't let you go and burn that.
context: I'll just...\Hey!\I'll just have to turn it into ash!\He held back my flames without even using his grimoire?!\D-Do something!\But...\Do it!\I can't let you go and burn that. response:	Don't bother to resist.
context: Hey!\I'll just have to turn it into ash!\He held back my flames without even using his grimoire?!\D-Do something!\But...\Do it!\I can't let you go and burn that.\Don't bother to resist. response:	My Creation Magic: Binding Iron Chain
context: I'll just have to turn it into ash!\He held back my flames without even using his grimoire?!\D-Do something!\But...\Do it!\I can't let you go and burn that.\Don't bother to resist.\My Creation Magic: Binding Iron Chain response:	restricts the magic and movements of the one it captures.
context: He held back my flames without even using his grimoire?!\D-Do something!\But...\Do it!\I can't let you go and burn that.\Don't bother to resist.\My Creation Magic: Binding Iron Chain\restricts the magic and movements of the one it captures. response:	Who are you?
context: D-Do something!\But...\Do it!\I can't let you go and burn that.\Don't bother to resist.\My Creation Magic: Binding Iron Chain\restricts the magic and movements of the one it captures.\Who are you? response:	Until recently, I was a pretty well-known Magic Knight called Revchi of Chain Magic.
context: But...\Do it!\I can't let you go and burn that.\Don't bother to resist.\My Creation Magic: Binding Iron Chain\restricts the magic and movements of the one it captures.\Who are you?\Until recently, I was a pretty well-known Magic Knight called Revchi of Chain Magic. response:	But I got kicked out, so now I'm just a wretched thief.
context: Do it!\I can't let you go and burn that.\Don't bother to resist.\My Creation Magic: Binding Iron Chain\restricts the magic and movements of the one it captures.\Who are you?\Until recently, I was a pretty well-known Magic Knight called Revchi of Chain Magic.\But I got kicked out, so now I'm just a wretched thief. response:	And I'll be taking that grimoire.
context: I can't let you go and burn that.\Don't bother to resist.\My Creation Magic: Binding Iron Chain\restricts the magic and movements of the one it captures.\Who are you?\Until recently, I was a pretty well-known Magic Knight called Revchi of Chain Magic.\But I got kicked out, so now I'm just a wretched thief.\And I'll be taking that grimoire. response:	Revchi, was it? It's pointless for you to steal that.
context: Don't bother to resist.\My Creation Magic: Binding Iron Chain\restricts the magic and movements of the one it captures.\Who are you?\Until recently, I was a pretty well-known Magic Knight called Revchi of Chain Magic.\But I got kicked out, so now I'm just a wretched thief.\And I'll be taking that grimoire.\Revchi, was it? It's pointless for you to steal that. response:	The only one
context: My Creation Magic: Binding Iron Chain\restricts the magic and movements of the one it captures.\Who are you?\Until recently, I was a pretty well-known Magic Knight called Revchi of Chain Magic.\But I got kicked out, so now I'm just a wretched thief.\And I'll be taking that grimoire.\Revchi, was it? It's pointless for you to steal that.\The only one response:	The only one who can use a grimoire is the one it chose.
context: restricts the magic and movements of the one it captures.\Who are you?\Until recently, I was a pretty well-known Magic Knight called Revchi of Chain Magic.\But I got kicked out, so now I'm just a wretched thief.\And I'll be taking that grimoire.\Revchi, was it? It's pointless for you to steal that.\The only one\The only one who can use a grimoire is the one it chose. response:	However, underground collectors are buying grimoires
context: Who are you?\Until recently, I was a pretty well-known Magic Knight called Revchi of Chain Magic.\But I got kicked out, so now I'm just a wretched thief.\And I'll be taking that grimoire.\Revchi, was it? It's pointless for you to steal that.\The only one\The only one who can use a grimoire is the one it chose.\However, underground collectors are buying grimoires response:	with four-leaf clovers for insane prices.
context: Until recently, I was a pretty well-known Magic Knight called Revchi of Chain Magic.\But I got kicked out, so now I'm just a wretched thief.\And I'll be taking that grimoire.\Revchi, was it? It's pointless for you to steal that.\The only one\The only one who can use a grimoire is the one it chose.\However, underground collectors are buying grimoires\with four-leaf clovers for insane prices. response:	A four-leaf clover may have chosen you,
context: But I got kicked out, so now I'm just a wretched thief.\And I'll be taking that grimoire.\Revchi, was it? It's pointless for you to steal that.\The only one\The only one who can use a grimoire is the one it chose.\However, underground collectors are buying grimoires\with four-leaf clovers for insane prices.\A four-leaf clover may have chosen you, response:	but you only just received it. You're still just a little chick.
context: And I'll be taking that grimoire.\Revchi, was it? It's pointless for you to steal that.\The only one\The only one who can use a grimoire is the one it chose.\However, underground collectors are buying grimoires\with four-leaf clovers for insane prices.\A four-leaf clover may have chosen you,\but you only just received it. You're still just a little chick. response:	How unfortunate for you that I happened to be here.
context: Revchi, was it? It's pointless for you to steal that.\The only one\The only one who can use a grimoire is the one it chose.\However, underground collectors are buying grimoires\with four-leaf clovers for insane prices.\A four-leaf clover may have chosen you,\but you only just received it. You're still just a little chick.\How unfortunate for you that I happened to be here. response:	Your legend is going to end before it even begins.
context: The only one\The only one who can use a grimoire is the one it chose.\However, underground collectors are buying grimoires\with four-leaf clovers for insane prices.\A four-leaf clover may have chosen you,\but you only just received it. You're still just a little chick.\How unfortunate for you that I happened to be here.\Your legend is going to end before it even begins. response:	Hey, that pendant looks like it's worth something, too.
context: The only one who can use a grimoire is the one it chose.\However, underground collectors are buying grimoires\with four-leaf clovers for insane prices.\A four-leaf clover may have chosen you,\but you only just received it. You're still just a little chick.\How unfortunate for you that I happened to be here.\Your legend is going to end before it even begins.\Hey, that pendant looks like it's worth something, too. response:	I guess I'll be taking that...
context: However, underground collectors are buying grimoires\with four-leaf clovers for insane prices.\A four-leaf clover may have chosen you,\but you only just received it. You're still just a little chick.\How unfortunate for you that I happened to be here.\Your legend is going to end before it even begins.\Hey, that pendant looks like it's worth something, too.\I guess I'll be taking that... response:	Hold it!
context: with four-leaf clovers for insane prices.\A four-leaf clover may have chosen you,\but you only just received it. You're still just a little chick.\How unfortunate for you that I happened to be here.\Your legend is going to end before it even begins.\Hey, that pendant looks like it's worth something, too.\I guess I'll be taking that...\Hold it! response:	What do you think you're doing?!
context: A four-leaf clover may have chosen you,\but you only just received it. You're still just a little chick.\How unfortunate for you that I happened to be here.\Your legend is going to end before it even begins.\Hey, that pendant looks like it's worth something, too.\I guess I'll be taking that...\Hold it!\What do you think you're doing?! response:	I've come to save...
context: but you only just received it. You're still just a little chick.\How unfortunate for you that I happened to be here.\Your legend is going to end before it even begins.\Hey, that pendant looks like it's worth something, too.\I guess I'll be taking that...\Hold it!\What do you think you're doing?!\I've come to save... response:	Huh?
context: How unfortunate for you that I happened to be here.\Your legend is going to end before it even begins.\Hey, that pendant looks like it's worth something, too.\I guess I'll be taking that...\Hold it!\What do you think you're doing?!\I've come to save...\Huh? response:	Who the hell are you?!
context: Your legend is going to end before it even begins.\Hey, that pendant looks like it's worth something, too.\I guess I'll be taking that...\Hold it!\What do you think you're doing?!\I've come to save...\Huh?\Who the hell are you?! response:	That's Yuno's grimoire!
context: Hey, that pendant looks like it's worth something, too.\I guess I'll be taking that...\Hold it!\What do you think you're doing?!\I've come to save...\Huh?\Who the hell are you?!\That's Yuno's grimoire! response:	Why do you have it? You thief!
context: I guess I'll be taking that...\Hold it!\What do you think you're doing?!\I've come to save...\Huh?\Who the hell are you?!\That's Yuno's grimoire!\Why do you have it? You thief! response:	Aren't you the pathetic little brat who wasn't even given a grimoire?
context: Hold it!\What do you think you're doing?!\I've come to save...\Huh?\Who the hell are you?!\That's Yuno's grimoire!\Why do you have it? You thief!\Aren't you the pathetic little brat who wasn't even given a grimoire? response:	Oh, you remember me!
context: What do you think you're doing?!\I've come to save...\Huh?\Who the hell are you?!\That's Yuno's grimoire!\Why do you have it? You thief!\Aren't you the pathetic little brat who wasn't even given a grimoire?\Oh, you remember me! response:	Yeah, I'm that pathetic little brat!
context: I've come to save...\Huh?\Who the hell are you?!\That's Yuno's grimoire!\Why do you have it? You thief!\Aren't you the pathetic little brat who wasn't even given a grimoire?\Oh, you remember me!\Yeah, I'm that pathetic little brat! response:	A grimoire is precious to the person who received it!
context: Huh?\Who the hell are you?!\That's Yuno's grimoire!\Why do you have it? You thief!\Aren't you the pathetic little brat who wasn't even given a grimoire?\Oh, you remember me!\Yeah, I'm that pathetic little brat!\A grimoire is precious to the person who received it! response:	Give it back to Yuno, you jerk!
context: Who the hell are you?!\That's Yuno's grimoire!\Why do you have it? You thief!\Aren't you the pathetic little brat who wasn't even given a grimoire?\Oh, you remember me!\Yeah, I'm that pathetic little brat!\A grimoire is precious to the person who received it!\Give it back to Yuno, you jerk! response:	The outside world is a place where crooked deeds like this can be overlooked.
context: That's Yuno's grimoire!\Why do you have it? You thief!\Aren't you the pathetic little brat who wasn't even given a grimoire?\Oh, you remember me!\Yeah, I'm that pathetic little brat!\A grimoire is precious to the person who received it!\Give it back to Yuno, you jerk!\The outside world is a place where crooked deeds like this can be overlooked. response:	But you'll be dead before you find that out for yourself.
context: Why do you have it? You thief!\Aren't you the pathetic little brat who wasn't even given a grimoire?\Oh, you remember me!\Yeah, I'm that pathetic little brat!\A grimoire is precious to the person who received it!\Give it back to Yuno, you jerk!\The outside world is a place where crooked deeds like this can be overlooked.\But you'll be dead before you find that out for yourself. response:	Asta, run!
context: Aren't you the pathetic little brat who wasn't even given a grimoire?\Oh, you remember me!\Yeah, I'm that pathetic little brat!\A grimoire is precious to the person who received it!\Give it back to Yuno, you jerk!\The outside world is a place where crooked deeds like this can be overlooked.\But you'll be dead before you find that out for yourself.\Asta, run! response:	I'm not going to run away
context: Oh, you remember me!\Yeah, I'm that pathetic little brat!\A grimoire is precious to the person who received it!\Give it back to Yuno, you jerk!\The outside world is a place where crooked deeds like this can be overlooked.\But you'll be dead before you find that out for yourself.\Asta, run!\I'm not going to run away response:	from a disgraced loser like him!
context: Yeah, I'm that pathetic little brat!\A grimoire is precious to the person who received it!\Give it back to Yuno, you jerk!\The outside world is a place where crooked deeds like this can be overlooked.\But you'll be dead before you find that out for yourself.\Asta, run!\I'm not going to run away\from a disgraced loser like him! response:	I'm not done yet!
context: A grimoire is precious to the person who received it!\Give it back to Yuno, you jerk!\The outside world is a place where crooked deeds like this can be overlooked.\But you'll be dead before you find that out for yourself.\Asta, run!\I'm not going to run away\from a disgraced loser like him!\I'm not done yet! response:	No... You're finished.
context: Give it back to Yuno, you jerk!\The outside world is a place where crooked deeds like this can be overlooked.\But you'll be dead before you find that out for yourself.\Asta, run!\I'm not going to run away\from a disgraced loser like him!\I'm not done yet!\No... You're finished. response:	Dance of the Pitless Viper!
context: The outside world is a place where crooked deeds like this can be overlooked.\But you'll be dead before you find that out for yourself.\Asta, run!\I'm not going to run away\from a disgraced loser like him!\I'm not done yet!\No... You're finished.\Dance of the Pitless Viper! response:	Wh-What a heavy blow...
context: But you'll be dead before you find that out for yourself.\Asta, run!\I'm not going to run away\from a disgraced loser like him!\I'm not done yet!\No... You're finished.\Dance of the Pitless Viper!\Wh-What a heavy blow... response:	So this is the power of the mages from outside this town.
context: Asta, run!\I'm not going to run away\from a disgraced loser like him!\I'm not done yet!\No... You're finished.\Dance of the Pitless Viper!\Wh-What a heavy blow...\So this is the power of the mages from outside this town. response:	I can't possibly beat him with just my physical training.
context: I'm not going to run away\from a disgraced loser like him!\I'm not done yet!\No... You're finished.\Dance of the Pitless Viper!\Wh-What a heavy blow...\So this is the power of the mages from outside this town.\I can't possibly beat him with just my physical training. response:	Thank you for that useless struggle, brat.
context: from a disgraced loser like him!\I'm not done yet!\No... You're finished.\Dance of the Pitless Viper!\Wh-What a heavy blow...\So this is the power of the mages from outside this town.\I can't possibly beat him with just my physical training.\Thank you for that useless struggle, brat. response:	Not yet. I'm not finished...
context: I'm not done yet!\No... You're finished.\Dance of the Pitless Viper!\Wh-What a heavy blow...\So this is the power of the mages from outside this town.\I can't possibly beat him with just my physical training.\Thank you for that useless struggle, brat.\Not yet. I'm not finished... response:	I'm going to be... the Wizard King.
context: No... You're finished.\Dance of the Pitless Viper!\Wh-What a heavy blow...\So this is the power of the mages from outside this town.\I can't possibly beat him with just my physical training.\Thank you for that useless struggle, brat.\Not yet. I'm not finished...\I'm going to be... the Wizard King. response:	You? The Wizard King?
context: Dance of the Pitless Viper!\Wh-What a heavy blow...\So this is the power of the mages from outside this town.\I can't possibly beat him with just my physical training.\Thank you for that useless struggle, brat.\Not yet. I'm not finished...\I'm going to be... the Wizard King.\You? The Wizard King? response:	I have the ability to find out
context: Wh-What a heavy blow...\So this is the power of the mages from outside this town.\I can't possibly beat him with just my physical training.\Thank you for that useless struggle, brat.\Not yet. I'm not finished...\I'm going to be... the Wizard King.\You? The Wizard King?\I have the ability to find out response:	just how much magical power one has with these chains.
context: So this is the power of the mages from outside this town.\I can't possibly beat him with just my physical training.\Thank you for that useless struggle, brat.\Not yet. I'm not finished...\I'm going to be... the Wizard King.\You? The Wizard King?\I have the ability to find out\just how much magical power one has with these chains. response:	And you have no magic whatsoever.
context: I can't possibly beat him with just my physical training.\Thank you for that useless struggle, brat.\Not yet. I'm not finished...\I'm going to be... the Wizard King.\You? The Wizard King?\I have the ability to find out\just how much magical power one has with these chains.\And you have no magic whatsoever. response:	You must've been born that way. No wonder you couldn't get a grimoire.
context: Thank you for that useless struggle, brat.\Not yet. I'm not finished...\I'm going to be... the Wizard King.\You? The Wizard King?\I have the ability to find out\just how much magical power one has with these chains.\And you have no magic whatsoever.\You must've been born that way. No wonder you couldn't get a grimoire. response:	To think that you lack even an ounce of magic
context: Not yet. I'm not finished...\I'm going to be... the Wizard King.\You? The Wizard King?\I have the ability to find out\just how much magical power one has with these chains.\And you have no magic whatsoever.\You must've been born that way. No wonder you couldn't get a grimoire.\To think that you lack even an ounce of magic response:	in this world where magic is everything.
context: I'm going to be... the Wizard King.\You? The Wizard King?\I have the ability to find out\just how much magical power one has with these chains.\And you have no magic whatsoever.\You must've been born that way. No wonder you couldn't get a grimoire.\To think that you lack even an ounce of magic\in this world where magic is everything. response:	What a priceless find!
context: You? The Wizard King?\I have the ability to find out\just how much magical power one has with these chains.\And you have no magic whatsoever.\You must've been born that way. No wonder you couldn't get a grimoire.\To think that you lack even an ounce of magic\in this world where magic is everything.\What a priceless find! response:	Huh?
context: I have the ability to find out\just how much magical power one has with these chains.\And you have no magic whatsoever.\You must've been born that way. No wonder you couldn't get a grimoire.\To think that you lack even an ounce of magic\in this world where magic is everything.\What a priceless find!\Huh? response:	What the hell?
context: just how much magical power one has with these chains.\And you have no magic whatsoever.\You must've been born that way. No wonder you couldn't get a grimoire.\To think that you lack even an ounce of magic\in this world where magic is everything.\What a priceless find!\Huh?\What the hell? response:	Then no matter how hard I try, I won't be able to use magic?
context: And you have no magic whatsoever.\You must've been born that way. No wonder you couldn't get a grimoire.\To think that you lack even an ounce of magic\in this world where magic is everything.\What a priceless find!\Huh?\What the hell?\Then no matter how hard I try, I won't be able to use magic? response:	To think that someone so pathetic existed.
context: You must've been born that way. No wonder you couldn't get a grimoire.\To think that you lack even an ounce of magic\in this world where magic is everything.\What a priceless find!\Huh?\What the hell?\Then no matter how hard I try, I won't be able to use magic?\To think that someone so pathetic existed. response:	You won't even be able to find a job, let alone become the Wizard King!
context: To think that you lack even an ounce of magic\in this world where magic is everything.\What a priceless find!\Huh?\What the hell?\Then no matter how hard I try, I won't be able to use magic?\To think that someone so pathetic existed.\You won't even be able to find a job, let alone become the Wizard King! response:	I'm sure your friend, the great genius over there, mocks you, too.
context: in this world where magic is everything.\What a priceless find!\Huh?\What the hell?\Then no matter how hard I try, I won't be able to use magic?\To think that someone so pathetic existed.\You won't even be able to find a job, let alone become the Wizard King!\I'm sure your friend, the great genius over there, mocks you, too. response:	Yeah, maybe.
context: What a priceless find!\Huh?\What the hell?\Then no matter how hard I try, I won't be able to use magic?\To think that someone so pathetic existed.\You won't even be able to find a job, let alone become the Wizard King!\I'm sure your friend, the great genius over there, mocks you, too.\Yeah, maybe. response:	Yuno's so amazing that he was chosen by the four-leaf.
context: Huh?\What the hell?\Then no matter how hard I try, I won't be able to use magic?\To think that someone so pathetic existed.\You won't even be able to find a job, let alone become the Wizard King!\I'm sure your friend, the great genius over there, mocks you, too.\Yeah, maybe.\Yuno's so amazing that he was chosen by the four-leaf. response:	I'm just...
context: What the hell?\Then no matter how hard I try, I won't be able to use magic?\To think that someone so pathetic existed.\You won't even be able to find a job, let alone become the Wizard King!\I'm sure your friend, the great genius over there, mocks you, too.\Yeah, maybe.\Yuno's so amazing that he was chosen by the four-leaf.\I'm just... response:	You can't do a thing in this world. Just give up on everything.
context: Then no matter how hard I try, I won't be able to use magic?\To think that someone so pathetic existed.\You won't even be able to find a job, let alone become the Wizard King!\I'm sure your friend, the great genius over there, mocks you, too.\Yeah, maybe.\Yuno's so amazing that he was chosen by the four-leaf.\I'm just...\You can't do a thing in this world. Just give up on everything. response:	You were born a loser!
context: To think that someone so pathetic existed.\You won't even be able to find a job, let alone become the Wizard King!\I'm sure your friend, the great genius over there, mocks you, too.\Yeah, maybe.\Yuno's so amazing that he was chosen by the four-leaf.\I'm just...\You can't do a thing in this world. Just give up on everything.\You were born a loser! response:	He's right.
context: You won't even be able to find a job, let alone become the Wizard King!\I'm sure your friend, the great genius over there, mocks you, too.\Yeah, maybe.\Yuno's so amazing that he was chosen by the four-leaf.\I'm just...\You can't do a thing in this world. Just give up on everything.\You were born a loser!\He's right. response:	No matter how hard I try, some things just can't be helped.
context: I'm sure your friend, the great genius over there, mocks you, too.\Yeah, maybe.\Yuno's so amazing that he was chosen by the four-leaf.\I'm just...\You can't do a thing in this world. Just give up on everything.\You were born a loser!\He's right.\No matter how hard I try, some things just can't be helped. response:	I'm just going to give...
context: Yeah, maybe.\Yuno's so amazing that he was chosen by the four-leaf.\I'm just...\You can't do a thing in this world. Just give up on everything.\You were born a loser!\He's right.\No matter how hard I try, some things just can't be helped.\I'm just going to give... response:	Hey!
context: Yuno's so amazing that he was chosen by the four-leaf.\I'm just...\You can't do a thing in this world. Just give up on everything.\You were born a loser!\He's right.\No matter how hard I try, some things just can't be helped.\I'm just going to give...\Hey! response:	Who are you calling a loser?
context: I'm just...\You can't do a thing in this world. Just give up on everything.\You were born a loser!\He's right.\No matter how hard I try, some things just can't be helped.\I'm just going to give...\Hey!\Who are you calling a loser? response:	Asta, it's true that you won't be able to become the Wizard King,
context: You can't do a thing in this world. Just give up on everything.\You were born a loser!\He's right.\No matter how hard I try, some things just can't be helped.\I'm just going to give...\Hey!\Who are you calling a loser?\Asta, it's true that you won't be able to become the Wizard King, response:	no matter what.
context: You were born a loser!\He's right.\No matter how hard I try, some things just can't be helped.\I'm just going to give...\Hey!\Who are you calling a loser?\Asta, it's true that you won't be able to become the Wizard King,\no matter what. response:	You hear that? Even your little friend is telling you it's impossible.
context: He's right.\No matter how hard I try, some things just can't be helped.\I'm just going to give...\Hey!\Who are you calling a loser?\Asta, it's true that you won't be able to become the Wizard King,\no matter what.\You hear that? Even your little friend is telling you it's impossible. response:	That's because I'm going to become the Wizard King!
context: No matter how hard I try, some things just can't be helped.\I'm just going to give...\Hey!\Who are you calling a loser?\Asta, it's true that you won't be able to become the Wizard King,\no matter what.\You hear that? Even your little friend is telling you it's impossible.\That's because I'm going to become the Wizard King! response:	What?
context: I'm just going to give...\Hey!\Who are you calling a loser?\Asta, it's true that you won't be able to become the Wizard King,\no matter what.\You hear that? Even your little friend is telling you it's impossible.\That's because I'm going to become the Wizard King!\What? response:	He's no loser.
context: Hey!\Who are you calling a loser?\Asta, it's true that you won't be able to become the Wizard King,\no matter what.\You hear that? Even your little friend is telling you it's impossible.\That's because I'm going to become the Wizard King!\What?\He's no loser. response:	He's...
context: Who are you calling a loser?\Asta, it's true that you won't be able to become the Wizard King,\no matter what.\You hear that? Even your little friend is telling you it's impossible.\That's because I'm going to become the Wizard King!\What?\He's no loser.\He's... response:	Asta's my rival!
context: Asta, it's true that you won't be able to become the Wizard King,\no matter what.\You hear that? Even your little friend is telling you it's impossible.\That's because I'm going to become the Wizard King!\What?\He's no loser.\He's...\Asta's my rival! response:	Huh?
context: no matter what.\You hear that? Even your little friend is telling you it's impossible.\That's because I'm going to become the Wizard King!\What?\He's no loser.\He's...\Asta's my rival!\Huh? response:	Him? Your rival?
context: You hear that? Even your little friend is telling you it's impossible.\That's because I'm going to become the Wizard King!\What?\He's no loser.\He's...\Asta's my rival!\Huh?\Him? Your rival? response:	This brat who has no magical power whatsoever?
context: That's because I'm going to become the Wizard King!\What?\He's no loser.\He's...\Asta's my rival!\Huh?\Him? Your rival?\This brat who has no magical power whatsoever? response:	Not... Not yet.
context: What?\He's no loser.\He's...\Asta's my rival!\Huh?\Him? Your rival?\This brat who has no magical power whatsoever?\Not... Not yet. response:	Sorry you had to see me looking that pathetic, Yuno.
context: He's no loser.\He's...\Asta's my rival!\Huh?\Him? Your rival?\This brat who has no magical power whatsoever?\Not... Not yet.\Sorry you had to see me looking that pathetic, Yuno. response:	Just a sec...
context: He's...\Asta's my rival!\Huh?\Him? Your rival?\This brat who has no magical power whatsoever?\Not... Not yet.\Sorry you had to see me looking that pathetic, Yuno.\Just a sec... response:	I'm gonna kick this guy's butt!
context: Asta's my rival!\Huh?\Him? Your rival?\This brat who has no magical power whatsoever?\Not... Not yet.\Sorry you had to see me looking that pathetic, Yuno.\Just a sec...\I'm gonna kick this guy's butt! response:	A gri... moire?
context: Huh?\Him? Your rival?\This brat who has no magical power whatsoever?\Not... Not yet.\Sorry you had to see me looking that pathetic, Yuno.\Just a sec...\I'm gonna kick this guy's butt!\A gri... moire? response:	I knew it.
context: Him? Your rival?\This brat who has no magical power whatsoever?\Not... Not yet.\Sorry you had to see me looking that pathetic, Yuno.\Just a sec...\I'm gonna kick this guy's butt!\A gri... moire?\I knew it. response:	There's no way that Asta wouldn't have been chosen!
context: This brat who has no magical power whatsoever?\Not... Not yet.\Sorry you had to see me looking that pathetic, Yuno.\Just a sec...\I'm gonna kick this guy's butt!\A gri... moire?\I knew it.\There's no way that Asta wouldn't have been chosen! response:	Your magic?
context: Not... Not yet.\Sorry you had to see me looking that pathetic, Yuno.\Just a sec...\I'm gonna kick this guy's butt!\A gri... moire?\I knew it.\There's no way that Asta wouldn't have been chosen!\Your magic? response:	But you didn't have any magic within you!
context: Sorry you had to see me looking that pathetic, Yuno.\Just a sec...\I'm gonna kick this guy's butt!\A gri... moire?\I knew it.\There's no way that Asta wouldn't have been chosen!\Your magic?\But you didn't have any magic within you! response:	What in the world is that grimoire?!
context: Just a sec...\I'm gonna kick this guy's butt!\A gri... moire?\I knew it.\There's no way that Asta wouldn't have been chosen!\Your magic?\But you didn't have any magic within you!\What in the world is that grimoire?! response:	The three leaves of the clover represent faith, hope, and love.
context: I'm gonna kick this guy's butt!\A gri... moire?\I knew it.\There's no way that Asta wouldn't have been chosen!\Your magic?\But you didn't have any magic within you!\What in the world is that grimoire?!\The three leaves of the clover represent faith, hope, and love. response:	Within a fourth leaf dwells good luck.
context: A gri... moire?\I knew it.\There's no way that Asta wouldn't have been chosen!\Your magic?\But you didn't have any magic within you!\What in the world is that grimoire?!\The three leaves of the clover represent faith, hope, and love.\Within a fourth leaf dwells good luck. response:	Within a fifth leaf...
context: I knew it.\There's no way that Asta wouldn't have been chosen!\Your magic?\But you didn't have any magic within you!\What in the world is that grimoire?!\The three leaves of the clover represent faith, hope, and love.\Within a fourth leaf dwells good luck.\Within a fifth leaf... response:	resides a demon.
context: There's no way that Asta wouldn't have been chosen!\Your magic?\But you didn't have any magic within you!\What in the world is that grimoire?!\The three leaves of the clover represent faith, hope, and love.\Within a fourth leaf dwells good luck.\Within a fifth leaf...\resides a demon. response:	Asta and Yuno
context: Your magic?\But you didn't have any magic within you!\What in the world is that grimoire?!\The three leaves of the clover represent faith, hope, and love.\Within a fourth leaf dwells good luck.\Within a fifth leaf...\resides a demon.\Asta and Yuno response:	Grey words can't make anything happen
context: But you didn't have any magic within you!\What in the world is that grimoire?!\The three leaves of the clover represent faith, hope, and love.\Within a fourth leaf dwells good luck.\Within a fifth leaf...\resides a demon.\Asta and Yuno\Grey words can't make anything happen response:	I know, yeah I know
context: What in the world is that grimoire?!\The three leaves of the clover represent faith, hope, and love.\Within a fourth leaf dwells good luck.\Within a fifth leaf...\resides a demon.\Asta and Yuno\Grey words can't make anything happen\I know, yeah I know response:	Wishing to fly freely across the sky
context: The three leaves of the clover represent faith, hope, and love.\Within a fourth leaf dwells good luck.\Within a fifth leaf...\resides a demon.\Asta and Yuno\Grey words can't make anything happen\I know, yeah I know\Wishing to fly freely across the sky response:	I dreamed it all my life
context: Within a fourth leaf dwells good luck.\Within a fifth leaf...\resides a demon.\Asta and Yuno\Grey words can't make anything happen\I know, yeah I know\Wishing to fly freely across the sky\I dreamed it all my life response:	Step by step I go, though it's a doubtful world
context: Within a fifth leaf...\resides a demon.\Asta and Yuno\Grey words can't make anything happen\I know, yeah I know\Wishing to fly freely across the sky\I dreamed it all my life\Step by step I go, though it's a doubtful world response:	Don't care how much I fall
context: resides a demon.\Asta and Yuno\Grey words can't make anything happen\I know, yeah I know\Wishing to fly freely across the sky\I dreamed it all my life\Step by step I go, though it's a doubtful world\Don't care how much I fall response:	Instinct is my guide, I never give up
context: Asta and Yuno\Grey words can't make anything happen\I know, yeah I know\Wishing to fly freely across the sky\I dreamed it all my life\Step by step I go, though it's a doubtful world\Don't care how much I fall\Instinct is my guide, I never give up response:	To faraway future, I burst out running
context: Grey words can't make anything happen\I know, yeah I know\Wishing to fly freely across the sky\I dreamed it all my life\Step by step I go, though it's a doubtful world\Don't care how much I fall\Instinct is my guide, I never give up\To faraway future, I burst out running response:	Go beyond even the unseen fears
context: I know, yeah I know\Wishing to fly freely across the sky\I dreamed it all my life\Step by step I go, though it's a doubtful world\Don't care how much I fall\Instinct is my guide, I never give up\To faraway future, I burst out running\Go beyond even the unseen fears response:	The vision I had, so I can be myself
context: Wishing to fly freely across the sky\I dreamed it all my life\Step by step I go, though it's a doubtful world\Don't care how much I fall\Instinct is my guide, I never give up\To faraway future, I burst out running\Go beyond even the unseen fears\The vision I had, so I can be myself response:	Someday I will write the next page
context: I dreamed it all my life\Step by step I go, though it's a doubtful world\Don't care how much I fall\Instinct is my guide, I never give up\To faraway future, I burst out running\Go beyond even the unseen fears\The vision I had, so I can be myself\Someday I will write the next page response:	You are my hope
context: Step by step I go, though it's a doubtful world\Don't care how much I fall\Instinct is my guide, I never give up\To faraway future, I burst out running\Go beyond even the unseen fears\The vision I had, so I can be myself\Someday I will write the next page\You are my hope response:	Like that page from someday
context: Don't care how much I fall\Instinct is my guide, I never give up\To faraway future, I burst out running\Go beyond even the unseen fears\The vision I had, so I can be myself\Someday I will write the next page\You are my hope\Like that page from someday response:	I was able to meet you
context: Instinct is my guide, I never give up\To faraway future, I burst out running\Go beyond even the unseen fears\The vision I had, so I can be myself\Someday I will write the next page\You are my hope\Like that page from someday\I was able to meet you response:	I call this a miracle
context: To faraway future, I burst out running\Go beyond even the unseen fears\The vision I had, so I can be myself\Someday I will write the next page\You are my hope\Like that page from someday\I was able to meet you\I call this a miracle response:	I'm not going to give up just because I can't use magic!
context: Go beyond even the unseen fears\The vision I had, so I can be myself\Someday I will write the next page\You are my hope\Like that page from someday\I was able to meet you\I call this a miracle\I'm not going to give up just because I can't use magic! response:	It doesn't matter if you're a peasant or an orphan! Anyone can shine in this world!
context: The vision I had, so I can be myself\Someday I will write the next page\You are my hope\Like that page from someday\I was able to meet you\I call this a miracle\I'm not going to give up just because I can't use magic!\It doesn't matter if you're a peasant or an orphan! Anyone can shine in this world! response:	Black Clover, Page 2: The Boys' Promise.
context: Someday I will write the next page\You are my hope\Like that page from someday\I was able to meet you\I call this a miracle\I'm not going to give up just because I can't use magic!\It doesn't matter if you're a peasant or an orphan! Anyone can shine in this world!\Black Clover, Page 2: The Boys' Promise. response:	Page 2 The Boys' Promise
context: You are my hope\Like that page from someday\I was able to meet you\I call this a miracle\I'm not going to give up just because I can't use magic!\It doesn't matter if you're a peasant or an orphan! Anyone can shine in this world!\Black Clover, Page 2: The Boys' Promise.\Page 2 The Boys' Promise response:	Not giving up is my magic!