context: Do you feel better now? response:	I do! Thank you!
context: Do you feel better now?\I do! Thank you! response:	Mikono!
context: Do you feel better now?\I do! Thank you!\Mikono! response:	Mikono's on the tower!
context: Do you feel better now?\I do! Thank you!\Mikono!\Mikono's on the tower! response:	Mikono!
context: Do you feel better now?\I do! Thank you!\Mikono!\Mikono's on the tower!\Mikono! response:	Calling all Elements.
context: Do you feel better now?\I do! Thank you!\Mikono!\Mikono's on the tower!\Mikono!\Calling all Elements. response:	Abductors detected in the Neo-Kowloon area.
context: Do you feel better now?\I do! Thank you!\Mikono!\Mikono's on the tower!\Mikono!\Calling all Elements.\Abductors detected in the Neo-Kowloon area. response:	Training has been suspended.
context: Do you feel better now?\I do! Thank you!\Mikono!\Mikono's on the tower!\Mikono!\Calling all Elements.\Abductors detected in the Neo-Kowloon area.\Training has been suspended. response:	Cayenne, Zessica, and Andy, please return to the Academy immediately.
context: I do! Thank you!\Mikono!\Mikono's on the tower!\Mikono!\Calling all Elements.\Abductors detected in the Neo-Kowloon area.\Training has been suspended.\Cayenne, Zessica, and Andy, please return to the Academy immediately. response:	I'll take care of it for you, my friend.
context: Mikono!\Mikono's on the tower!\Mikono!\Calling all Elements.\Abductors detected in the Neo-Kowloon area.\Training has been suspended.\Cayenne, Zessica, and Andy, please return to the Academy immediately.\I'll take care of it for you, my friend. response:	Head back to the Academy.
context: Mikono's on the tower!\Mikono!\Calling all Elements.\Abductors detected in the Neo-Kowloon area.\Training has been suspended.\Cayenne, Zessica, and Andy, please return to the Academy immediately.\I'll take care of it for you, my friend.\Head back to the Academy. response:	You too, Sazanka.
context: Mikono!\Calling all Elements.\Abductors detected in the Neo-Kowloon area.\Training has been suspended.\Cayenne, Zessica, and Andy, please return to the Academy immediately.\I'll take care of it for you, my friend.\Head back to the Academy.\You too, Sazanka. response:	But Mikono is in danger!
context: Calling all Elements.\Abductors detected in the Neo-Kowloon area.\Training has been suspended.\Cayenne, Zessica, and Andy, please return to the Academy immediately.\I'll take care of it for you, my friend.\Head back to the Academy.\You too, Sazanka.\But Mikono is in danger! response:	Do you think your sister is more important than your duty as an Element?
context: Abductors detected in the Neo-Kowloon area.\Training has been suspended.\Cayenne, Zessica, and Andy, please return to the Academy immediately.\I'll take care of it for you, my friend.\Head back to the Academy.\You too, Sazanka.\But Mikono is in danger!\Do you think your sister is more important than your duty as an Element? response:	Hey, wait for me!
context: Training has been suspended.\Cayenne, Zessica, and Andy, please return to the Academy immediately.\I'll take care of it for you, my friend.\Head back to the Academy.\You too, Sazanka.\But Mikono is in danger!\Do you think your sister is more important than your duty as an Element?\Hey, wait for me! response:	You go well together.
context: Cayenne, Zessica, and Andy, please return to the Academy immediately.\I'll take care of it for you, my friend.\Head back to the Academy.\You too, Sazanka.\But Mikono is in danger!\Do you think your sister is more important than your duty as an Element?\Hey, wait for me!\You go well together. response:	Your Union will be the greatest and most beautiful of all.
context: I'll take care of it for you, my friend.\Head back to the Academy.\You too, Sazanka.\But Mikono is in danger!\Do you think your sister is more important than your duty as an Element?\Hey, wait for me!\You go well together.\Your Union will be the greatest and most beautiful of all. response:	If only I could give it to you.
context: Head back to the Academy.\You too, Sazanka.\But Mikono is in danger!\Do you think your sister is more important than your duty as an Element?\Hey, wait for me!\You go well together.\Your Union will be the greatest and most beautiful of all.\If only I could give it to you. response:	Found you.
context: You too, Sazanka.\But Mikono is in danger!\Do you think your sister is more important than your duty as an Element?\Hey, wait for me!\You go well together.\Your Union will be the greatest and most beautiful of all.\If only I could give it to you.\Found you. response:	You stink.
context: But Mikono is in danger!\Do you think your sister is more important than your duty as an Element?\Hey, wait for me!\You go well together.\Your Union will be the greatest and most beautiful of all.\If only I could give it to you.\Found you.\You stink. response:	You stink deliciously.
context: Do you think your sister is more important than your duty as an Element?\Hey, wait for me!\You go well together.\Your Union will be the greatest and most beautiful of all.\If only I could give it to you.\Found you.\You stink.\You stink deliciously. response:	Mikono!
context: Hey, wait for me!\You go well together.\Your Union will be the greatest and most beautiful of all.\If only I could give it to you.\Found you.\You stink.\You stink deliciously.\Mikono! response:	This is...
context: You go well together.\Your Union will be the greatest and most beautiful of all.\If only I could give it to you.\Found you.\You stink.\You stink deliciously.\Mikono!\This is... response:	It's not love.
context: Your Union will be the greatest and most beautiful of all.\If only I could give it to you.\Found you.\You stink.\You stink deliciously.\Mikono!\This is...\It's not love. response:	This is...
context: If only I could give it to you.\Found you.\You stink.\You stink deliciously.\Mikono!\This is...\It's not love.\This is... response:	a forbidden meeting.
context: Found you.\You stink.\You stink deliciously.\Mikono!\This is...\It's not love.\This is...\a forbidden meeting. response:	Mikono!
context: You stink.\You stink deliciously.\Mikono!\This is...\It's not love.\This is...\a forbidden meeting.\Mikono! response:	What a delicate little thing.
context: You stink deliciously.\Mikono!\This is...\It's not love.\This is...\a forbidden meeting.\Mikono!\What a delicate little thing. response:	Let Mikono go!
context: Mikono!\This is...\It's not love.\This is...\a forbidden meeting.\Mikono!\What a delicate little thing.\Let Mikono go! response:	Where's your smell?
context: This is...\It's not love.\This is...\a forbidden meeting.\Mikono!\What a delicate little thing.\Let Mikono go!\Where's your smell? response:	You don't. You don't smell at all.
context: It's not love.\This is...\a forbidden meeting.\Mikono!\What a delicate little thing.\Let Mikono go!\Where's your smell?\You don't. You don't smell at all. response:	Why the hell don't you have a smell?
context: This is...\a forbidden meeting.\Mikono!\What a delicate little thing.\Let Mikono go!\Where's your smell?\You don't. You don't smell at all.\Why the hell don't you have a smell? response:	Hey.
context: a forbidden meeting.\Mikono!\What a delicate little thing.\Let Mikono go!\Where's your smell?\You don't. You don't smell at all.\Why the hell don't you have a smell?\Hey. response:	Mind if I kill you?
context: Mikono!\What a delicate little thing.\Let Mikono go!\Where's your smell?\You don't. You don't smell at all.\Why the hell don't you have a smell?\Hey.\Mind if I kill you? response:	I'd really prefer you didn't...
context: What a delicate little thing.\Let Mikono go!\Where's your smell?\You don't. You don't smell at all.\Why the hell don't you have a smell?\Hey.\Mind if I kill you?\I'd really prefer you didn't... response:	Huh.
context: Let Mikono go!\Where's your smell?\You don't. You don't smell at all.\Why the hell don't you have a smell?\Hey.\Mind if I kill you?\I'd really prefer you didn't...\Huh. response:	Wait!
context: Where's your smell?\You don't. You don't smell at all.\Why the hell don't you have a smell?\Hey.\Mind if I kill you?\I'd really prefer you didn't...\Huh.\Wait! response:	Buzz off.
context: You don't. You don't smell at all.\Why the hell don't you have a smell?\Hey.\Mind if I kill you?\I'd really prefer you didn't...\Huh.\Wait!\Buzz off. response:	This is my wench.
context: Why the hell don't you have a smell?\Hey.\Mind if I kill you?\I'd really prefer you didn't...\Huh.\Wait!\Buzz off.\This is my wench. response:	No...
context: Hey.\Mind if I kill you?\I'd really prefer you didn't...\Huh.\Wait!\Buzz off.\This is my wench.\No... response:	I won't let you...
context: Mind if I kill you?\I'd really prefer you didn't...\Huh.\Wait!\Buzz off.\This is my wench.\No...\I won't let you... response:	I won't let you have Mikono!
context: I'd really prefer you didn't...\Huh.\Wait!\Buzz off.\This is my wench.\No...\I won't let you...\I won't let you have Mikono! response:	Asshole!
context: Huh.\Wait!\Buzz off.\This is my wench.\No...\I won't let you...\I won't let you have Mikono!\Asshole! response:	His wings!
context: Wait!\Buzz off.\This is my wench.\No...\I won't let you...\I won't let you have Mikono!\Asshole!\His wings! response:	What the hell's that noise?
context: Buzz off.\This is my wench.\No...\I won't let you...\I won't let you have Mikono!\Asshole!\His wings!\What the hell's that noise? response:	Kagura has gone to Vega again.
context: This is my wench.\No...\I won't let you...\I won't let you have Mikono!\Asshole!\His wings!\What the hell's that noise?\Kagura has gone to Vega again. response:	Who opened the gate for him?
context: No...\I won't let you...\I won't let you have Mikono!\Asshole!\His wings!\What the hell's that noise?\Kagura has gone to Vega again.\Who opened the gate for him? response:	Kagura's Gnis was supposed to be locked out.
context: I won't let you...\I won't let you have Mikono!\Asshole!\His wings!\What the hell's that noise?\Kagura has gone to Vega again.\Who opened the gate for him?\Kagura's Gnis was supposed to be locked out. response:	It's been a long time, Izumo.
context: I won't let you have Mikono!\Asshole!\His wings!\What the hell's that noise?\Kagura has gone to Vega again.\Who opened the gate for him?\Kagura's Gnis was supposed to be locked out.\It's been a long time, Izumo. response:	You've grown up, Jin.
context: Asshole!\His wings!\What the hell's that noise?\Kagura has gone to Vega again.\Who opened the gate for him?\Kagura's Gnis was supposed to be locked out.\It's been a long time, Izumo.\You've grown up, Jin. response:	Mikage!
context: His wings!\What the hell's that noise?\Kagura has gone to Vega again.\Who opened the gate for him?\Kagura's Gnis was supposed to be locked out.\It's been a long time, Izumo.\You've grown up, Jin.\Mikage! response:	I had a feeling you were behind this.
context: What the hell's that noise?\Kagura has gone to Vega again.\Who opened the gate for him?\Kagura's Gnis was supposed to be locked out.\It's been a long time, Izumo.\You've grown up, Jin.\Mikage!\I had a feeling you were behind this. response:	When did you awaken?
context: Kagura has gone to Vega again.\Who opened the gate for him?\Kagura's Gnis was supposed to be locked out.\It's been a long time, Izumo.\You've grown up, Jin.\Mikage!\I had a feeling you were behind this.\When did you awaken? response:	When?
context: Who opened the gate for him?\Kagura's Gnis was supposed to be locked out.\It's been a long time, Izumo.\You've grown up, Jin.\Mikage!\I had a feeling you were behind this.\When did you awaken?\When? response:	I was awakened by a kiss.
context: Kagura's Gnis was supposed to be locked out.\It's been a long time, Izumo.\You've grown up, Jin.\Mikage!\I had a feeling you were behind this.\When did you awaken?\When?\I was awakened by a kiss. response:	From the Machine Angel's forbidden power.
context: It's been a long time, Izumo.\You've grown up, Jin.\Mikage!\I had a feeling you were behind this.\When did you awaken?\When?\I was awakened by a kiss.\From the Machine Angel's forbidden power. response:	Why did you help Kagura?
context: You've grown up, Jin.\Mikage!\I had a feeling you were behind this.\When did you awaken?\When?\I was awakened by a kiss.\From the Machine Angel's forbidden power.\Why did you help Kagura? response:	I merely saw him off.
context: Mikage!\I had a feeling you were behind this.\When did you awaken?\When?\I was awakened by a kiss.\From the Machine Angel's forbidden power.\Why did you help Kagura?\I merely saw him off. response:	The chosen one, blazing a trail into a new world of love.
context: I had a feeling you were behind this.\When did you awaken?\When?\I was awakened by a kiss.\From the Machine Angel's forbidden power.\Why did you help Kagura?\I merely saw him off.\The chosen one, blazing a trail into a new world of love. response:	New world of love?
context: When did you awaken?\When?\I was awakened by a kiss.\From the Machine Angel's forbidden power.\Why did you help Kagura?\I merely saw him off.\The chosen one, blazing a trail into a new world of love.\New world of love? response:	The Machine Angel unleashed its forbidden powers.
context: When?\I was awakened by a kiss.\From the Machine Angel's forbidden power.\Why did you help Kagura?\I merely saw him off.\The chosen one, blazing a trail into a new world of love.\New world of love?\The Machine Angel unleashed its forbidden powers. response:	And so, the Rare Igura within it is guiding Kagura.
context: I was awakened by a kiss.\From the Machine Angel's forbidden power.\Why did you help Kagura?\I merely saw him off.\The chosen one, blazing a trail into a new world of love.\New world of love?\The Machine Angel unleashed its forbidden powers.\And so, the Rare Igura within it is guiding Kagura. response:	Aren't you a little curious about the Rare Igura he follows so doggedly?
context: From the Machine Angel's forbidden power.\Why did you help Kagura?\I merely saw him off.\The chosen one, blazing a trail into a new world of love.\New world of love?\The Machine Angel unleashed its forbidden powers.\And so, the Rare Igura within it is guiding Kagura.\Aren't you a little curious about the Rare Igura he follows so doggedly? response:	One that can leash the Machine Angel, at that.
context: Why did you help Kagura?\I merely saw him off.\The chosen one, blazing a trail into a new world of love.\New world of love?\The Machine Angel unleashed its forbidden powers.\And so, the Rare Igura within it is guiding Kagura.\Aren't you a little curious about the Rare Igura he follows so doggedly?\One that can leash the Machine Angel, at that. response:	She may be the true Eve for us of Altair.
context: I merely saw him off.\The chosen one, blazing a trail into a new world of love.\New world of love?\The Machine Angel unleashed its forbidden powers.\And so, the Rare Igura within it is guiding Kagura.\Aren't you a little curious about the Rare Igura he follows so doggedly?\One that can leash the Machine Angel, at that.\She may be the true Eve for us of Altair. response:	Continue the reconnaissance of Vega.
context: The chosen one, blazing a trail into a new world of love.\New world of love?\The Machine Angel unleashed its forbidden powers.\And so, the Rare Igura within it is guiding Kagura.\Aren't you a little curious about the Rare Igura he follows so doggedly?\One that can leash the Machine Angel, at that.\She may be the true Eve for us of Altair.\Continue the reconnaissance of Vega. response:	If another irregularity occurs, take back the Mithra Gnis by force.
context: New world of love?\The Machine Angel unleashed its forbidden powers.\And so, the Rare Igura within it is guiding Kagura.\Aren't you a little curious about the Rare Igura he follows so doggedly?\One that can leash the Machine Angel, at that.\She may be the true Eve for us of Altair.\Continue the reconnaissance of Vega.\If another irregularity occurs, take back the Mithra Gnis by force. response:	Yes, sir.
context: The Machine Angel unleashed its forbidden powers.\And so, the Rare Igura within it is guiding Kagura.\Aren't you a little curious about the Rare Igura he follows so doggedly?\One that can leash the Machine Angel, at that.\She may be the true Eve for us of Altair.\Continue the reconnaissance of Vega.\If another irregularity occurs, take back the Mithra Gnis by force.\Yes, sir. response:	Alisia...
context: And so, the Rare Igura within it is guiding Kagura.\Aren't you a little curious about the Rare Igura he follows so doggedly?\One that can leash the Machine Angel, at that.\She may be the true Eve for us of Altair.\Continue the reconnaissance of Vega.\If another irregularity occurs, take back the Mithra Gnis by force.\Yes, sir.\Alisia... response:	Hey, mind if I kill you?
context: Aren't you a little curious about the Rare Igura he follows so doggedly?\One that can leash the Machine Angel, at that.\She may be the true Eve for us of Altair.\Continue the reconnaissance of Vega.\If another irregularity occurs, take back the Mithra Gnis by force.\Yes, sir.\Alisia...\Hey, mind if I kill you? response:	Sure.
context: One that can leash the Machine Angel, at that.\She may be the true Eve for us of Altair.\Continue the reconnaissance of Vega.\If another irregularity occurs, take back the Mithra Gnis by force.\Yes, sir.\Alisia...\Hey, mind if I kill you?\Sure. response:	If you can play me.
context: She may be the true Eve for us of Altair.\Continue the reconnaissance of Vega.\If another irregularity occurs, take back the Mithra Gnis by force.\Yes, sir.\Alisia...\Hey, mind if I kill you?\Sure.\If you can play me. response:	You smell real faint.
context: Continue the reconnaissance of Vega.\If another irregularity occurs, take back the Mithra Gnis by force.\Yes, sir.\Alisia...\Hey, mind if I kill you?\Sure.\If you can play me.\You smell real faint. response:	And you kinda smell like her.
context: If another irregularity occurs, take back the Mithra Gnis by force.\Yes, sir.\Alisia...\Hey, mind if I kill you?\Sure.\If you can play me.\You smell real faint.\And you kinda smell like her. response:	Damn it!
context: Yes, sir.\Alisia...\Hey, mind if I kill you?\Sure.\If you can play me.\You smell real faint.\And you kinda smell like her.\Damn it! response:	You would play a lovely sound.
context: Alisia...\Hey, mind if I kill you?\Sure.\If you can play me.\You smell real faint.\And you kinda smell like her.\Damn it!\You would play a lovely sound. response:	Shrade stayed in Neo-Kowloon, didn't he?
context: Hey, mind if I kill you?\Sure.\If you can play me.\You smell real faint.\And you kinda smell like her.\Damn it!\You would play a lovely sound.\Shrade stayed in Neo-Kowloon, didn't he? response:	Fine.
context: Sure.\If you can play me.\You smell real faint.\And you kinda smell like her.\Damn it!\You would play a lovely sound.\Shrade stayed in Neo-Kowloon, didn't he?\Fine. response:	Deploy as soon as Cayenne, Zessica, and Andy return.
context: If you can play me.\You smell real faint.\And you kinda smell like her.\Damn it!\You would play a lovely sound.\Shrade stayed in Neo-Kowloon, didn't he?\Fine.\Deploy as soon as Cayenne, Zessica, and Andy return. response:	Roger.
context: You smell real faint.\And you kinda smell like her.\Damn it!\You would play a lovely sound.\Shrade stayed in Neo-Kowloon, didn't he?\Fine.\Deploy as soon as Cayenne, Zessica, and Andy return.\Roger. response:	Uhm... I've been wondering this for a while.
context: And you kinda smell like her.\Damn it!\You would play a lovely sound.\Shrade stayed in Neo-Kowloon, didn't he?\Fine.\Deploy as soon as Cayenne, Zessica, and Andy return.\Roger.\Uhm... I've been wondering this for a while. response:	How come Shrade's never been deployed?
context: Damn it!\You would play a lovely sound.\Shrade stayed in Neo-Kowloon, didn't he?\Fine.\Deploy as soon as Cayenne, Zessica, and Andy return.\Roger.\Uhm... I've been wondering this for a while.\How come Shrade's never been deployed? response:	He always has the best record for the mock battles.
context: You would play a lovely sound.\Shrade stayed in Neo-Kowloon, didn't he?\Fine.\Deploy as soon as Cayenne, Zessica, and Andy return.\Roger.\Uhm... I've been wondering this for a while.\How come Shrade's never been deployed?\He always has the best record for the mock battles. response:	So the girls have been curious as to why...
context: Shrade stayed in Neo-Kowloon, didn't he?\Fine.\Deploy as soon as Cayenne, Zessica, and Andy return.\Roger.\Uhm... I've been wondering this for a while.\How come Shrade's never been deployed?\He always has the best record for the mock battles.\So the girls have been curious as to why... response:	Boys and girls Union together now,
context: Fine.\Deploy as soon as Cayenne, Zessica, and Andy return.\Roger.\Uhm... I've been wondering this for a while.\How come Shrade's never been deployed?\He always has the best record for the mock battles.\So the girls have been curious as to why...\Boys and girls Union together now, response:	so we should know about Elements we might do it with sometime.
context: Deploy as soon as Cayenne, Zessica, and Andy return.\Roger.\Uhm... I've been wondering this for a while.\How come Shrade's never been deployed?\He always has the best record for the mock battles.\So the girls have been curious as to why...\Boys and girls Union together now,\so we should know about Elements we might do it with sometime. response:	Shrade Elan had a great gift with music from a young age.
context: Roger.\Uhm... I've been wondering this for a while.\How come Shrade's never been deployed?\He always has the best record for the mock battles.\So the girls have been curious as to why...\Boys and girls Union together now,\so we should know about Elements we might do it with sometime.\Shrade Elan had a great gift with music from a young age. response:	But a strong, dark Element power infused the music from his piano.
context: Uhm... I've been wondering this for a while.\How come Shrade's never been deployed?\He always has the best record for the mock battles.\So the girls have been curious as to why...\Boys and girls Union together now,\so we should know about Elements we might do it with sometime.\Shrade Elan had a great gift with music from a young age.\But a strong, dark Element power infused the music from his piano. response:	They said his music could reach into people's minds and play on their pain.
context: How come Shrade's never been deployed?\He always has the best record for the mock battles.\So the girls have been curious as to why...\Boys and girls Union together now,\so we should know about Elements we might do it with sometime.\Shrade Elan had a great gift with music from a young age.\But a strong, dark Element power infused the music from his piano.\They said his music could reach into people's minds and play on their pain. response:	So rumors spread, and eventually he became a terrible weapon.
context: He always has the best record for the mock battles.\So the girls have been curious as to why...\Boys and girls Union together now,\so we should know about Elements we might do it with sometime.\Shrade Elan had a great gift with music from a young age.\But a strong, dark Element power infused the music from his piano.\They said his music could reach into people's minds and play on their pain.\So rumors spread, and eventually he became a terrible weapon. response:	This sound!
context: So the girls have been curious as to why...\Boys and girls Union together now,\so we should know about Elements we might do it with sometime.\Shrade Elan had a great gift with music from a young age.\But a strong, dark Element power infused the music from his piano.\They said his music could reach into people's minds and play on their pain.\So rumors spread, and eventually he became a terrible weapon.\This sound! response:	Neo-Deava?
context: Boys and girls Union together now,\so we should know about Elements we might do it with sometime.\Shrade Elan had a great gift with music from a young age.\But a strong, dark Element power infused the music from his piano.\They said his music could reach into people's minds and play on their pain.\So rumors spread, and eventually he became a terrible weapon.\This sound!\Neo-Deava? response:	So Shrade got pulled in by the chairman kid?
context: so we should know about Elements we might do it with sometime.\Shrade Elan had a great gift with music from a young age.\But a strong, dark Element power infused the music from his piano.\They said his music could reach into people's minds and play on their pain.\So rumors spread, and eventually he became a terrible weapon.\This sound!\Neo-Deava?\So Shrade got pulled in by the chairman kid? response:	Wait, how old is the chairman anyway?
context: Shrade Elan had a great gift with music from a young age.\But a strong, dark Element power infused the music from his piano.\They said his music could reach into people's minds and play on their pain.\So rumors spread, and eventually he became a terrible weapon.\This sound!\Neo-Deava?\So Shrade got pulled in by the chairman kid?\Wait, how old is the chairman anyway? response:	But the Element aptitude test revealed something terrible.
context: But a strong, dark Element power infused the music from his piano.\They said his music could reach into people's minds and play on their pain.\So rumors spread, and eventually he became a terrible weapon.\This sound!\Neo-Deava?\So Shrade got pulled in by the chairman kid?\Wait, how old is the chairman anyway?\But the Element aptitude test revealed something terrible. response:	Piloting Aquarion would shorten Shrade's life.
context: They said his music could reach into people's minds and play on their pain.\So rumors spread, and eventually he became a terrible weapon.\This sound!\Neo-Deava?\So Shrade got pulled in by the chairman kid?\Wait, how old is the chairman anyway?\But the Element aptitude test revealed something terrible.\Piloting Aquarion would shorten Shrade's life. response:	Aquarion amplifies the power within its Elements.
context: So rumors spread, and eventually he became a terrible weapon.\This sound!\Neo-Deava?\So Shrade got pulled in by the chairman kid?\Wait, how old is the chairman anyway?\But the Element aptitude test revealed something terrible.\Piloting Aquarion would shorten Shrade's life.\Aquarion amplifies the power within its Elements. response:	That power feeds back into the Elements, each strengthening the other.
context: This sound!\Neo-Deava?\So Shrade got pulled in by the chairman kid?\Wait, how old is the chairman anyway?\But the Element aptitude test revealed something terrible.\Piloting Aquarion would shorten Shrade's life.\Aquarion amplifies the power within its Elements.\That power feeds back into the Elements, each strengthening the other. response:	Shrade's Element power is too strong.
context: Neo-Deava?\So Shrade got pulled in by the chairman kid?\Wait, how old is the chairman anyway?\But the Element aptitude test revealed something terrible.\Piloting Aquarion would shorten Shrade's life.\Aquarion amplifies the power within its Elements.\That power feeds back into the Elements, each strengthening the other.\Shrade's Element power is too strong. response:	His sick body can't handle channeling Aquarion's power.
context: So Shrade got pulled in by the chairman kid?\Wait, how old is the chairman anyway?\But the Element aptitude test revealed something terrible.\Piloting Aquarion would shorten Shrade's life.\Aquarion amplifies the power within its Elements.\That power feeds back into the Elements, each strengthening the other.\Shrade's Element power is too strong.\His sick body can't handle channeling Aquarion's power. response:	I'm so sorry.
context: Wait, how old is the chairman anyway?\But the Element aptitude test revealed something terrible.\Piloting Aquarion would shorten Shrade's life.\Aquarion amplifies the power within its Elements.\That power feeds back into the Elements, each strengthening the other.\Shrade's Element power is too strong.\His sick body can't handle channeling Aquarion's power.\I'm so sorry. response:	It took a little damage.
context: But the Element aptitude test revealed something terrible.\Piloting Aquarion would shorten Shrade's life.\Aquarion amplifies the power within its Elements.\That power feeds back into the Elements, each strengthening the other.\Shrade's Element power is too strong.\His sick body can't handle channeling Aquarion's power.\I'm so sorry.\It took a little damage. response:	But it has a lovely sound.
context: Piloting Aquarion would shorten Shrade's life.\Aquarion amplifies the power within its Elements.\That power feeds back into the Elements, each strengthening the other.\Shrade's Element power is too strong.\His sick body can't handle channeling Aquarion's power.\I'm so sorry.\It took a little damage.\But it has a lovely sound. response:	I would die happy hearing its voice.
context: Aquarion amplifies the power within its Elements.\That power feeds back into the Elements, each strengthening the other.\Shrade's Element power is too strong.\His sick body can't handle channeling Aquarion's power.\I'm so sorry.\It took a little damage.\But it has a lovely sound.\I would die happy hearing its voice. response:	Mikono!
context: That power feeds back into the Elements, each strengthening the other.\Shrade's Element power is too strong.\His sick body can't handle channeling Aquarion's power.\I'm so sorry.\It took a little damage.\But it has a lovely sound.\I would die happy hearing its voice.\Mikono! response:	I'm sorry...
context: Shrade's Element power is too strong.\His sick body can't handle channeling Aquarion's power.\I'm so sorry.\It took a little damage.\But it has a lovely sound.\I would die happy hearing its voice.\Mikono!\I'm sorry... response:	I have to tell him I'm sorry...
context: His sick body can't handle channeling Aquarion's power.\I'm so sorry.\It took a little damage.\But it has a lovely sound.\I would die happy hearing its voice.\Mikono!\I'm sorry...\I have to tell him I'm sorry... response:	You're sorry? Him?
context: I'm so sorry.\It took a little damage.\But it has a lovely sound.\I would die happy hearing its voice.\Mikono!\I'm sorry...\I have to tell him I'm sorry...\You're sorry? Him? response:	What are you talking about, Mikono?
context: It took a little damage.\But it has a lovely sound.\I would die happy hearing its voice.\Mikono!\I'm sorry...\I have to tell him I'm sorry...\You're sorry? Him?\What are you talking about, Mikono? response:	The Abductor alarm!
context: But it has a lovely sound.\I would die happy hearing its voice.\Mikono!\I'm sorry...\I have to tell him I'm sorry...\You're sorry? Him?\What are you talking about, Mikono?\The Abductor alarm! response:	Vectors!
context: I would die happy hearing its voice.\Mikono!\I'm sorry...\I have to tell him I'm sorry...\You're sorry? Him?\What are you talking about, Mikono?\The Abductor alarm!\Vectors! response:	Goddamn it! Why can't anyone leave us alone?
context: Mikono!\I'm sorry...\I have to tell him I'm sorry...\You're sorry? Him?\What are you talking about, Mikono?\The Abductor alarm!\Vectors!\Goddamn it! Why can't anyone leave us alone? response:	My wench...
context: I'm sorry...\I have to tell him I'm sorry...\You're sorry? Him?\What are you talking about, Mikono?\The Abductor alarm!\Vectors!\Goddamn it! Why can't anyone leave us alone?\My wench... response:	Where is she?!
context: I have to tell him I'm sorry...\You're sorry? Him?\What are you talking about, Mikono?\The Abductor alarm!\Vectors!\Goddamn it! Why can't anyone leave us alone?\My wench...\Where is she?! response:	It's him!
context: You're sorry? Him?\What are you talking about, Mikono?\The Abductor alarm!\Vectors!\Goddamn it! Why can't anyone leave us alone?\My wench...\Where is she?!\It's him! response:	It's that beastial Abductor again!
context: What are you talking about, Mikono?\The Abductor alarm!\Vectors!\Goddamn it! Why can't anyone leave us alone?\My wench...\Where is she?!\It's him!\It's that beastial Abductor again! response:	Mithra Gnis.
context: The Abductor alarm!\Vectors!\Goddamn it! Why can't anyone leave us alone?\My wench...\Where is she?!\It's him!\It's that beastial Abductor again!\Mithra Gnis. response:	Is that the name of the robot, High Commander?
context: Vectors!\Goddamn it! Why can't anyone leave us alone?\My wench...\Where is she?!\It's him!\It's that beastial Abductor again!\Mithra Gnis.\Is that the name of the robot, High Commander? response:	I can smell better from in here.
context: Goddamn it! Why can't anyone leave us alone?\My wench...\Where is she?!\It's him!\It's that beastial Abductor again!\Mithra Gnis.\Is that the name of the robot, High Commander?\I can smell better from in here. response:	Cayenne!
context: My wench...\Where is she?!\It's him!\It's that beastial Abductor again!\Mithra Gnis.\Is that the name of the robot, High Commander?\I can smell better from in here.\Cayenne! response:	Not this one.
context: Where is she?!\It's him!\It's that beastial Abductor again!\Mithra Gnis.\Is that the name of the robot, High Commander?\I can smell better from in here.\Cayenne!\Not this one. response:	Must be that one!
context: It's him!\It's that beastial Abductor again!\Mithra Gnis.\Is that the name of the robot, High Commander?\I can smell better from in here.\Cayenne!\Not this one.\Must be that one! response:	Look out, Zessica!
context: It's that beastial Abductor again!\Mithra Gnis.\Is that the name of the robot, High Commander?\I can smell better from in here.\Cayenne!\Not this one.\Must be that one!\Look out, Zessica! response:	I can tell...
context: Mithra Gnis.\Is that the name of the robot, High Commander?\I can smell better from in here.\Cayenne!\Not this one.\Must be that one!\Look out, Zessica!\I can tell... response:	He's looking for Mikono.
context: Is that the name of the robot, High Commander?\I can smell better from in here.\Cayenne!\Not this one.\Must be that one!\Look out, Zessica!\I can tell...\He's looking for Mikono. response:	Mikono! You're awake!
context: I can smell better from in here.\Cayenne!\Not this one.\Must be that one!\Look out, Zessica!\I can tell...\He's looking for Mikono.\Mikono! You're awake! response:	Amata...
context: Cayenne!\Not this one.\Must be that one!\Look out, Zessica!\I can tell...\He's looking for Mikono.\Mikono! You're awake!\Amata... response:	Where am I?
context: Not this one.\Must be that one!\Look out, Zessica!\I can tell...\He's looking for Mikono.\Mikono! You're awake!\Amata...\Where am I? response:	Mikono, you were saying that you have to apologize to him.
context: Must be that one!\Look out, Zessica!\I can tell...\He's looking for Mikono.\Mikono! You're awake!\Amata...\Where am I?\Mikono, you were saying that you have to apologize to him. response:	Apologize?
context: Look out, Zessica!\I can tell...\He's looking for Mikono.\Mikono! You're awake!\Amata...\Where am I?\Mikono, you were saying that you have to apologize to him.\Apologize? response:	I don't know.
context: I can tell...\He's looking for Mikono.\Mikono! You're awake!\Amata...\Where am I?\Mikono, you were saying that you have to apologize to him.\Apologize?\I don't know. response:	I was so scared when he grabbed me.
context: He's looking for Mikono.\Mikono! You're awake!\Amata...\Where am I?\Mikono, you were saying that you have to apologize to him.\Apologize?\I don't know.\I was so scared when he grabbed me. response:	But I felt like he really cared about me.
context: Mikono! You're awake!\Amata...\Where am I?\Mikono, you were saying that you have to apologize to him.\Apologize?\I don't know.\I was so scared when he grabbed me.\But I felt like he really cared about me. response:	And then I thought, I'd felt that before...
context: Amata...\Where am I?\Mikono, you were saying that you have to apologize to him.\Apologize?\I don't know.\I was so scared when he grabbed me.\But I felt like he really cared about me.\And then I thought, I'd felt that before... response:	I can't shake him!
context: Where am I?\Mikono, you were saying that you have to apologize to him.\Apologize?\I don't know.\I was so scared when he grabbed me.\But I felt like he really cared about me.\And then I thought, I'd felt that before...\I can't shake him! response:	Found you.
context: Mikono, you were saying that you have to apologize to him.\Apologize?\I don't know.\I was so scared when he grabbed me.\But I felt like he really cared about me.\And then I thought, I'd felt that before...\I can't shake him!\Found you. response:	My wench!
context: Apologize?\I don't know.\I was so scared when he grabbed me.\But I felt like he really cared about me.\And then I thought, I'd felt that before...\I can't shake him!\Found you.\My wench! response:	Are you all right, my friend?
context: I don't know.\I was so scared when he grabbed me.\But I felt like he really cared about me.\And then I thought, I'd felt that before...\I can't shake him!\Found you.\My wench!\Are you all right, my friend? response:	Shrade?
context: I was so scared when he grabbed me.\But I felt like he really cared about me.\And then I thought, I'd felt that before...\I can't shake him!\Found you.\My wench!\Are you all right, my friend?\Shrade? response:	Let me take over.
context: But I felt like he really cared about me.\And then I thought, I'd felt that before...\I can't shake him!\Found you.\My wench!\Are you all right, my friend?\Shrade?\Let me take over. response:	But your body can't take it!
context: And then I thought, I'd felt that before...\I can't shake him!\Found you.\My wench!\Are you all right, my friend?\Shrade?\Let me take over.\But your body can't take it! response:	Give me my wench!
context: I can't shake him!\Found you.\My wench!\Are you all right, my friend?\Shrade?\Let me take over.\But your body can't take it!\Give me my wench! response:	Mikono! Why, that...
context: Found you.\My wench!\Are you all right, my friend?\Shrade?\Let me take over.\But your body can't take it!\Give me my wench!\Mikono! Why, that... response:	Don't worry about me! Amata!
context: My wench!\Are you all right, my friend?\Shrade?\Let me take over.\But your body can't take it!\Give me my wench!\Mikono! Why, that...\Don't worry about me! Amata! response:	I felt it too.
context: Are you all right, my friend?\Shrade?\Let me take over.\But your body can't take it!\Give me my wench!\Mikono! Why, that...\Don't worry about me! Amata!\I felt it too. response:	I think I know him.
context: Shrade?\Let me take over.\But your body can't take it!\Give me my wench!\Mikono! Why, that...\Don't worry about me! Amata!\I felt it too.\I think I know him. response:	And I know I can't let him take you.
context: Let me take over.\But your body can't take it!\Give me my wench!\Mikono! Why, that...\Don't worry about me! Amata!\I felt it too.\I think I know him.\And I know I can't let him take you. response:	Cayenne!
context: But your body can't take it!\Give me my wench!\Mikono! Why, that...\Don't worry about me! Amata!\I felt it too.\I think I know him.\And I know I can't let him take you.\Cayenne! response:	That's not him! Wait...
context: Give me my wench!\Mikono! Why, that...\Don't worry about me! Amata!\I felt it too.\I think I know him.\And I know I can't let him take you.\Cayenne!\That's not him! Wait... response:	Shrade!
context: Mikono! Why, that...\Don't worry about me! Amata!\I felt it too.\I think I know him.\And I know I can't let him take you.\Cayenne!\That's not him! Wait...\Shrade! response:	Why is he in a Vector?
context: Don't worry about me! Amata!\I felt it too.\I think I know him.\And I know I can't let him take you.\Cayenne!\That's not him! Wait...\Shrade!\Why is he in a Vector? response:	You can't do this!
context: I felt it too.\I think I know him.\And I know I can't let him take you.\Cayenne!\That's not him! Wait...\Shrade!\Why is he in a Vector?\You can't do this! response:	Our enemy is not playing with us.
context: I think I know him.\And I know I can't let him take you.\Cayenne!\That's not him! Wait...\Shrade!\Why is he in a Vector?\You can't do this!\Our enemy is not playing with us. response:	You need me for this fight.
context: And I know I can't let him take you.\Cayenne!\That's not him! Wait...\Shrade!\Why is he in a Vector?\You can't do this!\Our enemy is not playing with us.\You need me for this fight. response:	But your body...
context: Cayenne!\That's not him! Wait...\Shrade!\Why is he in a Vector?\You can't do this!\Our enemy is not playing with us.\You need me for this fight.\But your body... response:	Element Change!
context: That's not him! Wait...\Shrade!\Why is he in a Vector?\You can't do this!\Our enemy is not playing with us.\You need me for this fight.\But your body...\Element Change! response:	Call back Andy W. Hol!
context: Shrade!\Why is he in a Vector?\You can't do this!\Our enemy is not playing with us.\You need me for this fight.\But your body...\Element Change!\Call back Andy W. Hol! response:	What? But I was finally about to Union with a girl!
context: Why is he in a Vector?\You can't do this!\Our enemy is not playing with us.\You need me for this fight.\But your body...\Element Change!\Call back Andy W. Hol!\What? But I was finally about to Union with a girl! response:	Get over here, wench!
context: You can't do this!\Our enemy is not playing with us.\You need me for this fight.\But your body...\Element Change!\Call back Andy W. Hol!\What? But I was finally about to Union with a girl!\Get over here, wench! response:	What are you doing?
context: Our enemy is not playing with us.\You need me for this fight.\But your body...\Element Change!\Call back Andy W. Hol!\What? But I was finally about to Union with a girl!\Get over here, wench!\What are you doing? response:	Vector Z!
context: You need me for this fight.\But your body...\Element Change!\Call back Andy W. Hol!\What? But I was finally about to Union with a girl!\Get over here, wench!\What are you doing?\Vector Z! response:	Mikono, get out of here.
context: But your body...\Element Change!\Call back Andy W. Hol!\What? But I was finally about to Union with a girl!\Get over here, wench!\What are you doing?\Vector Z!\Mikono, get out of here. response:	Amata!
context: Element Change!\Call back Andy W. Hol!\What? But I was finally about to Union with a girl!\Get over here, wench!\What are you doing?\Vector Z!\Mikono, get out of here.\Amata! response:	Chairman Crea, requesting permission for Union.
context: Call back Andy W. Hol!\What? But I was finally about to Union with a girl!\Get over here, wench!\What are you doing?\Vector Z!\Mikono, get out of here.\Amata!\Chairman Crea, requesting permission for Union. response:	Shrade! You can't!
context: What? But I was finally about to Union with a girl!\Get over here, wench!\What are you doing?\Vector Z!\Mikono, get out of here.\Amata!\Chairman Crea, requesting permission for Union.\Shrade! You can't! response:	I'm ready to die.
context: Get over here, wench!\What are you doing?\Vector Z!\Mikono, get out of here.\Amata!\Chairman Crea, requesting permission for Union.\Shrade! You can't!\I'm ready to die. response:	If I can't play Aquarion, I may as well be dead.
context: What are you doing?\Vector Z!\Mikono, get out of here.\Amata!\Chairman Crea, requesting permission for Union.\Shrade! You can't!\I'm ready to die.\If I can't play Aquarion, I may as well be dead. response:	Union authorized! Shrade Elan, you're the head!
context: Vector Z!\Mikono, get out of here.\Amata!\Chairman Crea, requesting permission for Union.\Shrade! You can't!\I'm ready to die.\If I can't play Aquarion, I may as well be dead.\Union authorized! Shrade Elan, you're the head! response:	I've been waiting for this.
context: Mikono, get out of here.\Amata!\Chairman Crea, requesting permission for Union.\Shrade! You can't!\I'm ready to die.\If I can't play Aquarion, I may as well be dead.\Union authorized! Shrade Elan, you're the head!\I've been waiting for this. response:	For when I could finally play Aquarion!
context: Amata!\Chairman Crea, requesting permission for Union.\Shrade! You can't!\I'm ready to die.\If I can't play Aquarion, I may as well be dead.\Union authorized! Shrade Elan, you're the head!\I've been waiting for this.\For when I could finally play Aquarion! response:	Melodic Union! Go, Aquarion!
context: Chairman Crea, requesting permission for Union.\Shrade! You can't!\I'm ready to die.\If I can't play Aquarion, I may as well be dead.\Union authorized! Shrade Elan, you're the head!\I've been waiting for this.\For when I could finally play Aquarion!\Melodic Union! Go, Aquarion! response:	A powerful sound is resonating inside my chest!
context: Shrade! You can't!\I'm ready to die.\If I can't play Aquarion, I may as well be dead.\Union authorized! Shrade Elan, you're the head!\I've been waiting for this.\For when I could finally play Aquarion!\Melodic Union! Go, Aquarion!\A powerful sound is resonating inside my chest! response:	But why does it feel so comfortable?
context: I'm ready to die.\If I can't play Aquarion, I may as well be dead.\Union authorized! Shrade Elan, you're the head!\I've been waiting for this.\For when I could finally play Aquarion!\Melodic Union! Go, Aquarion!\A powerful sound is resonating inside my chest!\But why does it feel so comfortable? response:	This is the sound of life itself!
context: If I can't play Aquarion, I may as well be dead.\Union authorized! Shrade Elan, you're the head!\I've been waiting for this.\For when I could finally play Aquarion!\Melodic Union! Go, Aquarion!\A powerful sound is resonating inside my chest!\But why does it feel so comfortable?\This is the sound of life itself! response:	The first sound we made when we came out of the womb!
context: Union authorized! Shrade Elan, you're the head!\I've been waiting for this.\For when I could finally play Aquarion!\Melodic Union! Go, Aquarion!\A powerful sound is resonating inside my chest!\But why does it feel so comfortable?\This is the sound of life itself!\The first sound we made when we came out of the womb! response:	Aquarion Spada!
context: I've been waiting for this.\For when I could finally play Aquarion!\Melodic Union! Go, Aquarion!\A powerful sound is resonating inside my chest!\But why does it feel so comfortable?\This is the sound of life itself!\The first sound we made when we came out of the womb!\Aquarion Spada! response:	A Union with Vector Y as the head!
context: For when I could finally play Aquarion!\Melodic Union! Go, Aquarion!\A powerful sound is resonating inside my chest!\But why does it feel so comfortable?\This is the sound of life itself!\The first sound we made when we came out of the womb!\Aquarion Spada!\A Union with Vector Y as the head! response:	Aquarion Spada!
context: Melodic Union! Go, Aquarion!\A powerful sound is resonating inside my chest!\But why does it feel so comfortable?\This is the sound of life itself!\The first sound we made when we came out of the womb!\Aquarion Spada!\A Union with Vector Y as the head!\Aquarion Spada! response:	Shrade's power has given Aquarion a new form.
context: A powerful sound is resonating inside my chest!\But why does it feel so comfortable?\This is the sound of life itself!\The first sound we made when we came out of the womb!\Aquarion Spada!\A Union with Vector Y as the head!\Aquarion Spada!\Shrade's power has given Aquarion a new form. response:	Aquarion.
context: But why does it feel so comfortable?\This is the sound of life itself!\The first sound we made when we came out of the womb!\Aquarion Spada!\A Union with Vector Y as the head!\Aquarion Spada!\Shrade's power has given Aquarion a new form.\Aquarion. response:	The moment I first laid eyes upon it,
context: This is the sound of life itself!\The first sound we made when we came out of the womb!\Aquarion Spada!\A Union with Vector Y as the head!\Aquarion Spada!\Shrade's power has given Aquarion a new form.\Aquarion.\The moment I first laid eyes upon it, response:	my still heart began to beat once more in a powerful staccato.
context: The first sound we made when we came out of the womb!\Aquarion Spada!\A Union with Vector Y as the head!\Aquarion Spada!\Shrade's power has given Aquarion a new form.\Aquarion.\The moment I first laid eyes upon it,\my still heart began to beat once more in a powerful staccato. response:	That is...
context: Aquarion Spada!\A Union with Vector Y as the head!\Aquarion Spada!\Shrade's power has given Aquarion a new form.\Aquarion.\The moment I first laid eyes upon it,\my still heart began to beat once more in a powerful staccato.\That is... response:	the melody of my soul.
context: A Union with Vector Y as the head!\Aquarion Spada!\Shrade's power has given Aquarion a new form.\Aquarion.\The moment I first laid eyes upon it,\my still heart began to beat once more in a powerful staccato.\That is...\the melody of my soul. response:	Damn you, Machine Angel! I'll get you out of my way for good!
context: Aquarion Spada!\Shrade's power has given Aquarion a new form.\Aquarion.\The moment I first laid eyes upon it,\my still heart began to beat once more in a powerful staccato.\That is...\the melody of my soul.\Damn you, Machine Angel! I'll get you out of my way for good! response:	Amata. Zessica.
context: Shrade's power has given Aquarion a new form.\Aquarion.\The moment I first laid eyes upon it,\my still heart began to beat once more in a powerful staccato.\That is...\the melody of my soul.\Damn you, Machine Angel! I'll get you out of my way for good!\Amata. Zessica. response:	To live is to engrave your life.
context: Aquarion.\The moment I first laid eyes upon it,\my still heart began to beat once more in a powerful staccato.\That is...\the melody of my soul.\Damn you, Machine Angel! I'll get you out of my way for good!\Amata. Zessica.\To live is to engrave your life. response:	To make the melody of your life resonate with the world!
context: The moment I first laid eyes upon it,\my still heart began to beat once more in a powerful staccato.\That is...\the melody of my soul.\Damn you, Machine Angel! I'll get you out of my way for good!\Amata. Zessica.\To live is to engrave your life.\To make the melody of your life resonate with the world! response:	Help me! Help me play out the melody of my life!
context: my still heart began to beat once more in a powerful staccato.\That is...\the melody of my soul.\Damn you, Machine Angel! I'll get you out of my way for good!\Amata. Zessica.\To live is to engrave your life.\To make the melody of your life resonate with the world!\Help me! Help me play out the melody of my life! response:	You got it!
context: That is...\the melody of my soul.\Damn you, Machine Angel! I'll get you out of my way for good!\Amata. Zessica.\To live is to engrave your life.\To make the melody of your life resonate with the world!\Help me! Help me play out the melody of my life!\You got it! response:	If you're going to beat him, I'm with you!
context: the melody of my soul.\Damn you, Machine Angel! I'll get you out of my way for good!\Amata. Zessica.\To live is to engrave your life.\To make the melody of your life resonate with the world!\Help me! Help me play out the melody of my life!\You got it!\If you're going to beat him, I'm with you! response:	Now let us play out our souls a arpeggio!
context: Damn you, Machine Angel! I'll get you out of my way for good!\Amata. Zessica.\To live is to engrave your life.\To make the melody of your life resonate with the world!\Help me! Help me play out the melody of my life!\You got it!\If you're going to beat him, I'm with you!\Now let us play out our souls a arpeggio! response:	Damn it!
context: Amata. Zessica.\To live is to engrave your life.\To make the melody of your life resonate with the world!\Help me! Help me play out the melody of my life!\You got it!\If you're going to beat him, I'm with you!\Now let us play out our souls a arpeggio!\Damn it! response:	Amata's Element power is rocketing!
context: To live is to engrave your life.\To make the melody of your life resonate with the world!\Help me! Help me play out the melody of my life!\You got it!\If you're going to beat him, I'm with you!\Now let us play out our souls a arpeggio!\Damn it!\Amata's Element power is rocketing! response:	Add Zessica's force...
context: To make the melody of your life resonate with the world!\Help me! Help me play out the melody of my life!\You got it!\If you're going to beat him, I'm with you!\Now let us play out our souls a arpeggio!\Damn it!\Amata's Element power is rocketing!\Add Zessica's force... response:	And when you combine those two with Shrade's power...
context: Help me! Help me play out the melody of my life!\You got it!\If you're going to beat him, I'm with you!\Now let us play out our souls a arpeggio!\Damn it!\Amata's Element power is rocketing!\Add Zessica's force...\And when you combine those two with Shrade's power... response:	Set the moon in the sky with vibrato,
context: You got it!\If you're going to beat him, I'm with you!\Now let us play out our souls a arpeggio!\Damn it!\Amata's Element power is rocketing!\Add Zessica's force...\And when you combine those two with Shrade's power...\Set the moon in the sky with vibrato, response:	and the moon on the water in allegro vivace.
context: If you're going to beat him, I'm with you!\Now let us play out our souls a arpeggio!\Damn it!\Amata's Element power is rocketing!\Add Zessica's force...\And when you combine those two with Shrade's power...\Set the moon in the sky with vibrato,\and the moon on the water in allegro vivace. response:	What are you talking about?
context: Now let us play out our souls a arpeggio!\Damn it!\Amata's Element power is rocketing!\Add Zessica's force...\And when you combine those two with Shrade's power...\Set the moon in the sky with vibrato,\and the moon on the water in allegro vivace.\What are you talking about? response:	Then I will play the moon within us in the agitato of life!
context: Damn it!\Amata's Element power is rocketing!\Add Zessica's force...\And when you combine those two with Shrade's power...\Set the moon in the sky with vibrato,\and the moon on the water in allegro vivace.\What are you talking about?\Then I will play the moon within us in the agitato of life! response:	Moonlight Requiem!
context: Amata's Element power is rocketing!\Add Zessica's force...\And when you combine those two with Shrade's power...\Set the moon in the sky with vibrato,\and the moon on the water in allegro vivace.\What are you talking about?\Then I will play the moon within us in the agitato of life!\Moonlight Requiem! response:	What?
context: Add Zessica's force...\And when you combine those two with Shrade's power...\Set the moon in the sky with vibrato,\and the moon on the water in allegro vivace.\What are you talking about?\Then I will play the moon within us in the agitato of life!\Moonlight Requiem!\What? response:	Did he win?
context: And when you combine those two with Shrade's power...\Set the moon in the sky with vibrato,\and the moon on the water in allegro vivace.\What are you talking about?\Then I will play the moon within us in the agitato of life!\Moonlight Requiem!\What?\Did he win? response:	I'm not done...
context: Set the moon in the sky with vibrato,\and the moon on the water in allegro vivace.\What are you talking about?\Then I will play the moon within us in the agitato of life!\Moonlight Requiem!\What?\Did he win?\I'm not done... response:	I'm not done fighting yet!
context: and the moon on the water in allegro vivace.\What are you talking about?\Then I will play the moon within us in the agitato of life!\Moonlight Requiem!\What?\Did he win?\I'm not done...\I'm not done fighting yet! response:	Sorry. I'm taking back the Mithra Gnis.
context: What are you talking about?\Then I will play the moon within us in the agitato of life!\Moonlight Requiem!\What?\Did he win?\I'm not done...\I'm not done fighting yet!\Sorry. I'm taking back the Mithra Gnis. response:	Stop messing up our Vega reconnaissance.
context: Then I will play the moon within us in the agitato of life!\Moonlight Requiem!\What?\Did he win?\I'm not done...\I'm not done fighting yet!\Sorry. I'm taking back the Mithra Gnis.\Stop messing up our Vega reconnaissance. response:	You're just making my job harder.
context: Moonlight Requiem!\What?\Did he win?\I'm not done...\I'm not done fighting yet!\Sorry. I'm taking back the Mithra Gnis.\Stop messing up our Vega reconnaissance.\You're just making my job harder. response:	Damn you, Jin...
context: What?\Did he win?\I'm not done...\I'm not done fighting yet!\Sorry. I'm taking back the Mithra Gnis.\Stop messing up our Vega reconnaissance.\You're just making my job harder.\Damn you, Jin... response:	He's getting away!
context: Did he win?\I'm not done...\I'm not done fighting yet!\Sorry. I'm taking back the Mithra Gnis.\Stop messing up our Vega reconnaissance.\You're just making my job harder.\Damn you, Jin...\He's getting away! response:	Shrade, let's go after him!
context: I'm not done...\I'm not done fighting yet!\Sorry. I'm taking back the Mithra Gnis.\Stop messing up our Vega reconnaissance.\You're just making my job harder.\Damn you, Jin...\He's getting away!\Shrade, let's go after him! response:	Shrade?
context: I'm not done fighting yet!\Sorry. I'm taking back the Mithra Gnis.\Stop messing up our Vega reconnaissance.\You're just making my job harder.\Damn you, Jin...\He's getting away!\Shrade, let's go after him!\Shrade? response:	Wait, Shrade is...
context: Sorry. I'm taking back the Mithra Gnis.\Stop messing up our Vega reconnaissance.\You're just making my job harder.\Damn you, Jin...\He's getting away!\Shrade, let's go after him!\Shrade?\Wait, Shrade is... response:	Shrade! Are you okay?
context: Stop messing up our Vega reconnaissance.\You're just making my job harder.\Damn you, Jin...\He's getting away!\Shrade, let's go after him!\Shrade?\Wait, Shrade is...\Shrade! Are you okay? response:	Shrade!
context: You're just making my job harder.\Damn you, Jin...\He's getting away!\Shrade, let's go after him!\Shrade?\Wait, Shrade is...\Shrade! Are you okay?\Shrade! response:	Shrade!
context: Damn you, Jin...\He's getting away!\Shrade, let's go after him!\Shrade?\Wait, Shrade is...\Shrade! Are you okay?\Shrade!\Shrade! response:	Mikono?
context: He's getting away!\Shrade, let's go after him!\Shrade?\Wait, Shrade is...\Shrade! Are you okay?\Shrade!\Shrade!\Mikono? response:	What's the matter, Mikono?
context: Shrade, let's go after him!\Shrade?\Wait, Shrade is...\Shrade! Are you okay?\Shrade!\Shrade!\Mikono?\What's the matter, Mikono? response:	I don't know.
context: Shrade?\Wait, Shrade is...\Shrade! Are you okay?\Shrade!\Shrade!\Mikono?\What's the matter, Mikono?\I don't know. response:	I don't know, but...
context: Wait, Shrade is...\Shrade! Are you okay?\Shrade!\Shrade!\Mikono?\What's the matter, Mikono?\I don't know.\I don't know, but... response:	It hurts that I don't know.
context: Shrade! Are you okay?\Shrade!\Shrade!\Mikono?\What's the matter, Mikono?\I don't know.\I don't know, but...\It hurts that I don't know. response:	I hear the Academy is haunted by the ghost of a missing Element.
context: Shrade!\Shrade!\Mikono?\What's the matter, Mikono?\I don't know.\I don't know, but...\It hurts that I don't know.\I hear the Academy is haunted by the ghost of a missing Element. response:	You'll be so scared you can't even take a leak at night!
context: Shrade!\Mikono?\What's the matter, Mikono?\I don't know.\I don't know, but...\It hurts that I don't know.\I hear the Academy is haunted by the ghost of a missing Element.\You'll be so scared you can't even take a leak at night! response:	I'll dig a hole out, just in case.
context: Mikono?\What's the matter, Mikono?\I don't know.\I don't know, but...\It hurts that I don't know.\I hear the Academy is haunted by the ghost of a missing Element.\You'll be so scared you can't even take a leak at night!\I'll dig a hole out, just in case. response:	Next time on Aquarion Evol: The Midnight Girl.
context: What's the matter, Mikono?\I don't know.\I don't know, but...\It hurts that I don't know.\I hear the Academy is haunted by the ghost of a missing Element.\You'll be so scared you can't even take a leak at night!\I'll dig a hole out, just in case.\Next time on Aquarion Evol: The Midnight Girl. response:	The Agitato of Life
context: I don't know.\I don't know, but...\It hurts that I don't know.\I hear the Academy is haunted by the ghost of a missing Element.\You'll be so scared you can't even take a leak at night!\I'll dig a hole out, just in case.\Next time on Aquarion Evol: The Midnight Girl.\The Agitato of Life response:	Next Time
context: I don't know, but...\It hurts that I don't know.\I hear the Academy is haunted by the ghost of a missing Element.\You'll be so scared you can't even take a leak at night!\I'll dig a hole out, just in case.\Next time on Aquarion Evol: The Midnight Girl.\The Agitato of Life\Next Time response:	The Midnight Girl
context: It hurts that I don't know.\I hear the Academy is haunted by the ghost of a missing Element.\You'll be so scared you can't even take a leak at night!\I'll dig a hole out, just in case.\Next time on Aquarion Evol: The Midnight Girl.\The Agitato of Life\Next Time\The Midnight Girl response:	osore
context: I hear the Academy is haunted by the ghost of a missing Element.\You'll be so scared you can't even take a leak at night!\I'll dig a hole out, just in case.\Next time on Aquarion Evol: The Midnight Girl.\The Agitato of Life\Next Time\The Midnight Girl\osore response:	living your life don't give up now keep moving on
context: You'll be so scared you can't even take a leak at night!\I'll dig a hole out, just in case.\Next time on Aquarion Evol: The Midnight Girl.\The Agitato of Life\Next Time\The Midnight Girl\osore\living your life don't give up now keep moving on response:	kimi wo dakishimeru nandomo nandomo nandomo
context: I'll dig a hole out, just in case.\Next time on Aquarion Evol: The Midnight Girl.\The Agitato of Life\Next Time\The Midnight Girl\osore\living your life don't give up now keep moving on\kimi wo dakishimeru nandomo nandomo nandomo response:	ashita boku wa kimi ni deau darou
context: Next time on Aquarion Evol: The Midnight Girl.\The Agitato of Life\Next Time\The Midnight Girl\osore\living your life don't give up now keep moving on\kimi wo dakishimeru nandomo nandomo nandomo\ashita boku wa kimi ni deau darou response:	wazukana hoshiakari wo tayori ni
context: The Agitato of Life\Next Time\The Midnight Girl\osore\living your life don't give up now keep moving on\kimi wo dakishimeru nandomo nandomo nandomo\ashita boku wa kimi ni deau darou\wazukana hoshiakari wo tayori ni response:	boku ni wa kimi ga wakaru yo wakaru yo
context: Next Time\The Midnight Girl\osore\living your life don't give up now keep moving on\kimi wo dakishimeru nandomo nandomo nandomo\ashita boku wa kimi ni deau darou\wazukana hoshiakari wo tayori ni\boku ni wa kimi ga wakaru yo wakaru yo response:	sen'oku no toki wo koe futari hiraku densetsu no tobira
context: The Midnight Girl\osore\living your life don't give up now keep moving on\kimi wo dakishimeru nandomo nandomo nandomo\ashita boku wa kimi ni deau darou\wazukana hoshiakari wo tayori ni\boku ni wa kimi ga wakaru yo wakaru yo\sen'oku no toki wo koe futari hiraku densetsu no tobira response:	naraku no ao tobikoete
context: osore\living your life don't give up now keep moving on\kimi wo dakishimeru nandomo nandomo nandomo\ashita boku wa kimi ni deau darou\wazukana hoshiakari wo tayori ni\boku ni wa kimi ga wakaru yo wakaru yo\sen'oku no toki wo koe futari hiraku densetsu no tobira\naraku no ao tobikoete response:	kimi to hai ni naru tame
context: living your life don't give up now keep moving on\kimi wo dakishimeru nandomo nandomo nandomo\ashita boku wa kimi ni deau darou\wazukana hoshiakari wo tayori ni\boku ni wa kimi ga wakaru yo wakaru yo\sen'oku no toki wo koe futari hiraku densetsu no tobira\naraku no ao tobikoete\kimi to hai ni naru tame response:	nagaki rinne wo kanashimi tsurete tabi shitekitanda
context: kimi wo dakishimeru nandomo nandomo nandomo\ashita boku wa kimi ni deau darou\wazukana hoshiakari wo tayori ni\boku ni wa kimi ga wakaru yo wakaru yo\sen'oku no toki wo koe futari hiraku densetsu no tobira\naraku no ao tobikoete\kimi to hai ni naru tame\nagaki rinne wo kanashimi tsurete tabi shitekitanda response:	zenryoku de mikansei kimi no tonari de
context: ashita boku wa kimi ni deau darou\wazukana hoshiakari wo tayori ni\boku ni wa kimi ga wakaru yo wakaru yo\sen'oku no toki wo koe futari hiraku densetsu no tobira\naraku no ao tobikoete\kimi to hai ni naru tame\nagaki rinne wo kanashimi tsurete tabi shitekitanda\zenryoku de mikansei kimi no tonari de response:	kawaita kokoro hodoke chi wo nagasu kedo
context: wazukana hoshiakari wo tayori ni\boku ni wa kimi ga wakaru yo wakaru yo\sen'oku no toki wo koe futari hiraku densetsu no tobira\naraku no ao tobikoete\kimi to hai ni naru tame\nagaki rinne wo kanashimi tsurete tabi shitekitanda\zenryoku de mikansei kimi no tonari de\kawaita kokoro hodoke chi wo nagasu kedo response:	soba ni iru yo zutto yorisotte zutto
context: boku ni wa kimi ga wakaru yo wakaru yo\sen'oku no toki wo koe futari hiraku densetsu no tobira\naraku no ao tobikoete\kimi to hai ni naru tame\nagaki rinne wo kanashimi tsurete tabi shitekitanda\zenryoku de mikansei kimi no tonari de\kawaita kokoro hodoke chi wo nagasu kedo\soba ni iru yo zutto yorisotte zutto response:	futari hikari no fune ni noru
context: sen'oku no toki wo koe futari hiraku densetsu no tobira\naraku no ao tobikoete\kimi to hai ni naru tame\nagaki rinne wo kanashimi tsurete tabi shitekitanda\zenryoku de mikansei kimi no tonari de\kawaita kokoro hodoke chi wo nagasu kedo\soba ni iru yo zutto yorisotte zutto\futari hikari no fune ni noru response:	kaze no hajimari no oto kanadeyou
context: naraku no ao tobikoete\kimi to hai ni naru tame\nagaki rinne wo kanashimi tsurete tabi shitekitanda\zenryoku de mikansei kimi no tonari de\kawaita kokoro hodoke chi wo nagasu kedo\soba ni iru yo zutto yorisotte zutto\futari hikari no fune ni noru\kaze no hajimari no oto kanadeyou response:	Even if you're scared
context: kimi to hai ni naru tame\nagaki rinne wo kanashimi tsurete tabi shitekitanda\zenryoku de mikansei kimi no tonari de\kawaita kokoro hodoke chi wo nagasu kedo\soba ni iru yo zutto yorisotte zutto\futari hikari no fune ni noru\kaze no hajimari no oto kanadeyou\Even if you're scared response:	Just live your life, don't give up now, keep moving on
context: nagaki rinne wo kanashimi tsurete tabi shitekitanda\zenryoku de mikansei kimi no tonari de\kawaita kokoro hodoke chi wo nagasu kedo\soba ni iru yo zutto yorisotte zutto\futari hikari no fune ni noru\kaze no hajimari no oto kanadeyou\Even if you're scared\Just live your life, don't give up now, keep moving on response:	And I'll come for you over and over and over again
context: zenryoku de mikansei kimi no tonari de\kawaita kokoro hodoke chi wo nagasu kedo\soba ni iru yo zutto yorisotte zutto\futari hikari no fune ni noru\kaze no hajimari no oto kanadeyou\Even if you're scared\Just live your life, don't give up now, keep moving on\And I'll come for you over and over and over again response:	We'll find each other soon enough
context: kawaita kokoro hodoke chi wo nagasu kedo\soba ni iru yo zutto yorisotte zutto\futari hikari no fune ni noru\kaze no hajimari no oto kanadeyou\Even if you're scared\Just live your life, don't give up now, keep moving on\And I'll come for you over and over and over again\We'll find each other soon enough response:	By the faintest glimmer of starlight
context: soba ni iru yo zutto yorisotte zutto\futari hikari no fune ni noru\kaze no hajimari no oto kanadeyou\Even if you're scared\Just live your life, don't give up now, keep moving on\And I'll come for you over and over and over again\We'll find each other soon enough\By the faintest glimmer of starlight response:	I know you, I know you
context: futari hikari no fune ni noru\kaze no hajimari no oto kanadeyou\Even if you're scared\Just live your life, don't give up now, keep moving on\And I'll come for you over and over and over again\We'll find each other soon enough\By the faintest glimmer of starlight\I know you, I know you response:	It's been billions of years, but now we can open the door to our legend
context: kaze no hajimari no oto kanadeyou\Even if you're scared\Just live your life, don't give up now, keep moving on\And I'll come for you over and over and over again\We'll find each other soon enough\By the faintest glimmer of starlight\I know you, I know you\It's been billions of years, but now we can open the door to our legend response:	I crossed over the deep blue void
context: Even if you're scared\Just live your life, don't give up now, keep moving on\And I'll come for you over and over and over again\We'll find each other soon enough\By the faintest glimmer of starlight\I know you, I know you\It's been billions of years, but now we can open the door to our legend\I crossed over the deep blue void response:	so I could burn to ash along with you
context: Just live your life, don't give up now, keep moving on\And I'll come for you over and over and over again\We'll find each other soon enough\By the faintest glimmer of starlight\I know you, I know you\It's been billions of years, but now we can open the door to our legend\I crossed over the deep blue void\so I could burn to ash along with you response:	I've had a long journey on the vast wheel of fate, gathering sorrows along the way
context: And I'll come for you over and over and over again\We'll find each other soon enough\By the faintest glimmer of starlight\I know you, I know you\It's been billions of years, but now we can open the door to our legend\I crossed over the deep blue void\so I could burn to ash along with you\I've had a long journey on the vast wheel of fate, gathering sorrows along the way response:	I'm not perfect, but I'm giving all I have
context: We'll find each other soon enough\By the faintest glimmer of starlight\I know you, I know you\It's been billions of years, but now we can open the door to our legend\I crossed over the deep blue void\so I could burn to ash along with you\I've had a long journey on the vast wheel of fate, gathering sorrows along the way\I'm not perfect, but I'm giving all I have response:	If I open my fragile heart to you, I know I'll bleed...
context: By the faintest glimmer of starlight\I know you, I know you\It's been billions of years, but now we can open the door to our legend\I crossed over the deep blue void\so I could burn to ash along with you\I've had a long journey on the vast wheel of fate, gathering sorrows along the way\I'm not perfect, but I'm giving all I have\If I open my fragile heart to you, I know I'll bleed... response:	But I'll always be with you, always be in your arms
context: I know you, I know you\It's been billions of years, but now we can open the door to our legend\I crossed over the deep blue void\so I could burn to ash along with you\I've had a long journey on the vast wheel of fate, gathering sorrows along the way\I'm not perfect, but I'm giving all I have\If I open my fragile heart to you, I know I'll bleed...\But I'll always be with you, always be in your arms response:	We'll get on a shining ship of light
context: It's been billions of years, but now we can open the door to our legend\I crossed over the deep blue void\so I could burn to ash along with you\I've had a long journey on the vast wheel of fate, gathering sorrows along the way\I'm not perfect, but I'm giving all I have\If I open my fragile heart to you, I know I'll bleed...\But I'll always be with you, always be in your arms\We'll get on a shining ship of light response:	And call forth the wind with our voices
context: I crossed over the deep blue void\so I could burn to ash along with you\I've had a long journey on the vast wheel of fate, gathering sorrows along the way\I'm not perfect, but I'm giving all I have\If I open my fragile heart to you, I know I'll bleed...\But I'll always be with you, always be in your arms\We'll get on a shining ship of light\And call forth the wind with our voices response:	kaze ni ubawareta wake janai
context: so I could burn to ash along with you\I've had a long journey on the vast wheel of fate, gathering sorrows along the way\I'm not perfect, but I'm giving all I have\If I open my fragile heart to you, I know I'll bleed...\But I'll always be with you, always be in your arms\We'll get on a shining ship of light\And call forth the wind with our voices\kaze ni ubawareta wake janai response:	katamichi bun no yuuki de bokura
context: I've had a long journey on the vast wheel of fate, gathering sorrows along the way\I'm not perfect, but I'm giving all I have\If I open my fragile heart to you, I know I'll bleed...\But I'll always be with you, always be in your arms\We'll get on a shining ship of light\And call forth the wind with our voices\kaze ni ubawareta wake janai\katamichi bun no yuuki de bokura response:	higeki wo ukeireru
context: I'm not perfect, but I'm giving all I have\If I open my fragile heart to you, I know I'll bleed...\But I'll always be with you, always be in your arms\We'll get on a shining ship of light\And call forth the wind with our voices\kaze ni ubawareta wake janai\katamichi bun no yuuki de bokura\higeki wo ukeireru response:	kokoro ga koko ni atta hazu no kuudou
context: If I open my fragile heart to you, I know I'll bleed...\But I'll always be with you, always be in your arms\We'll get on a shining ship of light\And call forth the wind with our voices\kaze ni ubawareta wake janai\katamichi bun no yuuki de bokura\higeki wo ukeireru\kokoro ga koko ni atta hazu no kuudou response:	motto boku ga ookikereba
context: But I'll always be with you, always be in your arms\We'll get on a shining ship of light\And call forth the wind with our voices\kaze ni ubawareta wake janai\katamichi bun no yuuki de bokura\higeki wo ukeireru\kokoro ga koko ni atta hazu no kuudou\motto boku ga ookikereba response:	kimi wo mirai wo sukueta darou ka
context: We'll get on a shining ship of light\And call forth the wind with our voices\kaze ni ubawareta wake janai\katamichi bun no yuuki de bokura\higeki wo ukeireru\kokoro ga koko ni atta hazu no kuudou\motto boku ga ookikereba\kimi wo mirai wo sukueta darou ka response:	taisetsu na hito wo mamoru sube ga tatta hitotsu shika motenai
context: And call forth the wind with our voices\kaze ni ubawareta wake janai\katamichi bun no yuuki de bokura\higeki wo ukeireru\kokoro ga koko ni atta hazu no kuudou\motto boku ga ookikereba\kimi wo mirai wo sukueta darou ka\taisetsu na hito wo mamoru sube ga tatta hitotsu shika motenai response:	sonna anata ga haguretadayou sora
context: kaze ni ubawareta wake janai\katamichi bun no yuuki de bokura\higeki wo ukeireru\kokoro ga koko ni atta hazu no kuudou\motto boku ga ookikereba\kimi wo mirai wo sukueta darou ka\taisetsu na hito wo mamoru sube ga tatta hitotsu shika motenai\sonna anata ga haguretadayou sora response:	anata ijou no hito ni deaenai
context: katamichi bun no yuuki de bokura\higeki wo ukeireru\kokoro ga koko ni atta hazu no kuudou\motto boku ga ookikereba\kimi wo mirai wo sukueta darou ka\taisetsu na hito wo mamoru sube ga tatta hitotsu shika motenai\sonna anata ga haguretadayou sora\anata ijou no hito ni deaenai response:	tsuki ni aragau nagai furea
context: higeki wo ukeireru\kokoro ga koko ni atta hazu no kuudou\motto boku ga ookikereba\kimi wo mirai wo sukueta darou ka\taisetsu na hito wo mamoru sube ga tatta hitotsu shika motenai\sonna anata ga haguretadayou sora\anata ijou no hito ni deaenai\tsuki ni aragau nagai furea response:	hajimaru mo sezu owaru monogatari
context: kokoro ga koko ni atta hazu no kuudou\motto boku ga ookikereba\kimi wo mirai wo sukueta darou ka\taisetsu na hito wo mamoru sube ga tatta hitotsu shika motenai\sonna anata ga haguretadayou sora\anata ijou no hito ni deaenai\tsuki ni aragau nagai furea\hajimaru mo sezu owaru monogatari response:	kizutsukiuru yawarakasa
context: motto boku ga ookikereba\kimi wo mirai wo sukueta darou ka\taisetsu na hito wo mamoru sube ga tatta hitotsu shika motenai\sonna anata ga haguretadayou sora\anata ijou no hito ni deaenai\tsuki ni aragau nagai furea\hajimaru mo sezu owaru monogatari\kizutsukiuru yawarakasa response:	tojikometa senritsu kanaderu hodo
context: kimi wo mirai wo sukueta darou ka\taisetsu na hito wo mamoru sube ga tatta hitotsu shika motenai\sonna anata ga haguretadayou sora\anata ijou no hito ni deaenai\tsuki ni aragau nagai furea\hajimaru mo sezu owaru monogatari\kizutsukiuru yawarakasa\tojikometa senritsu kanaderu hodo response:	utau hodo kowareru hodo ni
context: taisetsu na hito wo mamoru sube ga tatta hitotsu shika motenai\sonna anata ga haguretadayou sora\anata ijou no hito ni deaenai\tsuki ni aragau nagai furea\hajimaru mo sezu owaru monogatari\kizutsukiuru yawarakasa\tojikometa senritsu kanaderu hodo\utau hodo kowareru hodo ni response:	anata ga koishii
context: sonna anata ga haguretadayou sora\anata ijou no hito ni deaenai\tsuki ni aragau nagai furea\hajimaru mo sezu owaru monogatari\kizutsukiuru yawarakasa\tojikometa senritsu kanaderu hodo\utau hodo kowareru hodo ni\anata ga koishii response:	We weren't spirited away on the wind
context: anata ijou no hito ni deaenai\tsuki ni aragau nagai furea\hajimaru mo sezu owaru monogatari\kizutsukiuru yawarakasa\tojikometa senritsu kanaderu hodo\utau hodo kowareru hodo ni\anata ga koishii\We weren't spirited away on the wind response:	We knew we could never return, and found the courage
context: tsuki ni aragau nagai furea\hajimaru mo sezu owaru monogatari\kizutsukiuru yawarakasa\tojikometa senritsu kanaderu hodo\utau hodo kowareru hodo ni\anata ga koishii\We weren't spirited away on the wind\We knew we could never return, and found the courage response:	to accept the hardship
context: hajimaru mo sezu owaru monogatari\kizutsukiuru yawarakasa\tojikometa senritsu kanaderu hodo\utau hodo kowareru hodo ni\anata ga koishii\We weren't spirited away on the wind\We knew we could never return, and found the courage\to accept the hardship response:	There's an emptiness where my heart used to be
context: kizutsukiuru yawarakasa\tojikometa senritsu kanaderu hodo\utau hodo kowareru hodo ni\anata ga koishii\We weren't spirited away on the wind\We knew we could never return, and found the courage\to accept the hardship\There's an emptiness where my heart used to be response:	If only I was stronger
context: tojikometa senritsu kanaderu hodo\utau hodo kowareru hodo ni\anata ga koishii\We weren't spirited away on the wind\We knew we could never return, and found the courage\to accept the hardship\There's an emptiness where my heart used to be\If only I was stronger response:	I could have saved you, and our future...
context: utau hodo kowareru hodo ni\anata ga koishii\We weren't spirited away on the wind\We knew we could never return, and found the courage\to accept the hardship\There's an emptiness where my heart used to be\If only I was stronger\I could have saved you, and our future... response:	I only know of one way to keep the people I love
context: anata ga koishii\We weren't spirited away on the wind\We knew we could never return, and found the courage\to accept the hardship\There's an emptiness where my heart used to be\If only I was stronger\I could have saved you, and our future...\I only know of one way to keep the people I love response:	And you left me and disappeared into the sky
context: We weren't spirited away on the wind\We knew we could never return, and found the courage\to accept the hardship\There's an emptiness where my heart used to be\If only I was stronger\I could have saved you, and our future...\I only know of one way to keep the people I love\And you left me and disappeared into the sky response:	I'll never find anyone like you again
context: We knew we could never return, and found the courage\to accept the hardship\There's an emptiness where my heart used to be\If only I was stronger\I could have saved you, and our future...\I only know of one way to keep the people I love\And you left me and disappeared into the sky\I'll never find anyone like you again response:	A long flare reaches out against the moon
context: to accept the hardship\There's an emptiness where my heart used to be\If only I was stronger\I could have saved you, and our future...\I only know of one way to keep the people I love\And you left me and disappeared into the sky\I'll never find anyone like you again\A long flare reaches out against the moon response:	The story ends before it could even begin
context: There's an emptiness where my heart used to be\If only I was stronger\I could have saved you, and our future...\I only know of one way to keep the people I love\And you left me and disappeared into the sky\I'll never find anyone like you again\A long flare reaches out against the moon\The story ends before it could even begin response:	So soft, so fragile
context: If only I was stronger\I could have saved you, and our future...\I only know of one way to keep the people I love\And you left me and disappeared into the sky\I'll never find anyone like you again\A long flare reaches out against the moon\The story ends before it could even begin\So soft, so fragile response:	I will call up the melody locked away
context: I could have saved you, and our future...\I only know of one way to keep the people I love\And you left me and disappeared into the sky\I'll never find anyone like you again\A long flare reaches out against the moon\The story ends before it could even begin\So soft, so fragile\I will call up the melody locked away response:	And sing it until I destroy myself
context: I only know of one way to keep the people I love\And you left me and disappeared into the sky\I'll never find anyone like you again\A long flare reaches out against the moon\The story ends before it could even begin\So soft, so fragile\I will call up the melody locked away\And sing it until I destroy myself response:	That's how much I love you