context: Why did you only choose students within this school for your works of art? response:	This academy is a girls' boarding school.
context: Why did you only choose students within this school for your works of art?\This academy is a girls' boarding school. response:	What do you think of their education policy, Mr. Makishima?
context: Why did you only choose students within this school for your works of art?\This academy is a girls' boarding school.\What do you think of their education policy, Mr. Makishima? response:	We were so close.
context: Why did you only choose students within this school for your works of art?\This academy is a girls' boarding school.\What do you think of their education policy, Mr. Makishima?\We were so close. response:	Ouryou Rikako has already been put on the wanted list.
context: Why did you only choose students within this school for your works of art?\This academy is a girls' boarding school.\What do you think of their education policy, Mr. Makishima?\We were so close.\Ouryou Rikako has already been put on the wanted list. response:	It's just a matter of time.
context: Why did you only choose students within this school for your works of art?\This academy is a girls' boarding school.\What do you think of their education policy, Mr. Makishima?\We were so close.\Ouryou Rikako has already been put on the wanted list.\It's just a matter of time. response:	She'll disappear.
context: Why did you only choose students within this school for your works of art?\This academy is a girls' boarding school.\What do you think of their education policy, Mr. Makishima?\We were so close.\Ouryou Rikako has already been put on the wanted list.\It's just a matter of time.\She'll disappear. response:	What?
context: Why did you only choose students within this school for your works of art?\This academy is a girls' boarding school.\What do you think of their education policy, Mr. Makishima?\We were so close.\Ouryou Rikako has already been put on the wanted list.\It's just a matter of time.\She'll disappear.\What? response:	Come with me. I'd like to talk with you.
context: This academy is a girls' boarding school.\What do you think of their education policy, Mr. Makishima?\We were so close.\Ouryou Rikako has already been put on the wanted list.\It's just a matter of time.\She'll disappear.\What?\Come with me. I'd like to talk with you. response:	What is it? If you have a problem with me, just spit it out.
context: What do you think of their education policy, Mr. Makishima?\We were so close.\Ouryou Rikako has already been put on the wanted list.\It's just a matter of time.\She'll disappear.\What?\Come with me. I'd like to talk with you.\What is it? If you have a problem with me, just spit it out. response:	I'm sorry.
context: We were so close.\Ouryou Rikako has already been put on the wanted list.\It's just a matter of time.\She'll disappear.\What?\Come with me. I'd like to talk with you.\What is it? If you have a problem with me, just spit it out.\I'm sorry. response:	It was me who got emotional. Looks like your culprit was real after all.
context: Ouryou Rikako has already been put on the wanted list.\It's just a matter of time.\She'll disappear.\What?\Come with me. I'd like to talk with you.\What is it? If you have a problem with me, just spit it out.\I'm sorry.\It was me who got emotional. Looks like your culprit was real after all. response:	Don't worry about it.
context: It's just a matter of time.\She'll disappear.\What?\Come with me. I'd like to talk with you.\What is it? If you have a problem with me, just spit it out.\I'm sorry.\It was me who got emotional. Looks like your culprit was real after all.\Don't worry about it. response:	If you took everything Enforcers said seriously, you'd be a poor Inspector.
context: She'll disappear.\What?\Come with me. I'd like to talk with you.\What is it? If you have a problem with me, just spit it out.\I'm sorry.\It was me who got emotional. Looks like your culprit was real after all.\Don't worry about it.\If you took everything Enforcers said seriously, you'd be a poor Inspector. response:	That's how it is, right?
context: What?\Come with me. I'd like to talk with you.\What is it? If you have a problem with me, just spit it out.\I'm sorry.\It was me who got emotional. Looks like your culprit was real after all.\Don't worry about it.\If you took everything Enforcers said seriously, you'd be a poor Inspector.\That's how it is, right? response:	But...
context: Come with me. I'd like to talk with you.\What is it? If you have a problem with me, just spit it out.\I'm sorry.\It was me who got emotional. Looks like your culprit was real after all.\Don't worry about it.\If you took everything Enforcers said seriously, you'd be a poor Inspector.\That's how it is, right?\But... response:	It feels like my quarry's tail just brushed the tip of my nose.
context: What is it? If you have a problem with me, just spit it out.\I'm sorry.\It was me who got emotional. Looks like your culprit was real after all.\Don't worry about it.\If you took everything Enforcers said seriously, you'd be a poor Inspector.\That's how it is, right?\But...\It feels like my quarry's tail just brushed the tip of my nose. response:	I'm feeling better than I have in a long time, Gino.
context: I'm sorry.\It was me who got emotional. Looks like your culprit was real after all.\Don't worry about it.\If you took everything Enforcers said seriously, you'd be a poor Inspector.\That's how it is, right?\But...\It feels like my quarry's tail just brushed the tip of my nose.\I'm feeling better than I have in a long time, Gino. response:	My head is full of things
context: It was me who got emotional. Looks like your culprit was real after all.\Don't worry about it.\If you took everything Enforcers said seriously, you'd be a poor Inspector.\That's how it is, right?\But...\It feels like my quarry's tail just brushed the tip of my nose.\I'm feeling better than I have in a long time, Gino.\My head is full of things response:	My head is full of things
context: Don't worry about it.\If you took everything Enforcers said seriously, you'd be a poor Inspector.\That's how it is, right?\But...\It feels like my quarry's tail just brushed the tip of my nose.\I'm feeling better than I have in a long time, Gino.\My head is full of things\My head is full of things response:	that I can never tell anybody of
context: If you took everything Enforcers said seriously, you'd be a poor Inspector.\That's how it is, right?\But...\It feels like my quarry's tail just brushed the tip of my nose.\I'm feeling better than I have in a long time, Gino.\My head is full of things\My head is full of things\that I can never tell anybody of response:	that I can never tell anybody of
context: That's how it is, right?\But...\It feels like my quarry's tail just brushed the tip of my nose.\I'm feeling better than I have in a long time, Gino.\My head is full of things\My head is full of things\that I can never tell anybody of\that I can never tell anybody of response:	In this perfect world
context: But...\It feels like my quarry's tail just brushed the tip of my nose.\I'm feeling better than I have in a long time, Gino.\My head is full of things\My head is full of things\that I can never tell anybody of\that I can never tell anybody of\In this perfect world response:	In this perfect world
context: It feels like my quarry's tail just brushed the tip of my nose.\I'm feeling better than I have in a long time, Gino.\My head is full of things\My head is full of things\that I can never tell anybody of\that I can never tell anybody of\In this perfect world\In this perfect world response:	I roam, a lost being
context: I'm feeling better than I have in a long time, Gino.\My head is full of things\My head is full of things\that I can never tell anybody of\that I can never tell anybody of\In this perfect world\In this perfect world\I roam, a lost being response:	I roam, a lost being
context: My head is full of things\My head is full of things\that I can never tell anybody of\that I can never tell anybody of\In this perfect world\In this perfect world\I roam, a lost being\I roam, a lost being response:	This world is impossibly hard on me
context: My head is full of things\that I can never tell anybody of\that I can never tell anybody of\In this perfect world\In this perfect world\I roam, a lost being\I roam, a lost being\This world is impossibly hard on me response:	This world is impossibly hard on me
context: that I can never tell anybody of\that I can never tell anybody of\In this perfect world\In this perfect world\I roam, a lost being\I roam, a lost being\This world is impossibly hard on me\This world is impossibly hard on me response:	It's an illusion that plays out before my eyes
context: that I can never tell anybody of\In this perfect world\In this perfect world\I roam, a lost being\I roam, a lost being\This world is impossibly hard on me\This world is impossibly hard on me\It's an illusion that plays out before my eyes response:	It's an illusion that plays out before my eyes
context: In this perfect world\In this perfect world\I roam, a lost being\I roam, a lost being\This world is impossibly hard on me\This world is impossibly hard on me\It's an illusion that plays out before my eyes\It's an illusion that plays out before my eyes response:	Can I find its faults?
context: In this perfect world\I roam, a lost being\I roam, a lost being\This world is impossibly hard on me\This world is impossibly hard on me\It's an illusion that plays out before my eyes\It's an illusion that plays out before my eyes\Can I find its faults? response:	Can I find its faults?
context: I roam, a lost being\I roam, a lost being\This world is impossibly hard on me\This world is impossibly hard on me\It's an illusion that plays out before my eyes\It's an illusion that plays out before my eyes\Can I find its faults?\Can I find its faults? response:	Plastic, all is plastic
context: I roam, a lost being\This world is impossibly hard on me\This world is impossibly hard on me\It's an illusion that plays out before my eyes\It's an illusion that plays out before my eyes\Can I find its faults?\Can I find its faults?\Plastic, all is plastic response:	Plastic, all is plastic
context: This world is impossibly hard on me\This world is impossibly hard on me\It's an illusion that plays out before my eyes\It's an illusion that plays out before my eyes\Can I find its faults?\Can I find its faults?\Plastic, all is plastic\Plastic, all is plastic response:	Nobody is allowed to be insane
context: This world is impossibly hard on me\It's an illusion that plays out before my eyes\It's an illusion that plays out before my eyes\Can I find its faults?\Can I find its faults?\Plastic, all is plastic\Plastic, all is plastic\Nobody is allowed to be insane response:	Nobody is allowed to be insane
context: It's an illusion that plays out before my eyes\It's an illusion that plays out before my eyes\Can I find its faults?\Can I find its faults?\Plastic, all is plastic\Plastic, all is plastic\Nobody is allowed to be insane\Nobody is allowed to be insane response:	You're made of plastic too, like this beautiful world
context: It's an illusion that plays out before my eyes\Can I find its faults?\Can I find its faults?\Plastic, all is plastic\Plastic, all is plastic\Nobody is allowed to be insane\Nobody is allowed to be insane\You're made of plastic too, like this beautiful world response:	You're made of plastic too, like this beautiful world
context: Can I find its faults?\Can I find its faults?\Plastic, all is plastic\Plastic, all is plastic\Nobody is allowed to be insane\Nobody is allowed to be insane\You're made of plastic too, like this beautiful world\You're made of plastic too, like this beautiful world response:	In this beautiful world
context: Can I find its faults?\Plastic, all is plastic\Plastic, all is plastic\Nobody is allowed to be insane\Nobody is allowed to be insane\You're made of plastic too, like this beautiful world\You're made of plastic too, like this beautiful world\In this beautiful world response:	In this beautiful world
context: Plastic, all is plastic\Plastic, all is plastic\Nobody is allowed to be insane\Nobody is allowed to be insane\You're made of plastic too, like this beautiful world\You're made of plastic too, like this beautiful world\In this beautiful world\In this beautiful world response:	there is something
context: Plastic, all is plastic\Nobody is allowed to be insane\Nobody is allowed to be insane\You're made of plastic too, like this beautiful world\You're made of plastic too, like this beautiful world\In this beautiful world\In this beautiful world\there is something response:	there is something
context: Nobody is allowed to be insane\Nobody is allowed to be insane\You're made of plastic too, like this beautiful world\You're made of plastic too, like this beautiful world\In this beautiful world\In this beautiful world\there is something\there is something response:	that obscures all light for me
context: Nobody is allowed to be insane\You're made of plastic too, like this beautiful world\You're made of plastic too, like this beautiful world\In this beautiful world\In this beautiful world\there is something\there is something\that obscures all light for me response:	that obscures all light for me
context: You're made of plastic too, like this beautiful world\You're made of plastic too, like this beautiful world\In this beautiful world\In this beautiful world\there is something\there is something\that obscures all light for me\that obscures all light for me response:	My heart tries to break out
context: You're made of plastic too, like this beautiful world\In this beautiful world\In this beautiful world\there is something\there is something\that obscures all light for me\that obscures all light for me\My heart tries to break out response:	My heart tries to break out
context: In this beautiful world\In this beautiful world\there is something\there is something\that obscures all light for me\that obscures all light for me\My heart tries to break out\My heart tries to break out response:	and finds no answer
context: In this beautiful world\there is something\there is something\that obscures all light for me\that obscures all light for me\My heart tries to break out\My heart tries to break out\and finds no answer response:	and finds no answer
context: there is something\there is something\that obscures all light for me\that obscures all light for me\My heart tries to break out\My heart tries to break out\and finds no answer\and finds no answer response:	Secret kills for you
context: there is something\that obscures all light for me\that obscures all light for me\My heart tries to break out\My heart tries to break out\and finds no answer\and finds no answer\Secret kills for you response:	Secret kills for you
context: that obscures all light for me\that obscures all light for me\My heart tries to break out\My heart tries to break out\and finds no answer\and finds no answer\Secret kills for you\Secret kills for you response:	Secret kills for you
context: that obscures all light for me\My heart tries to break out\My heart tries to break out\and finds no answer\and finds no answer\Secret kills for you\Secret kills for you\Secret kills for you response:	Secret kills for you
context: My heart tries to break out\My heart tries to break out\and finds no answer\and finds no answer\Secret kills for you\Secret kills for you\Secret kills for you\Secret kills for you response:	The secret remains for you
context: My heart tries to break out\and finds no answer\and finds no answer\Secret kills for you\Secret kills for you\Secret kills for you\Secret kills for you\The secret remains for you response:	The secret remains for you
context: and finds no answer\and finds no answer\Secret kills for you\Secret kills for you\Secret kills for you\Secret kills for you\The secret remains for you\The secret remains for you response:	Don't show me a dark future
context: and finds no answer\Secret kills for you\Secret kills for you\Secret kills for you\Secret kills for you\The secret remains for you\The secret remains for you\Don't show me a dark future response:	Don't show me a dark future
context: Secret kills for you\Secret kills for you\Secret kills for you\Secret kills for you\The secret remains for you\The secret remains for you\Don't show me a dark future\Don't show me a dark future response:	nor a world of pretense
context: Secret kills for you\Secret kills for you\Secret kills for you\The secret remains for you\The secret remains for you\Don't show me a dark future\Don't show me a dark future\nor a world of pretense response:	nor a world of pretense
context: Secret kills for you\Secret kills for you\The secret remains for you\The secret remains for you\Don't show me a dark future\Don't show me a dark future\nor a world of pretense\nor a world of pretense response:	Keep our motion secret
context: Secret kills for you\The secret remains for you\The secret remains for you\Don't show me a dark future\Don't show me a dark future\nor a world of pretense\nor a world of pretense\Keep our motion secret response:	Keep our motion secret
context: The secret remains for you\The secret remains for you\Don't show me a dark future\Don't show me a dark future\nor a world of pretense\nor a world of pretense\Keep our motion secret\Keep our motion secret response:	09: Paradise Fruit
context: The secret remains for you\Don't show me a dark future\Don't show me a dark future\nor a world of pretense\nor a world of pretense\Keep our motion secret\Keep our motion secret\09: Paradise Fruit response:	Okay.
context: Don't show me a dark future\Don't show me a dark future\nor a world of pretense\nor a world of pretense\Keep our motion secret\Keep our motion secret\09: Paradise Fruit\Okay. response:	Have you decided?
context: Don't show me a dark future\nor a world of pretense\nor a world of pretense\Keep our motion secret\Keep our motion secret\09: Paradise Fruit\Okay.\Have you decided? response:	Yep.
context: nor a world of pretense\nor a world of pretense\Keep our motion secret\Keep our motion secret\09: Paradise Fruit\Okay.\Have you decided?\Yep. response:	Add this outfit to my favorites.
context: nor a world of pretense\Keep our motion secret\Keep our motion secret\09: Paradise Fruit\Okay.\Have you decided?\Yep.\Add this outfit to my favorites. response:	Roger!
context: Keep our motion secret\Keep our motion secret\09: Paradise Fruit\Okay.\Have you decided?\Yep.\Add this outfit to my favorites.\Roger! response:	Oh! Do you have a date?
context: Keep our motion secret\09: Paradise Fruit\Okay.\Have you decided?\Yep.\Add this outfit to my favorites.\Roger!\Oh! Do you have a date? response:	I-It's not like that!
context: 09: Paradise Fruit\Okay.\Have you decided?\Yep.\Add this outfit to my favorites.\Roger!\Oh! Do you have a date?\I-It's not like that! response:	Holo team! Use the pattern that we discussed yesterday!
context: Okay.\Have you decided?\Yep.\Add this outfit to my favorites.\Roger!\Oh! Do you have a date?\I-It's not like that!\Holo team! Use the pattern that we discussed yesterday! response:	Provided by the Cyberization Health Bureau, Ministry of Welfare
context: Have you decided?\Yep.\Add this outfit to my favorites.\Roger!\Oh! Do you have a date?\I-It's not like that!\Holo team! Use the pattern that we discussed yesterday!\Provided by the Cyberization Health Bureau, Ministry of Welfare response:	Advanced Medical Treatments of the Future That Will Change Your Life
context: Yep.\Add this outfit to my favorites.\Roger!\Oh! Do you have a date?\I-It's not like that!\Holo team! Use the pattern that we discussed yesterday!\Provided by the Cyberization Health Bureau, Ministry of Welfare\Advanced Medical Treatments of the Future That Will Change Your Life response:	Okay!
context: Add this outfit to my favorites.\Roger!\Oh! Do you have a date?\I-It's not like that!\Holo team! Use the pattern that we discussed yesterday!\Provided by the Cyberization Health Bureau, Ministry of Welfare\Advanced Medical Treatments of the Future That Will Change Your Life\Okay! response:	Hmm... I'm not sure...
context: Roger!\Oh! Do you have a date?\I-It's not like that!\Holo team! Use the pattern that we discussed yesterday!\Provided by the Cyberization Health Bureau, Ministry of Welfare\Advanced Medical Treatments of the Future That Will Change Your Life\Okay!\Hmm... I'm not sure... response:	Isn't it a little too flashy? People might feel it's tacky instead.
context: Oh! Do you have a date?\I-It's not like that!\Holo team! Use the pattern that we discussed yesterday!\Provided by the Cyberization Health Bureau, Ministry of Welfare\Advanced Medical Treatments of the Future That Will Change Your Life\Okay!\Hmm... I'm not sure...\Isn't it a little too flashy? People might feel it's tacky instead. response:	Well, we can try some other patterns as well.
context: I-It's not like that!\Holo team! Use the pattern that we discussed yesterday!\Provided by the Cyberization Health Bureau, Ministry of Welfare\Advanced Medical Treatments of the Future That Will Change Your Life\Okay!\Hmm... I'm not sure...\Isn't it a little too flashy? People might feel it's tacky instead.\Well, we can try some other patterns as well. response:	How about getting a present for your date?
context: Holo team! Use the pattern that we discussed yesterday!\Provided by the Cyberization Health Bureau, Ministry of Welfare\Advanced Medical Treatments of the Future That Will Change Your Life\Okay!\Hmm... I'm not sure...\Isn't it a little too flashy? People might feel it's tacky instead.\Well, we can try some other patterns as well.\How about getting a present for your date? response:	Also, I could arrange a bouquet to be delivered
context: Provided by the Cyberization Health Bureau, Ministry of Welfare\Advanced Medical Treatments of the Future That Will Change Your Life\Okay!\Hmm... I'm not sure...\Isn't it a little too flashy? People might feel it's tacky instead.\Well, we can try some other patterns as well.\How about getting a present for your date?\Also, I could arrange a bouquet to be delivered response:	Didn't I just say it's not like that?!
context: Advanced Medical Treatments of the Future That Will Change Your Life\Okay!\Hmm... I'm not sure...\Isn't it a little too flashy? People might feel it's tacky instead.\Well, we can try some other patterns as well.\How about getting a present for your date?\Also, I could arrange a bouquet to be delivered\Didn't I just say it's not like that?! response:	Cancel! Delete memory!
context: Okay!\Hmm... I'm not sure...\Isn't it a little too flashy? People might feel it's tacky instead.\Well, we can try some other patterns as well.\How about getting a present for your date?\Also, I could arrange a bouquet to be delivered\Didn't I just say it's not like that?!\Cancel! Delete memory! response:	As you wish. Speculation circuit will be reset!
context: Hmm... I'm not sure...\Isn't it a little too flashy? People might feel it's tacky instead.\Well, we can try some other patterns as well.\How about getting a present for your date?\Also, I could arrange a bouquet to be delivered\Didn't I just say it's not like that?!\Cancel! Delete memory!\As you wish. Speculation circuit will be reset! response:	Candy, turn on some news.
context: Isn't it a little too flashy? People might feel it's tacky instead.\Well, we can try some other patterns as well.\How about getting a present for your date?\Also, I could arrange a bouquet to be delivered\Didn't I just say it's not like that?!\Cancel! Delete memory!\As you wish. Speculation circuit will be reset!\Candy, turn on some news. response:	The Ministry of Welfare uploaded a recommended video.
context: Well, we can try some other patterns as well.\How about getting a present for your date?\Also, I could arrange a bouquet to be delivered\Didn't I just say it's not like that?!\Cancel! Delete memory!\As you wish. Speculation circuit will be reset!\Candy, turn on some news.\The Ministry of Welfare uploaded a recommended video. response:	Then play that one.
context: How about getting a present for your date?\Also, I could arrange a bouquet to be delivered\Didn't I just say it's not like that?!\Cancel! Delete memory!\As you wish. Speculation circuit will be reset!\Candy, turn on some news.\The Ministry of Welfare uploaded a recommended video.\Then play that one. response:	Today, we have Mr. Senguji Toyohisa, a pioneer of whole-body cyberization
context: Also, I could arrange a bouquet to be delivered\Didn't I just say it's not like that?!\Cancel! Delete memory!\As you wish. Speculation circuit will be reset!\Candy, turn on some news.\The Ministry of Welfare uploaded a recommended video.\Then play that one.\Today, we have Mr. Senguji Toyohisa, a pioneer of whole-body cyberization response:	and chairman of the Teito Network Construction Corporation,
context: Didn't I just say it's not like that?!\Cancel! Delete memory!\As you wish. Speculation circuit will be reset!\Candy, turn on some news.\The Ministry of Welfare uploaded a recommended video.\Then play that one.\Today, we have Mr. Senguji Toyohisa, a pioneer of whole-body cyberization\and chairman of the Teito Network Construction Corporation, response:	a company that works on underground redevelopment.
context: Cancel! Delete memory!\As you wish. Speculation circuit will be reset!\Candy, turn on some news.\The Ministry of Welfare uploaded a recommended video.\Then play that one.\Today, we have Mr. Senguji Toyohisa, a pioneer of whole-body cyberization\and chairman of the Teito Network Construction Corporation,\a company that works on underground redevelopment. response:	Chairman of the Teito Network Construction Corporation
context: As you wish. Speculation circuit will be reset!\Candy, turn on some news.\The Ministry of Welfare uploaded a recommended video.\Then play that one.\Today, we have Mr. Senguji Toyohisa, a pioneer of whole-body cyberization\and chairman of the Teito Network Construction Corporation,\a company that works on underground redevelopment.\Chairman of the Teito Network Construction Corporation response:	Chairman of the Teito Network Construction Corporation
context: Candy, turn on some news.\The Ministry of Welfare uploaded a recommended video.\Then play that one.\Today, we have Mr. Senguji Toyohisa, a pioneer of whole-body cyberization\and chairman of the Teito Network Construction Corporation,\a company that works on underground redevelopment.\Chairman of the Teito Network Construction Corporation\Chairman of the Teito Network Construction Corporation response:	Senguji Toyohisa
context: The Ministry of Welfare uploaded a recommended video.\Then play that one.\Today, we have Mr. Senguji Toyohisa, a pioneer of whole-body cyberization\and chairman of the Teito Network Construction Corporation,\a company that works on underground redevelopment.\Chairman of the Teito Network Construction Corporation\Chairman of the Teito Network Construction Corporation\Senguji Toyohisa response:	Senguji Toyohisa
context: Then play that one.\Today, we have Mr. Senguji Toyohisa, a pioneer of whole-body cyberization\and chairman of the Teito Network Construction Corporation,\a company that works on underground redevelopment.\Chairman of the Teito Network Construction Corporation\Chairman of the Teito Network Construction Corporation\Senguji Toyohisa\Senguji Toyohisa response:	Thanks for having me.
context: Today, we have Mr. Senguji Toyohisa, a pioneer of whole-body cyberization\and chairman of the Teito Network Construction Corporation,\a company that works on underground redevelopment.\Chairman of the Teito Network Construction Corporation\Chairman of the Teito Network Construction Corporation\Senguji Toyohisa\Senguji Toyohisa\Thanks for having me. response:	The use of cyborg technology for medical purposes is now commonplace.
context: and chairman of the Teito Network Construction Corporation,\a company that works on underground redevelopment.\Chairman of the Teito Network Construction Corporation\Chairman of the Teito Network Construction Corporation\Senguji Toyohisa\Senguji Toyohisa\Thanks for having me.\The use of cyborg technology for medical purposes is now commonplace. response:	However, it's still rare to see someone like Chairman Senguji who,
context: a company that works on underground redevelopment.\Chairman of the Teito Network Construction Corporation\Chairman of the Teito Network Construction Corporation\Senguji Toyohisa\Senguji Toyohisa\Thanks for having me.\The use of cyborg technology for medical purposes is now commonplace.\However, it's still rare to see someone like Chairman Senguji who, response:	except for his brain and nervous system, is entirely cybernetic.
context: Chairman of the Teito Network Construction Corporation\Chairman of the Teito Network Construction Corporation\Senguji Toyohisa\Senguji Toyohisa\Thanks for having me.\The use of cyborg technology for medical purposes is now commonplace.\However, it's still rare to see someone like Chairman Senguji who,\except for his brain and nervous system, is entirely cybernetic. response:	It's a mystery to me why other people haven't given up those limiting bodies of theirs.
context: Chairman of the Teito Network Construction Corporation\Senguji Toyohisa\Senguji Toyohisa\Thanks for having me.\The use of cyborg technology for medical purposes is now commonplace.\However, it's still rare to see someone like Chairman Senguji who,\except for his brain and nervous system, is entirely cybernetic.\It's a mystery to me why other people haven't given up those limiting bodies of theirs. response:	Limiting, you say?
context: Senguji Toyohisa\Senguji Toyohisa\Thanks for having me.\The use of cyborg technology for medical purposes is now commonplace.\However, it's still rare to see someone like Chairman Senguji who,\except for his brain and nervous system, is entirely cybernetic.\It's a mystery to me why other people haven't given up those limiting bodies of theirs.\Limiting, you say? response:	Plato said that our souls were imprisoned in our bodies.
context: Senguji Toyohisa\Thanks for having me.\The use of cyborg technology for medical purposes is now commonplace.\However, it's still rare to see someone like Chairman Senguji who,\except for his brain and nervous system, is entirely cybernetic.\It's a mystery to me why other people haven't given up those limiting bodies of theirs.\Limiting, you say?\Plato said that our souls were imprisoned in our bodies. response:	You seem to be in a bad mood already, Kougami.
context: Thanks for having me.\The use of cyborg technology for medical purposes is now commonplace.\However, it's still rare to see someone like Chairman Senguji who,\except for his brain and nervous system, is entirely cybernetic.\It's a mystery to me why other people haven't given up those limiting bodies of theirs.\Limiting, you say?\Plato said that our souls were imprisoned in our bodies.\You seem to be in a bad mood already, Kougami. response:	When I tried to smoke, that thing tried to bite me.
context: The use of cyborg technology for medical purposes is now commonplace.\However, it's still rare to see someone like Chairman Senguji who,\except for his brain and nervous system, is entirely cybernetic.\It's a mystery to me why other people haven't given up those limiting bodies of theirs.\Limiting, you say?\Plato said that our souls were imprisoned in our bodies.\You seem to be in a bad mood already, Kougami.\When I tried to smoke, that thing tried to bite me. response:	What's your problem?!
context: However, it's still rare to see someone like Chairman Senguji who,\except for his brain and nervous system, is entirely cybernetic.\It's a mystery to me why other people haven't given up those limiting bodies of theirs.\Limiting, you say?\Plato said that our souls were imprisoned in our bodies.\You seem to be in a bad mood already, Kougami.\When I tried to smoke, that thing tried to bite me.\What's your problem?! response:	What was that about? Geez...
context: except for his brain and nervous system, is entirely cybernetic.\It's a mystery to me why other people haven't given up those limiting bodies of theirs.\Limiting, you say?\Plato said that our souls were imprisoned in our bodies.\You seem to be in a bad mood already, Kougami.\When I tried to smoke, that thing tried to bite me.\What's your problem?!\What was that about? Geez... response:	Sorry.
context: It's a mystery to me why other people haven't given up those limiting bodies of theirs.\Limiting, you say?\Plato said that our souls were imprisoned in our bodies.\You seem to be in a bad mood already, Kougami.\When I tried to smoke, that thing tried to bite me.\What's your problem?!\What was that about? Geez...\Sorry. response:	Hmm?
context: Limiting, you say?\Plato said that our souls were imprisoned in our bodies.\You seem to be in a bad mood already, Kougami.\When I tried to smoke, that thing tried to bite me.\What's your problem?!\What was that about? Geez...\Sorry.\Hmm? response:	Well, please don't worry about it. I'm curious too, so I don't mind.
context: Plato said that our souls were imprisoned in our bodies.\You seem to be in a bad mood already, Kougami.\When I tried to smoke, that thing tried to bite me.\What's your problem?!\What was that about? Geez...\Sorry.\Hmm?\Well, please don't worry about it. I'm curious too, so I don't mind. response:	I'm finding new pleasures in my life all the time.
context: You seem to be in a bad mood already, Kougami.\When I tried to smoke, that thing tried to bite me.\What's your problem?!\What was that about? Geez...\Sorry.\Hmm?\Well, please don't worry about it. I'm curious too, so I don't mind.\I'm finding new pleasures in my life all the time. response:	I never expected that overcoming aging would lead to such happiness.
context: When I tried to smoke, that thing tried to bite me.\What's your problem?!\What was that about? Geez...\Sorry.\Hmm?\Well, please don't worry about it. I'm curious too, so I don't mind.\I'm finding new pleasures in my life all the time.\I never expected that overcoming aging would lead to such happiness. response:	It's the kind of thing you can't understand until you have a cybernetic body yourself.
context: What's your problem?!\What was that about? Geez...\Sorry.\Hmm?\Well, please don't worry about it. I'm curious too, so I don't mind.\I'm finding new pleasures in my life all the time.\I never expected that overcoming aging would lead to such happiness.\It's the kind of thing you can't understand until you have a cybernetic body yourself. response:	But even with the latest technology,
context: What was that about? Geez...\Sorry.\Hmm?\Well, please don't worry about it. I'm curious too, so I don't mind.\I'm finding new pleasures in my life all the time.\I never expected that overcoming aging would lead to such happiness.\It's the kind of thing you can't understand until you have a cybernetic body yourself.\But even with the latest technology, response:	it's estimated that the brain's lifespan is about 150 years at most.
context: Sorry.\Hmm?\Well, please don't worry about it. I'm curious too, so I don't mind.\I'm finding new pleasures in my life all the time.\I never expected that overcoming aging would lead to such happiness.\It's the kind of thing you can't understand until you have a cybernetic body yourself.\But even with the latest technology,\it's estimated that the brain's lifespan is about 150 years at most. response:	I hear that we're still quite a ways away from complete cyberization of the brain.
context: Hmm?\Well, please don't worry about it. I'm curious too, so I don't mind.\I'm finding new pleasures in my life all the time.\I never expected that overcoming aging would lead to such happiness.\It's the kind of thing you can't understand until you have a cybernetic body yourself.\But even with the latest technology,\it's estimated that the brain's lifespan is about 150 years at most.\I hear that we're still quite a ways away from complete cyberization of the brain. response:	If I take my brain to its limits, I can squeeze a bit more life out of it.
context: Well, please don't worry about it. I'm curious too, so I don't mind.\I'm finding new pleasures in my life all the time.\I never expected that overcoming aging would lead to such happiness.\It's the kind of thing you can't understand until you have a cybernetic body yourself.\But even with the latest technology,\it's estimated that the brain's lifespan is about 150 years at most.\I hear that we're still quite a ways away from complete cyberization of the brain.\If I take my brain to its limits, I can squeeze a bit more life out of it. response:	So I'm counting on them to find a breakthrough in the meantime.
context: I'm finding new pleasures in my life all the time.\I never expected that overcoming aging would lead to such happiness.\It's the kind of thing you can't understand until you have a cybernetic body yourself.\But even with the latest technology,\it's estimated that the brain's lifespan is about 150 years at most.\I hear that we're still quite a ways away from complete cyberization of the brain.\If I take my brain to its limits, I can squeeze a bit more life out of it.\So I'm counting on them to find a breakthrough in the meantime. response:	I see. If that actually happens, then...
context: I never expected that overcoming aging would lead to such happiness.\It's the kind of thing you can't understand until you have a cybernetic body yourself.\But even with the latest technology,\it's estimated that the brain's lifespan is about 150 years at most.\I hear that we're still quite a ways away from complete cyberization of the brain.\If I take my brain to its limits, I can squeeze a bit more life out of it.\So I'm counting on them to find a breakthrough in the meantime.\I see. If that actually happens, then... response:	That's right.
context: It's the kind of thing you can't understand until you have a cybernetic body yourself.\But even with the latest technology,\it's estimated that the brain's lifespan is about 150 years at most.\I hear that we're still quite a ways away from complete cyberization of the brain.\If I take my brain to its limits, I can squeeze a bit more life out of it.\So I'm counting on them to find a breakthrough in the meantime.\I see. If that actually happens, then...\That's right. response:	The era of immortality will have arrived.
context: But even with the latest technology,\it's estimated that the brain's lifespan is about 150 years at most.\I hear that we're still quite a ways away from complete cyberization of the brain.\If I take my brain to its limits, I can squeeze a bit more life out of it.\So I'm counting on them to find a breakthrough in the meantime.\I see. If that actually happens, then...\That's right.\The era of immortality will have arrived. response:	It's said that God created man in his own image.
context: it's estimated that the brain's lifespan is about 150 years at most.\I hear that we're still quite a ways away from complete cyberization of the brain.\If I take my brain to its limits, I can squeeze a bit more life out of it.\So I'm counting on them to find a breakthrough in the meantime.\I see. If that actually happens, then...\That's right.\The era of immortality will have arrived.\It's said that God created man in his own image. response:	Isn't it about time for us humans to become a little more like God?
context: I hear that we're still quite a ways away from complete cyberization of the brain.\If I take my brain to its limits, I can squeeze a bit more life out of it.\So I'm counting on them to find a breakthrough in the meantime.\I see. If that actually happens, then...\That's right.\The era of immortality will have arrived.\It's said that God created man in his own image.\Isn't it about time for us humans to become a little more like God? response:	What do you think about gaining eternal youth and immortality by becoming a cyborg?
context: If I take my brain to its limits, I can squeeze a bit more life out of it.\So I'm counting on them to find a breakthrough in the meantime.\I see. If that actually happens, then...\That's right.\The era of immortality will have arrived.\It's said that God created man in his own image.\Isn't it about time for us humans to become a little more like God?\What do you think about gaining eternal youth and immortality by becoming a cyborg? response:	I'm not interested.
context: So I'm counting on them to find a breakthrough in the meantime.\I see. If that actually happens, then...\That's right.\The era of immortality will have arrived.\It's said that God created man in his own image.\Isn't it about time for us humans to become a little more like God?\What do you think about gaining eternal youth and immortality by becoming a cyborg?\I'm not interested. response:	Life as a latent criminal isn't the sort of thing you'd want to go on forever.
context: I see. If that actually happens, then...\That's right.\The era of immortality will have arrived.\It's said that God created man in his own image.\Isn't it about time for us humans to become a little more like God?\What do you think about gaining eternal youth and immortality by becoming a cyborg?\I'm not interested.\Life as a latent criminal isn't the sort of thing you'd want to go on forever. response:	But... As society progresses, the rights of latent criminals may improve.
context: That's right.\The era of immortality will have arrived.\It's said that God created man in his own image.\Isn't it about time for us humans to become a little more like God?\What do you think about gaining eternal youth and immortality by becoming a cyborg?\I'm not interested.\Life as a latent criminal isn't the sort of thing you'd want to go on forever.\But... As society progresses, the rights of latent criminals may improve. response:	No wonder your Psycho-Pass always manages to stay so clear.
context: The era of immortality will have arrived.\It's said that God created man in his own image.\Isn't it about time for us humans to become a little more like God?\What do you think about gaining eternal youth and immortality by becoming a cyborg?\I'm not interested.\Life as a latent criminal isn't the sort of thing you'd want to go on forever.\But... As society progresses, the rights of latent criminals may improve.\No wonder your Psycho-Pass always manages to stay so clear. response:	According to a survey,
context: It's said that God created man in his own image.\Isn't it about time for us humans to become a little more like God?\What do you think about gaining eternal youth and immortality by becoming a cyborg?\I'm not interested.\Life as a latent criminal isn't the sort of thing you'd want to go on forever.\But... As society progresses, the rights of latent criminals may improve.\No wonder your Psycho-Pass always manages to stay so clear.\According to a survey, response:	it seems that a majority of people have answered that they feel reluctant to be more than 50 cyborg.
context: Isn't it about time for us humans to become a little more like God?\What do you think about gaining eternal youth and immortality by becoming a cyborg?\I'm not interested.\Life as a latent criminal isn't the sort of thing you'd want to go on forever.\But... As society progresses, the rights of latent criminals may improve.\No wonder your Psycho-Pass always manages to stay so clear.\According to a survey,\it seems that a majority of people have answered that they feel reluctant to be more than 50 cyborg. response:	I do understand the reluctance that those people feel.
context: What do you think about gaining eternal youth and immortality by becoming a cyborg?\I'm not interested.\Life as a latent criminal isn't the sort of thing you'd want to go on forever.\But... As society progresses, the rights of latent criminals may improve.\No wonder your Psycho-Pass always manages to stay so clear.\According to a survey,\it seems that a majority of people have answered that they feel reluctant to be more than 50 cyborg.\I do understand the reluctance that those people feel. response:	In the end, it's a matter of degree.
context: I'm not interested.\Life as a latent criminal isn't the sort of thing you'd want to go on forever.\But... As society progresses, the rights of latent criminals may improve.\No wonder your Psycho-Pass always manages to stay so clear.\According to a survey,\it seems that a majority of people have answered that they feel reluctant to be more than 50 cyborg.\I do understand the reluctance that those people feel.\In the end, it's a matter of degree. response:	For example, take yourself.
context: Life as a latent criminal isn't the sort of thing you'd want to go on forever.\But... As society progresses, the rights of latent criminals may improve.\No wonder your Psycho-Pass always manages to stay so clear.\According to a survey,\it seems that a majority of people have answered that they feel reluctant to be more than 50 cyborg.\I do understand the reluctance that those people feel.\In the end, it's a matter of degree.\For example, take yourself. response:	You're quite the cyborg too.
context: But... As society progresses, the rights of latent criminals may improve.\No wonder your Psycho-Pass always manages to stay so clear.\According to a survey,\it seems that a majority of people have answered that they feel reluctant to be more than 50 cyborg.\I do understand the reluctance that those people feel.\In the end, it's a matter of degree.\For example, take yourself.\You're quite the cyborg too. response:	But I don't use artificial arms, legs, or organs.
context: No wonder your Psycho-Pass always manages to stay so clear.\According to a survey,\it seems that a majority of people have answered that they feel reluctant to be more than 50 cyborg.\I do understand the reluctance that those people feel.\In the end, it's a matter of degree.\For example, take yourself.\You're quite the cyborg too.\But I don't use artificial arms, legs, or organs. response:	You do, however, carry some form of portable information terminal, am I right?
context: According to a survey,\it seems that a majority of people have answered that they feel reluctant to be more than 50 cyborg.\I do understand the reluctance that those people feel.\In the end, it's a matter of degree.\For example, take yourself.\You're quite the cyborg too.\But I don't use artificial arms, legs, or organs.\You do, however, carry some form of portable information terminal, am I right? response:	Well, yes... but doesn't everyone?
context: it seems that a majority of people have answered that they feel reluctant to be more than 50 cyborg.\I do understand the reluctance that those people feel.\In the end, it's a matter of degree.\For example, take yourself.\You're quite the cyborg too.\But I don't use artificial arms, legs, or organs.\You do, however, carry some form of portable information terminal, am I right?\Well, yes... but doesn't everyone? response:	A costume device, too?
context: I do understand the reluctance that those people feel.\In the end, it's a matter of degree.\For example, take yourself.\You're quite the cyborg too.\But I don't use artificial arms, legs, or organs.\You do, however, carry some form of portable information terminal, am I right?\Well, yes... but doesn't everyone?\A costume device, too? response:	Of course.
context: In the end, it's a matter of degree.\For example, take yourself.\You're quite the cyborg too.\But I don't use artificial arms, legs, or organs.\You do, however, carry some form of portable information terminal, am I right?\Well, yes... but doesn't everyone?\A costume device, too?\Of course. response:	And at home, you probably have home automation and an AI secretary.
context: For example, take yourself.\You're quite the cyborg too.\But I don't use artificial arms, legs, or organs.\You do, however, carry some form of portable information terminal, am I right?\Well, yes... but doesn't everyone?\A costume device, too?\Of course.\And at home, you probably have home automation and an AI secretary. response:	Yes.
context: You're quite the cyborg too.\But I don't use artificial arms, legs, or organs.\You do, however, carry some form of portable information terminal, am I right?\Well, yes... but doesn't everyone?\A costume device, too?\Of course.\And at home, you probably have home automation and an AI secretary.\Yes. response:	What would happen to you if all the data in those devices was lost due to some kind of disaster or accident?
context: But I don't use artificial arms, legs, or organs.\You do, however, carry some form of portable information terminal, am I right?\Well, yes... but doesn't everyone?\A costume device, too?\Of course.\And at home, you probably have home automation and an AI secretary.\Yes.\What would happen to you if all the data in those devices was lost due to some kind of disaster or accident? response:	Well...
context: You do, however, carry some form of portable information terminal, am I right?\Well, yes... but doesn't everyone?\A costume device, too?\Of course.\And at home, you probably have home automation and an AI secretary.\Yes.\What would happen to you if all the data in those devices was lost due to some kind of disaster or accident?\Well... response:	I wouldn't be able to do any work until it was restored.
context: Well, yes... but doesn't everyone?\A costume device, too?\Of course.\And at home, you probably have home automation and an AI secretary.\Yes.\What would happen to you if all the data in those devices was lost due to some kind of disaster or accident?\Well...\I wouldn't be able to do any work until it was restored. response:	When you entrust so much of your everyday life to those electronic devices,
context: A costume device, too?\Of course.\And at home, you probably have home automation and an AI secretary.\Yes.\What would happen to you if all the data in those devices was lost due to some kind of disaster or accident?\Well...\I wouldn't be able to do any work until it was restored.\When you entrust so much of your everyday life to those electronic devices, response:	the argument that you're not a cyborg isn't very convincing.
context: Of course.\And at home, you probably have home automation and an AI secretary.\Yes.\What would happen to you if all the data in those devices was lost due to some kind of disaster or accident?\Well...\I wouldn't be able to do any work until it was restored.\When you entrust so much of your everyday life to those electronic devices,\the argument that you're not a cyborg isn't very convincing. response:	To you, those portable terminals are already your second brain.
context: And at home, you probably have home automation and an AI secretary.\Yes.\What would happen to you if all the data in those devices was lost due to some kind of disaster or accident?\Well...\I wouldn't be able to do any work until it was restored.\When you entrust so much of your everyday life to those electronic devices,\the argument that you're not a cyborg isn't very convincing.\To you, those portable terminals are already your second brain. response:	Isn't that right?
context: Yes.\What would happen to you if all the data in those devices was lost due to some kind of disaster or accident?\Well...\I wouldn't be able to do any work until it was restored.\When you entrust so much of your everyday life to those electronic devices,\the argument that you're not a cyborg isn't very convincing.\To you, those portable terminals are already your second brain.\Isn't that right? response:	It can be said that the history of science is a history of the expansion of the human body's functionality.
context: What would happen to you if all the data in those devices was lost due to some kind of disaster or accident?\Well...\I wouldn't be able to do any work until it was restored.\When you entrust so much of your everyday life to those electronic devices,\the argument that you're not a cyborg isn't very convincing.\To you, those portable terminals are already your second brain.\Isn't that right?\It can be said that the history of science is a history of the expansion of the human body's functionality. response:	In other words, the history of man's cyberization.
context: Well...\I wouldn't be able to do any work until it was restored.\When you entrust so much of your everyday life to those electronic devices,\the argument that you're not a cyborg isn't very convincing.\To you, those portable terminals are already your second brain.\Isn't that right?\It can be said that the history of science is a history of the expansion of the human body's functionality.\In other words, the history of man's cyberization. response:	That's why it's a matter of degree.
context: I wouldn't be able to do any work until it was restored.\When you entrust so much of your everyday life to those electronic devices,\the argument that you're not a cyborg isn't very convincing.\To you, those portable terminals are already your second brain.\Isn't that right?\It can be said that the history of science is a history of the expansion of the human body's functionality.\In other words, the history of man's cyberization.\That's why it's a matter of degree. response:	Private Property No Trespassing
context: When you entrust so much of your everyday life to those electronic devices,\the argument that you're not a cyborg isn't very convincing.\To you, those portable terminals are already your second brain.\Isn't that right?\It can be said that the history of science is a history of the expansion of the human body's functionality.\In other words, the history of man's cyberization.\That's why it's a matter of degree.\Private Property No Trespassing response:	Yes?
context: the argument that you're not a cyborg isn't very convincing.\To you, those portable terminals are already your second brain.\Isn't that right?\It can be said that the history of science is a history of the expansion of the human body's functionality.\In other words, the history of man's cyberization.\That's why it's a matter of degree.\Private Property No Trespassing\Yes? response:	Hey. It's me, Kougami.
context: To you, those portable terminals are already your second brain.\Isn't that right?\It can be said that the history of science is a history of the expansion of the human body's functionality.\In other words, the history of man's cyberization.\That's why it's a matter of degree.\Private Property No Trespassing\Yes?\Hey. It's me, Kougami. response:	Oh, hold on a sec.
context: Isn't that right?\It can be said that the history of science is a history of the expansion of the human body's functionality.\In other words, the history of man's cyberization.\That's why it's a matter of degree.\Private Property No Trespassing\Yes?\Hey. It's me, Kougami.\Oh, hold on a sec. response:	I don't see much environment Holo in use here.
context: It can be said that the history of science is a history of the expansion of the human body's functionality.\In other words, the history of man's cyberization.\That's why it's a matter of degree.\Private Property No Trespassing\Yes?\Hey. It's me, Kougami.\Oh, hold on a sec.\I don't see much environment Holo in use here. response:	He doesn't like that kind of stuff.
context: In other words, the history of man's cyberization.\That's why it's a matter of degree.\Private Property No Trespassing\Yes?\Hey. It's me, Kougami.\Oh, hold on a sec.\I don't see much environment Holo in use here.\He doesn't like that kind of stuff. response:	It's been a while, Professor Saiga.
context: That's why it's a matter of degree.\Private Property No Trespassing\Yes?\Hey. It's me, Kougami.\Oh, hold on a sec.\I don't see much environment Holo in use here.\He doesn't like that kind of stuff.\It's been a while, Professor Saiga. response:	Stop calling me professor. How many years do you think it's been since I quit?
context: Private Property No Trespassing\Yes?\Hey. It's me, Kougami.\Oh, hold on a sec.\I don't see much environment Holo in use here.\He doesn't like that kind of stuff.\It's been a while, Professor Saiga.\Stop calling me professor. How many years do you think it's been since I quit? response:	Who's this young lady?
context: Yes?\Hey. It's me, Kougami.\Oh, hold on a sec.\I don't see much environment Holo in use here.\He doesn't like that kind of stuff.\It's been a while, Professor Saiga.\Stop calling me professor. How many years do you think it's been since I quit?\Who's this young lady? response:	I'm Tsunemori Akane, an Inspector at the Public Safety Bureau. Thanks for seeing me today.
context: Hey. It's me, Kougami.\Oh, hold on a sec.\I don't see much environment Holo in use here.\He doesn't like that kind of stuff.\It's been a while, Professor Saiga.\Stop calling me professor. How many years do you think it's been since I quit?\Who's this young lady?\I'm Tsunemori Akane, an Inspector at the Public Safety Bureau. Thanks for seeing me today. response:	Clinical Psychology Special Lecture A Sibyl Education Investig ation Research Center
context: Oh, hold on a sec.\I don't see much environment Holo in use here.\He doesn't like that kind of stuff.\It's been a while, Professor Saiga.\Stop calling me professor. How many years do you think it's been since I quit?\Who's this young lady?\I'm Tsunemori Akane, an Inspector at the Public Safety Bureau. Thanks for seeing me today.\Clinical Psychology Special Lecture A Sibyl Education Investig ation Research Center response:	Is coffee okay?
context: I don't see much environment Holo in use here.\He doesn't like that kind of stuff.\It's been a while, Professor Saiga.\Stop calling me professor. How many years do you think it's been since I quit?\Who's this young lady?\I'm Tsunemori Akane, an Inspector at the Public Safety Bureau. Thanks for seeing me today.\Clinical Psychology Special Lecture A Sibyl Education Investig ation Research Center\Is coffee okay? response:	Yes.
context: He doesn't like that kind of stuff.\It's been a while, Professor Saiga.\Stop calling me professor. How many years do you think it's been since I quit?\Who's this young lady?\I'm Tsunemori Akane, an Inspector at the Public Safety Bureau. Thanks for seeing me today.\Clinical Psychology Special Lecture A Sibyl Education Investig ation Research Center\Is coffee okay?\Yes. response:	Ah, yes.
context: It's been a while, Professor Saiga.\Stop calling me professor. How many years do you think it's been since I quit?\Who's this young lady?\I'm Tsunemori Akane, an Inspector at the Public Safety Bureau. Thanks for seeing me today.\Clinical Psychology Special Lecture A Sibyl Education Investig ation Research Center\Is coffee okay?\Yes.\Ah, yes. response:	Just as well, since coffee's all I've got.
context: Stop calling me professor. How many years do you think it's been since I quit?\Who's this young lady?\I'm Tsunemori Akane, an Inspector at the Public Safety Bureau. Thanks for seeing me today.\Clinical Psychology Special Lecture A Sibyl Education Investig ation Research Center\Is coffee okay?\Yes.\Ah, yes.\Just as well, since coffee's all I've got. response:	Inspector Tsunemori Akane...
context: Who's this young lady?\I'm Tsunemori Akane, an Inspector at the Public Safety Bureau. Thanks for seeing me today.\Clinical Psychology Special Lecture A Sibyl Education Investig ation Research Center\Is coffee okay?\Yes.\Ah, yes.\Just as well, since coffee's all I've got.\Inspector Tsunemori Akane... response:	Yes?
context: I'm Tsunemori Akane, an Inspector at the Public Safety Bureau. Thanks for seeing me today.\Clinical Psychology Special Lecture A Sibyl Education Investig ation Research Center\Is coffee okay?\Yes.\Ah, yes.\Just as well, since coffee's all I've got.\Inspector Tsunemori Akane...\Yes? response:	Are you from Chiba prefecture?
context: Clinical Psychology Special Lecture A Sibyl Education Investig ation Research Center\Is coffee okay?\Yes.\Ah, yes.\Just as well, since coffee's all I've got.\Inspector Tsunemori Akane...\Yes?\Are you from Chiba prefecture? response:	Yes, I am.
context: Is coffee okay?\Yes.\Ah, yes.\Just as well, since coffee's all I've got.\Inspector Tsunemori Akane...\Yes?\Are you from Chiba prefecture?\Yes, I am. response:	Your athletic ability isn't bad, and yet...
context: Yes.\Ah, yes.\Just as well, since coffee's all I've got.\Inspector Tsunemori Akane...\Yes?\Are you from Chiba prefecture?\Yes, I am.\Your athletic ability isn't bad, and yet... response:	I wonder why...
context: Ah, yes.\Just as well, since coffee's all I've got.\Inspector Tsunemori Akane...\Yes?\Are you from Chiba prefecture?\Yes, I am.\Your athletic ability isn't bad, and yet...\I wonder why... response:	Yeah...
context: Just as well, since coffee's all I've got.\Inspector Tsunemori Akane...\Yes?\Are you from Chiba prefecture?\Yes, I am.\Your athletic ability isn't bad, and yet...\I wonder why...\Yeah... response:	I wonder why you can't swim.
context: Inspector Tsunemori Akane...\Yes?\Are you from Chiba prefecture?\Yes, I am.\Your athletic ability isn't bad, and yet...\I wonder why...\Yeah...\I wonder why you can't swim. response:	What?!
context: Yes?\Are you from Chiba prefecture?\Yes, I am.\Your athletic ability isn't bad, and yet...\I wonder why...\Yeah...\I wonder why you can't swim.\What?! response:	Both of your parents are still alive.
context: Are you from Chiba prefecture?\Yes, I am.\Your athletic ability isn't bad, and yet...\I wonder why...\Yeah...\I wonder why you can't swim.\What?!\Both of your parents are still alive. response:	They're worried about their only daughter not finding a boyfriend.
context: Yes, I am.\Your athletic ability isn't bad, and yet...\I wonder why...\Yeah...\I wonder why you can't swim.\What?!\Both of your parents are still alive.\They're worried about their only daughter not finding a boyfriend. response:	Umm...
context: Your athletic ability isn't bad, and yet...\I wonder why...\Yeah...\I wonder why you can't swim.\What?!\Both of your parents are still alive.\They're worried about their only daughter not finding a boyfriend.\Umm... response:	They were opposed to you working at the Bureau, too.
context: I wonder why...\Yeah...\I wonder why you can't swim.\What?!\Both of your parents are still alive.\They're worried about their only daughter not finding a boyfriend.\Umm...\They were opposed to you working at the Bureau, too. response:	And, your grandfather or grandmother...
context: Yeah...\I wonder why you can't swim.\What?!\Both of your parents are still alive.\They're worried about their only daughter not finding a boyfriend.\Umm...\They were opposed to you working at the Bureau, too.\And, your grandfather or grandmother... response:	It must be your grandmother.
context: I wonder why you can't swim.\What?!\Both of your parents are still alive.\They're worried about their only daughter not finding a boyfriend.\Umm...\They were opposed to you working at the Bureau, too.\And, your grandfather or grandmother...\It must be your grandmother. response:	She treated you with great affection.
context: What?!\Both of your parents are still alive.\They're worried about their only daughter not finding a boyfriend.\Umm...\They were opposed to you working at the Bureau, too.\And, your grandfather or grandmother...\It must be your grandmother.\She treated you with great affection. response:	It seems that you're quite the grandma's girl.
context: Both of your parents are still alive.\They're worried about their only daughter not finding a boyfriend.\Umm...\They were opposed to you working at the Bureau, too.\And, your grandfather or grandmother...\It must be your grandmother.\She treated you with great affection.\It seems that you're quite the grandma's girl. response:	It's often true that the more time you spend with the elderly during your childhood,
context: They're worried about their only daughter not finding a boyfriend.\Umm...\They were opposed to you working at the Bureau, too.\And, your grandfather or grandmother...\It must be your grandmother.\She treated you with great affection.\It seems that you're quite the grandma's girl.\It's often true that the more time you spend with the elderly during your childhood, response:	the better you can get along with Holo Avatar AIs during your adult life.
context: Umm...\They were opposed to you working at the Bureau, too.\And, your grandfather or grandmother...\It must be your grandmother.\She treated you with great affection.\It seems that you're quite the grandma's girl.\It's often true that the more time you spend with the elderly during your childhood,\the better you can get along with Holo Avatar AIs during your adult life. response:	You fit that pattern, Ms. Tsunemori.
context: They were opposed to you working at the Bureau, too.\And, your grandfather or grandmother...\It must be your grandmother.\She treated you with great affection.\It seems that you're quite the grandma's girl.\It's often true that the more time you spend with the elderly during your childhood,\the better you can get along with Holo Avatar AIs during your adult life.\You fit that pattern, Ms. Tsunemori. response:	Umm...
context: And, your grandfather or grandmother...\It must be your grandmother.\She treated you with great affection.\It seems that you're quite the grandma's girl.\It's often true that the more time you spend with the elderly during your childhood,\the better you can get along with Holo Avatar AIs during your adult life.\You fit that pattern, Ms. Tsunemori.\Umm... response:	You're as sharp as ever, Saiga.
context: It must be your grandmother.\She treated you with great affection.\It seems that you're quite the grandma's girl.\It's often true that the more time you spend with the elderly during your childhood,\the better you can get along with Holo Avatar AIs during your adult life.\You fit that pattern, Ms. Tsunemori.\Umm...\You're as sharp as ever, Saiga. response:	How... did you do that?
context: She treated you with great affection.\It seems that you're quite the grandma's girl.\It's often true that the more time you spend with the elderly during your childhood,\the better you can get along with Holo Avatar AIs during your adult life.\You fit that pattern, Ms. Tsunemori.\Umm...\You're as sharp as ever, Saiga.\How... did you do that? response:	Simple observation.
context: It seems that you're quite the grandma's girl.\It's often true that the more time you spend with the elderly during your childhood,\the better you can get along with Holo Avatar AIs during your adult life.\You fit that pattern, Ms. Tsunemori.\Umm...\You're as sharp as ever, Saiga.\How... did you do that?\Simple observation. response:	People manifest all sorts of signs unconsciously.
context: It's often true that the more time you spend with the elderly during your childhood,\the better you can get along with Holo Avatar AIs during your adult life.\You fit that pattern, Ms. Tsunemori.\Umm...\You're as sharp as ever, Saiga.\How... did you do that?\Simple observation.\People manifest all sorts of signs unconsciously. response:	Once you get the knack of it, you can read those signs pretty easily.
context: the better you can get along with Holo Avatar AIs during your adult life.\You fit that pattern, Ms. Tsunemori.\Umm...\You're as sharp as ever, Saiga.\How... did you do that?\Simple observation.\People manifest all sorts of signs unconsciously.\Once you get the knack of it, you can read those signs pretty easily. response:	Saiga Jouji...
context: You fit that pattern, Ms. Tsunemori.\Umm...\You're as sharp as ever, Saiga.\How... did you do that?\Simple observation.\People manifest all sorts of signs unconsciously.\Once you get the knack of it, you can read those signs pretty easily.\Saiga Jouji... response:	You specialize in clinical psychology.
context: Umm...\You're as sharp as ever, Saiga.\How... did you do that?\Simple observation.\People manifest all sorts of signs unconsciously.\Once you get the knack of it, you can read those signs pretty easily.\Saiga Jouji...\You specialize in clinical psychology. response:	As I worked as a psychiatric examiner and assisted in investigations and such,
context: You're as sharp as ever, Saiga.\How... did you do that?\Simple observation.\People manifest all sorts of signs unconsciously.\Once you get the knack of it, you can read those signs pretty easily.\Saiga Jouji...\You specialize in clinical psychology.\As I worked as a psychiatric examiner and assisted in investigations and such, response:	my main focus shifted to criminal research before I knew it.
context: How... did you do that?\Simple observation.\People manifest all sorts of signs unconsciously.\Once you get the knack of it, you can read those signs pretty easily.\Saiga Jouji...\You specialize in clinical psychology.\As I worked as a psychiatric examiner and assisted in investigations and such,\my main focus shifted to criminal research before I knew it. response:	I have two favors to ask you today.
context: Simple observation.\People manifest all sorts of signs unconsciously.\Once you get the knack of it, you can read those signs pretty easily.\Saiga Jouji...\You specialize in clinical psychology.\As I worked as a psychiatric examiner and assisted in investigations and such,\my main focus shifted to criminal research before I knew it.\I have two favors to ask you today. response:	Ask me anything.
context: People manifest all sorts of signs unconsciously.\Once you get the knack of it, you can read those signs pretty easily.\Saiga Jouji...\You specialize in clinical psychology.\As I worked as a psychiatric examiner and assisted in investigations and such,\my main focus shifted to criminal research before I knew it.\I have two favors to ask you today.\Ask me anything. response:	First, I'd like you to give this Inspector an intensive short course.
context: Once you get the knack of it, you can read those signs pretty easily.\Saiga Jouji...\You specialize in clinical psychology.\As I worked as a psychiatric examiner and assisted in investigations and such,\my main focus shifted to criminal research before I knew it.\I have two favors to ask you today.\Ask me anything.\First, I'd like you to give this Inspector an intensive short course. response:	I'd like to learn about profiling and such.
context: Saiga Jouji...\You specialize in clinical psychology.\As I worked as a psychiatric examiner and assisted in investigations and such,\my main focus shifted to criminal research before I knew it.\I have two favors to ask you today.\Ask me anything.\First, I'd like you to give this Inspector an intensive short course.\I'd like to learn about profiling and such. response:	They say it's an outdated method, but I'm very interested in it.
context: You specialize in clinical psychology.\As I worked as a psychiatric examiner and assisted in investigations and such,\my main focus shifted to criminal research before I knew it.\I have two favors to ask you today.\Ask me anything.\First, I'd like you to give this Inspector an intensive short course.\I'd like to learn about profiling and such.\They say it's an outdated method, but I'm very interested in it. response:	Or rather, I became interested recently.
context: As I worked as a psychiatric examiner and assisted in investigations and such,\my main focus shifted to criminal research before I knew it.\I have two favors to ask you today.\Ask me anything.\First, I'd like you to give this Inspector an intensive short course.\I'd like to learn about profiling and such.\They say it's an outdated method, but I'm very interested in it.\Or rather, I became interested recently. response:	I'm a hermit. I actually feel grateful for the opportunity to teach you.
context: my main focus shifted to criminal research before I knew it.\I have two favors to ask you today.\Ask me anything.\First, I'd like you to give this Inspector an intensive short course.\I'd like to learn about profiling and such.\They say it's an outdated method, but I'm very interested in it.\Or rather, I became interested recently.\I'm a hermit. I actually feel grateful for the opportunity to teach you. response:	So, what's the other one?
context: I have two favors to ask you today.\Ask me anything.\First, I'd like you to give this Inspector an intensive short course.\I'd like to learn about profiling and such.\They say it's an outdated method, but I'm very interested in it.\Or rather, I became interested recently.\I'm a hermit. I actually feel grateful for the opportunity to teach you.\So, what's the other one? response:	I'd like to see the list of past course attendees that you keep with you.
context: Ask me anything.\First, I'd like you to give this Inspector an intensive short course.\I'd like to learn about profiling and such.\They say it's an outdated method, but I'm very interested in it.\Or rather, I became interested recently.\I'm a hermit. I actually feel grateful for the opportunity to teach you.\So, what's the other one?\I'd like to see the list of past course attendees that you keep with you. response:	Is that a request from the Bureau?
context: First, I'd like you to give this Inspector an intensive short course.\I'd like to learn about profiling and such.\They say it's an outdated method, but I'm very interested in it.\Or rather, I became interested recently.\I'm a hermit. I actually feel grateful for the opportunity to teach you.\So, what's the other one?\I'd like to see the list of past course attendees that you keep with you.\Is that a request from the Bureau? response:	No. It's a request from me.
context: I'd like to learn about profiling and such.\They say it's an outdated method, but I'm very interested in it.\Or rather, I became interested recently.\I'm a hermit. I actually feel grateful for the opportunity to teach you.\So, what's the other one?\I'd like to see the list of past course attendees that you keep with you.\Is that a request from the Bureau?\No. It's a request from me. response:	If it was an order, I would've turned it down.
context: They say it's an outdated method, but I'm very interested in it.\Or rather, I became interested recently.\I'm a hermit. I actually feel grateful for the opportunity to teach you.\So, what's the other one?\I'd like to see the list of past course attendees that you keep with you.\Is that a request from the Bureau?\No. It's a request from me.\If it was an order, I would've turned it down. response:	Who are you looking for?
context: Or rather, I became interested recently.\I'm a hermit. I actually feel grateful for the opportunity to teach you.\So, what's the other one?\I'd like to see the list of past course attendees that you keep with you.\Is that a request from the Bureau?\No. It's a request from me.\If it was an order, I would've turned it down.\Who are you looking for? response:	I think this guy must be the worst criminal to have lived since the creation of the Sibyl System.
context: I'm a hermit. I actually feel grateful for the opportunity to teach you.\So, what's the other one?\I'd like to see the list of past course attendees that you keep with you.\Is that a request from the Bureau?\No. It's a request from me.\If it was an order, I would've turned it down.\Who are you looking for?\I think this guy must be the worst criminal to have lived since the creation of the Sibyl System. response:	What do you mean?
context: So, what's the other one?\I'd like to see the list of past course attendees that you keep with you.\Is that a request from the Bureau?\No. It's a request from me.\If it was an order, I would've turned it down.\Who are you looking for?\I think this guy must be the worst criminal to have lived since the creation of the Sibyl System.\What do you mean? response:	He's a high-level white-collar criminal
context: I'd like to see the list of past course attendees that you keep with you.\Is that a request from the Bureau?\No. It's a request from me.\If it was an order, I would've turned it down.\Who are you looking for?\I think this guy must be the worst criminal to have lived since the creation of the Sibyl System.\What do you mean?\He's a high-level white-collar criminal response:	who most likely keeps himself in good health.
context: Is that a request from the Bureau?\No. It's a request from me.\If it was an order, I would've turned it down.\Who are you looking for?\I think this guy must be the worst criminal to have lived since the creation of the Sibyl System.\What do you mean?\He's a high-level white-collar criminal\who most likely keeps himself in good health. response:	Possessing a unique charisma, he rarely kills people with his own hands.
context: No. It's a request from me.\If it was an order, I would've turned it down.\Who are you looking for?\I think this guy must be the worst criminal to have lived since the creation of the Sibyl System.\What do you mean?\He's a high-level white-collar criminal\who most likely keeps himself in good health.\Possessing a unique charisma, he rarely kills people with his own hands. response:	Rather, he chooses to influence the minds of others.
context: If it was an order, I would've turned it down.\Who are you looking for?\I think this guy must be the worst criminal to have lived since the creation of the Sibyl System.\What do you mean?\He's a high-level white-collar criminal\who most likely keeps himself in good health.\Possessing a unique charisma, he rarely kills people with his own hands.\Rather, he chooses to influence the minds of others. response:	Much like a music conductor, he orchestrates one crime after another.
context: Who are you looking for?\I think this guy must be the worst criminal to have lived since the creation of the Sibyl System.\What do you mean?\He's a high-level white-collar criminal\who most likely keeps himself in good health.\Possessing a unique charisma, he rarely kills people with his own hands.\Rather, he chooses to influence the minds of others.\Much like a music conductor, he orchestrates one crime after another. response:	Kougami, please explain what charisma is.
context: I think this guy must be the worst criminal to have lived since the creation of the Sibyl System.\What do you mean?\He's a high-level white-collar criminal\who most likely keeps himself in good health.\Possessing a unique charisma, he rarely kills people with his own hands.\Rather, he chooses to influence the minds of others.\Much like a music conductor, he orchestrates one crime after another.\Kougami, please explain what charisma is. response:	I used it to mean the nature of a hero or a ruler.
context: What do you mean?\He's a high-level white-collar criminal\who most likely keeps himself in good health.\Possessing a unique charisma, he rarely kills people with his own hands.\Rather, he chooses to influence the minds of others.\Much like a music conductor, he orchestrates one crime after another.\Kougami, please explain what charisma is.\I used it to mean the nature of a hero or a ruler. response:	I'd give that answer... twenty points.
context: He's a high-level white-collar criminal\who most likely keeps himself in good health.\Possessing a unique charisma, he rarely kills people with his own hands.\Rather, he chooses to influence the minds of others.\Much like a music conductor, he orchestrates one crime after another.\Kougami, please explain what charisma is.\I used it to mean the nature of a hero or a ruler.\I'd give that answer... twenty points. response:	Charisma has three elements.
context: who most likely keeps himself in good health.\Possessing a unique charisma, he rarely kills people with his own hands.\Rather, he chooses to influence the minds of others.\Much like a music conductor, he orchestrates one crime after another.\Kougami, please explain what charisma is.\I used it to mean the nature of a hero or a ruler.\I'd give that answer... twenty points.\Charisma has three elements. response:	The nature of a hero or a prophet,
context: Possessing a unique charisma, he rarely kills people with his own hands.\Rather, he chooses to influence the minds of others.\Much like a music conductor, he orchestrates one crime after another.\Kougami, please explain what charisma is.\I used it to mean the nature of a hero or a ruler.\I'd give that answer... twenty points.\Charisma has three elements.\The nature of a hero or a prophet, response:	the ability to simply make you feel good when you're around them,
context: Rather, he chooses to influence the minds of others.\Much like a music conductor, he orchestrates one crime after another.\Kougami, please explain what charisma is.\I used it to mean the nature of a hero or a ruler.\I'd give that answer... twenty points.\Charisma has three elements.\The nature of a hero or a prophet,\the ability to simply make you feel good when you're around them, response:	and the intelligence to eloquently talk about all sorts of things.
context: Much like a music conductor, he orchestrates one crime after another.\Kougami, please explain what charisma is.\I used it to mean the nature of a hero or a ruler.\I'd give that answer... twenty points.\Charisma has three elements.\The nature of a hero or a prophet,\the ability to simply make you feel good when you're around them,\and the intelligence to eloquently talk about all sorts of things. response:	Of those, which elements does this guy you're looking for have?
context: Kougami, please explain what charisma is.\I used it to mean the nature of a hero or a ruler.\I'd give that answer... twenty points.\Charisma has three elements.\The nature of a hero or a prophet,\the ability to simply make you feel good when you're around them,\and the intelligence to eloquently talk about all sorts of things.\Of those, which elements does this guy you're looking for have? response:	I think he has all of them.
context: I used it to mean the nature of a hero or a ruler.\I'd give that answer... twenty points.\Charisma has three elements.\The nature of a hero or a prophet,\the ability to simply make you feel good when you're around them,\and the intelligence to eloquently talk about all sorts of things.\Of those, which elements does this guy you're looking for have?\I think he has all of them. response:	This is Shibata Yukimori, an art teacher at Ousou Academy.
context: I'd give that answer... twenty points.\Charisma has three elements.\The nature of a hero or a prophet,\the ability to simply make you feel good when you're around them,\and the intelligence to eloquently talk about all sorts of things.\Of those, which elements does this guy you're looking for have?\I think he has all of them.\This is Shibata Yukimori, an art teacher at Ousou Academy. response:	Well, that's who he's supposed to be,
context: Charisma has three elements.\The nature of a hero or a prophet,\the ability to simply make you feel good when you're around them,\and the intelligence to eloquently talk about all sorts of things.\Of those, which elements does this guy you're looking for have?\I think he has all of them.\This is Shibata Yukimori, an art teacher at Ousou Academy.\Well, that's who he's supposed to be, response:	but it turns out that he's actually an old man in a nursing home who has nothing to do with the academy.
context: The nature of a hero or a prophet,\the ability to simply make you feel good when you're around them,\and the intelligence to eloquently talk about all sorts of things.\Of those, which elements does this guy you're looking for have?\I think he has all of them.\This is Shibata Yukimori, an art teacher at Ousou Academy.\Well, that's who he's supposed to be,\but it turns out that he's actually an old man in a nursing home who has nothing to do with the academy. response:	His background profile was altered and used by our suspect when he pretended to be a teacher.
context: the ability to simply make you feel good when you're around them,\and the intelligence to eloquently talk about all sorts of things.\Of those, which elements does this guy you're looking for have?\I think he has all of them.\This is Shibata Yukimori, an art teacher at Ousou Academy.\Well, that's who he's supposed to be,\but it turns out that he's actually an old man in a nursing home who has nothing to do with the academy.\His background profile was altered and used by our suspect when he pretended to be a teacher. response:	It's quite cruelly clever of him not to completely fake his background.
context: and the intelligence to eloquently talk about all sorts of things.\Of those, which elements does this guy you're looking for have?\I think he has all of them.\This is Shibata Yukimori, an art teacher at Ousou Academy.\Well, that's who he's supposed to be,\but it turns out that he's actually an old man in a nursing home who has nothing to do with the academy.\His background profile was altered and used by our suspect when he pretended to be a teacher.\It's quite cruelly clever of him not to completely fake his background. response:	But he then chose to work as a teacher, placing himself right in the public eye?
context: Of those, which elements does this guy you're looking for have?\I think he has all of them.\This is Shibata Yukimori, an art teacher at Ousou Academy.\Well, that's who he's supposed to be,\but it turns out that he's actually an old man in a nursing home who has nothing to do with the academy.\His background profile was altered and used by our suspect when he pretended to be a teacher.\It's quite cruelly clever of him not to completely fake his background.\But he then chose to work as a teacher, placing himself right in the public eye? response:	Is he daring or just a fool?
context: I think he has all of them.\This is Shibata Yukimori, an art teacher at Ousou Academy.\Well, that's who he's supposed to be,\but it turns out that he's actually an old man in a nursing home who has nothing to do with the academy.\His background profile was altered and used by our suspect when he pretended to be a teacher.\It's quite cruelly clever of him not to completely fake his background.\But he then chose to work as a teacher, placing himself right in the public eye?\Is he daring or just a fool? response:	Well, about that...
context: This is Shibata Yukimori, an art teacher at Ousou Academy.\Well, that's who he's supposed to be,\but it turns out that he's actually an old man in a nursing home who has nothing to do with the academy.\His background profile was altered and used by our suspect when he pretended to be a teacher.\It's quite cruelly clever of him not to completely fake his background.\But he then chose to work as a teacher, placing himself right in the public eye?\Is he daring or just a fool?\Well, about that... response:	All the video data was destroyed.
context: Well, that's who he's supposed to be,\but it turns out that he's actually an old man in a nursing home who has nothing to do with the academy.\His background profile was altered and used by our suspect when he pretended to be a teacher.\It's quite cruelly clever of him not to completely fake his background.\But he then chose to work as a teacher, placing himself right in the public eye?\Is he daring or just a fool?\Well, about that...\All the video data was destroyed. response:	The only thing we were able to salvage was a short sound file.
context: but it turns out that he's actually an old man in a nursing home who has nothing to do with the academy.\His background profile was altered and used by our suspect when he pretended to be a teacher.\It's quite cruelly clever of him not to completely fake his background.\But he then chose to work as a teacher, placing himself right in the public eye?\Is he daring or just a fool?\Well, about that...\All the video data was destroyed.\The only thing we were able to salvage was a short sound file. response:	There are only two methods left: creating a traditional photofit picture or drawing a composite sketch.
context: His background profile was altered and used by our suspect when he pretended to be a teacher.\It's quite cruelly clever of him not to completely fake his background.\But he then chose to work as a teacher, placing himself right in the public eye?\Is he daring or just a fool?\Well, about that...\All the video data was destroyed.\The only thing we were able to salvage was a short sound file.\There are only two methods left: creating a traditional photofit picture or drawing a composite sketch. response:	Of course, we tried both methods.
context: It's quite cruelly clever of him not to completely fake his background.\But he then chose to work as a teacher, placing himself right in the public eye?\Is he daring or just a fool?\Well, about that...\All the video data was destroyed.\The only thing we were able to salvage was a short sound file.\There are only two methods left: creating a traditional photofit picture or drawing a composite sketch.\Of course, we tried both methods. response:	From the sound of it, they didn't work?
context: But he then chose to work as a teacher, placing himself right in the public eye?\Is he daring or just a fool?\Well, about that...\All the video data was destroyed.\The only thing we were able to salvage was a short sound file.\There are only two methods left: creating a traditional photofit picture or drawing a composite sketch.\Of course, we tried both methods.\From the sound of it, they didn't work? response:	Right.
context: Is he daring or just a fool?\Well, about that...\All the video data was destroyed.\The only thing we were able to salvage was a short sound file.\There are only two methods left: creating a traditional photofit picture or drawing a composite sketch.\Of course, we tried both methods.\From the sound of it, they didn't work?\Right. response:	In the end, the only lead we have is the blurry picture Sasayama took, right?
context: Well, about that...\All the video data was destroyed.\The only thing we were able to salvage was a short sound file.\There are only two methods left: creating a traditional photofit picture or drawing a composite sketch.\Of course, we tried both methods.\From the sound of it, they didn't work?\Right.\In the end, the only lead we have is the blurry picture Sasayama took, right? response:	Did you end up getting anything out of that?
context: All the video data was destroyed.\The only thing we were able to salvage was a short sound file.\There are only two methods left: creating a traditional photofit picture or drawing a composite sketch.\Of course, we tried both methods.\From the sound of it, they didn't work?\Right.\In the end, the only lead we have is the blurry picture Sasayama took, right?\Did you end up getting anything out of that? response:	Y-Yes, it helped a lot!
context: The only thing we were able to salvage was a short sound file.\There are only two methods left: creating a traditional photofit picture or drawing a composite sketch.\Of course, we tried both methods.\From the sound of it, they didn't work?\Right.\In the end, the only lead we have is the blurry picture Sasayama took, right?\Did you end up getting anything out of that?\Y-Yes, it helped a lot! response:	He's an incredible teacher.
context: There are only two methods left: creating a traditional photofit picture or drawing a composite sketch.\Of course, we tried both methods.\From the sound of it, they didn't work?\Right.\In the end, the only lead we have is the blurry picture Sasayama took, right?\Did you end up getting anything out of that?\Y-Yes, it helped a lot!\He's an incredible teacher. response:	I don't understand why his lectures aren't in the Bureau's archives.
context: Of course, we tried both methods.\From the sound of it, they didn't work?\Right.\In the end, the only lead we have is the blurry picture Sasayama took, right?\Did you end up getting anything out of that?\Y-Yes, it helped a lot!\He's an incredible teacher.\I don't understand why his lectures aren't in the Bureau's archives. response:	There's no way they'd put them in the archives.
context: From the sound of it, they didn't work?\Right.\In the end, the only lead we have is the blurry picture Sasayama took, right?\Did you end up getting anything out of that?\Y-Yes, it helped a lot!\He's an incredible teacher.\I don't understand why his lectures aren't in the Bureau's archives.\There's no way they'd put them in the archives. response:	Did something happen?
context: Right.\In the end, the only lead we have is the blurry picture Sasayama took, right?\Did you end up getting anything out of that?\Y-Yes, it helped a lot!\He's an incredible teacher.\I don't understand why his lectures aren't in the Bureau's archives.\There's no way they'd put them in the archives.\Did something happen? response:	This was around the time that both the Sibyl System and the university system existed together.
context: In the end, the only lead we have is the blurry picture Sasayama took, right?\Did you end up getting anything out of that?\Y-Yes, it helped a lot!\He's an incredible teacher.\I don't understand why his lectures aren't in the Bureau's archives.\There's no way they'd put them in the archives.\Did something happen?\This was around the time that both the Sibyl System and the university system existed together. response:	Saiga's special courses were set up for the Bureau's investigators.
context: Did you end up getting anything out of that?\Y-Yes, it helped a lot!\He's an incredible teacher.\I don't understand why his lectures aren't in the Bureau's archives.\There's no way they'd put them in the archives.\Did something happen?\This was around the time that both the Sibyl System and the university system existed together.\Saiga's special courses were set up for the Bureau's investigators. response:	But one day, a major concern came to light.
context: Y-Yes, it helped a lot!\He's an incredible teacher.\I don't understand why his lectures aren't in the Bureau's archives.\There's no way they'd put them in the archives.\Did something happen?\This was around the time that both the Sibyl System and the university system existed together.\Saiga's special courses were set up for the Bureau's investigators.\But one day, a major concern came to light. response:	The course attendees' Hues became cloudier and their Crime Coefficients rose.
context: He's an incredible teacher.\I don't understand why his lectures aren't in the Bureau's archives.\There's no way they'd put them in the archives.\Did something happen?\This was around the time that both the Sibyl System and the university system existed together.\Saiga's special courses were set up for the Bureau's investigators.\But one day, a major concern came to light.\The course attendees' Hues became cloudier and their Crime Coefficients rose. response:	Well, not all of them.
context: I don't understand why his lectures aren't in the Bureau's archives.\There's no way they'd put them in the archives.\Did something happen?\This was around the time that both the Sibyl System and the university system existed together.\Saiga's special courses were set up for the Bureau's investigators.\But one day, a major concern came to light.\The course attendees' Hues became cloudier and their Crime Coefficients rose.\Well, not all of them. response:	A one-on-one lecture like the one you had today should be fine.
context: There's no way they'd put them in the archives.\Did something happen?\This was around the time that both the Sibyl System and the university system existed together.\Saiga's special courses were set up for the Bureau's investigators.\But one day, a major concern came to light.\The course attendees' Hues became cloudier and their Crime Coefficients rose.\Well, not all of them.\A one-on-one lecture like the one you had today should be fine. response:	Besides, I don't see your Hue clouding that easily at all.
context: Did something happen?\This was around the time that both the Sibyl System and the university system existed together.\Saiga's special courses were set up for the Bureau's investigators.\But one day, a major concern came to light.\The course attendees' Hues became cloudier and their Crime Coefficients rose.\Well, not all of them.\A one-on-one lecture like the one you had today should be fine.\Besides, I don't see your Hue clouding that easily at all. response:	But...
context: This was around the time that both the Sibyl System and the university system existed together.\Saiga's special courses were set up for the Bureau's investigators.\But one day, a major concern came to light.\The course attendees' Hues became cloudier and their Crime Coefficients rose.\Well, not all of them.\A one-on-one lecture like the one you had today should be fine.\Besides, I don't see your Hue clouding that easily at all.\But... response:	It's crazy that just listening to lectures could raise your Crime Coefficient.
context: Saiga's special courses were set up for the Bureau's investigators.\But one day, a major concern came to light.\The course attendees' Hues became cloudier and their Crime Coefficients rose.\Well, not all of them.\A one-on-one lecture like the one you had today should be fine.\Besides, I don't see your Hue clouding that easily at all.\But...\It's crazy that just listening to lectures could raise your Crime Coefficient. response:	Say you're at a dark swamp and you can't see the bottom.
context: But one day, a major concern came to light.\The course attendees' Hues became cloudier and their Crime Coefficients rose.\Well, not all of them.\A one-on-one lecture like the one you had today should be fine.\Besides, I don't see your Hue clouding that easily at all.\But...\It's crazy that just listening to lectures could raise your Crime Coefficient.\Say you're at a dark swamp and you can't see the bottom. response:	If you want to find out what's in that swamp, you have no choice but to jump in.
context: The course attendees' Hues became cloudier and their Crime Coefficients rose.\Well, not all of them.\A one-on-one lecture like the one you had today should be fine.\Besides, I don't see your Hue clouding that easily at all.\But...\It's crazy that just listening to lectures could raise your Crime Coefficient.\Say you're at a dark swamp and you can't see the bottom.\If you want to find out what's in that swamp, you have no choice but to jump in. response:	Saiga's used to it since he's dived in so many times already.
context: Well, not all of them.\A one-on-one lecture like the one you had today should be fine.\Besides, I don't see your Hue clouding that easily at all.\But...\It's crazy that just listening to lectures could raise your Crime Coefficient.\Say you're at a dark swamp and you can't see the bottom.\If you want to find out what's in that swamp, you have no choice but to jump in.\Saiga's used to it since he's dived in so many times already. response:	But it's not like all his students can dive into that swamp and come back safely.
context: A one-on-one lecture like the one you had today should be fine.\Besides, I don't see your Hue clouding that easily at all.\But...\It's crazy that just listening to lectures could raise your Crime Coefficient.\Say you're at a dark swamp and you can't see the bottom.\If you want to find out what's in that swamp, you have no choice but to jump in.\Saiga's used to it since he's dived in so many times already.\But it's not like all his students can dive into that swamp and come back safely. response:	There are gaps in their abilities, not to mention their basic suitability.
context: Besides, I don't see your Hue clouding that easily at all.\But...\It's crazy that just listening to lectures could raise your Crime Coefficient.\Say you're at a dark swamp and you can't see the bottom.\If you want to find out what's in that swamp, you have no choice but to jump in.\Saiga's used to it since he's dived in so many times already.\But it's not like all his students can dive into that swamp and come back safely.\There are gaps in their abilities, not to mention their basic suitability. response:	You seem like someone who'd dive right to the bottom... and yet come back safely.
context: But...\It's crazy that just listening to lectures could raise your Crime Coefficient.\Say you're at a dark swamp and you can't see the bottom.\If you want to find out what's in that swamp, you have no choice but to jump in.\Saiga's used to it since he's dived in so many times already.\But it's not like all his students can dive into that swamp and come back safely.\There are gaps in their abilities, not to mention their basic suitability.\You seem like someone who'd dive right to the bottom... and yet come back safely. response:	Well, I don't know about that.
context: It's crazy that just listening to lectures could raise your Crime Coefficient.\Say you're at a dark swamp and you can't see the bottom.\If you want to find out what's in that swamp, you have no choice but to jump in.\Saiga's used to it since he's dived in so many times already.\But it's not like all his students can dive into that swamp and come back safely.\There are gaps in their abilities, not to mention their basic suitability.\You seem like someone who'd dive right to the bottom... and yet come back safely.\Well, I don't know about that. response:	At least, the Sibyl System decided that I couldn't come back.
context: Say you're at a dark swamp and you can't see the bottom.\If you want to find out what's in that swamp, you have no choice but to jump in.\Saiga's used to it since he's dived in so many times already.\But it's not like all his students can dive into that swamp and come back safely.\There are gaps in their abilities, not to mention their basic suitability.\You seem like someone who'd dive right to the bottom... and yet come back safely.\Well, I don't know about that.\At least, the Sibyl System decided that I couldn't come back. response:	What would you say is the most cunning animal?
context: If you want to find out what's in that swamp, you have no choice but to jump in.\Saiga's used to it since he's dived in so many times already.\But it's not like all his students can dive into that swamp and come back safely.\There are gaps in their abilities, not to mention their basic suitability.\You seem like someone who'd dive right to the bottom... and yet come back safely.\Well, I don't know about that.\At least, the Sibyl System decided that I couldn't come back.\What would you say is the most cunning animal? response:	One that's at no risk of extinction no matter how many are hunted and killed?
context: Saiga's used to it since he's dived in so many times already.\But it's not like all his students can dive into that swamp and come back safely.\There are gaps in their abilities, not to mention their basic suitability.\You seem like someone who'd dive right to the bottom... and yet come back safely.\Well, I don't know about that.\At least, the Sibyl System decided that I couldn't come back.\What would you say is the most cunning animal?\One that's at no risk of extinction no matter how many are hunted and killed? response:	That'd be humans.
context: But it's not like all his students can dive into that swamp and come back safely.\There are gaps in their abilities, not to mention their basic suitability.\You seem like someone who'd dive right to the bottom... and yet come back safely.\Well, I don't know about that.\At least, the Sibyl System decided that I couldn't come back.\What would you say is the most cunning animal?\One that's at no risk of extinction no matter how many are hunted and killed?\That'd be humans. response:	Too easy, huh?
context: There are gaps in their abilities, not to mention their basic suitability.\You seem like someone who'd dive right to the bottom... and yet come back safely.\Well, I don't know about that.\At least, the Sibyl System decided that I couldn't come back.\What would you say is the most cunning animal?\One that's at no risk of extinction no matter how many are hunted and killed?\That'd be humans.\Too easy, huh? response:	These days...
context: You seem like someone who'd dive right to the bottom... and yet come back safely.\Well, I don't know about that.\At least, the Sibyl System decided that I couldn't come back.\What would you say is the most cunning animal?\One that's at no risk of extinction no matter how many are hunted and killed?\That'd be humans.\Too easy, huh?\These days... response:	they no longer issue hunting licenses under normal circumstances.
context: Well, I don't know about that.\At least, the Sibyl System decided that I couldn't come back.\What would you say is the most cunning animal?\One that's at no risk of extinction no matter how many are hunted and killed?\That'd be humans.\Too easy, huh?\These days...\they no longer issue hunting licenses under normal circumstances. response:	I really appreciate what you've done for me, Makishima.
context: At least, the Sibyl System decided that I couldn't come back.\What would you say is the most cunning animal?\One that's at no risk of extinction no matter how many are hunted and killed?\That'd be humans.\Too easy, huh?\These days...\they no longer issue hunting licenses under normal circumstances.\I really appreciate what you've done for me, Makishima. response:	That's not ivory... is it?
context: What would you say is the most cunning animal?\One that's at no risk of extinction no matter how many are hunted and killed?\That'd be humans.\Too easy, huh?\These days...\they no longer issue hunting licenses under normal circumstances.\I really appreciate what you've done for me, Makishima.\That's not ivory... is it? response:	I guess I haven't shown this one to you before.
context: One that's at no risk of extinction no matter how many are hunted and killed?\That'd be humans.\Too easy, huh?\These days...\they no longer issue hunting licenses under normal circumstances.\I really appreciate what you've done for me, Makishima.\That's not ivory... is it?\I guess I haven't shown this one to you before. response:	Excluding the mouthpiece, this pipe is made from Ouryou Rikako's bones.
context: That'd be humans.\Too easy, huh?\These days...\they no longer issue hunting licenses under normal circumstances.\I really appreciate what you've done for me, Makishima.\That's not ivory... is it?\I guess I haven't shown this one to you before.\Excluding the mouthpiece, this pipe is made from Ouryou Rikako's bones. response:	I see.
context: Too easy, huh?\These days...\they no longer issue hunting licenses under normal circumstances.\I really appreciate what you've done for me, Makishima.\That's not ivory... is it?\I guess I haven't shown this one to you before.\Excluding the mouthpiece, this pipe is made from Ouryou Rikako's bones.\I see. response:	When I'm touching it like this...
context: These days...\they no longer issue hunting licenses under normal circumstances.\I really appreciate what you've done for me, Makishima.\That's not ivory... is it?\I guess I haven't shown this one to you before.\Excluding the mouthpiece, this pipe is made from Ouryou Rikako's bones.\I see.\When I'm touching it like this... response:	my mind regains its youth.
context: they no longer issue hunting licenses under normal circumstances.\I really appreciate what you've done for me, Makishima.\That's not ivory... is it?\I guess I haven't shown this one to you before.\Excluding the mouthpiece, this pipe is made from Ouryou Rikako's bones.\I see.\When I'm touching it like this...\my mind regains its youth. response:	The souls of my terrified prey give me energy.
context: I really appreciate what you've done for me, Makishima.\That's not ivory... is it?\I guess I haven't shown this one to you before.\Excluding the mouthpiece, this pipe is made from Ouryou Rikako's bones.\I see.\When I'm touching it like this...\my mind regains its youth.\The souls of my terrified prey give me energy. response:	You've overcome your body's aging.
context: That's not ivory... is it?\I guess I haven't shown this one to you before.\Excluding the mouthpiece, this pipe is made from Ouryou Rikako's bones.\I see.\When I'm touching it like this...\my mind regains its youth.\The souls of my terrified prey give me energy.\You've overcome your body's aging. response:	I guess that just leaves your mind?
context: I guess I haven't shown this one to you before.\Excluding the mouthpiece, this pipe is made from Ouryou Rikako's bones.\I see.\When I'm touching it like this...\my mind regains its youth.\The souls of my terrified prey give me energy.\You've overcome your body's aging.\I guess that just leaves your mind? response:	Yeah, that's right.
context: Excluding the mouthpiece, this pipe is made from Ouryou Rikako's bones.\I see.\When I'm touching it like this...\my mind regains its youth.\The souls of my terrified prey give me energy.\You've overcome your body's aging.\I guess that just leaves your mind?\Yeah, that's right. response:	You maintain a healthy and sound life...
context: I see.\When I'm touching it like this...\my mind regains its youth.\The souls of my terrified prey give me energy.\You've overcome your body's aging.\I guess that just leaves your mind?\Yeah, that's right.\You maintain a healthy and sound life... response:	by sacrificing other lives.
context: When I'm touching it like this...\my mind regains its youth.\The souls of my terrified prey give me energy.\You've overcome your body's aging.\I guess that just leaves your mind?\Yeah, that's right.\You maintain a healthy and sound life...\by sacrificing other lives. response:	But if people only seek youth for their bodies
context: my mind regains its youth.\The souls of my terrified prey give me energy.\You've overcome your body's aging.\I guess that just leaves your mind?\Yeah, that's right.\You maintain a healthy and sound life...\by sacrificing other lives.\But if people only seek youth for their bodies response:	and lose sight of the means to cultivate their minds,
context: The souls of my terrified prey give me energy.\You've overcome your body's aging.\I guess that just leaves your mind?\Yeah, that's right.\You maintain a healthy and sound life...\by sacrificing other lives.\But if people only seek youth for their bodies\and lose sight of the means to cultivate their minds, response:	it's only natural that it would lead to an increase in the number of living dead.
context: You've overcome your body's aging.\I guess that just leaves your mind?\Yeah, that's right.\You maintain a healthy and sound life...\by sacrificing other lives.\But if people only seek youth for their bodies\and lose sight of the means to cultivate their minds,\it's only natural that it would lead to an increase in the number of living dead. response:	Don't you think it's foolish?
context: I guess that just leaves your mind?\Yeah, that's right.\You maintain a healthy and sound life...\by sacrificing other lives.\But if people only seek youth for their bodies\and lose sight of the means to cultivate their minds,\it's only natural that it would lead to an increase in the number of living dead.\Don't you think it's foolish? response:	The energy that comes from the thrill of the hunt...
context: Yeah, that's right.\You maintain a healthy and sound life...\by sacrificing other lives.\But if people only seek youth for their bodies\and lose sight of the means to cultivate their minds,\it's only natural that it would lead to an increase in the number of living dead.\Don't you think it's foolish?\The energy that comes from the thrill of the hunt... response:	It's a dangerous reward that goes hand in hand with death, isn't it?
context: You maintain a healthy and sound life...\by sacrificing other lives.\But if people only seek youth for their bodies\and lose sight of the means to cultivate their minds,\it's only natural that it would lead to an increase in the number of living dead.\Don't you think it's foolish?\The energy that comes from the thrill of the hunt...\It's a dangerous reward that goes hand in hand with death, isn't it? response:	That's right.
context: by sacrificing other lives.\But if people only seek youth for their bodies\and lose sight of the means to cultivate their minds,\it's only natural that it would lead to an increase in the number of living dead.\Don't you think it's foolish?\The energy that comes from the thrill of the hunt...\It's a dangerous reward that goes hand in hand with death, isn't it?\That's right. response:	In hunting, the tougher your prey is, the fresher the youth you can gain from it.
context: But if people only seek youth for their bodies\and lose sight of the means to cultivate their minds,\it's only natural that it would lead to an increase in the number of living dead.\Don't you think it's foolish?\The energy that comes from the thrill of the hunt...\It's a dangerous reward that goes hand in hand with death, isn't it?\That's right.\In hunting, the tougher your prey is, the fresher the youth you can gain from it. response:	With all that in mind,
context: and lose sight of the means to cultivate their minds,\it's only natural that it would lead to an increase in the number of living dead.\Don't you think it's foolish?\The energy that comes from the thrill of the hunt...\It's a dangerous reward that goes hand in hand with death, isn't it?\That's right.\In hunting, the tougher your prey is, the fresher the youth you can gain from it.\With all that in mind, response:	I think I can arrange for your next prey to be most exquisite indeed.
context: it's only natural that it would lead to an increase in the number of living dead.\Don't you think it's foolish?\The energy that comes from the thrill of the hunt...\It's a dangerous reward that goes hand in hand with death, isn't it?\That's right.\In hunting, the tougher your prey is, the fresher the youth you can gain from it.\With all that in mind,\I think I can arrange for your next prey to be most exquisite indeed. response:	Oh?
context: Don't you think it's foolish?\The energy that comes from the thrill of the hunt...\It's a dangerous reward that goes hand in hand with death, isn't it?\That's right.\In hunting, the tougher your prey is, the fresher the youth you can gain from it.\With all that in mind,\I think I can arrange for your next prey to be most exquisite indeed.\Oh? response:	It's an Enforcer from the Public Safety Bureau.
context: The energy that comes from the thrill of the hunt...\It's a dangerous reward that goes hand in hand with death, isn't it?\That's right.\In hunting, the tougher your prey is, the fresher the youth you can gain from it.\With all that in mind,\I think I can arrange for your next prey to be most exquisite indeed.\Oh?\It's an Enforcer from the Public Safety Bureau. response:	The Bureau?
context: It's a dangerous reward that goes hand in hand with death, isn't it?\That's right.\In hunting, the tougher your prey is, the fresher the youth you can gain from it.\With all that in mind,\I think I can arrange for your next prey to be most exquisite indeed.\Oh?\It's an Enforcer from the Public Safety Bureau.\The Bureau? response:	His name is...
context: That's right.\In hunting, the tougher your prey is, the fresher the youth you can gain from it.\With all that in mind,\I think I can arrange for your next prey to be most exquisite indeed.\Oh?\It's an Enforcer from the Public Safety Bureau.\The Bureau?\His name is... response:	In the end, I guess checking Professor Saiga's lecture attendees list didn't help much.
context: In hunting, the tougher your prey is, the fresher the youth you can gain from it.\With all that in mind,\I think I can arrange for your next prey to be most exquisite indeed.\Oh?\It's an Enforcer from the Public Safety Bureau.\The Bureau?\His name is...\In the end, I guess checking Professor Saiga's lecture attendees list didn't help much. response:	That's how it goes sometimes.
context: With all that in mind,\I think I can arrange for your next prey to be most exquisite indeed.\Oh?\It's an Enforcer from the Public Safety Bureau.\The Bureau?\His name is...\In the end, I guess checking Professor Saiga's lecture attendees list didn't help much.\That's how it goes sometimes. response:	But if Makishima is a living person, he's left a trace somewhere for sure.
context: I think I can arrange for your next prey to be most exquisite indeed.\Oh?\It's an Enforcer from the Public Safety Bureau.\The Bureau?\His name is...\In the end, I guess checking Professor Saiga's lecture attendees list didn't help much.\That's how it goes sometimes.\But if Makishima is a living person, he's left a trace somewhere for sure. response:	I heard that you brought Inspector Tsunemori to Saiga Jouji.
context: Oh?\It's an Enforcer from the Public Safety Bureau.\The Bureau?\His name is...\In the end, I guess checking Professor Saiga's lecture attendees list didn't help much.\That's how it goes sometimes.\But if Makishima is a living person, he's left a trace somewhere for sure.\I heard that you brought Inspector Tsunemori to Saiga Jouji. response:	Yeah.
context: It's an Enforcer from the Public Safety Bureau.\The Bureau?\His name is...\In the end, I guess checking Professor Saiga's lecture attendees list didn't help much.\That's how it goes sometimes.\But if Makishima is a living person, he's left a trace somewhere for sure.\I heard that you brought Inspector Tsunemori to Saiga Jouji.\Yeah. response:	He did it because I asked him to.
context: The Bureau?\His name is...\In the end, I guess checking Professor Saiga's lecture attendees list didn't help much.\That's how it goes sometimes.\But if Makishima is a living person, he's left a trace somewhere for sure.\I heard that you brought Inspector Tsunemori to Saiga Jouji.\Yeah.\He did it because I asked him to. response:	What are you playing at? Are you trying to drag her into your problem,
context: His name is...\In the end, I guess checking Professor Saiga's lecture attendees list didn't help much.\That's how it goes sometimes.\But if Makishima is a living person, he's left a trace somewhere for sure.\I heard that you brought Inspector Tsunemori to Saiga Jouji.\Yeah.\He did it because I asked him to.\What are you playing at? Are you trying to drag her into your problem, response:	making her a latent criminal who strayed from the right path, like you?
context: In the end, I guess checking Professor Saiga's lecture attendees list didn't help much.\That's how it goes sometimes.\But if Makishima is a living person, he's left a trace somewhere for sure.\I heard that you brought Inspector Tsunemori to Saiga Jouji.\Yeah.\He did it because I asked him to.\What are you playing at? Are you trying to drag her into your problem,\making her a latent criminal who strayed from the right path, like you? response:	Wait a minute!
context: That's how it goes sometimes.\But if Makishima is a living person, he's left a trace somewhere for sure.\I heard that you brought Inspector Tsunemori to Saiga Jouji.\Yeah.\He did it because I asked him to.\What are you playing at? Are you trying to drag her into your problem,\making her a latent criminal who strayed from the right path, like you?\Wait a minute! response:	Why are you treating me like a child?
context: But if Makishima is a living person, he's left a trace somewhere for sure.\I heard that you brought Inspector Tsunemori to Saiga Jouji.\Yeah.\He did it because I asked him to.\What are you playing at? Are you trying to drag her into your problem,\making her a latent criminal who strayed from the right path, like you?\Wait a minute!\Why are you treating me like a child? response:	Because you are a child!
context: I heard that you brought Inspector Tsunemori to Saiga Jouji.\Yeah.\He did it because I asked him to.\What are you playing at? Are you trying to drag her into your problem,\making her a latent criminal who strayed from the right path, like you?\Wait a minute!\Why are you treating me like a child?\Because you are a child! response:	A brat who's confused about anything and everything!
context: Yeah.\He did it because I asked him to.\What are you playing at? Are you trying to drag her into your problem,\making her a latent criminal who strayed from the right path, like you?\Wait a minute!\Why are you treating me like a child?\Because you are a child!\A brat who's confused about anything and everything! response:	Why do you think we split the force into Inspectors and Enforcers in the first place?
context: He did it because I asked him to.\What are you playing at? Are you trying to drag her into your problem,\making her a latent criminal who strayed from the right path, like you?\Wait a minute!\Why are you treating me like a child?\Because you are a child!\A brat who's confused about anything and everything!\Why do you think we split the force into Inspectors and Enforcers in the first place? response:	It's to avoid the risk of having healthy people's Psycho-Passes get clouded by criminal investigations.
context: What are you playing at? Are you trying to drag her into your problem,\making her a latent criminal who strayed from the right path, like you?\Wait a minute!\Why are you treating me like a child?\Because you are a child!\A brat who's confused about anything and everything!\Why do you think we split the force into Inspectors and Enforcers in the first place?\It's to avoid the risk of having healthy people's Psycho-Passes get clouded by criminal investigations. response:	We use latent criminals, who can never return to society, in our place.
context: making her a latent criminal who strayed from the right path, like you?\Wait a minute!\Why are you treating me like a child?\Because you are a child!\A brat who's confused about anything and everything!\Why do you think we split the force into Inspectors and Enforcers in the first place?\It's to avoid the risk of having healthy people's Psycho-Passes get clouded by criminal investigations.\We use latent criminals, who can never return to society, in our place. response:	That's precisely how you're able to fulfill your duty while keeping a healthy mind!
context: Wait a minute!\Why are you treating me like a child?\Because you are a child!\A brat who's confused about anything and everything!\Why do you think we split the force into Inspectors and Enforcers in the first place?\It's to avoid the risk of having healthy people's Psycho-Passes get clouded by criminal investigations.\We use latent criminals, who can never return to society, in our place.\That's precisely how you're able to fulfill your duty while keeping a healthy mind! response:	That's not teamwork!
context: Why are you treating me like a child?\Because you are a child!\A brat who's confused about anything and everything!\Why do you think we split the force into Inspectors and Enforcers in the first place?\It's to avoid the risk of having healthy people's Psycho-Passes get clouded by criminal investigations.\We use latent criminals, who can never return to society, in our place.\That's precisely how you're able to fulfill your duty while keeping a healthy mind!\That's not teamwork! response:	Are we here to solve crimes or protect our own Psycho-Passes?
context: Because you are a child!\A brat who's confused about anything and everything!\Why do you think we split the force into Inspectors and Enforcers in the first place?\It's to avoid the risk of having healthy people's Psycho-Passes get clouded by criminal investigations.\We use latent criminals, who can never return to society, in our place.\That's precisely how you're able to fulfill your duty while keeping a healthy mind!\That's not teamwork!\Are we here to solve crimes or protect our own Psycho-Passes? response:	Which one do you think matters more?!
context: A brat who's confused about anything and everything!\Why do you think we split the force into Inspectors and Enforcers in the first place?\It's to avoid the risk of having healthy people's Psycho-Passes get clouded by criminal investigations.\We use latent criminals, who can never return to society, in our place.\That's precisely how you're able to fulfill your duty while keeping a healthy mind!\That's not teamwork!\Are we here to solve crimes or protect our own Psycho-Passes?\Which one do you think matters more?! response:	Do you want to throw away your career?
context: Why do you think we split the force into Inspectors and Enforcers in the first place?\It's to avoid the risk of having healthy people's Psycho-Passes get clouded by criminal investigations.\We use latent criminals, who can never return to society, in our place.\That's precisely how you're able to fulfill your duty while keeping a healthy mind!\That's not teamwork!\Are we here to solve crimes or protect our own Psycho-Passes?\Which one do you think matters more?!\Do you want to throw away your career? response:	Do you intend to sacrifice everything you've built so far?
context: It's to avoid the risk of having healthy people's Psycho-Passes get clouded by criminal investigations.\We use latent criminals, who can never return to society, in our place.\That's precisely how you're able to fulfill your duty while keeping a healthy mind!\That's not teamwork!\Are we here to solve crimes or protect our own Psycho-Passes?\Which one do you think matters more?!\Do you want to throw away your career?\Do you intend to sacrifice everything you've built so far? response:	It's...
context: We use latent criminals, who can never return to society, in our place.\That's precisely how you're able to fulfill your duty while keeping a healthy mind!\That's not teamwork!\Are we here to solve crimes or protect our own Psycho-Passes?\Which one do you think matters more?!\Do you want to throw away your career?\Do you intend to sacrifice everything you've built so far?\It's... response:	It's certainly true that I'm new here.
context: That's precisely how you're able to fulfill your duty while keeping a healthy mind!\That's not teamwork!\Are we here to solve crimes or protect our own Psycho-Passes?\Which one do you think matters more?!\Do you want to throw away your career?\Do you intend to sacrifice everything you've built so far?\It's...\It's certainly true that I'm new here. response:	You're my senior, Inspector Ginoza, and I respect that.
context: That's not teamwork!\Are we here to solve crimes or protect our own Psycho-Passes?\Which one do you think matters more?!\Do you want to throw away your career?\Do you intend to sacrifice everything you've built so far?\It's...\It's certainly true that I'm new here.\You're my senior, Inspector Ginoza, and I respect that. response:	But please don't forget that we're on equal footing in terms of our rank!
context: Are we here to solve crimes or protect our own Psycho-Passes?\Which one do you think matters more?!\Do you want to throw away your career?\Do you intend to sacrifice everything you've built so far?\It's...\It's certainly true that I'm new here.\You're my senior, Inspector Ginoza, and I respect that.\But please don't forget that we're on equal footing in terms of our rank! response:	I'm managing my Hue just fine.
context: Which one do you think matters more?!\Do you want to throw away your career?\Do you intend to sacrifice everything you've built so far?\It's...\It's certainly true that I'm new here.\You're my senior, Inspector Ginoza, and I respect that.\But please don't forget that we're on equal footing in terms of our rank!\I'm managing my Hue just fine. response:	You may be my senior, but I'd appreciate it if you would refrain from questioning my ability
context: Do you want to throw away your career?\Do you intend to sacrifice everything you've built so far?\It's...\It's certainly true that I'm new here.\You're my senior, Inspector Ginoza, and I respect that.\But please don't forget that we're on equal footing in terms of our rank!\I'm managing my Hue just fine.\You may be my senior, but I'd appreciate it if you would refrain from questioning my ability response:	at the workplace and in front of the Enforcers!
context: Do you intend to sacrifice everything you've built so far?\It's...\It's certainly true that I'm new here.\You're my senior, Inspector Ginoza, and I respect that.\But please don't forget that we're on equal footing in terms of our rank!\I'm managing my Hue just fine.\You may be my senior, but I'd appreciate it if you would refrain from questioning my ability\at the workplace and in front of the Enforcers! response:	I can't believe he...
context: It's...\It's certainly true that I'm new here.\You're my senior, Inspector Ginoza, and I respect that.\But please don't forget that we're on equal footing in terms of our rank!\I'm managing my Hue just fine.\You may be my senior, but I'd appreciate it if you would refrain from questioning my ability\at the workplace and in front of the Enforcers!\I can't believe he... response:	Where are you going?
context: It's certainly true that I'm new here.\You're my senior, Inspector Ginoza, and I respect that.\But please don't forget that we're on equal footing in terms of our rank!\I'm managing my Hue just fine.\You may be my senior, but I'd appreciate it if you would refrain from questioning my ability\at the workplace and in front of the Enforcers!\I can't believe he...\Where are you going? response:	I'm going to file a complaint with the bureau chief.
context: You're my senior, Inspector Ginoza, and I respect that.\But please don't forget that we're on equal footing in terms of our rank!\I'm managing my Hue just fine.\You may be my senior, but I'd appreciate it if you would refrain from questioning my ability\at the workplace and in front of the Enforcers!\I can't believe he...\Where are you going?\I'm going to file a complaint with the bureau chief. response:	Any chance of you passing on that, missy?
context: But please don't forget that we're on equal footing in terms of our rank!\I'm managing my Hue just fine.\You may be my senior, but I'd appreciate it if you would refrain from questioning my ability\at the workplace and in front of the Enforcers!\I can't believe he...\Where are you going?\I'm going to file a complaint with the bureau chief.\Any chance of you passing on that, missy? response:	But...
context: I'm managing my Hue just fine.\You may be my senior, but I'd appreciate it if you would refrain from questioning my ability\at the workplace and in front of the Enforcers!\I can't believe he...\Where are you going?\I'm going to file a complaint with the bureau chief.\Any chance of you passing on that, missy?\But... response:	Inspector Ginoza's father is a latent criminal.
context: You may be my senior, but I'd appreciate it if you would refrain from questioning my ability\at the workplace and in front of the Enforcers!\I can't believe he...\Where are you going?\I'm going to file a complaint with the bureau chief.\Any chance of you passing on that, missy?\But...\Inspector Ginoza's father is a latent criminal. response:	What?
context: at the workplace and in front of the Enforcers!\I can't believe he...\Where are you going?\I'm going to file a complaint with the bureau chief.\Any chance of you passing on that, missy?\But...\Inspector Ginoza's father is a latent criminal.\What? response:	He was a child when the Sibyl System had just been put into operation.
context: I can't believe he...\Where are you going?\I'm going to file a complaint with the bureau chief.\Any chance of you passing on that, missy?\But...\Inspector Ginoza's father is a latent criminal.\What?\He was a child when the Sibyl System had just been put into operation. response:	Terrible misunderstandings and rumors about latent criminals were common in those days.
context: Where are you going?\I'm going to file a complaint with the bureau chief.\Any chance of you passing on that, missy?\But...\Inspector Ginoza's father is a latent criminal.\What?\He was a child when the Sibyl System had just been put into operation.\Terrible misunderstandings and rumors about latent criminals were common in those days. response:	If a family member happened to show a high Crime Coefficient,
context: I'm going to file a complaint with the bureau chief.\Any chance of you passing on that, missy?\But...\Inspector Ginoza's father is a latent criminal.\What?\He was a child when the Sibyl System had just been put into operation.\Terrible misunderstandings and rumors about latent criminals were common in those days.\If a family member happened to show a high Crime Coefficient, response:	that alone caused the rest of the family to be treated as if they were the same.
context: Any chance of you passing on that, missy?\But...\Inspector Ginoza's father is a latent criminal.\What?\He was a child when the Sibyl System had just been put into operation.\Terrible misunderstandings and rumors about latent criminals were common in those days.\If a family member happened to show a high Crime Coefficient,\that alone caused the rest of the family to be treated as if they were the same. response:	I'm sure he suffered quite a bit.
context: But...\Inspector Ginoza's father is a latent criminal.\What?\He was a child when the Sibyl System had just been put into operation.\Terrible misunderstandings and rumors about latent criminals were common in those days.\If a family member happened to show a high Crime Coefficient,\that alone caused the rest of the family to be treated as if they were the same.\I'm sure he suffered quite a bit. response:	When a detective gets deeply involved in an investigation,
context: Inspector Ginoza's father is a latent criminal.\What?\He was a child when the Sibyl System had just been put into operation.\Terrible misunderstandings and rumors about latent criminals were common in those days.\If a family member happened to show a high Crime Coefficient,\that alone caused the rest of the family to be treated as if they were the same.\I'm sure he suffered quite a bit.\When a detective gets deeply involved in an investigation, response:	in the end the Sibyl System starts keeping an eye on them just like it does with the criminals.
context: What?\He was a child when the Sibyl System had just been put into operation.\Terrible misunderstandings and rumors about latent criminals were common in those days.\If a family member happened to show a high Crime Coefficient,\that alone caused the rest of the family to be treated as if they were the same.\I'm sure he suffered quite a bit.\When a detective gets deeply involved in an investigation,\in the end the Sibyl System starts keeping an eye on them just like it does with the criminals. response:	Remember what I said about committing crimes and cracking down on them?
context: He was a child when the Sibyl System had just been put into operation.\Terrible misunderstandings and rumors about latent criminals were common in those days.\If a family member happened to show a high Crime Coefficient,\that alone caused the rest of the family to be treated as if they were the same.\I'm sure he suffered quite a bit.\When a detective gets deeply involved in an investigation,\in the end the Sibyl System starts keeping an eye on them just like it does with the criminals.\Remember what I said about committing crimes and cracking down on them? response:	They're two sides of the same coin. The phenomenon called crime.
context: Terrible misunderstandings and rumors about latent criminals were common in those days.\If a family member happened to show a high Crime Coefficient,\that alone caused the rest of the family to be treated as if they were the same.\I'm sure he suffered quite a bit.\When a detective gets deeply involved in an investigation,\in the end the Sibyl System starts keeping an eye on them just like it does with the criminals.\Remember what I said about committing crimes and cracking down on them?\They're two sides of the same coin. The phenomenon called crime. response:	We have Enforcers now, but before they created that position,
context: If a family member happened to show a high Crime Coefficient,\that alone caused the rest of the family to be treated as if they were the same.\I'm sure he suffered quite a bit.\When a detective gets deeply involved in an investigation,\in the end the Sibyl System starts keeping an eye on them just like it does with the criminals.\Remember what I said about committing crimes and cracking down on them?\They're two sides of the same coin. The phenomenon called crime.\We have Enforcers now, but before they created that position, response:	there were many detectives who ended up as latent criminals that way.
context: that alone caused the rest of the family to be treated as if they were the same.\I'm sure he suffered quite a bit.\When a detective gets deeply involved in an investigation,\in the end the Sibyl System starts keeping an eye on them just like it does with the criminals.\Remember what I said about committing crimes and cracking down on them?\They're two sides of the same coin. The phenomenon called crime.\We have Enforcers now, but before they created that position,\there were many detectives who ended up as latent criminals that way. response:	Inspector Ginoza's father was one of them.
context: I'm sure he suffered quite a bit.\When a detective gets deeply involved in an investigation,\in the end the Sibyl System starts keeping an eye on them just like it does with the criminals.\Remember what I said about committing crimes and cracking down on them?\They're two sides of the same coin. The phenomenon called crime.\We have Enforcers now, but before they created that position,\there were many detectives who ended up as latent criminals that way.\Inspector Ginoza's father was one of them. response:	I didn't know...
context: When a detective gets deeply involved in an investigation,\in the end the Sibyl System starts keeping an eye on them just like it does with the criminals.\Remember what I said about committing crimes and cracking down on them?\They're two sides of the same coin. The phenomenon called crime.\We have Enforcers now, but before they created that position,\there were many detectives who ended up as latent criminals that way.\Inspector Ginoza's father was one of them.\I didn't know... response:	That's why he won't allow the other Inspectors to take risks on their own.
context: in the end the Sibyl System starts keeping an eye on them just like it does with the criminals.\Remember what I said about committing crimes and cracking down on them?\They're two sides of the same coin. The phenomenon called crime.\We have Enforcers now, but before they created that position,\there were many detectives who ended up as latent criminals that way.\Inspector Ginoza's father was one of them.\I didn't know...\That's why he won't allow the other Inspectors to take risks on their own. response:	Even then, Kougami, his former colleague, suffered the same fate.
context: Remember what I said about committing crimes and cracking down on them?\They're two sides of the same coin. The phenomenon called crime.\We have Enforcers now, but before they created that position,\there were many detectives who ended up as latent criminals that way.\Inspector Ginoza's father was one of them.\I didn't know...\That's why he won't allow the other Inspectors to take risks on their own.\Even then, Kougami, his former colleague, suffered the same fate. response:	Yes, I know.
context: They're two sides of the same coin. The phenomenon called crime.\We have Enforcers now, but before they created that position,\there were many detectives who ended up as latent criminals that way.\Inspector Ginoza's father was one of them.\I didn't know...\That's why he won't allow the other Inspectors to take risks on their own.\Even then, Kougami, his former colleague, suffered the same fate.\Yes, I know. response:	He feels as though he was betrayed twice.
context: We have Enforcers now, but before they created that position,\there were many detectives who ended up as latent criminals that way.\Inspector Ginoza's father was one of them.\I didn't know...\That's why he won't allow the other Inspectors to take risks on their own.\Even then, Kougami, his former colleague, suffered the same fate.\Yes, I know.\He feels as though he was betrayed twice. response:	First by his father and then by his colleague.
context: there were many detectives who ended up as latent criminals that way.\Inspector Ginoza's father was one of them.\I didn't know...\That's why he won't allow the other Inspectors to take risks on their own.\Even then, Kougami, his former colleague, suffered the same fate.\Yes, I know.\He feels as though he was betrayed twice.\First by his father and then by his colleague. response:	That's why he acts like that toward you.
context: Inspector Ginoza's father was one of them.\I didn't know...\That's why he won't allow the other Inspectors to take risks on their own.\Even then, Kougami, his former colleague, suffered the same fate.\Yes, I know.\He feels as though he was betrayed twice.\First by his father and then by his colleague.\That's why he acts like that toward you. response:	But even so...
context: I didn't know...\That's why he won't allow the other Inspectors to take risks on their own.\Even then, Kougami, his former colleague, suffered the same fate.\Yes, I know.\He feels as though he was betrayed twice.\First by his father and then by his colleague.\That's why he acts like that toward you.\But even so... response:	You're right.
context: That's why he won't allow the other Inspectors to take risks on their own.\Even then, Kougami, his former colleague, suffered the same fate.\Yes, I know.\He feels as though he was betrayed twice.\First by his father and then by his colleague.\That's why he acts like that toward you.\But even so...\You're right. response:	Don't you have family and friends of your own, missy?
context: Even then, Kougami, his former colleague, suffered the same fate.\Yes, I know.\He feels as though he was betrayed twice.\First by his father and then by his colleague.\That's why he acts like that toward you.\But even so...\You're right.\Don't you have family and friends of your own, missy? response:	If your Psycho-Pass gets clouded,
context: Yes, I know.\He feels as though he was betrayed twice.\First by his father and then by his colleague.\That's why he acts like that toward you.\But even so...\You're right.\Don't you have family and friends of your own, missy?\If your Psycho-Pass gets clouded, response:	those people will suffer the same hardships Nobuchika did.
context: He feels as though he was betrayed twice.\First by his father and then by his colleague.\That's why he acts like that toward you.\But even so...\You're right.\Don't you have family and friends of your own, missy?\If your Psycho-Pass gets clouded,\those people will suffer the same hardships Nobuchika did. response:	We Enforcers are here to prevent that.
context: First by his father and then by his colleague.\That's why he acts like that toward you.\But even so...\You're right.\Don't you have family and friends of your own, missy?\If your Psycho-Pass gets clouded,\those people will suffer the same hardships Nobuchika did.\We Enforcers are here to prevent that. response:	Do you think Kougami feels that way too?
context: That's why he acts like that toward you.\But even so...\You're right.\Don't you have family and friends of your own, missy?\If your Psycho-Pass gets clouded,\those people will suffer the same hardships Nobuchika did.\We Enforcers are here to prevent that.\Do you think Kougami feels that way too? response:	He used to.
context: But even so...\You're right.\Don't you have family and friends of your own, missy?\If your Psycho-Pass gets clouded,\those people will suffer the same hardships Nobuchika did.\We Enforcers are here to prevent that.\Do you think Kougami feels that way too?\He used to. response:	But now...
context: You're right.\Don't you have family and friends of your own, missy?\If your Psycho-Pass gets clouded,\those people will suffer the same hardships Nobuchika did.\We Enforcers are here to prevent that.\Do you think Kougami feels that way too?\He used to.\But now... response:	I think he's oblivious to anything that's not related to that Makishima guy.
context: Don't you have family and friends of your own, missy?\If your Psycho-Pass gets clouded,\those people will suffer the same hardships Nobuchika did.\We Enforcers are here to prevent that.\Do you think Kougami feels that way too?\He used to.\But now...\I think he's oblivious to anything that's not related to that Makishima guy. response:	I've no interest in capturing him alive.
context: If your Psycho-Pass gets clouded,\those people will suffer the same hardships Nobuchika did.\We Enforcers are here to prevent that.\Do you think Kougami feels that way too?\He used to.\But now...\I think he's oblivious to anything that's not related to that Makishima guy.\I've no interest in capturing him alive. response:	Is that okay with you?
context: those people will suffer the same hardships Nobuchika did.\We Enforcers are here to prevent that.\Do you think Kougami feels that way too?\He used to.\But now...\I think he's oblivious to anything that's not related to that Makishima guy.\I've no interest in capturing him alive.\Is that okay with you? response:	Of course.
context: We Enforcers are here to prevent that.\Do you think Kougami feels that way too?\He used to.\But now...\I think he's oblivious to anything that's not related to that Makishima guy.\I've no interest in capturing him alive.\Is that okay with you?\Of course. response:	What would even be the point?
context: Do you think Kougami feels that way too?\He used to.\But now...\I think he's oblivious to anything that's not related to that Makishima guy.\I've no interest in capturing him alive.\Is that okay with you?\Of course.\What would even be the point? response:	Kougami Shinya...
context: He used to.\But now...\I think he's oblivious to anything that's not related to that Makishima guy.\I've no interest in capturing him alive.\Is that okay with you?\Of course.\What would even be the point?\Kougami Shinya... response:	That name always seems to bring a smile to your face.
context: But now...\I think he's oblivious to anything that's not related to that Makishima guy.\I've no interest in capturing him alive.\Is that okay with you?\Of course.\What would even be the point?\Kougami Shinya...\That name always seems to bring a smile to your face. response:	It seems all fairy tales are dead
context: I think he's oblivious to anything that's not related to that Makishima guy.\I've no interest in capturing him alive.\Is that okay with you?\Of course.\What would even be the point?\Kougami Shinya...\That name always seems to bring a smile to your face.\It seems all fairy tales are dead response:	It seems all fairy tales are dead
context: I've no interest in capturing him alive.\Is that okay with you?\Of course.\What would even be the point?\Kougami Shinya...\That name always seems to bring a smile to your face.\It seems all fairy tales are dead\It seems all fairy tales are dead response:	In a hospital ward of brick stones
context: Is that okay with you?\Of course.\What would even be the point?\Kougami Shinya...\That name always seems to bring a smile to your face.\It seems all fairy tales are dead\It seems all fairy tales are dead\In a hospital ward of brick stones response:	my voice is too coarse to sing
context: Of course.\What would even be the point?\Kougami Shinya...\That name always seems to bring a smile to your face.\It seems all fairy tales are dead\It seems all fairy tales are dead\In a hospital ward of brick stones\my voice is too coarse to sing response:	Outside in the foggy haze
context: What would even be the point?\Kougami Shinya...\That name always seems to bring a smile to your face.\It seems all fairy tales are dead\It seems all fairy tales are dead\In a hospital ward of brick stones\my voice is too coarse to sing\Outside in the foggy haze response:	a red moon glows
context: Kougami Shinya...\That name always seems to bring a smile to your face.\It seems all fairy tales are dead\It seems all fairy tales are dead\In a hospital ward of brick stones\my voice is too coarse to sing\Outside in the foggy haze\a red moon glows response:	Look at me
context: That name always seems to bring a smile to your face.\It seems all fairy tales are dead\It seems all fairy tales are dead\In a hospital ward of brick stones\my voice is too coarse to sing\Outside in the foggy haze\a red moon glows\Look at me response:	Do not avert your gaze
context: It seems all fairy tales are dead\It seems all fairy tales are dead\In a hospital ward of brick stones\my voice is too coarse to sing\Outside in the foggy haze\a red moon glows\Look at me\Do not avert your gaze response:	Behind black bars
context: It seems all fairy tales are dead\In a hospital ward of brick stones\my voice is too coarse to sing\Outside in the foggy haze\a red moon glows\Look at me\Do not avert your gaze\Behind black bars response:	I was born
context: In a hospital ward of brick stones\my voice is too coarse to sing\Outside in the foggy haze\a red moon glows\Look at me\Do not avert your gaze\Behind black bars\I was born response:	I wish there were a punishment for evil
context: my voice is too coarse to sing\Outside in the foggy haze\a red moon glows\Look at me\Do not avert your gaze\Behind black bars\I was born\I wish there were a punishment for evil response:	Always I need you
context: Outside in the foggy haze\a red moon glows\Look at me\Do not avert your gaze\Behind black bars\I was born\I wish there were a punishment for evil\Always I need you response:	Now, grant us justice
context: a red moon glows\Look at me\Do not avert your gaze\Behind black bars\I was born\I wish there were a punishment for evil\Always I need you\Now, grant us justice response:	before chaos takes us all
context: Look at me\Do not avert your gaze\Behind black bars\I was born\I wish there were a punishment for evil\Always I need you\Now, grant us justice\before chaos takes us all response:	Pay the price of fate and let us go together,
context: Do not avert your gaze\Behind black bars\I was born\I wish there were a punishment for evil\Always I need you\Now, grant us justice\before chaos takes us all\Pay the price of fate and let us go together, response:	nameless beasts
context: Behind black bars\I was born\I wish there were a punishment for evil\Always I need you\Now, grant us justice\before chaos takes us all\Pay the price of fate and let us go together,\nameless beasts response:	This is a world where the mental state and personal tendencies of humans can be quantified. While all sorts of inclinations are recorded and policed, these measured numbers used to judge people's souls are commonly called Psycho-Pass.
context: I was born\I wish there were a punishment for evil\Always I need you\Now, grant us justice\before chaos takes us all\Pay the price of fate and let us go together,\nameless beasts\This is a world where the mental state and personal tendencies of humans can be quantified. While all sorts of inclinations are recorded and policed, these measured numbers used to judge people's souls are commonly called Psycho-Pass. response:	This is a world where the mental state and personal tendencies of humans can be quantified. While all sorts of inclinations are recorded and policed, these measured numbers used to judge people's souls are commonly called Psycho-Pass.
context: I wish there were a punishment for evil\Always I need you\Now, grant us justice\before chaos takes us all\Pay the price of fate and let us go together,\nameless beasts\This is a world where the mental state and personal tendencies of humans can be quantified. While all sorts of inclinations are recorded and policed, these measured numbers used to judge people's souls are commonly called Psycho-Pass.\This is a world where the mental state and personal tendencies of humans can be quantified. While all sorts of inclinations are recorded and policed, these measured numbers used to judge people's souls are commonly called Psycho-Pass. response:	This story is a work of fiction. The names of all individuals and organizations that appear in this show are fictitious and any similarity to those in existence in the real world is purely coincidental.
context: Always I need you\Now, grant us justice\before chaos takes us all\Pay the price of fate and let us go together,\nameless beasts\This is a world where the mental state and personal tendencies of humans can be quantified. While all sorts of inclinations are recorded and policed, these measured numbers used to judge people's souls are commonly called Psycho-Pass.\This is a world where the mental state and personal tendencies of humans can be quantified. While all sorts of inclinations are recorded and policed, these measured numbers used to judge people's souls are commonly called Psycho-Pass.\This story is a work of fiction. The names of all individuals and organizations that appear in this show are fictitious and any similarity to those in existence in the real world is purely coincidental. response:	This story is a work of fiction. The names of all individuals and organizations that appear in this show are fictitious and any similarity to those in existence in the real world is purely coincidental.