context: Naraku had dispelled the barrier around his castle. response:	In otherwords, he had abandoned his castle
context: Naraku had dispelled the barrier around his castle.\In otherwords, he had abandoned his castle response:	and hid himself somewhere else.
context: Naraku had dispelled the barrier around his castle.\In otherwords, he had abandoned his castle\and hid himself somewhere else. response:	In the past, no matterwhere he hid,
context: Naraku had dispelled the barrier around his castle.\In otherwords, he had abandoned his castle\and hid himself somewhere else.\In the past, no matterwhere he hid, response:	I could sense the presence of his barrier.
context: Naraku had dispelled the barrier around his castle.\In otherwords, he had abandoned his castle\and hid himself somewhere else.\In the past, no matterwhere he hid,\I could sense the presence of his barrier. response:	But now, as though he had disappeared from this world,
context: Naraku had dispelled the barrier around his castle.\In otherwords, he had abandoned his castle\and hid himself somewhere else.\In the past, no matterwhere he hid,\I could sense the presence of his barrier.\But now, as though he had disappeared from this world, response:	there is absolutely no sign of Naraku.
context: Naraku had dispelled the barrier around his castle.\In otherwords, he had abandoned his castle\and hid himself somewhere else.\In the past, no matterwhere he hid,\I could sense the presence of his barrier.\But now, as though he had disappeared from this world,\there is absolutely no sign of Naraku. response:	There is something behind this.
context: Naraku had dispelled the barrier around his castle.\In otherwords, he had abandoned his castle\and hid himself somewhere else.\In the past, no matterwhere he hid,\I could sense the presence of his barrier.\But now, as though he had disappeared from this world,\there is absolutely no sign of Naraku.\There is something behind this. response:	I have had my soul collectors search forhis demonic aura.
context: In otherwords, he had abandoned his castle\and hid himself somewhere else.\In the past, no matterwhere he hid,\I could sense the presence of his barrier.\But now, as though he had disappeared from this world,\there is absolutely no sign of Naraku.\There is something behind this.\I have had my soul collectors search forhis demonic aura. response:	But they cannot detect a barrier.
context: and hid himself somewhere else.\In the past, no matterwhere he hid,\I could sense the presence of his barrier.\But now, as though he had disappeared from this world,\there is absolutely no sign of Naraku.\There is something behind this.\I have had my soul collectors search forhis demonic aura.\But they cannot detect a barrier. response:	A demonic aura of such size... how did he hide it?
context: In the past, no matterwhere he hid,\I could sense the presence of his barrier.\But now, as though he had disappeared from this world,\there is absolutely no sign of Naraku.\There is something behind this.\I have had my soul collectors search forhis demonic aura.\But they cannot detect a barrier.\A demonic aura of such size... how did he hide it? response:	Say, let's rest somewhere.
context: I could sense the presence of his barrier.\But now, as though he had disappeared from this world,\there is absolutely no sign of Naraku.\There is something behind this.\I have had my soul collectors search forhis demonic aura.\But they cannot detect a barrier.\A demonic aura of such size... how did he hide it?\Say, let's rest somewhere. response:	Not again?!
context: But now, as though he had disappeared from this world,\there is absolutely no sign of Naraku.\There is something behind this.\I have had my soul collectors search forhis demonic aura.\But they cannot detect a barrier.\A demonic aura of such size... how did he hide it?\Say, let's rest somewhere.\Not again?! response:	We just stopped to rest awhile ago!
context: there is absolutely no sign of Naraku.\There is something behind this.\I have had my soul collectors search forhis demonic aura.\But they cannot detect a barrier.\A demonic aura of such size... how did he hide it?\Say, let's rest somewhere.\Not again?!\We just stopped to rest awhile ago! response:	But it's raining.
context: There is something behind this.\I have had my soul collectors search forhis demonic aura.\But they cannot detect a barrier.\A demonic aura of such size... how did he hide it?\Say, let's rest somewhere.\Not again?!\We just stopped to rest awhile ago!\But it's raining. response:	What're you, made of paper or somethin'?
context: I have had my soul collectors search forhis demonic aura.\But they cannot detect a barrier.\A demonic aura of such size... how did he hide it?\Say, let's rest somewhere.\Not again?!\We just stopped to rest awhile ago!\But it's raining.\What're you, made of paper or somethin'? response:	You can't call this rain!
context: But they cannot detect a barrier.\A demonic aura of such size... how did he hide it?\Say, let's rest somewhere.\Not again?!\We just stopped to rest awhile ago!\But it's raining.\What're you, made of paper or somethin'?\You can't call this rain! response:	It's not only that.
context: A demonic aura of such size... how did he hide it?\Say, let's rest somewhere.\Not again?!\We just stopped to rest awhile ago!\But it's raining.\What're you, made of paper or somethin'?\You can't call this rain!\It's not only that. response:	Besides! You're riding that weird contraption.
context: Say, let's rest somewhere.\Not again?!\We just stopped to rest awhile ago!\But it's raining.\What're you, made of paper or somethin'?\You can't call this rain!\It's not only that.\Besides! You're riding that weird contraption. response:	You've got it easy!
context: Not again?!\We just stopped to rest awhile ago!\But it's raining.\What're you, made of paper or somethin'?\You can't call this rain!\It's not only that.\Besides! You're riding that weird contraption.\You've got it easy! response:	But!
context: We just stopped to rest awhile ago!\But it's raining.\What're you, made of paper or somethin'?\You can't call this rain!\It's not only that.\Besides! You're riding that weird contraption.\You've got it easy!\But! response:	If you ride this for a long time, yourbutt starts to hurt!
context: But it's raining.\What're you, made of paper or somethin'?\You can't call this rain!\It's not only that.\Besides! You're riding that weird contraption.\You've got it easy!\But!\If you ride this for a long time, yourbutt starts to hurt! response:	Geez!
context: What're you, made of paper or somethin'?\You can't call this rain!\It's not only that.\Besides! You're riding that weird contraption.\You've got it easy!\But!\If you ride this for a long time, yourbutt starts to hurt!\Geez! response:	Why'd you make me say it, stupid?!
context: You can't call this rain!\It's not only that.\Besides! You're riding that weird contraption.\You've got it easy!\But!\If you ride this for a long time, yourbutt starts to hurt!\Geez!\Why'd you make me say it, stupid?! response:	Huh?
context: It's not only that.\Besides! You're riding that weird contraption.\You've got it easy!\But!\If you ride this for a long time, yourbutt starts to hurt!\Geez!\Why'd you make me say it, stupid?!\Huh? response:	Inuyasha!
context: Besides! You're riding that weird contraption.\You've got it easy!\But!\If you ride this for a long time, yourbutt starts to hurt!\Geez!\Why'd you make me say it, stupid?!\Huh?\Inuyasha! response:	What if Kagome's butt gets deformed!?
context: You've got it easy!\But!\If you ride this for a long time, yourbutt starts to hurt!\Geez!\Why'd you make me say it, stupid?!\Huh?\Inuyasha!\What if Kagome's butt gets deformed!? response:	S-Shippo...
context: But!\If you ride this for a long time, yourbutt starts to hurt!\Geez!\Why'd you make me say it, stupid?!\Huh?\Inuyasha!\What if Kagome's butt gets deformed!?\S-Shippo... response:	Oh well...
context: If you ride this for a long time, yourbutt starts to hurt!\Geez!\Why'd you make me say it, stupid?!\Huh?\Inuyasha!\What if Kagome's butt gets deformed!?\S-Shippo...\Oh well... response:	But understand this.
context: Geez!\Why'd you make me say it, stupid?!\Huh?\Inuyasha!\What if Kagome's butt gets deformed!?\S-Shippo...\Oh well...\But understand this. response:	We start up again as soon as Kagome's butt returns to normal.
context: Why'd you make me say it, stupid?!\Huh?\Inuyasha!\What if Kagome's butt gets deformed!?\S-Shippo...\Oh well...\But understand this.\We start up again as soon as Kagome's butt returns to normal. response:	Got it?
context: Huh?\Inuyasha!\What if Kagome's butt gets deformed!?\S-Shippo...\Oh well...\But understand this.\We start up again as soon as Kagome's butt returns to normal.\Got it? response:	Inuyasha!
context: Inuyasha!\What if Kagome's butt gets deformed!?\S-Shippo...\Oh well...\But understand this.\We start up again as soon as Kagome's butt returns to normal.\Got it?\Inuyasha! response:	Sit!
context: What if Kagome's butt gets deformed!?\S-Shippo...\Oh well...\But understand this.\We start up again as soon as Kagome's butt returns to normal.\Got it?\Inuyasha!\Sit! response:	It's turning into a downpour.
context: S-Shippo...\Oh well...\But understand this.\We start up again as soon as Kagome's butt returns to normal.\Got it?\Inuyasha!\Sit!\It's turning into a downpour. response:	Let's look for shelter.
context: Oh well...\But understand this.\We start up again as soon as Kagome's butt returns to normal.\Got it?\Inuyasha!\Sit!\It's turning into a downpour.\Let's look for shelter. response:	Hey! Don't leave me! Hey!
context: But understand this.\We start up again as soon as Kagome's butt returns to normal.\Got it?\Inuyasha!\Sit!\It's turning into a downpour.\Let's look for shelter.\Hey! Don't leave me! Hey! response:	An evil apparition?
context: We start up again as soon as Kagome's butt returns to normal.\Got it?\Inuyasha!\Sit!\It's turning into a downpour.\Let's look for shelter.\Hey! Don't leave me! Hey!\An evil apparition? response:	Yes.
context: Got it?\Inuyasha!\Sit!\It's turning into a downpour.\Let's look for shelter.\Hey! Don't leave me! Hey!\An evil apparition?\Yes. response:	Several villagers have already been killed.
context: Inuyasha!\Sit!\It's turning into a downpour.\Let's look for shelter.\Hey! Don't leave me! Hey!\An evil apparition?\Yes.\Several villagers have already been killed. response:	Priestess, please put a spell on the apparition.
context: Sit!\It's turning into a downpour.\Let's look for shelter.\Hey! Don't leave me! Hey!\An evil apparition?\Yes.\Several villagers have already been killed.\Priestess, please put a spell on the apparition. response:	- Please! - Please!
context: It's turning into a downpour.\Let's look for shelter.\Hey! Don't leave me! Hey!\An evil apparition?\Yes.\Several villagers have already been killed.\Priestess, please put a spell on the apparition.\- Please! - Please! response:	The apparition lives in the misty swamp at the top of the mountain.
context: Let's look for shelter.\Hey! Don't leave me! Hey!\An evil apparition?\Yes.\Several villagers have already been killed.\Priestess, please put a spell on the apparition.\- Please! - Please!\The apparition lives in the misty swamp at the top of the mountain. response:	Please, Priestess!
context: Hey! Don't leave me! Hey!\An evil apparition?\Yes.\Several villagers have already been killed.\Priestess, please put a spell on the apparition.\- Please! - Please!\The apparition lives in the misty swamp at the top of the mountain.\Please, Priestess! response:	I understand. The misty swamp, you say?
context: An evil apparition?\Yes.\Several villagers have already been killed.\Priestess, please put a spell on the apparition.\- Please! - Please!\The apparition lives in the misty swamp at the top of the mountain.\Please, Priestess!\I understand. The misty swamp, you say? response:	So this is the place...
context: Yes.\Several villagers have already been killed.\Priestess, please put a spell on the apparition.\- Please! - Please!\The apparition lives in the misty swamp at the top of the mountain.\Please, Priestess!\I understand. The misty swamp, you say?\So this is the place... response:	I see...
context: Several villagers have already been killed.\Priestess, please put a spell on the apparition.\- Please! - Please!\The apparition lives in the misty swamp at the top of the mountain.\Please, Priestess!\I understand. The misty swamp, you say?\So this is the place...\I see... response:	There's an uncommon air about this place.
context: Priestess, please put a spell on the apparition.\- Please! - Please!\The apparition lives in the misty swamp at the top of the mountain.\Please, Priestess!\I understand. The misty swamp, you say?\So this is the place...\I see...\There's an uncommon air about this place. response:	What?
context: - Please! - Please!\The apparition lives in the misty swamp at the top of the mountain.\Please, Priestess!\I understand. The misty swamp, you say?\So this is the place...\I see...\There's an uncommon air about this place.\What? response:	This isn't the place.
context: The apparition lives in the misty swamp at the top of the mountain.\Please, Priestess!\I understand. The misty swamp, you say?\So this is the place...\I see...\There's an uncommon air about this place.\What?\This isn't the place. response:	I have been traveling around looking forareas with a demonic aura...
context: Please, Priestess!\I understand. The misty swamp, you say?\So this is the place...\I see...\There's an uncommon air about this place.\What?\This isn't the place.\I have been traveling around looking forareas with a demonic aura... response:	but I have not come across...
context: I understand. The misty swamp, you say?\So this is the place...\I see...\There's an uncommon air about this place.\What?\This isn't the place.\I have been traveling around looking forareas with a demonic aura...\but I have not come across... response:	any sign of Naraku.
context: So this is the place...\I see...\There's an uncommon air about this place.\What?\This isn't the place.\I have been traveling around looking forareas with a demonic aura...\but I have not come across...\any sign of Naraku. response:	With Naraku's disappearance,
context: I see...\There's an uncommon air about this place.\What?\This isn't the place.\I have been traveling around looking forareas with a demonic aura...\but I have not come across...\any sign of Naraku.\With Naraku's disappearance, response:	the numberof demons and apparitions has grown.
context: There's an uncommon air about this place.\What?\This isn't the place.\I have been traveling around looking forareas with a demonic aura...\but I have not come across...\any sign of Naraku.\With Naraku's disappearance,\the numberof demons and apparitions has grown. response:	Simply searching forplaces with a demonic aura
context: What?\This isn't the place.\I have been traveling around looking forareas with a demonic aura...\but I have not come across...\any sign of Naraku.\With Naraku's disappearance,\the numberof demons and apparitions has grown.\Simply searching forplaces with a demonic aura response:	is not the answerto capturing Naraku.
context: This isn't the place.\I have been traveling around looking forareas with a demonic aura...\but I have not come across...\any sign of Naraku.\With Naraku's disappearance,\the numberof demons and apparitions has grown.\Simply searching forplaces with a demonic aura\is not the answerto capturing Naraku. response:	Hey!
context: I have been traveling around looking forareas with a demonic aura...\but I have not come across...\any sign of Naraku.\With Naraku's disappearance,\the numberof demons and apparitions has grown.\Simply searching forplaces with a demonic aura\is not the answerto capturing Naraku.\Hey! response:	A human?
context: but I have not come across...\any sign of Naraku.\With Naraku's disappearance,\the numberof demons and apparitions has grown.\Simply searching forplaces with a demonic aura\is not the answerto capturing Naraku.\Hey!\A human? response:	He has a serious illness.
context: any sign of Naraku.\With Naraku's disappearance,\the numberof demons and apparitions has grown.\Simply searching forplaces with a demonic aura\is not the answerto capturing Naraku.\Hey!\A human?\He has a serious illness. response:	He does not have long to live.
context: With Naraku's disappearance,\the numberof demons and apparitions has grown.\Simply searching forplaces with a demonic aura\is not the answerto capturing Naraku.\Hey!\A human?\He has a serious illness.\He does not have long to live. response:	The villagers gave you a fat reward forexterminating the demon, huh?
context: the numberof demons and apparitions has grown.\Simply searching forplaces with a demonic aura\is not the answerto capturing Naraku.\Hey!\A human?\He has a serious illness.\He does not have long to live.\The villagers gave you a fat reward forexterminating the demon, huh? response:	Reward?
context: Simply searching forplaces with a demonic aura\is not the answerto capturing Naraku.\Hey!\A human?\He has a serious illness.\He does not have long to live.\The villagers gave you a fat reward forexterminating the demon, huh?\Reward? response:	No such thing.
context: is not the answerto capturing Naraku.\Hey!\A human?\He has a serious illness.\He does not have long to live.\The villagers gave you a fat reward forexterminating the demon, huh?\Reward?\No such thing. response:	Any amount will do.
context: Hey!\A human?\He has a serious illness.\He does not have long to live.\The villagers gave you a fat reward forexterminating the demon, huh?\Reward?\No such thing.\Any amount will do. response:	Leave all yourmoney.
context: A human?\He has a serious illness.\He does not have long to live.\The villagers gave you a fat reward forexterminating the demon, huh?\Reward?\No such thing.\Any amount will do.\Leave all yourmoney. response:	I don't have money.
context: He has a serious illness.\He does not have long to live.\The villagers gave you a fat reward forexterminating the demon, huh?\Reward?\No such thing.\Any amount will do.\Leave all yourmoney.\I don't have money. response:	There's no temple or shrine hereabouts.
context: He does not have long to live.\The villagers gave you a fat reward forexterminating the demon, huh?\Reward?\No such thing.\Any amount will do.\Leave all yourmoney.\I don't have money.\There's no temple or shrine hereabouts. response:	You're traveling without a farthing?
context: The villagers gave you a fat reward forexterminating the demon, huh?\Reward?\No such thing.\Any amount will do.\Leave all yourmoney.\I don't have money.\There's no temple or shrine hereabouts.\You're traveling without a farthing? response:	If you think I lie, go ahead and search me.
context: Reward?\No such thing.\Any amount will do.\Leave all yourmoney.\I don't have money.\There's no temple or shrine hereabouts.\You're traveling without a farthing?\If you think I lie, go ahead and search me. response:	Don't tell me you eat mist to survive?
context: No such thing.\Any amount will do.\Leave all yourmoney.\I don't have money.\There's no temple or shrine hereabouts.\You're traveling without a farthing?\If you think I lie, go ahead and search me.\Don't tell me you eat mist to survive? response:	Hmph... you could say that.
context: Any amount will do.\Leave all yourmoney.\I don't have money.\There's no temple or shrine hereabouts.\You're traveling without a farthing?\If you think I lie, go ahead and search me.\Don't tell me you eat mist to survive?\Hmph... you could say that. response:	Never mind then. Disappearfrom here.
context: Leave all yourmoney.\I don't have money.\There's no temple or shrine hereabouts.\You're traveling without a farthing?\If you think I lie, go ahead and search me.\Don't tell me you eat mist to survive?\Hmph... you could say that.\Never mind then. Disappearfrom here. response:	What're you looking at?
context: I don't have money.\There's no temple or shrine hereabouts.\You're traveling without a farthing?\If you think I lie, go ahead and search me.\Don't tell me you eat mist to survive?\Hmph... you could say that.\Never mind then. Disappearfrom here.\What're you looking at? response:	Go!
context: There's no temple or shrine hereabouts.\You're traveling without a farthing?\If you think I lie, go ahead and search me.\Don't tell me you eat mist to survive?\Hmph... you could say that.\Never mind then. Disappearfrom here.\What're you looking at?\Go! response:	A Sacred Jewel shard?
context: You're traveling without a farthing?\If you think I lie, go ahead and search me.\Don't tell me you eat mist to survive?\Hmph... you could say that.\Never mind then. Disappearfrom here.\What're you looking at?\Go!\A Sacred Jewel shard? response:	That shard is what keeps you alive.
context: If you think I lie, go ahead and search me.\Don't tell me you eat mist to survive?\Hmph... you could say that.\Never mind then. Disappearfrom here.\What're you looking at?\Go!\A Sacred Jewel shard?\That shard is what keeps you alive. response:	Isn't that so?
context: Don't tell me you eat mist to survive?\Hmph... you could say that.\Never mind then. Disappearfrom here.\What're you looking at?\Go!\A Sacred Jewel shard?\That shard is what keeps you alive.\Isn't that so? response:	I'll be seventy next year.
context: Hmph... you could say that.\Never mind then. Disappearfrom here.\What're you looking at?\Go!\A Sacred Jewel shard?\That shard is what keeps you alive.\Isn't that so?\I'll be seventy next year. response:	If the average man lives 50 years, I've lived too long.
context: Never mind then. Disappearfrom here.\What're you looking at?\Go!\A Sacred Jewel shard?\That shard is what keeps you alive.\Isn't that so?\I'll be seventy next year.\If the average man lives 50 years, I've lived too long. response:	But I can't die yet.
context: What're you looking at?\Go!\A Sacred Jewel shard?\That shard is what keeps you alive.\Isn't that so?\I'll be seventy next year.\If the average man lives 50 years, I've lived too long.\But I can't die yet. response:	As long as I have this Sacred Jewel shard...
context: Go!\A Sacred Jewel shard?\That shard is what keeps you alive.\Isn't that so?\I'll be seventy next year.\If the average man lives 50 years, I've lived too long.\But I can't die yet.\As long as I have this Sacred Jewel shard... response:	What do you intend to do in that condition?
context: A Sacred Jewel shard?\That shard is what keeps you alive.\Isn't that so?\I'll be seventy next year.\If the average man lives 50 years, I've lived too long.\But I can't die yet.\As long as I have this Sacred Jewel shard...\What do you intend to do in that condition? response:	Find my death place...
context: That shard is what keeps you alive.\Isn't that so?\I'll be seventy next year.\If the average man lives 50 years, I've lived too long.\But I can't die yet.\As long as I have this Sacred Jewel shard...\What do you intend to do in that condition?\Find my death place... response:	Drink this. It'll ease the pain.
context: Isn't that so?\I'll be seventy next year.\If the average man lives 50 years, I've lived too long.\But I can't die yet.\As long as I have this Sacred Jewel shard...\What do you intend to do in that condition?\Find my death place...\Drink this. It'll ease the pain. response:	Why do you help a man like me?
context: I'll be seventy next year.\If the average man lives 50 years, I've lived too long.\But I can't die yet.\As long as I have this Sacred Jewel shard...\What do you intend to do in that condition?\Find my death place...\Drink this. It'll ease the pain.\Why do you help a man like me? response:	You didn't finish your story.
context: If the average man lives 50 years, I've lived too long.\But I can't die yet.\As long as I have this Sacred Jewel shard...\What do you intend to do in that condition?\Find my death place...\Drink this. It'll ease the pain.\Why do you help a man like me?\You didn't finish your story. response:	I went searching for a suitable place to die.
context: But I can't die yet.\As long as I have this Sacred Jewel shard...\What do you intend to do in that condition?\Find my death place...\Drink this. It'll ease the pain.\Why do you help a man like me?\You didn't finish your story.\I went searching for a suitable place to die. response:	Suitable place to die?
context: As long as I have this Sacred Jewel shard...\What do you intend to do in that condition?\Find my death place...\Drink this. It'll ease the pain.\Why do you help a man like me?\You didn't finish your story.\I went searching for a suitable place to die.\Suitable place to die? response:	Yes...
context: What do you intend to do in that condition?\Find my death place...\Drink this. It'll ease the pain.\Why do you help a man like me?\You didn't finish your story.\I went searching for a suitable place to die.\Suitable place to die?\Yes... response:	From the days of my youth,
context: Find my death place...\Drink this. It'll ease the pain.\Why do you help a man like me?\You didn't finish your story.\I went searching for a suitable place to die.\Suitable place to die?\Yes...\From the days of my youth, response:	I've committed all kinds of evil.
context: Drink this. It'll ease the pain.\Why do you help a man like me?\You didn't finish your story.\I went searching for a suitable place to die.\Suitable place to die?\Yes...\From the days of my youth,\I've committed all kinds of evil. response:	Kansuke, the Mad Killer Rasetsu was quite notorious.
context: Why do you help a man like me?\You didn't finish your story.\I went searching for a suitable place to die.\Suitable place to die?\Yes...\From the days of my youth,\I've committed all kinds of evil.\Kansuke, the Mad Killer Rasetsu was quite notorious. response:	I killed... stole... burned...
context: You didn't finish your story.\I went searching for a suitable place to die.\Suitable place to die?\Yes...\From the days of my youth,\I've committed all kinds of evil.\Kansuke, the Mad Killer Rasetsu was quite notorious.\I killed... stole... burned... response:	I did whatever I felt like doing.
context: I went searching for a suitable place to die.\Suitable place to die?\Yes...\From the days of my youth,\I've committed all kinds of evil.\Kansuke, the Mad Killer Rasetsu was quite notorious.\I killed... stole... burned...\I did whatever I felt like doing. response:	I figured I was gonna end up dead soon anyway.
context: Suitable place to die?\Yes...\From the days of my youth,\I've committed all kinds of evil.\Kansuke, the Mad Killer Rasetsu was quite notorious.\I killed... stole... burned...\I did whatever I felt like doing.\I figured I was gonna end up dead soon anyway. response:	So I lived as I pleased.
context: Yes...\From the days of my youth,\I've committed all kinds of evil.\Kansuke, the Mad Killer Rasetsu was quite notorious.\I killed... stole... burned...\I did whatever I felt like doing.\I figured I was gonna end up dead soon anyway.\So I lived as I pleased. response:	But I was a stubborn guy.
context: From the days of my youth,\I've committed all kinds of evil.\Kansuke, the Mad Killer Rasetsu was quite notorious.\I killed... stole... burned...\I did whatever I felt like doing.\I figured I was gonna end up dead soon anyway.\So I lived as I pleased.\But I was a stubborn guy. response:	I got to be old like this... and I'm still living.
context: I've committed all kinds of evil.\Kansuke, the Mad Killer Rasetsu was quite notorious.\I killed... stole... burned...\I did whatever I felt like doing.\I figured I was gonna end up dead soon anyway.\So I lived as I pleased.\But I was a stubborn guy.\I got to be old like this... and I'm still living. response:	What's the matter?
context: Kansuke, the Mad Killer Rasetsu was quite notorious.\I killed... stole... burned...\I did whatever I felt like doing.\I figured I was gonna end up dead soon anyway.\So I lived as I pleased.\But I was a stubborn guy.\I got to be old like this... and I'm still living.\What's the matter? response:	I hate growing old.
context: I killed... stole... burned...\I did whatever I felt like doing.\I figured I was gonna end up dead soon anyway.\So I lived as I pleased.\But I was a stubborn guy.\I got to be old like this... and I'm still living.\What's the matter?\I hate growing old. response:	I keep forgetting things these days.
context: I did whatever I felt like doing.\I figured I was gonna end up dead soon anyway.\So I lived as I pleased.\But I was a stubborn guy.\I got to be old like this... and I'm still living.\What's the matter?\I hate growing old.\I keep forgetting things these days. response:	But I suddenly recall silly things.
context: I figured I was gonna end up dead soon anyway.\So I lived as I pleased.\But I was a stubborn guy.\I got to be old like this... and I'm still living.\What's the matter?\I hate growing old.\I keep forgetting things these days.\But I suddenly recall silly things. response:	When I first saw you, I was thinking...
context: So I lived as I pleased.\But I was a stubborn guy.\I got to be old like this... and I'm still living.\What's the matter?\I hate growing old.\I keep forgetting things these days.\But I suddenly recall silly things.\When I first saw you, I was thinking... response:	that you look like her.
context: But I was a stubborn guy.\I got to be old like this... and I'm still living.\What's the matter?\I hate growing old.\I keep forgetting things these days.\But I suddenly recall silly things.\When I first saw you, I was thinking...\that you look like her. response:	Look like who?
context: I got to be old like this... and I'm still living.\What's the matter?\I hate growing old.\I keep forgetting things these days.\But I suddenly recall silly things.\When I first saw you, I was thinking...\that you look like her.\Look like who? response:	Long ago, I came upon a priestess who looked exactly like you.
context: What's the matter?\I hate growing old.\I keep forgetting things these days.\But I suddenly recall silly things.\When I first saw you, I was thinking...\that you look like her.\Look like who?\Long ago, I came upon a priestess who looked exactly like you. response:	Hername was...
context: I hate growing old.\I keep forgetting things these days.\But I suddenly recall silly things.\When I first saw you, I was thinking...\that you look like her.\Look like who?\Long ago, I came upon a priestess who looked exactly like you.\Hername was... response:	Kikyo, I think.
context: I keep forgetting things these days.\But I suddenly recall silly things.\When I first saw you, I was thinking...\that you look like her.\Look like who?\Long ago, I came upon a priestess who looked exactly like you.\Hername was...\Kikyo, I think. response:	Pure coincidence.
context: But I suddenly recall silly things.\When I first saw you, I was thinking...\that you look like her.\Look like who?\Long ago, I came upon a priestess who looked exactly like you.\Hername was...\Kikyo, I think.\Pure coincidence. response:	Naturally. I'm talking about fifty years ago.
context: When I first saw you, I was thinking...\that you look like her.\Look like who?\Long ago, I came upon a priestess who looked exactly like you.\Hername was...\Kikyo, I think.\Pure coincidence.\Naturally. I'm talking about fifty years ago. response:	If she were still alive, she'd be an old woman.
context: that you look like her.\Look like who?\Long ago, I came upon a priestess who looked exactly like you.\Hername was...\Kikyo, I think.\Pure coincidence.\Naturally. I'm talking about fifty years ago.\If she were still alive, she'd be an old woman. response:	If she lived...
context: Look like who?\Long ago, I came upon a priestess who looked exactly like you.\Hername was...\Kikyo, I think.\Pure coincidence.\Naturally. I'm talking about fifty years ago.\If she were still alive, she'd be an old woman.\If she lived... response:	Well... I heard through the grapevine that she died.
context: Long ago, I came upon a priestess who looked exactly like you.\Hername was...\Kikyo, I think.\Pure coincidence.\Naturally. I'm talking about fifty years ago.\If she were still alive, she'd be an old woman.\If she lived...\Well... I heard through the grapevine that she died. response:	And that the Sacred Jewel was interred with her.
context: Hername was...\Kikyo, I think.\Pure coincidence.\Naturally. I'm talking about fifty years ago.\If she were still alive, she'd be an old woman.\If she lived...\Well... I heard through the grapevine that she died.\And that the Sacred Jewel was interred with her. response:	I don't know how this thing came to exist in this world.
context: Kikyo, I think.\Pure coincidence.\Naturally. I'm talking about fifty years ago.\If she were still alive, she'd be an old woman.\If she lived...\Well... I heard through the grapevine that she died.\And that the Sacred Jewel was interred with her.\I don't know how this thing came to exist in this world. response:	But I got it at the very last moment.
context: Pure coincidence.\Naturally. I'm talking about fifty years ago.\If she were still alive, she'd be an old woman.\If she lived...\Well... I heard through the grapevine that she died.\And that the Sacred Jewel was interred with her.\I don't know how this thing came to exist in this world.\But I got it at the very last moment. response:	Were you seeking the Sacred Jewel fifty years ago?
context: Naturally. I'm talking about fifty years ago.\If she were still alive, she'd be an old woman.\If she lived...\Well... I heard through the grapevine that she died.\And that the Sacred Jewel was interred with her.\I don't know how this thing came to exist in this world.\But I got it at the very last moment.\Were you seeking the Sacred Jewel fifty years ago? response:	Yeah... Along with a fellow named Onigumo.
context: If she were still alive, she'd be an old woman.\If she lived...\Well... I heard through the grapevine that she died.\And that the Sacred Jewel was interred with her.\I don't know how this thing came to exist in this world.\But I got it at the very last moment.\Were you seeking the Sacred Jewel fifty years ago?\Yeah... Along with a fellow named Onigumo. response:	Onigumo?
context: If she lived...\Well... I heard through the grapevine that she died.\And that the Sacred Jewel was interred with her.\I don't know how this thing came to exist in this world.\But I got it at the very last moment.\Were you seeking the Sacred Jewel fifty years ago?\Yeah... Along with a fellow named Onigumo.\Onigumo? response:	He had a burn scarthat was shaped like a spider.
context: Well... I heard through the grapevine that she died.\And that the Sacred Jewel was interred with her.\I don't know how this thing came to exist in this world.\But I got it at the very last moment.\Were you seeking the Sacred Jewel fifty years ago?\Yeah... Along with a fellow named Onigumo.\Onigumo?\He had a burn scarthat was shaped like a spider. response:	Now he was a true villain... I couldn't compare with him.
context: And that the Sacred Jewel was interred with her.\I don't know how this thing came to exist in this world.\But I got it at the very last moment.\Were you seeking the Sacred Jewel fifty years ago?\Yeah... Along with a fellow named Onigumo.\Onigumo?\He had a burn scarthat was shaped like a spider.\Now he was a true villain... I couldn't compare with him. response:	It'll grant any wish?
context: I don't know how this thing came to exist in this world.\But I got it at the very last moment.\Were you seeking the Sacred Jewel fifty years ago?\Yeah... Along with a fellow named Onigumo.\Onigumo?\He had a burn scarthat was shaped like a spider.\Now he was a true villain... I couldn't compare with him.\It'll grant any wish? response:	Sure.
context: But I got it at the very last moment.\Were you seeking the Sacred Jewel fifty years ago?\Yeah... Along with a fellow named Onigumo.\Onigumo?\He had a burn scarthat was shaped like a spider.\Now he was a true villain... I couldn't compare with him.\It'll grant any wish?\Sure. response:	That's amazing! And it's called the Shikon Jewel?
context: Were you seeking the Sacred Jewel fifty years ago?\Yeah... Along with a fellow named Onigumo.\Onigumo?\He had a burn scarthat was shaped like a spider.\Now he was a true villain... I couldn't compare with him.\It'll grant any wish?\Sure.\That's amazing! And it's called the Shikon Jewel? response:	In the village overyonder...
context: Yeah... Along with a fellow named Onigumo.\Onigumo?\He had a burn scarthat was shaped like a spider.\Now he was a true villain... I couldn't compare with him.\It'll grant any wish?\Sure.\That's amazing! And it's called the Shikon Jewel?\In the village overyonder... response:	A priestess named Kikyo has possession of it.
context: Onigumo?\He had a burn scarthat was shaped like a spider.\Now he was a true villain... I couldn't compare with him.\It'll grant any wish?\Sure.\That's amazing! And it's called the Shikon Jewel?\In the village overyonder...\A priestess named Kikyo has possession of it. response:	Then we'll attack this village tomorrow.
context: He had a burn scarthat was shaped like a spider.\Now he was a true villain... I couldn't compare with him.\It'll grant any wish?\Sure.\That's amazing! And it's called the Shikon Jewel?\In the village overyonder...\A priestess named Kikyo has possession of it.\Then we'll attack this village tomorrow. response:	No, Rasetsu... go alone.
context: Now he was a true villain... I couldn't compare with him.\It'll grant any wish?\Sure.\That's amazing! And it's called the Shikon Jewel?\In the village overyonder...\A priestess named Kikyo has possession of it.\Then we'll attack this village tomorrow.\No, Rasetsu... go alone. response:	Why?
context: It'll grant any wish?\Sure.\That's amazing! And it's called the Shikon Jewel?\In the village overyonder...\A priestess named Kikyo has possession of it.\Then we'll attack this village tomorrow.\No, Rasetsu... go alone.\Why? response:	Kikyo has sharp senses.
context: Sure.\That's amazing! And it's called the Shikon Jewel?\In the village overyonder...\A priestess named Kikyo has possession of it.\Then we'll attack this village tomorrow.\No, Rasetsu... go alone.\Why?\Kikyo has sharp senses. response:	If we go in numbers, she'll escape.
context: That's amazing! And it's called the Shikon Jewel?\In the village overyonder...\A priestess named Kikyo has possession of it.\Then we'll attack this village tomorrow.\No, Rasetsu... go alone.\Why?\Kikyo has sharp senses.\If we go in numbers, she'll escape. response:	Damn! Then what'll I do?
context: In the village overyonder...\A priestess named Kikyo has possession of it.\Then we'll attack this village tomorrow.\No, Rasetsu... go alone.\Why?\Kikyo has sharp senses.\If we go in numbers, she'll escape.\Damn! Then what'll I do? response:	With your bow and arrow,
context: A priestess named Kikyo has possession of it.\Then we'll attack this village tomorrow.\No, Rasetsu... go alone.\Why?\Kikyo has sharp senses.\If we go in numbers, she'll escape.\Damn! Then what'll I do?\With your bow and arrow, response:	you can get herfrom a distance with one shot.
context: Then we'll attack this village tomorrow.\No, Rasetsu... go alone.\Why?\Kikyo has sharp senses.\If we go in numbers, she'll escape.\Damn! Then what'll I do?\With your bow and arrow,\you can get herfrom a distance with one shot. response:	Isn't that so?
context: No, Rasetsu... go alone.\Why?\Kikyo has sharp senses.\If we go in numbers, she'll escape.\Damn! Then what'll I do?\With your bow and arrow,\you can get herfrom a distance with one shot.\Isn't that so? response:	Well...
context: Why?\Kikyo has sharp senses.\If we go in numbers, she'll escape.\Damn! Then what'll I do?\With your bow and arrow,\you can get herfrom a distance with one shot.\Isn't that so?\Well... response:	Won't you try it, Rasetsu?
context: Kikyo has sharp senses.\If we go in numbers, she'll escape.\Damn! Then what'll I do?\With your bow and arrow,\you can get herfrom a distance with one shot.\Isn't that so?\Well...\Won't you try it, Rasetsu? response:	Whatever I want, huh?
context: If we go in numbers, she'll escape.\Damn! Then what'll I do?\With your bow and arrow,\you can get herfrom a distance with one shot.\Isn't that so?\Well...\Won't you try it, Rasetsu?\Whatever I want, huh? response:	I'll be able to drink all the sake I want.
context: Damn! Then what'll I do?\With your bow and arrow,\you can get herfrom a distance with one shot.\Isn't that so?\Well...\Won't you try it, Rasetsu?\Whatever I want, huh?\I'll be able to drink all the sake I want. response:	And next, I'll conquer the world!
context: With your bow and arrow,\you can get herfrom a distance with one shot.\Isn't that so?\Well...\Won't you try it, Rasetsu?\Whatever I want, huh?\I'll be able to drink all the sake I want.\And next, I'll conquer the world! response:	I found you! Die!
context: you can get herfrom a distance with one shot.\Isn't that so?\Well...\Won't you try it, Rasetsu?\Whatever I want, huh?\I'll be able to drink all the sake I want.\And next, I'll conquer the world!\I found you! Die! response:	What?!
context: Isn't that so?\Well...\Won't you try it, Rasetsu?\Whatever I want, huh?\I'll be able to drink all the sake I want.\And next, I'll conquer the world!\I found you! Die!\What?! response:	Who are you?!
context: Well...\Won't you try it, Rasetsu?\Whatever I want, huh?\I'll be able to drink all the sake I want.\And next, I'll conquer the world!\I found you! Die!\What?!\Who are you?! response:	What?!
context: Won't you try it, Rasetsu?\Whatever I want, huh?\I'll be able to drink all the sake I want.\And next, I'll conquer the world!\I found you! Die!\What?!\Who are you?!\What?! response:	A human like you... trying to take Kikyo's life...
context: Whatever I want, huh?\I'll be able to drink all the sake I want.\And next, I'll conquer the world!\I found you! Die!\What?!\Who are you?!\What?!\A human like you... trying to take Kikyo's life... response:	You've got some nerve!
context: I'll be able to drink all the sake I want.\And next, I'll conquer the world!\I found you! Die!\What?!\Who are you?!\What?!\A human like you... trying to take Kikyo's life...\You've got some nerve! response:	Are you after the Sacred Jewel?
context: And next, I'll conquer the world!\I found you! Die!\What?!\Who are you?!\What?!\A human like you... trying to take Kikyo's life...\You've got some nerve!\Are you after the Sacred Jewel? response:	Shut up, demon!
context: I found you! Die!\What?!\Who are you?!\What?!\A human like you... trying to take Kikyo's life...\You've got some nerve!\Are you after the Sacred Jewel?\Shut up, demon! response:	Unfortunately, I'm no demon!
context: What?!\Who are you?!\What?!\A human like you... trying to take Kikyo's life...\You've got some nerve!\Are you after the Sacred Jewel?\Shut up, demon!\Unfortunately, I'm no demon! response:	Now prepare to die!
context: Who are you?!\What?!\A human like you... trying to take Kikyo's life...\You've got some nerve!\Are you after the Sacred Jewel?\Shut up, demon!\Unfortunately, I'm no demon!\Now prepare to die! response:	Inuyasha!
context: What?!\A human like you... trying to take Kikyo's life...\You've got some nerve!\Are you after the Sacred Jewel?\Shut up, demon!\Unfortunately, I'm no demon!\Now prepare to die!\Inuyasha! response:	Damn! You're a lucky dog!
context: A human like you... trying to take Kikyo's life...\You've got some nerve!\Are you after the Sacred Jewel?\Shut up, demon!\Unfortunately, I'm no demon!\Now prepare to die!\Inuyasha!\Damn! You're a lucky dog! response:	Did something happen?
context: You've got some nerve!\Are you after the Sacred Jewel?\Shut up, demon!\Unfortunately, I'm no demon!\Now prepare to die!\Inuyasha!\Damn! You're a lucky dog!\Did something happen? response:	Huh! It was nothing.
context: Are you after the Sacred Jewel?\Shut up, demon!\Unfortunately, I'm no demon!\Now prepare to die!\Inuyasha!\Damn! You're a lucky dog!\Did something happen?\Huh! It was nothing. response:	Don't do anything rough when I'm around.
context: Shut up, demon!\Unfortunately, I'm no demon!\Now prepare to die!\Inuyasha!\Damn! You're a lucky dog!\Did something happen?\Huh! It was nothing.\Don't do anything rough when I'm around. response:	Where?
context: Unfortunately, I'm no demon!\Now prepare to die!\Inuyasha!\Damn! You're a lucky dog!\Did something happen?\Huh! It was nothing.\Don't do anything rough when I'm around.\Where? response:	Where did they go?!
context: Now prepare to die!\Inuyasha!\Damn! You're a lucky dog!\Did something happen?\Huh! It was nothing.\Don't do anything rough when I'm around.\Where?\Where did they go?! response:	Damn that Onigumo!
context: Inuyasha!\Damn! You're a lucky dog!\Did something happen?\Huh! It was nothing.\Don't do anything rough when I'm around.\Where?\Where did they go?!\Damn that Onigumo! response:	He planned to take my men from the start!
context: Damn! You're a lucky dog!\Did something happen?\Huh! It was nothing.\Don't do anything rough when I'm around.\Where?\Where did they go?!\Damn that Onigumo!\He planned to take my men from the start! response:	So this is where...
context: Did something happen?\Huh! It was nothing.\Don't do anything rough when I'm around.\Where?\Where did they go?!\Damn that Onigumo!\He planned to take my men from the start!\So this is where... response:	B-Boss!
context: Huh! It was nothing.\Don't do anything rough when I'm around.\Where?\Where did they go?!\Damn that Onigumo!\He planned to take my men from the start!\So this is where...\B-Boss! response:	You're alive!
context: Don't do anything rough when I'm around.\Where?\Where did they go?!\Damn that Onigumo!\He planned to take my men from the start!\So this is where...\B-Boss!\You're alive! response:	Boss!
context: Where?\Where did they go?!\Damn that Onigumo!\He planned to take my men from the start!\So this is where...\B-Boss!\You're alive!\Boss! response:	We didn't mean to betray you!
context: Where did they go?!\Damn that Onigumo!\He planned to take my men from the start!\So this is where...\B-Boss!\You're alive!\Boss!\We didn't mean to betray you! response:	Shut up!
context: Damn that Onigumo!\He planned to take my men from the start!\So this is where...\B-Boss!\You're alive!\Boss!\We didn't mean to betray you!\Shut up! response:	If you come back to me, I'll spare your lives!
context: He planned to take my men from the start!\So this is where...\B-Boss!\You're alive!\Boss!\We didn't mean to betray you!\Shut up!\If you come back to me, I'll spare your lives! response:	However...
context: So this is where...\B-Boss!\You're alive!\Boss!\We didn't mean to betray you!\Shut up!\If you come back to me, I'll spare your lives!\However... response:	Where is he?
context: B-Boss!\You're alive!\Boss!\We didn't mean to betray you!\Shut up!\If you come back to me, I'll spare your lives!\However...\Where is he? response:	Where is that Onigumo?!
context: You're alive!\Boss!\We didn't mean to betray you!\Shut up!\If you come back to me, I'll spare your lives!\However...\Where is he?\Where is that Onigumo?! response:	Damn him!
context: Boss!\We didn't mean to betray you!\Shut up!\If you come back to me, I'll spare your lives!\However...\Where is he?\Where is that Onigumo?!\Damn him! response:	I won't let him go!
context: We didn't mean to betray you!\Shut up!\If you come back to me, I'll spare your lives!\However...\Where is he?\Where is that Onigumo?!\Damn him!\I won't let him go! response:	Didn't that half-demon kill you?!
context: Shut up!\If you come back to me, I'll spare your lives!\However...\Where is he?\Where is that Onigumo?!\Damn him!\I won't let him go!\Didn't that half-demon kill you?! response:	How dare you set me up like that!
context: If you come back to me, I'll spare your lives!\However...\Where is he?\Where is that Onigumo?!\Damn him!\I won't let him go!\Didn't that half-demon kill you?!\How dare you set me up like that! response:	Now I'll return the favor!
context: However...\Where is he?\Where is that Onigumo?!\Damn him!\I won't let him go!\Didn't that half-demon kill you?!\How dare you set me up like that!\Now I'll return the favor! response:	Rasetsu!
context: Where is he?\Where is that Onigumo?!\Damn him!\I won't let him go!\Didn't that half-demon kill you?!\How dare you set me up like that!\Now I'll return the favor!\Rasetsu! response:	So long, Onigumo!
context: Where is that Onigumo?!\Damn him!\I won't let him go!\Didn't that half-demon kill you?!\How dare you set me up like that!\Now I'll return the favor!\Rasetsu!\So long, Onigumo! response:	Burn! Burn!
context: Damn him!\I won't let him go!\Didn't that half-demon kill you?!\How dare you set me up like that!\Now I'll return the favor!\Rasetsu!\So long, Onigumo!\Burn! Burn! response:	Burn!
context: I won't let him go!\Didn't that half-demon kill you?!\How dare you set me up like that!\Now I'll return the favor!\Rasetsu!\So long, Onigumo!\Burn! Burn!\Burn! response:	R-Rasetsu!
context: Didn't that half-demon kill you?!\How dare you set me up like that!\Now I'll return the favor!\Rasetsu!\So long, Onigumo!\Burn! Burn!\Burn!\R-Rasetsu! response:	Stubborn fellow!
context: How dare you set me up like that!\Now I'll return the favor!\Rasetsu!\So long, Onigumo!\Burn! Burn!\Burn!\R-Rasetsu!\Stubborn fellow! response:	Here...
context: Now I'll return the favor!\Rasetsu!\So long, Onigumo!\Burn! Burn!\Burn!\R-Rasetsu!\Stubborn fellow!\Here... response:	Hey! Throw him over.
context: Rasetsu!\So long, Onigumo!\Burn! Burn!\Burn!\R-Rasetsu!\Stubborn fellow!\Here...\Hey! Throw him over. response:	Onigumo, this time you can go get it...
context: So long, Onigumo!\Burn! Burn!\Burn!\R-Rasetsu!\Stubborn fellow!\Here...\Hey! Throw him over.\Onigumo, this time you can go get it... response:	The Sacred Jewel.
context: Burn! Burn!\Burn!\R-Rasetsu!\Stubborn fellow!\Here...\Hey! Throw him over.\Onigumo, this time you can go get it...\The Sacred Jewel. response:	Say hello to Kikyo!
context: Burn!\R-Rasetsu!\Stubborn fellow!\Here...\Hey! Throw him over.\Onigumo, this time you can go get it...\The Sacred Jewel.\Say hello to Kikyo! response:	So you threw him over?
context: R-Rasetsu!\Stubborn fellow!\Here...\Hey! Throw him over.\Onigumo, this time you can go get it...\The Sacred Jewel.\Say hello to Kikyo!\So you threw him over? response:	Yeah. To the infernal abyss.
context: Stubborn fellow!\Here...\Hey! Throw him over.\Onigumo, this time you can go get it...\The Sacred Jewel.\Say hello to Kikyo!\So you threw him over?\Yeah. To the infernal abyss. response:	Infernal abyss... Naraku.
context: Here...\Hey! Throw him over.\Onigumo, this time you can go get it...\The Sacred Jewel.\Say hello to Kikyo!\So you threw him over?\Yeah. To the infernal abyss.\Infernal abyss... Naraku. response:	And? What happened afterthat?
context: Hey! Throw him over.\Onigumo, this time you can go get it...\The Sacred Jewel.\Say hello to Kikyo!\So you threw him over?\Yeah. To the infernal abyss.\Infernal abyss... Naraku.\And? What happened afterthat? response:	That was the end.
context: Onigumo, this time you can go get it...\The Sacred Jewel.\Say hello to Kikyo!\So you threw him over?\Yeah. To the infernal abyss.\Infernal abyss... Naraku.\And? What happened afterthat?\That was the end. response:	I stole this Sacred Jewel shard recently from a dying demon.
context: The Sacred Jewel.\Say hello to Kikyo!\So you threw him over?\Yeah. To the infernal abyss.\Infernal abyss... Naraku.\And? What happened afterthat?\That was the end.\I stole this Sacred Jewel shard recently from a dying demon. response:	But it won'tgrant my wish.
context: Say hello to Kikyo!\So you threw him over?\Yeah. To the infernal abyss.\Infernal abyss... Naraku.\And? What happened afterthat?\That was the end.\I stole this Sacred Jewel shard recently from a dying demon.\But it won'tgrant my wish. response:	It just prolongs my life...
context: So you threw him over?\Yeah. To the infernal abyss.\Infernal abyss... Naraku.\And? What happened afterthat?\That was the end.\I stole this Sacred Jewel shard recently from a dying demon.\But it won'tgrant my wish.\It just prolongs my life... response:	and tempts demons to constantly attack me.
context: Yeah. To the infernal abyss.\Infernal abyss... Naraku.\And? What happened afterthat?\That was the end.\I stole this Sacred Jewel shard recently from a dying demon.\But it won'tgrant my wish.\It just prolongs my life...\and tempts demons to constantly attack me. response:	Onigumo continues to betray me even in death.
context: Infernal abyss... Naraku.\And? What happened afterthat?\That was the end.\I stole this Sacred Jewel shard recently from a dying demon.\But it won'tgrant my wish.\It just prolongs my life...\and tempts demons to constantly attack me.\Onigumo continues to betray me even in death. response:	Although, this shard helps to ward off those demons.
context: And? What happened afterthat?\That was the end.\I stole this Sacred Jewel shard recently from a dying demon.\But it won'tgrant my wish.\It just prolongs my life...\and tempts demons to constantly attack me.\Onigumo continues to betray me even in death.\Although, this shard helps to ward off those demons. response:	What's the matter?
context: That was the end.\I stole this Sacred Jewel shard recently from a dying demon.\But it won'tgrant my wish.\It just prolongs my life...\and tempts demons to constantly attack me.\Onigumo continues to betray me even in death.\Although, this shard helps to ward off those demons.\What's the matter? response:	It's come.
context: I stole this Sacred Jewel shard recently from a dying demon.\But it won'tgrant my wish.\It just prolongs my life...\and tempts demons to constantly attack me.\Onigumo continues to betray me even in death.\Although, this shard helps to ward off those demons.\What's the matter?\It's come. response:	Most probably, to get that shard.
context: But it won'tgrant my wish.\It just prolongs my life...\and tempts demons to constantly attack me.\Onigumo continues to betray me even in death.\Although, this shard helps to ward off those demons.\What's the matter?\It's come.\Most probably, to get that shard. response:	Ademon?
context: It just prolongs my life...\and tempts demons to constantly attack me.\Onigumo continues to betray me even in death.\Although, this shard helps to ward off those demons.\What's the matter?\It's come.\Most probably, to get that shard.\Ademon? response:	This demonic aura...
context: and tempts demons to constantly attack me.\Onigumo continues to betray me even in death.\Although, this shard helps to ward off those demons.\What's the matter?\It's come.\Most probably, to get that shard.\Ademon?\This demonic aura... response:	It couldn't be... Naraku!
context: Onigumo continues to betray me even in death.\Although, this shard helps to ward off those demons.\What's the matter?\It's come.\Most probably, to get that shard.\Ademon?\This demonic aura...\It couldn't be... Naraku! response:	No, it's not. This is...
context: Although, this shard helps to ward off those demons.\What's the matter?\It's come.\Most probably, to get that shard.\Ademon?\This demonic aura...\It couldn't be... Naraku!\No, it's not. This is... response:	Give it to me...
context: What's the matter?\It's come.\Most probably, to get that shard.\Ademon?\This demonic aura...\It couldn't be... Naraku!\No, it's not. This is...\Give it to me... response:	Give me the Sacred Jewel shard!
context: It's come.\Most probably, to get that shard.\Ademon?\This demonic aura...\It couldn't be... Naraku!\No, it's not. This is...\Give it to me...\Give me the Sacred Jewel shard! response:	You...
context: Most probably, to get that shard.\Ademon?\This demonic aura...\It couldn't be... Naraku!\No, it's not. This is...\Give it to me...\Give me the Sacred Jewel shard!\You... response:	Just what are you to Naraku?!
context: Ademon?\This demonic aura...\It couldn't be... Naraku!\No, it's not. This is...\Give it to me...\Give me the Sacred Jewel shard!\You...\Just what are you to Naraku?! response:	Naraku?
context: This demonic aura...\It couldn't be... Naraku!\No, it's not. This is...\Give it to me...\Give me the Sacred Jewel shard!\You...\Just what are you to Naraku?!\Naraku? response:	That unforgivable Naraku?!
context: It couldn't be... Naraku!\No, it's not. This is...\Give it to me...\Give me the Sacred Jewel shard!\You...\Just what are you to Naraku?!\Naraku?\That unforgivable Naraku?! response:	Naraku severed me from him!
context: No, it's not. This is...\Give it to me...\Give me the Sacred Jewel shard!\You...\Just what are you to Naraku?!\Naraku?\That unforgivable Naraku?!\Naraku severed me from him! response:	Looking like this!
context: Give it to me...\Give me the Sacred Jewel shard!\You...\Just what are you to Naraku?!\Naraku?\That unforgivable Naraku?!\Naraku severed me from him!\Looking like this! response:	It's a portion of Naraku's body... which was abandoned?
context: Give me the Sacred Jewel shard!\You...\Just what are you to Naraku?!\Naraku?\That unforgivable Naraku?!\Naraku severed me from him!\Looking like this!\It's a portion of Naraku's body... which was abandoned? response:	The Sacred Jewel shard.
context: You...\Just what are you to Naraku?!\Naraku?\That unforgivable Naraku?!\Naraku severed me from him!\Looking like this!\It's a portion of Naraku's body... which was abandoned?\The Sacred Jewel shard. response:	If I have the shard,
context: Just what are you to Naraku?!\Naraku?\That unforgivable Naraku?!\Naraku severed me from him!\Looking like this!\It's a portion of Naraku's body... which was abandoned?\The Sacred Jewel shard.\If I have the shard, response:	I'll be able to secure myself a properbody.
context: Naraku?\That unforgivable Naraku?!\Naraku severed me from him!\Looking like this!\It's a portion of Naraku's body... which was abandoned?\The Sacred Jewel shard.\If I have the shard,\I'll be able to secure myself a properbody. response:	Give it here!
context: That unforgivable Naraku?!\Naraku severed me from him!\Looking like this!\It's a portion of Naraku's body... which was abandoned?\The Sacred Jewel shard.\If I have the shard,\I'll be able to secure myself a properbody.\Give it here! response:	Damn demon!
context: Naraku severed me from him!\Looking like this!\It's a portion of Naraku's body... which was abandoned?\The Sacred Jewel shard.\If I have the shard,\I'll be able to secure myself a properbody.\Give it here!\Damn demon! response:	Die!
context: Looking like this!\It's a portion of Naraku's body... which was abandoned?\The Sacred Jewel shard.\If I have the shard,\I'll be able to secure myself a properbody.\Give it here!\Damn demon!\Die! response:	A human dares defy me?!
context: It's a portion of Naraku's body... which was abandoned?\The Sacred Jewel shard.\If I have the shard,\I'll be able to secure myself a properbody.\Give it here!\Damn demon!\Die!\A human dares defy me?! response:	Give me... the bow and arrow!
context: The Sacred Jewel shard.\If I have the shard,\I'll be able to secure myself a properbody.\Give it here!\Damn demon!\Die!\A human dares defy me?!\Give me... the bow and arrow! response:	Hand overthe Sacred Jewel shard!
context: If I have the shard,\I'll be able to secure myself a properbody.\Give it here!\Damn demon!\Die!\A human dares defy me?!\Give me... the bow and arrow!\Hand overthe Sacred Jewel shard! response:	You want this so much?
context: I'll be able to secure myself a properbody.\Give it here!\Damn demon!\Die!\A human dares defy me?!\Give me... the bow and arrow!\Hand overthe Sacred Jewel shard!\You want this so much? response:	That arrow-!
context: Give it here!\Damn demon!\Die!\A human dares defy me?!\Give me... the bow and arrow!\Hand overthe Sacred Jewel shard!\You want this so much?\That arrow-! response:	Are you all right?
context: Damn demon!\Die!\A human dares defy me?!\Give me... the bow and arrow!\Hand overthe Sacred Jewel shard!\You want this so much?\That arrow-!\Are you all right? response:	How pitiful... saved by a woman!
context: Die!\A human dares defy me?!\Give me... the bow and arrow!\Hand overthe Sacred Jewel shard!\You want this so much?\That arrow-!\Are you all right?\How pitiful... saved by a woman! response:	However, you're some woman.
context: A human dares defy me?!\Give me... the bow and arrow!\Hand overthe Sacred Jewel shard!\You want this so much?\That arrow-!\Are you all right?\How pitiful... saved by a woman!\However, you're some woman. response:	I got it back foryou.
context: Give me... the bow and arrow!\Hand overthe Sacred Jewel shard!\You want this so much?\That arrow-!\Are you all right?\How pitiful... saved by a woman!\However, you're some woman.\I got it back foryou. response:	I have no need forthat.
context: Hand overthe Sacred Jewel shard!\You want this so much?\That arrow-!\Are you all right?\How pitiful... saved by a woman!\However, you're some woman.\I got it back foryou.\I have no need forthat. response:	I'll give it to you.
context: You want this so much?\That arrow-!\Are you all right?\How pitiful... saved by a woman!\However, you're some woman.\I got it back foryou.\I have no need forthat.\I'll give it to you. response:	However, I have just one request.
context: That arrow-!\Are you all right?\How pitiful... saved by a woman!\However, you're some woman.\I got it back foryou.\I have no need forthat.\I'll give it to you.\However, I have just one request. response:	Request?
context: Are you all right?\How pitiful... saved by a woman!\However, you're some woman.\I got it back foryou.\I have no need forthat.\I'll give it to you.\However, I have just one request.\Request? response:	I've lived the way I wanted.
context: How pitiful... saved by a woman!\However, you're some woman.\I got it back foryou.\I have no need forthat.\I'll give it to you.\However, I have just one request.\Request?\I've lived the way I wanted. response:	However, afterexperiencing old age and sickness,
context: However, you're some woman.\I got it back foryou.\I have no need forthat.\I'll give it to you.\However, I have just one request.\Request?\I've lived the way I wanted.\However, afterexperiencing old age and sickness, response:	I've become afraid of falling to Hell.
context: I got it back foryou.\I have no need forthat.\I'll give it to you.\However, I have just one request.\Request?\I've lived the way I wanted.\However, afterexperiencing old age and sickness,\I've become afraid of falling to Hell. response:	You want to be saved?
context: I have no need forthat.\I'll give it to you.\However, I have just one request.\Request?\I've lived the way I wanted.\However, afterexperiencing old age and sickness,\I've become afraid of falling to Hell.\You want to be saved? response:	I heard thateven villains like me can find salvation.
context: I'll give it to you.\However, I have just one request.\Request?\I've lived the way I wanted.\However, afterexperiencing old age and sickness,\I've become afraid of falling to Hell.\You want to be saved?\I heard thateven villains like me can find salvation. response:	And I've traveled in search of it as a place forme to die.
context: However, I have just one request.\Request?\I've lived the way I wanted.\However, afterexperiencing old age and sickness,\I've become afraid of falling to Hell.\You want to be saved?\I heard thateven villains like me can find salvation.\And I've traveled in search of it as a place forme to die. response:	But I guess I won't find it.
context: Request?\I've lived the way I wanted.\However, afterexperiencing old age and sickness,\I've become afraid of falling to Hell.\You want to be saved?\I heard thateven villains like me can find salvation.\And I've traveled in search of it as a place forme to die.\But I guess I won't find it. response:	So?
context: I've lived the way I wanted.\However, afterexperiencing old age and sickness,\I've become afraid of falling to Hell.\You want to be saved?\I heard thateven villains like me can find salvation.\And I've traveled in search of it as a place forme to die.\But I guess I won't find it.\So? response:	Take this...
context: However, afterexperiencing old age and sickness,\I've become afraid of falling to Hell.\You want to be saved?\I heard thateven villains like me can find salvation.\And I've traveled in search of it as a place forme to die.\But I guess I won't find it.\So?\Take this... response:	Iock of hair and bury it.
context: I've become afraid of falling to Hell.\You want to be saved?\I heard thateven villains like me can find salvation.\And I've traveled in search of it as a place forme to die.\But I guess I won't find it.\So?\Take this...\Iock of hair and bury it. response:	Woman...
context: You want to be saved?\I heard thateven villains like me can find salvation.\And I've traveled in search of it as a place forme to die.\But I guess I won't find it.\So?\Take this...\Iock of hair and bury it.\Woman... response:	What's yourname?
context: I heard thateven villains like me can find salvation.\And I've traveled in search of it as a place forme to die.\But I guess I won't find it.\So?\Take this...\Iock of hair and bury it.\Woman...\What's yourname? response:	It's Kikyo.
context: And I've traveled in search of it as a place forme to die.\But I guess I won't find it.\So?\Take this...\Iock of hair and bury it.\Woman...\What's yourname?\It's Kikyo. response:	That's a bad joke.
context: But I guess I won't find it.\So?\Take this...\Iock of hair and bury it.\Woman...\What's yourname?\It's Kikyo.\That's a bad joke. response:	The wheel of fortune is everin motion...so they say.
context: So?\Take this...\Iock of hair and bury it.\Woman...\What's yourname?\It's Kikyo.\That's a bad joke.\The wheel of fortune is everin motion...so they say. response:	Put this on so you won't catch a cold.
context: Take this...\Iock of hair and bury it.\Woman...\What's yourname?\It's Kikyo.\That's a bad joke.\The wheel of fortune is everin motion...so they say.\Put this on so you won't catch a cold. response:	You've already caught one!
context: Iock of hair and bury it.\Woman...\What's yourname?\It's Kikyo.\That's a bad joke.\The wheel of fortune is everin motion...so they say.\Put this on so you won't catch a cold.\You've already caught one! response:	No, someone's gossiping about me.
context: Woman...\What's yourname?\It's Kikyo.\That's a bad joke.\The wheel of fortune is everin motion...so they say.\Put this on so you won't catch a cold.\You've already caught one!\No, someone's gossiping about me. response:	Dummy! Who'd gossip about you?
context: What's yourname?\It's Kikyo.\That's a bad joke.\The wheel of fortune is everin motion...so they say.\Put this on so you won't catch a cold.\You've already caught one!\No, someone's gossiping about me.\Dummy! Who'd gossip about you? response:	Good, no fever.
context: It's Kikyo.\That's a bad joke.\The wheel of fortune is everin motion...so they say.\Put this on so you won't catch a cold.\You've already caught one!\No, someone's gossiping about me.\Dummy! Who'd gossip about you?\Good, no fever. response:	Thank you forbeing concerned.
context: That's a bad joke.\The wheel of fortune is everin motion...so they say.\Put this on so you won't catch a cold.\You've already caught one!\No, someone's gossiping about me.\Dummy! Who'd gossip about you?\Good, no fever.\Thank you forbeing concerned. response:	Huh... you're starting to get warm.
context: The wheel of fortune is everin motion...so they say.\Put this on so you won't catch a cold.\You've already caught one!\No, someone's gossiping about me.\Dummy! Who'd gossip about you?\Good, no fever.\Thank you forbeing concerned.\Huh... you're starting to get warm. response:	It's okay, don't worry.
context: Put this on so you won't catch a cold.\You've already caught one!\No, someone's gossiping about me.\Dummy! Who'd gossip about you?\Good, no fever.\Thank you forbeing concerned.\Huh... you're starting to get warm.\It's okay, don't worry. response:	Came all this way with his remains?
context: You've already caught one!\No, someone's gossiping about me.\Dummy! Who'd gossip about you?\Good, no fever.\Thank you forbeing concerned.\Huh... you're starting to get warm.\It's okay, don't worry.\Came all this way with his remains? response:	Thank you so much for all yourtrouble.
context: No, someone's gossiping about me.\Dummy! Who'd gossip about you?\Good, no fever.\Thank you forbeing concerned.\Huh... you're starting to get warm.\It's okay, don't worry.\Came all this way with his remains?\Thank you so much for all yourtrouble. response:	It was his dying wish.
context: Dummy! Who'd gossip about you?\Good, no fever.\Thank you forbeing concerned.\Huh... you're starting to get warm.\It's okay, don't worry.\Came all this way with his remains?\Thank you so much for all yourtrouble.\It was his dying wish. response:	I've heard about this place of purification.
context: Good, no fever.\Thank you forbeing concerned.\Huh... you're starting to get warm.\It's okay, don't worry.\Came all this way with his remains?\Thank you so much for all yourtrouble.\It was his dying wish.\I've heard about this place of purification. response:	I believe the priest's name was Hakushin.
context: Thank you forbeing concerned.\Huh... you're starting to get warm.\It's okay, don't worry.\Came all this way with his remains?\Thank you so much for all yourtrouble.\It was his dying wish.\I've heard about this place of purification.\I believe the priest's name was Hakushin. response:	Yes, yes!
context: Huh... you're starting to get warm.\It's okay, don't worry.\Came all this way with his remains?\Thank you so much for all yourtrouble.\It was his dying wish.\I've heard about this place of purification.\I believe the priest's name was Hakushin.\Yes, yes! response:	There's a temple started by this Priest Hakushin.
context: It's okay, don't worry.\Came all this way with his remains?\Thank you so much for all yourtrouble.\It was his dying wish.\I've heard about this place of purification.\I believe the priest's name was Hakushin.\Yes, yes!\There's a temple started by this Priest Hakushin. response:	And if the soul is returned there, he can cleanse any sin.
context: Came all this way with his remains?\Thank you so much for all yourtrouble.\It was his dying wish.\I've heard about this place of purification.\I believe the priest's name was Hakushin.\Yes, yes!\There's a temple started by this Priest Hakushin.\And if the soul is returned there, he can cleanse any sin. response:	Where is this temple?
context: Thank you so much for all yourtrouble.\It was his dying wish.\I've heard about this place of purification.\I believe the priest's name was Hakushin.\Yes, yes!\There's a temple started by this Priest Hakushin.\And if the soul is returned there, he can cleanse any sin.\Where is this temple? response:	Mount Hakurei.
context: It was his dying wish.\I've heard about this place of purification.\I believe the priest's name was Hakushin.\Yes, yes!\There's a temple started by this Priest Hakushin.\And if the soul is returned there, he can cleanse any sin.\Where is this temple?\Mount Hakurei. response:	Mount Hakurei?
context: I've heard about this place of purification.\I believe the priest's name was Hakushin.\Yes, yes!\There's a temple started by this Priest Hakushin.\And if the soul is returned there, he can cleanse any sin.\Where is this temple?\Mount Hakurei.\Mount Hakurei? response:	Beyond this forest,
context: I believe the priest's name was Hakushin.\Yes, yes!\There's a temple started by this Priest Hakushin.\And if the soul is returned there, he can cleanse any sin.\Where is this temple?\Mount Hakurei.\Mount Hakurei?\Beyond this forest, response:	there's a valley overwhich looms Mount Hakurei.
context: Yes, yes!\There's a temple started by this Priest Hakushin.\And if the soul is returned there, he can cleanse any sin.\Where is this temple?\Mount Hakurei.\Mount Hakurei?\Beyond this forest,\there's a valley overwhich looms Mount Hakurei. response:	So that is Mount Hakurei.
context: There's a temple started by this Priest Hakushin.\And if the soul is returned there, he can cleanse any sin.\Where is this temple?\Mount Hakurei.\Mount Hakurei?\Beyond this forest,\there's a valley overwhich looms Mount Hakurei.\So that is Mount Hakurei. response:	I'm getting a strange feeling...
context: And if the soul is returned there, he can cleanse any sin.\Where is this temple?\Mount Hakurei.\Mount Hakurei?\Beyond this forest,\there's a valley overwhich looms Mount Hakurei.\So that is Mount Hakurei.\I'm getting a strange feeling... response:	All the fields have been ruined! It's time to act, Inuyasha!
context: Where is this temple?\Mount Hakurei.\Mount Hakurei?\Beyond this forest,\there's a valley overwhich looms Mount Hakurei.\So that is Mount Hakurei.\I'm getting a strange feeling...\All the fields have been ruined! It's time to act, Inuyasha! response:	I'm no Dog God!
context: Mount Hakurei.\Mount Hakurei?\Beyond this forest,\there's a valley overwhich looms Mount Hakurei.\So that is Mount Hakurei.\I'm getting a strange feeling...\All the fields have been ruined! It's time to act, Inuyasha!\I'm no Dog God! response:	What's so hard about catching monkeys?
context: Mount Hakurei?\Beyond this forest,\there's a valley overwhich looms Mount Hakurei.\So that is Mount Hakurei.\I'm getting a strange feeling...\All the fields have been ruined! It's time to act, Inuyasha!\I'm no Dog God!\What's so hard about catching monkeys? response:	Why do I have to take care of monkeys?!
context: Beyond this forest,\there's a valley overwhich looms Mount Hakurei.\So that is Mount Hakurei.\I'm getting a strange feeling...\All the fields have been ruined! It's time to act, Inuyasha!\I'm no Dog God!\What's so hard about catching monkeys?\Why do I have to take care of monkeys?! response:	There! Oh, how cute?!
context: there's a valley overwhich looms Mount Hakurei.\So that is Mount Hakurei.\I'm getting a strange feeling...\All the fields have been ruined! It's time to act, Inuyasha!\I'm no Dog God!\What's so hard about catching monkeys?\Why do I have to take care of monkeys?!\There! Oh, how cute?! response:	Say, do you want some treats?
context: So that is Mount Hakurei.\I'm getting a strange feeling...\All the fields have been ruined! It's time to act, Inuyasha!\I'm no Dog God!\What's so hard about catching monkeys?\Why do I have to take care of monkeys?!\There! Oh, how cute?!\Say, do you want some treats? response:	What's this?!
context: I'm getting a strange feeling...\All the fields have been ruined! It's time to act, Inuyasha!\I'm no Dog God!\What's so hard about catching monkeys?\Why do I have to take care of monkeys?!\There! Oh, how cute?!\Say, do you want some treats?\What's this?! response:	Those baby monkeys have used some kind of magic!
context: All the fields have been ruined! It's time to act, Inuyasha!\I'm no Dog God!\What's so hard about catching monkeys?\Why do I have to take care of monkeys?!\There! Oh, how cute?!\Say, do you want some treats?\What's this?!\Those baby monkeys have used some kind of magic! response:	Next on Inuyasha: The Three Sprites of the Monkey God!
context: I'm no Dog God!\What's so hard about catching monkeys?\Why do I have to take care of monkeys?!\There! Oh, how cute?!\Say, do you want some treats?\What's this?!\Those baby monkeys have used some kind of magic!\Next on Inuyasha: The Three Sprites of the Monkey God! response:	Miroku, stop it! Don't use your Wind Tunnel!