context: Are you nervous? response:	No, it's just a track meet.
context: Are you nervous?\No, it's just a track meet. response:	Right, just a track meet.
context: Are you nervous?\No, it's just a track meet.\Right, just a track meet. response:	Episode 5: Hinode Bridge
context: Are you nervous?\No, it's just a track meet.\Right, just a track meet.\Episode 5: Hinode Bridge response:	He's smiling.
context: Are you nervous?\No, it's just a track meet.\Right, just a track meet.\Episode 5: Hinode Bridge\He's smiling. response:	Ready...
context: Are you nervous?\No, it's just a track meet.\Right, just a track meet.\Episode 5: Hinode Bridge\He's smiling.\Ready... response:	Ready...
context: Are you nervous?\No, it's just a track meet.\Right, just a track meet.\Episode 5: Hinode Bridge\He's smiling.\Ready...\Ready... response:	Hey.
context: Are you nervous?\No, it's just a track meet.\Right, just a track meet.\Episode 5: Hinode Bridge\He's smiling.\Ready...\Ready...\Hey. response:	Long time.
context: No, it's just a track meet.\Right, just a track meet.\Episode 5: Hinode Bridge\He's smiling.\Ready...\Ready...\Hey.\Long time. response:	How've you been?
context: Right, just a track meet.\Episode 5: Hinode Bridge\He's smiling.\Ready...\Ready...\Hey.\Long time.\How've you been? response:	Not bad.
context: Episode 5: Hinode Bridge\He's smiling.\Ready...\Ready...\Hey.\Long time.\How've you been?\Not bad. response:	How was it?
context: He's smiling.\Ready...\Ready...\Hey.\Long time.\How've you been?\Not bad.\How was it? response:	Must be hard to get back into it.
context: Ready...\Ready...\Hey.\Long time.\How've you been?\Not bad.\How was it?\Must be hard to get back into it. response:	I'm here.
context: Ready...\Hey.\Long time.\How've you been?\Not bad.\How was it?\Must be hard to get back into it.\I'm here. response:	Is that
context: Hey.\Long time.\How've you been?\Not bad.\How was it?\Must be hard to get back into it.\I'm here.\Is that response:	I'm jealous.
context: Long time.\How've you been?\Not bad.\How was it?\Must be hard to get back into it.\I'm here.\Is that\I'm jealous. response:	I'm Matsuda. I'm run sprints.
context: How've you been?\Not bad.\How was it?\Must be hard to get back into it.\I'm here.\Is that\I'm jealous.\I'm Matsuda. I'm run sprints. response:	I'm Nagai. I do hurdles.
context: Not bad.\How was it?\Must be hard to get back into it.\I'm here.\Is that\I'm jealous.\I'm Matsuda. I'm run sprints.\I'm Nagai. I do hurdles. response:	I'm Hyouno.
context: How was it?\Must be hard to get back into it.\I'm here.\Is that\I'm jealous.\I'm Matsuda. I'm run sprints.\I'm Nagai. I do hurdles.\I'm Hyouno. response:	I'm Yukinari's
context: Must be hard to get back into it.\I'm here.\Is that\I'm jealous.\I'm Matsuda. I'm run sprints.\I'm Nagai. I do hurdles.\I'm Hyouno.\I'm Yukinari's response:	Who cares, Yanagi. Let's go.
context: I'm here.\Is that\I'm jealous.\I'm Matsuda. I'm run sprints.\I'm Nagai. I do hurdles.\I'm Hyouno.\I'm Yukinari's\Who cares, Yanagi. Let's go. response:	They call each other by their first names.
context: Is that\I'm jealous.\I'm Matsuda. I'm run sprints.\I'm Nagai. I do hurdles.\I'm Hyouno.\I'm Yukinari's\Who cares, Yanagi. Let's go.\They call each other by their first names. response:	Yukinari, don't use up all your energy.
context: I'm jealous.\I'm Matsuda. I'm run sprints.\I'm Nagai. I do hurdles.\I'm Hyouno.\I'm Yukinari's\Who cares, Yanagi. Let's go.\They call each other by their first names.\Yukinari, don't use up all your energy. response:	You guys should
context: I'm Matsuda. I'm run sprints.\I'm Nagai. I do hurdles.\I'm Hyouno.\I'm Yukinari's\Who cares, Yanagi. Let's go.\They call each other by their first names.\Yukinari, don't use up all your energy.\You guys should response:	get some release, too, or it'll hurt your performance.
context: I'm Nagai. I do hurdles.\I'm Hyouno.\I'm Yukinari's\Who cares, Yanagi. Let's go.\They call each other by their first names.\Yukinari, don't use up all your energy.\You guys should\get some release, too, or it'll hurt your performance. response:	The fireworks were awesome the other day.
context: I'm Hyouno.\I'm Yukinari's\Who cares, Yanagi. Let's go.\They call each other by their first names.\Yukinari, don't use up all your energy.\You guys should\get some release, too, or it'll hurt your performance.\The fireworks were awesome the other day. response:	I wish I saw it.
context: I'm Yukinari's\Who cares, Yanagi. Let's go.\They call each other by their first names.\Yukinari, don't use up all your energy.\You guys should\get some release, too, or it'll hurt your performance.\The fireworks were awesome the other day.\I wish I saw it. response:	Next year, for sure.
context: Who cares, Yanagi. Let's go.\They call each other by their first names.\Yukinari, don't use up all your energy.\You guys should\get some release, too, or it'll hurt your performance.\The fireworks were awesome the other day.\I wish I saw it.\Next year, for sure. response:	They're really huge up close!
context: They call each other by their first names.\Yukinari, don't use up all your energy.\You guys should\get some release, too, or it'll hurt your performance.\The fireworks were awesome the other day.\I wish I saw it.\Next year, for sure.\They're really huge up close! response:	Are you sure you should have said that?
context: Yukinari, don't use up all your energy.\You guys should\get some release, too, or it'll hurt your performance.\The fireworks were awesome the other day.\I wish I saw it.\Next year, for sure.\They're really huge up close!\Are you sure you should have said that? response:	They're going to start rumors.
context: You guys should\get some release, too, or it'll hurt your performance.\The fireworks were awesome the other day.\I wish I saw it.\Next year, for sure.\They're really huge up close!\Are you sure you should have said that?\They're going to start rumors. response:	Let them.
context: get some release, too, or it'll hurt your performance.\The fireworks were awesome the other day.\I wish I saw it.\Next year, for sure.\They're really huge up close!\Are you sure you should have said that?\They're going to start rumors.\Let them. response:	I just remembered I have something to do. See you.
context: The fireworks were awesome the other day.\I wish I saw it.\Next year, for sure.\They're really huge up close!\Are you sure you should have said that?\They're going to start rumors.\Let them.\I just remembered I have something to do. See you. response:	Hey,
context: I wish I saw it.\Next year, for sure.\They're really huge up close!\Are you sure you should have said that?\They're going to start rumors.\Let them.\I just remembered I have something to do. See you.\Hey, response:	is Hiro-kun on another...
context: Next year, for sure.\They're really huge up close!\Are you sure you should have said that?\They're going to start rumors.\Let them.\I just remembered I have something to do. See you.\Hey,\is Hiro-kun on another... response:	A date, I think.
context: They're really huge up close!\Are you sure you should have said that?\They're going to start rumors.\Let them.\I just remembered I have something to do. See you.\Hey,\is Hiro-kun on another...\A date, I think. response:	If you don't mind me asking, whom's he with?
context: Are you sure you should have said that?\They're going to start rumors.\Let them.\I just remembered I have something to do. See you.\Hey,\is Hiro-kun on another...\A date, I think.\If you don't mind me asking, whom's he with? response:	I wouldn't know.
context: They're going to start rumors.\Let them.\I just remembered I have something to do. See you.\Hey,\is Hiro-kun on another...\A date, I think.\If you don't mind me asking, whom's he with?\I wouldn't know. response:	That's right.
context: Let them.\I just remembered I have something to do. See you.\Hey,\is Hiro-kun on another...\A date, I think.\If you don't mind me asking, whom's he with?\I wouldn't know.\That's right. response:	Of course you wouldn't.
context: I just remembered I have something to do. See you.\Hey,\is Hiro-kun on another...\A date, I think.\If you don't mind me asking, whom's he with?\I wouldn't know.\That's right.\Of course you wouldn't. response:	Touko-san, was it?
context: Hey,\is Hiro-kun on another...\A date, I think.\If you don't mind me asking, whom's he with?\I wouldn't know.\That's right.\Of course you wouldn't.\Touko-san, was it? response:	Yes.
context: is Hiro-kun on another...\A date, I think.\If you don't mind me asking, whom's he with?\I wouldn't know.\That's right.\Of course you wouldn't.\Touko-san, was it?\Yes. response:	You've become even
context: A date, I think.\If you don't mind me asking, whom's he with?\I wouldn't know.\That's right.\Of course you wouldn't.\Touko-san, was it?\Yes.\You've become even response:	more of a lady lately.
context: If you don't mind me asking, whom's he with?\I wouldn't know.\That's right.\Of course you wouldn't.\Touko-san, was it?\Yes.\You've become even\more of a lady lately. response:	Summer is the season of love, huh?
context: I wouldn't know.\That's right.\Of course you wouldn't.\Touko-san, was it?\Yes.\You've become even\more of a lady lately.\Summer is the season of love, huh? response:	Excuse me, I've said too much to a dear customer.
context: That's right.\Of course you wouldn't.\Touko-san, was it?\Yes.\You've become even\more of a lady lately.\Summer is the season of love, huh?\Excuse me, I've said too much to a dear customer. response:	No, it's fine.
context: Of course you wouldn't.\Touko-san, was it?\Yes.\You've become even\more of a lady lately.\Summer is the season of love, huh?\Excuse me, I've said too much to a dear customer.\No, it's fine. response:	Let me bring you a cookie to make up for it, on me.
context: Touko-san, was it?\Yes.\You've become even\more of a lady lately.\Summer is the season of love, huh?\Excuse me, I've said too much to a dear customer.\No, it's fine.\Let me bring you a cookie to make up for it, on me. response:	Thanks.
context: Yes.\You've become even\more of a lady lately.\Summer is the season of love, huh?\Excuse me, I've said too much to a dear customer.\No, it's fine.\Let me bring you a cookie to make up for it, on me.\Thanks. response:	Thanks.
context: You've become even\more of a lady lately.\Summer is the season of love, huh?\Excuse me, I've said too much to a dear customer.\No, it's fine.\Let me bring you a cookie to make up for it, on me.\Thanks.\Thanks. response:	Sacchan
context: more of a lady lately.\Summer is the season of love, huh?\Excuse me, I've said too much to a dear customer.\No, it's fine.\Let me bring you a cookie to make up for it, on me.\Thanks.\Thanks.\Sacchan response:	No way.
context: Summer is the season of love, huh?\Excuse me, I've said too much to a dear customer.\No, it's fine.\Let me bring you a cookie to make up for it, on me.\Thanks.\Thanks.\Sacchan\No way. response:	But, then...
context: Excuse me, I've said too much to a dear customer.\No, it's fine.\Let me bring you a cookie to make up for it, on me.\Thanks.\Thanks.\Sacchan\No way.\But, then... response:	Who? Who?!
context: No, it's fine.\Let me bring you a cookie to make up for it, on me.\Thanks.\Thanks.\Sacchan\No way.\But, then...\Who? Who?! response:	Thanks for earlier.
context: Let me bring you a cookie to make up for it, on me.\Thanks.\Thanks.\Sacchan\No way.\But, then...\Who? Who?!\Thanks for earlier. response:	You chased me down all out of breath just to say that?
context: Thanks.\Thanks.\Sacchan\No way.\But, then...\Who? Who?!\Thanks for earlier.\You chased me down all out of breath just to say that? response:	I wanted to talk to you about something.
context: Thanks.\Sacchan\No way.\But, then...\Who? Who?!\Thanks for earlier.\You chased me down all out of breath just to say that?\I wanted to talk to you about something. response:	I bet you've done it before, too.
context: Sacchan\No way.\But, then...\Who? Who?!\Thanks for earlier.\You chased me down all out of breath just to say that?\I wanted to talk to you about something.\I bet you've done it before, too. response:	Talking to the plaster figure in the art room
context: No way.\But, then...\Who? Who?!\Thanks for earlier.\You chased me down all out of breath just to say that?\I wanted to talk to you about something.\I bet you've done it before, too.\Talking to the plaster figure in the art room response:	to gather your thoughts.
context: But, then...\Who? Who?!\Thanks for earlier.\You chased me down all out of breath just to say that?\I wanted to talk to you about something.\I bet you've done it before, too.\Talking to the plaster figure in the art room\to gather your thoughts. response:	Not really.
context: Who? Who?!\Thanks for earlier.\You chased me down all out of breath just to say that?\I wanted to talk to you about something.\I bet you've done it before, too.\Talking to the plaster figure in the art room\to gather your thoughts.\Not really. response:	Touko says she has.
context: Thanks for earlier.\You chased me down all out of breath just to say that?\I wanted to talk to you about something.\I bet you've done it before, too.\Talking to the plaster figure in the art room\to gather your thoughts.\Not really.\Touko says she has. response:	So are you saying I don't have to respond?
context: You chased me down all out of breath just to say that?\I wanted to talk to you about something.\I bet you've done it before, too.\Talking to the plaster figure in the art room\to gather your thoughts.\Not really.\Touko says she has.\So are you saying I don't have to respond? response:	Hello. Is Sacchan in?
context: I wanted to talk to you about something.\I bet you've done it before, too.\Talking to the plaster figure in the art room\to gather your thoughts.\Not really.\Touko says she has.\So are you saying I don't have to respond?\Hello. Is Sacchan in? response:	Touko-chan's here.
context: I bet you've done it before, too.\Talking to the plaster figure in the art room\to gather your thoughts.\Not really.\Touko says she has.\So are you saying I don't have to respond?\Hello. Is Sacchan in?\Touko-chan's here. response:	She was coming today?
context: Talking to the plaster figure in the art room\to gather your thoughts.\Not really.\Touko says she has.\So are you saying I don't have to respond?\Hello. Is Sacchan in?\Touko-chan's here.\She was coming today? response:	Yeah.
context: to gather your thoughts.\Not really.\Touko says she has.\So are you saying I don't have to respond?\Hello. Is Sacchan in?\Touko-chan's here.\She was coming today?\Yeah. response:	Touko-chan.
context: Not really.\Touko says she has.\So are you saying I don't have to respond?\Hello. Is Sacchan in?\Touko-chan's here.\She was coming today?\Yeah.\Touko-chan. response:	Is it okay?
context: Touko says she has.\So are you saying I don't have to respond?\Hello. Is Sacchan in?\Touko-chan's here.\She was coming today?\Yeah.\Touko-chan.\Is it okay? response:	I'll be right there.
context: So are you saying I don't have to respond?\Hello. Is Sacchan in?\Touko-chan's here.\She was coming today?\Yeah.\Touko-chan.\Is it okay?\I'll be right there. response:	Come in.
context: Hello. Is Sacchan in?\Touko-chan's here.\She was coming today?\Yeah.\Touko-chan.\Is it okay?\I'll be right there.\Come in. response:	Thank you.
context: Touko-chan's here.\She was coming today?\Yeah.\Touko-chan.\Is it okay?\I'll be right there.\Come in.\Thank you. response:	No problem.
context: She was coming today?\Yeah.\Touko-chan.\Is it okay?\I'll be right there.\Come in.\Thank you.\No problem. response:	What's wrong?
context: Yeah.\Touko-chan.\Is it okay?\I'll be right there.\Come in.\Thank you.\No problem.\What's wrong? response:	Nothing. Come in.
context: Touko-chan.\Is it okay?\I'll be right there.\Come in.\Thank you.\No problem.\What's wrong?\Nothing. Come in. response:	Okay.
context: Is it okay?\I'll be right there.\Come in.\Thank you.\No problem.\What's wrong?\Nothing. Come in.\Okay. response:	Huh...
context: I'll be right there.\Come in.\Thank you.\No problem.\What's wrong?\Nothing. Come in.\Okay.\Huh... response:	I think it's Mom.
context: Come in.\Thank you.\No problem.\What's wrong?\Nothing. Come in.\Okay.\Huh...\I think it's Mom. response:	I'll go say hi.
context: Thank you.\No problem.\What's wrong?\Nothing. Come in.\Okay.\Huh...\I think it's Mom.\I'll go say hi. response:	There's no hurry.
context: No problem.\What's wrong?\Nothing. Come in.\Okay.\Huh...\I think it's Mom.\I'll go say hi.\There's no hurry. response:	Hm?
context: What's wrong?\Nothing. Come in.\Okay.\Huh...\I think it's Mom.\I'll go say hi.\There's no hurry.\Hm? response:	Yuki hurt his leg during the summer of first year.
context: Nothing. Come in.\Okay.\Huh...\I think it's Mom.\I'll go say hi.\There's no hurry.\Hm?\Yuki hurt his leg during the summer of first year. response:	He's rehabilitating.
context: Okay.\Huh...\I think it's Mom.\I'll go say hi.\There's no hurry.\Hm?\Yuki hurt his leg during the summer of first year.\He's rehabilitating. response:	There was a joint middle-school and high-school track meet today,
context: Huh...\I think it's Mom.\I'll go say hi.\There's no hurry.\Hm?\Yuki hurt his leg during the summer of first year.\He's rehabilitating.\There was a joint middle-school and high-school track meet today, response:	but it didn't go too well.
context: I think it's Mom.\I'll go say hi.\There's no hurry.\Hm?\Yuki hurt his leg during the summer of first year.\He's rehabilitating.\There was a joint middle-school and high-school track meet today,\but it didn't go too well. response:	Hiro-kun has
context: I'll go say hi.\There's no hurry.\Hm?\Yuki hurt his leg during the summer of first year.\He's rehabilitating.\There was a joint middle-school and high-school track meet today,\but it didn't go too well.\Hiro-kun has response:	a date today.
context: There's no hurry.\Hm?\Yuki hurt his leg during the summer of first year.\He's rehabilitating.\There was a joint middle-school and high-school track meet today,\but it didn't go too well.\Hiro-kun has\a date today. response:	I thought it'd be with you.
context: Hm?\Yuki hurt his leg during the summer of first year.\He's rehabilitating.\There was a joint middle-school and high-school track meet today,\but it didn't go too well.\Hiro-kun has\a date today.\I thought it'd be with you. response:	But I was already supposed to come over today.
context: Yuki hurt his leg during the summer of first year.\He's rehabilitating.\There was a joint middle-school and high-school track meet today,\but it didn't go too well.\Hiro-kun has\a date today.\I thought it'd be with you.\But I was already supposed to come over today. response:	Sacchan, are you going out with Hiro-kun?
context: He's rehabilitating.\There was a joint middle-school and high-school track meet today,\but it didn't go too well.\Hiro-kun has\a date today.\I thought it'd be with you.\But I was already supposed to come over today.\Sacchan, are you going out with Hiro-kun? response:	He was here until earlier.
context: There was a joint middle-school and high-school track meet today,\but it didn't go too well.\Hiro-kun has\a date today.\I thought it'd be with you.\But I was already supposed to come over today.\Sacchan, are you going out with Hiro-kun?\He was here until earlier. response:	So many surprises today.
context: but it didn't go too well.\Hiro-kun has\a date today.\I thought it'd be with you.\But I was already supposed to come over today.\Sacchan, are you going out with Hiro-kun?\He was here until earlier.\So many surprises today. response:	I didn't think you'd be going out.
context: Hiro-kun has\a date today.\I thought it'd be with you.\But I was already supposed to come over today.\Sacchan, are you going out with Hiro-kun?\He was here until earlier.\So many surprises today.\I didn't think you'd be going out. response:	I didn't know.
context: a date today.\I thought it'd be with you.\But I was already supposed to come over today.\Sacchan, are you going out with Hiro-kun?\He was here until earlier.\So many surprises today.\I didn't think you'd be going out.\I didn't know. response:	Touko-chan, you've got it wrong.
context: I thought it'd be with you.\But I was already supposed to come over today.\Sacchan, are you going out with Hiro-kun?\He was here until earlier.\So many surprises today.\I didn't think you'd be going out.\I didn't know.\Touko-chan, you've got it wrong. response:	I never said I'm going out with him.
context: But I was already supposed to come over today.\Sacchan, are you going out with Hiro-kun?\He was here until earlier.\So many surprises today.\I didn't think you'd be going out.\I didn't know.\Touko-chan, you've got it wrong.\I never said I'm going out with him. response:	We were just reading together.
context: Sacchan, are you going out with Hiro-kun?\He was here until earlier.\So many surprises today.\I didn't think you'd be going out.\I didn't know.\Touko-chan, you've got it wrong.\I never said I'm going out with him.\We were just reading together. response:	Oh, right. Of course.
context: He was here until earlier.\So many surprises today.\I didn't think you'd be going out.\I didn't know.\Touko-chan, you've got it wrong.\I never said I'm going out with him.\We were just reading together.\Oh, right. Of course. response:	I guess it wouldn't be anything more.
context: So many surprises today.\I didn't think you'd be going out.\I didn't know.\Touko-chan, you've got it wrong.\I never said I'm going out with him.\We were just reading together.\Oh, right. Of course.\I guess it wouldn't be anything more. response:	And you? Have you met with that guy since then?
context: I didn't think you'd be going out.\I didn't know.\Touko-chan, you've got it wrong.\I never said I'm going out with him.\We were just reading together.\Oh, right. Of course.\I guess it wouldn't be anything more.\And you? Have you met with that guy since then? response:	Yeah, about that.
context: I didn't know.\Touko-chan, you've got it wrong.\I never said I'm going out with him.\We were just reading together.\Oh, right. Of course.\I guess it wouldn't be anything more.\And you? Have you met with that guy since then?\Yeah, about that. response:	Okikura-kun seems stern,
context: Touko-chan, you've got it wrong.\I never said I'm going out with him.\We were just reading together.\Oh, right. Of course.\I guess it wouldn't be anything more.\And you? Have you met with that guy since then?\Yeah, about that.\Okikura-kun seems stern, response:	but I thought maybe he has a nice side.
context: I never said I'm going out with him.\We were just reading together.\Oh, right. Of course.\I guess it wouldn't be anything more.\And you? Have you met with that guy since then?\Yeah, about that.\Okikura-kun seems stern,\but I thought maybe he has a nice side. response:	Ah.
context: We were just reading together.\Oh, right. Of course.\I guess it wouldn't be anything more.\And you? Have you met with that guy since then?\Yeah, about that.\Okikura-kun seems stern,\but I thought maybe he has a nice side.\Ah. response:	And he's cute.
context: Oh, right. Of course.\I guess it wouldn't be anything more.\And you? Have you met with that guy since then?\Yeah, about that.\Okikura-kun seems stern,\but I thought maybe he has a nice side.\Ah.\And he's cute. response:	Oh. No, no, no. It's not like that.
context: I guess it wouldn't be anything more.\And you? Have you met with that guy since then?\Yeah, about that.\Okikura-kun seems stern,\but I thought maybe he has a nice side.\Ah.\And he's cute.\Oh. No, no, no. It's not like that. response:	Nothing like that.
context: And you? Have you met with that guy since then?\Yeah, about that.\Okikura-kun seems stern,\but I thought maybe he has a nice side.\Ah.\And he's cute.\Oh. No, no, no. It's not like that.\Nothing like that. response:	I'm going to be in the hospital for a while soon.
context: Yeah, about that.\Okikura-kun seems stern,\but I thought maybe he has a nice side.\Ah.\And he's cute.\Oh. No, no, no. It's not like that.\Nothing like that.\I'm going to be in the hospital for a while soon. response:	It's just for tests, so it's nothing to worry about.
context: Okikura-kun seems stern,\but I thought maybe he has a nice side.\Ah.\And he's cute.\Oh. No, no, no. It's not like that.\Nothing like that.\I'm going to be in the hospital for a while soon.\It's just for tests, so it's nothing to worry about. response:	Oh really?
context: but I thought maybe he has a nice side.\Ah.\And he's cute.\Oh. No, no, no. It's not like that.\Nothing like that.\I'm going to be in the hospital for a while soon.\It's just for tests, so it's nothing to worry about.\Oh really? response:	There's somewhere I want to go with you when I'm discharged.
context: Ah.\And he's cute.\Oh. No, no, no. It's not like that.\Nothing like that.\I'm going to be in the hospital for a while soon.\It's just for tests, so it's nothing to worry about.\Oh really?\There's somewhere I want to go with you when I'm discharged. response:	Where?
context: And he's cute.\Oh. No, no, no. It's not like that.\Nothing like that.\I'm going to be in the hospital for a while soon.\It's just for tests, so it's nothing to worry about.\Oh really?\There's somewhere I want to go with you when I'm discharged.\Where? response:	I can't tell you yet.
context: Oh. No, no, no. It's not like that.\Nothing like that.\I'm going to be in the hospital for a while soon.\It's just for tests, so it's nothing to worry about.\Oh really?\There's somewhere I want to go with you when I'm discharged.\Where?\I can't tell you yet. response:	I wish I could see the future.
context: Nothing like that.\I'm going to be in the hospital for a while soon.\It's just for tests, so it's nothing to worry about.\Oh really?\There's somewhere I want to go with you when I'm discharged.\Where?\I can't tell you yet.\I wish I could see the future. response:	I think Yuki's really worried.
context: I'm going to be in the hospital for a while soon.\It's just for tests, so it's nothing to worry about.\Oh really?\There's somewhere I want to go with you when I'm discharged.\Where?\I can't tell you yet.\I wish I could see the future.\I think Yuki's really worried. response:	Everyone wants to know the future, right?
context: It's just for tests, so it's nothing to worry about.\Oh really?\There's somewhere I want to go with you when I'm discharged.\Where?\I can't tell you yet.\I wish I could see the future.\I think Yuki's really worried.\Everyone wants to know the future, right? response:	Are you seriously not going to say anything?
context: Oh really?\There's somewhere I want to go with you when I'm discharged.\Where?\I can't tell you yet.\I wish I could see the future.\I think Yuki's really worried.\Everyone wants to know the future, right?\Are you seriously not going to say anything? response:	Nah,
context: There's somewhere I want to go with you when I'm discharged.\Where?\I can't tell you yet.\I wish I could see the future.\I think Yuki's really worried.\Everyone wants to know the future, right?\Are you seriously not going to say anything?\Nah, response:	I won't see it.
context: Where?\I can't tell you yet.\I wish I could see the future.\I think Yuki's really worried.\Everyone wants to know the future, right?\Are you seriously not going to say anything?\Nah,\I won't see it. response:	Okikura residence.
context: I can't tell you yet.\I wish I could see the future.\I think Yuki's really worried.\Everyone wants to know the future, right?\Are you seriously not going to say anything?\Nah,\I won't see it.\Okikura residence. response:	Okikura-kun? It's Fukami.
context: I wish I could see the future.\I think Yuki's really worried.\Everyone wants to know the future, right?\Are you seriously not going to say anything?\Nah,\I won't see it.\Okikura residence.\Okikura-kun? It's Fukami. response:	Can we meet up for a bit?
context: I think Yuki's really worried.\Everyone wants to know the future, right?\Are you seriously not going to say anything?\Nah,\I won't see it.\Okikura residence.\Okikura-kun? It's Fukami.\Can we meet up for a bit? response:	I know. What you said to me the other night...
context: Everyone wants to know the future, right?\Are you seriously not going to say anything?\Nah,\I won't see it.\Okikura residence.\Okikura-kun? It's Fukami.\Can we meet up for a bit?\I know. What you said to me the other night... response:	I thought about it.
context: Are you seriously not going to say anything?\Nah,\I won't see it.\Okikura residence.\Okikura-kun? It's Fukami.\Can we meet up for a bit?\I know. What you said to me the other night...\I thought about it. response:	Kakeru is out right now.
context: Nah,\I won't see it.\Okikura residence.\Okikura-kun? It's Fukami.\Can we meet up for a bit?\I know. What you said to me the other night...\I thought about it.\Kakeru is out right now. response:	Excuse my late introduction. I'm Kakeru's dad.
context: I won't see it.\Okikura residence.\Okikura-kun? It's Fukami.\Can we meet up for a bit?\I know. What you said to me the other night...\I thought about it.\Kakeru is out right now.\Excuse my late introduction. I'm Kakeru's dad. response:	I'll let him know you called when he gets home.
context: Okikura residence.\Okikura-kun? It's Fukami.\Can we meet up for a bit?\I know. What you said to me the other night...\I thought about it.\Kakeru is out right now.\Excuse my late introduction. I'm Kakeru's dad.\I'll let him know you called when he gets home. response:	I'm sorry. Good-bye.
context: Okikura-kun? It's Fukami.\Can we meet up for a bit?\I know. What you said to me the other night...\I thought about it.\Kakeru is out right now.\Excuse my late introduction. I'm Kakeru's dad.\I'll let him know you called when he gets home.\I'm sorry. Good-bye. response:	I'm home.
context: Can we meet up for a bit?\I know. What you said to me the other night...\I thought about it.\Kakeru is out right now.\Excuse my late introduction. I'm Kakeru's dad.\I'll let him know you called when he gets home.\I'm sorry. Good-bye.\I'm home. response:	You would do that!
context: I know. What you said to me the other night...\I thought about it.\Kakeru is out right now.\Excuse my late introduction. I'm Kakeru's dad.\I'll let him know you called when he gets home.\I'm sorry. Good-bye.\I'm home.\You would do that! response:	What is this?
context: I thought about it.\Kakeru is out right now.\Excuse my late introduction. I'm Kakeru's dad.\I'll let him know you called when he gets home.\I'm sorry. Good-bye.\I'm home.\You would do that!\What is this? response:	Nothing, nothing!
context: Kakeru is out right now.\Excuse my late introduction. I'm Kakeru's dad.\I'll let him know you called when he gets home.\I'm sorry. Good-bye.\I'm home.\You would do that!\What is this?\Nothing, nothing! response:	I just thought maybe I'd read for once.
context: Excuse my late introduction. I'm Kakeru's dad.\I'll let him know you called when he gets home.\I'm sorry. Good-bye.\I'm home.\You would do that!\What is this?\Nothing, nothing!\I just thought maybe I'd read for once. response:	So you bought it?
context: I'll let him know you called when he gets home.\I'm sorry. Good-bye.\I'm home.\You would do that!\What is this?\Nothing, nothing!\I just thought maybe I'd read for once.\So you bought it? response:	Y-Y-Yes!
context: I'm sorry. Good-bye.\I'm home.\You would do that!\What is this?\Nothing, nothing!\I just thought maybe I'd read for once.\So you bought it?\Y-Y-Yes! response:	No, you didn't.
context: I'm home.\You would do that!\What is this?\Nothing, nothing!\I just thought maybe I'd read for once.\So you bought it?\Y-Y-Yes!\No, you didn't. response:	There's no chance you'd read Camus.
context: You would do that!\What is this?\Nothing, nothing!\I just thought maybe I'd read for once.\So you bought it?\Y-Y-Yes!\No, you didn't.\There's no chance you'd read Camus. response:	Camus. Camus! The Myth of Sisyphus!
context: What is this?\Nothing, nothing!\I just thought maybe I'd read for once.\So you bought it?\Y-Y-Yes!\No, you didn't.\There's no chance you'd read Camus.\Camus. Camus! The Myth of Sisyphus! response:	It makes no sense!
context: Nothing, nothing!\I just thought maybe I'd read for once.\So you bought it?\Y-Y-Yes!\No, you didn't.\There's no chance you'd read Camus.\Camus. Camus! The Myth of Sisyphus!\It makes no sense! response:	It's that tragic glasses girl.
context: I just thought maybe I'd read for once.\So you bought it?\Y-Y-Yes!\No, you didn't.\There's no chance you'd read Camus.\Camus. Camus! The Myth of Sisyphus!\It makes no sense!\It's that tragic glasses girl. response:	Hello, Fukami here.
context: So you bought it?\Y-Y-Yes!\No, you didn't.\There's no chance you'd read Camus.\Camus. Camus! The Myth of Sisyphus!\It makes no sense!\It's that tragic glasses girl.\Hello, Fukami here. response:	Hey. Sorry, I was out earlier.
context: Y-Y-Yes!\No, you didn't.\There's no chance you'd read Camus.\Camus. Camus! The Myth of Sisyphus!\It makes no sense!\It's that tragic glasses girl.\Hello, Fukami here.\Hey. Sorry, I was out earlier. response:	It's fine. I
context: No, you didn't.\There's no chance you'd read Camus.\Camus. Camus! The Myth of Sisyphus!\It makes no sense!\It's that tragic glasses girl.\Hello, Fukami here.\Hey. Sorry, I was out earlier.\It's fine. I response:	My dad said he's sorry for troubling a young girl.
context: There's no chance you'd read Camus.\Camus. Camus! The Myth of Sisyphus!\It makes no sense!\It's that tragic glasses girl.\Hello, Fukami here.\Hey. Sorry, I was out earlier.\It's fine. I\My dad said he's sorry for troubling a young girl. response:	I'm sorry, too.
context: Camus. Camus! The Myth of Sisyphus!\It makes no sense!\It's that tragic glasses girl.\Hello, Fukami here.\Hey. Sorry, I was out earlier.\It's fine. I\My dad said he's sorry for troubling a young girl.\I'm sorry, too. response:	It was my mistake.
context: It makes no sense!\It's that tragic glasses girl.\Hello, Fukami here.\Hey. Sorry, I was out earlier.\It's fine. I\My dad said he's sorry for troubling a young girl.\I'm sorry, too.\It was my mistake. response:	Do you want to come over now?
context: It's that tragic glasses girl.\Hello, Fukami here.\Hey. Sorry, I was out earlier.\It's fine. I\My dad said he's sorry for troubling a young girl.\I'm sorry, too.\It was my mistake.\Do you want to come over now? response:	If you have time,
context: Hello, Fukami here.\Hey. Sorry, I was out earlier.\It's fine. I\My dad said he's sorry for troubling a young girl.\I'm sorry, too.\It was my mistake.\Do you want to come over now?\If you have time, response:	my dad says he wants to cook for you to make up for it.
context: Hey. Sorry, I was out earlier.\It's fine. I\My dad said he's sorry for troubling a young girl.\I'm sorry, too.\It was my mistake.\Do you want to come over now?\If you have time,\my dad says he wants to cook for you to make up for it. response:	Cook?
context: It's fine. I\My dad said he's sorry for troubling a young girl.\I'm sorry, too.\It was my mistake.\Do you want to come over now?\If you have time,\my dad says he wants to cook for you to make up for it.\Cook? response:	Dad's been living alone for a long time.
context: My dad said he's sorry for troubling a young girl.\I'm sorry, too.\It was my mistake.\Do you want to come over now?\If you have time,\my dad says he wants to cook for you to make up for it.\Cook?\Dad's been living alone for a long time. response:	He's good at cooking.
context: I'm sorry, too.\It was my mistake.\Do you want to come over now?\If you have time,\my dad says he wants to cook for you to make up for it.\Cook?\Dad's been living alone for a long time.\He's good at cooking. response:	But
context: It was my mistake.\Do you want to come over now?\If you have time,\my dad says he wants to cook for you to make up for it.\Cook?\Dad's been living alone for a long time.\He's good at cooking.\But response:	Didn't you want to talk to me?
context: Do you want to come over now?\If you have time,\my dad says he wants to cook for you to make up for it.\Cook?\Dad's been living alone for a long time.\He's good at cooking.\But\Didn't you want to talk to me? response:	Yeah, but...
context: If you have time,\my dad says he wants to cook for you to make up for it.\Cook?\Dad's been living alone for a long time.\He's good at cooking.\But\Didn't you want to talk to me?\Yeah, but... response:	There's something I need to tell you, too.
context: my dad says he wants to cook for you to make up for it.\Cook?\Dad's been living alone for a long time.\He's good at cooking.\But\Didn't you want to talk to me?\Yeah, but...\There's something I need to tell you, too. response:	Do you know how to get here?
context: Cook?\Dad's been living alone for a long time.\He's good at cooking.\But\Didn't you want to talk to me?\Yeah, but...\There's something I need to tell you, too.\Do you know how to get here? response:	I don't.
context: Dad's been living alone for a long time.\He's good at cooking.\But\Didn't you want to talk to me?\Yeah, but...\There's something I need to tell you, too.\Do you know how to get here?\I don't. response:	Come in.
context: He's good at cooking.\But\Didn't you want to talk to me?\Yeah, but...\There's something I need to tell you, too.\Do you know how to get here?\I don't.\Come in. response:	I'm Touko Fukami.
context: But\Didn't you want to talk to me?\Yeah, but...\There's something I need to tell you, too.\Do you know how to get here?\I don't.\Come in.\I'm Touko Fukami. response:	Thanks for having me.
context: Didn't you want to talk to me?\Yeah, but...\There's something I need to tell you, too.\Do you know how to get here?\I don't.\Come in.\I'm Touko Fukami.\Thanks for having me. response:	I'll make something.
context: Yeah, but...\There's something I need to tell you, too.\Do you know how to get here?\I don't.\Come in.\I'm Touko Fukami.\Thanks for having me.\I'll make something. response:	Think of it as a light snack.
context: There's something I need to tell you, too.\Do you know how to get here?\I don't.\Come in.\I'm Touko Fukami.\Thanks for having me.\I'll make something.\Think of it as a light snack. response:	Okay.
context: Do you know how to get here?\I don't.\Come in.\I'm Touko Fukami.\Thanks for having me.\I'll make something.\Think of it as a light snack.\Okay. response:	Kakeru, make Fukami-san at home in the meantime.
context: I don't.\Come in.\I'm Touko Fukami.\Thanks for having me.\I'll make something.\Think of it as a light snack.\Okay.\Kakeru, make Fukami-san at home in the meantime. response:	She's half my guest today, after all.
context: Come in.\I'm Touko Fukami.\Thanks for having me.\I'll make something.\Think of it as a light snack.\Okay.\Kakeru, make Fukami-san at home in the meantime.\She's half my guest today, after all. response:	All right. I'll keep her company.
context: I'm Touko Fukami.\Thanks for having me.\I'll make something.\Think of it as a light snack.\Okay.\Kakeru, make Fukami-san at home in the meantime.\She's half my guest today, after all.\All right. I'll keep her company. response:	I'll show you to my room.
context: Thanks for having me.\I'll make something.\Think of it as a light snack.\Okay.\Kakeru, make Fukami-san at home in the meantime.\She's half my guest today, after all.\All right. I'll keep her company.\I'll show you to my room. response:	That's my room.
context: I'll make something.\Think of it as a light snack.\Okay.\Kakeru, make Fukami-san at home in the meantime.\She's half my guest today, after all.\All right. I'll keep her company.\I'll show you to my room.\That's my room. response:	Hey...
context: Think of it as a light snack.\Okay.\Kakeru, make Fukami-san at home in the meantime.\She's half my guest today, after all.\All right. I'll keep her company.\I'll show you to my room.\That's my room.\Hey... response:	Yeah?
context: Okay.\Kakeru, make Fukami-san at home in the meantime.\She's half my guest today, after all.\All right. I'll keep her company.\I'll show you to my room.\That's my room.\Hey...\Yeah? response:	When it rained the other day,
context: Kakeru, make Fukami-san at home in the meantime.\She's half my guest today, after all.\All right. I'll keep her company.\I'll show you to my room.\That's my room.\Hey...\Yeah?\When it rained the other day, response:	on the road to Kirinkan...
context: She's half my guest today, after all.\All right. I'll keep her company.\I'll show you to my room.\That's my room.\Hey...\Yeah?\When it rained the other day,\on the road to Kirinkan... response:	You saw.
context: All right. I'll keep her company.\I'll show you to my room.\That's my room.\Hey...\Yeah?\When it rained the other day,\on the road to Kirinkan...\You saw. response:	I wasn't hugging her.
context: I'll show you to my room.\That's my room.\Hey...\Yeah?\When it rained the other day,\on the road to Kirinkan...\You saw.\I wasn't hugging her. response:	I just caught her.
context: That's my room.\Hey...\Yeah?\When it rained the other day,\on the road to Kirinkan...\You saw.\I wasn't hugging her.\I just caught her. response:	Hugging...
context: Hey...\Yeah?\When it rained the other day,\on the road to Kirinkan...\You saw.\I wasn't hugging her.\I just caught her.\Hugging... response:	She'd hurt her leg.
context: Yeah?\When it rained the other day,\on the road to Kirinkan...\You saw.\I wasn't hugging her.\I just caught her.\Hugging...\She'd hurt her leg. response:	You know about that, don't you?
context: When it rained the other day,\on the road to Kirinkan...\You saw.\I wasn't hugging her.\I just caught her.\Hugging...\She'd hurt her leg.\You know about that, don't you? response:	It's okay. I'm done talking.
context: on the road to Kirinkan...\You saw.\I wasn't hugging her.\I just caught her.\Hugging...\She'd hurt her leg.\You know about that, don't you?\It's okay. I'm done talking. response:	She nearly fell over on the steep road.
context: You saw.\I wasn't hugging her.\I just caught her.\Hugging...\She'd hurt her leg.\You know about that, don't you?\It's okay. I'm done talking.\She nearly fell over on the steep road. response:	Anyway, it's nothing.
context: I wasn't hugging her.\I just caught her.\Hugging...\She'd hurt her leg.\You know about that, don't you?\It's okay. I'm done talking.\She nearly fell over on the steep road.\Anyway, it's nothing. response:	But the reason I wanted you over today is to talk about herTakayama.
context: I just caught her.\Hugging...\She'd hurt her leg.\You know about that, don't you?\It's okay. I'm done talking.\She nearly fell over on the steep road.\Anyway, it's nothing.\But the reason I wanted you over today is to talk about herTakayama. response:	Takayama is going to confess to Yukinari Imi.
context: Hugging...\She'd hurt her leg.\You know about that, don't you?\It's okay. I'm done talking.\She nearly fell over on the steep road.\Anyway, it's nothing.\But the reason I wanted you over today is to talk about herTakayama.\Takayama is going to confess to Yukinari Imi. response:	Eh?
context: She'd hurt her leg.\You know about that, don't you?\It's okay. I'm done talking.\She nearly fell over on the steep road.\Anyway, it's nothing.\But the reason I wanted you over today is to talk about herTakayama.\Takayama is going to confess to Yukinari Imi.\Eh? response:	I said, Takayama is going to confess to Yukinari Imi.
context: You know about that, don't you?\It's okay. I'm done talking.\She nearly fell over on the steep road.\Anyway, it's nothing.\But the reason I wanted you over today is to talk about herTakayama.\Takayama is going to confess to Yukinari Imi.\Eh?\I said, Takayama is going to confess to Yukinari Imi. response:	What? What? What?
context: It's okay. I'm done talking.\She nearly fell over on the steep road.\Anyway, it's nothing.\But the reason I wanted you over today is to talk about herTakayama.\Takayama is going to confess to Yukinari Imi.\Eh?\I said, Takayama is going to confess to Yukinari Imi.\What? What? What? response:	How do you know that about her?
context: She nearly fell over on the steep road.\Anyway, it's nothing.\But the reason I wanted you over today is to talk about herTakayama.\Takayama is going to confess to Yukinari Imi.\Eh?\I said, Takayama is going to confess to Yukinari Imi.\What? What? What?\How do you know that about her? response:	Did you see the future?
context: Anyway, it's nothing.\But the reason I wanted you over today is to talk about herTakayama.\Takayama is going to confess to Yukinari Imi.\Eh?\I said, Takayama is going to confess to Yukinari Imi.\What? What? What?\How do you know that about her?\Did you see the future? response:	She told me herself.
context: But the reason I wanted you over today is to talk about herTakayama.\Takayama is going to confess to Yukinari Imi.\Eh?\I said, Takayama is going to confess to Yukinari Imi.\What? What? What?\How do you know that about her?\Did you see the future?\She told me herself. response:	She told me to tell you.
context: Takayama is going to confess to Yukinari Imi.\Eh?\I said, Takayama is going to confess to Yukinari Imi.\What? What? What?\How do you know that about her?\Did you see the future?\She told me herself.\She told me to tell you. response:	I want you to tell Touko about this.
context: Eh?\I said, Takayama is going to confess to Yukinari Imi.\What? What? What?\How do you know that about her?\Did you see the future?\She told me herself.\She told me to tell you.\I want you to tell Touko about this. response:	Because
context: I said, Takayama is going to confess to Yukinari Imi.\What? What? What?\How do you know that about her?\Did you see the future?\She told me herself.\She told me to tell you.\I want you to tell Touko about this.\Because response:	I won't ask why.
context: What? What? What?\How do you know that about her?\Did you see the future?\She told me herself.\She told me to tell you.\I want you to tell Touko about this.\Because\I won't ask why. response:	Don't talk, statue.
context: How do you know that about her?\Did you see the future?\She told me herself.\She told me to tell you.\I want you to tell Touko about this.\Because\I won't ask why.\Don't talk, statue. response:	Crap.
context: Did you see the future?\She told me herself.\She told me to tell you.\I want you to tell Touko about this.\Because\I won't ask why.\Don't talk, statue.\Crap. response:	It's good.
context: She told me herself.\She told me to tell you.\I want you to tell Touko about this.\Because\I won't ask why.\Don't talk, statue.\Crap.\It's good. response:	Say, Kakeru,
context: She told me to tell you.\I want you to tell Touko about this.\Because\I won't ask why.\Don't talk, statue.\Crap.\It's good.\Say, Kakeru, response:	this is a good opportunity. Why don't you get a cell phone?
context: I want you to tell Touko about this.\Because\I won't ask why.\Don't talk, statue.\Crap.\It's good.\Say, Kakeru,\this is a good opportunity. Why don't you get a cell phone? response:	It'd be useful.
context: Because\I won't ask why.\Don't talk, statue.\Crap.\It's good.\Say, Kakeru,\this is a good opportunity. Why don't you get a cell phone?\It'd be useful. response:	Are they really that useful?
context: I won't ask why.\Don't talk, statue.\Crap.\It's good.\Say, Kakeru,\this is a good opportunity. Why don't you get a cell phone?\It'd be useful.\Are they really that useful? response:	Yeah. Well, I might die without one.
context: Don't talk, statue.\Crap.\It's good.\Say, Kakeru,\this is a good opportunity. Why don't you get a cell phone?\It'd be useful.\Are they really that useful?\Yeah. Well, I might die without one. response:	Would anyone ever call me?
context: Crap.\It's good.\Say, Kakeru,\this is a good opportunity. Why don't you get a cell phone?\It'd be useful.\Are they really that useful?\Yeah. Well, I might die without one.\Would anyone ever call me? response:	Is Yana-chan's leg all better now?
context: It's good.\Say, Kakeru,\this is a good opportunity. Why don't you get a cell phone?\It'd be useful.\Are they really that useful?\Yeah. Well, I might die without one.\Would anyone ever call me?\Is Yana-chan's leg all better now? response:	I think so.
context: Say, Kakeru,\this is a good opportunity. Why don't you get a cell phone?\It'd be useful.\Are they really that useful?\Yeah. Well, I might die without one.\Would anyone ever call me?\Is Yana-chan's leg all better now?\I think so. response:	That's good to hear.
context: this is a good opportunity. Why don't you get a cell phone?\It'd be useful.\Are they really that useful?\Yeah. Well, I might die without one.\Would anyone ever call me?\Is Yana-chan's leg all better now?\I think so.\That's good to hear. response:	Seriously, I know your boyfriend's there,
context: It'd be useful.\Are they really that useful?\Yeah. Well, I might die without one.\Would anyone ever call me?\Is Yana-chan's leg all better now?\I think so.\That's good to hear.\Seriously, I know your boyfriend's there, response:	but you've seriously got ears all over the hospital.
context: Are they really that useful?\Yeah. Well, I might die without one.\Would anyone ever call me?\Is Yana-chan's leg all better now?\I think so.\That's good to hear.\Seriously, I know your boyfriend's there,\but you've seriously got ears all over the hospital. response:	How often are you there?
context: Yeah. Well, I might die without one.\Would anyone ever call me?\Is Yana-chan's leg all better now?\I think so.\That's good to hear.\Seriously, I know your boyfriend's there,\but you've seriously got ears all over the hospital.\How often are you there? response:	Three days a week.
context: Would anyone ever call me?\Is Yana-chan's leg all better now?\I think so.\That's good to hear.\Seriously, I know your boyfriend's there,\but you've seriously got ears all over the hospital.\How often are you there?\Three days a week. response:	They were such a cute couple.
context: Is Yana-chan's leg all better now?\I think so.\That's good to hear.\Seriously, I know your boyfriend's there,\but you've seriously got ears all over the hospital.\How often are you there?\Three days a week.\They were such a cute couple. response:	They're both remarried and have kids.
context: I think so.\That's good to hear.\Seriously, I know your boyfriend's there,\but you've seriously got ears all over the hospital.\How often are you there?\Three days a week.\They were such a cute couple.\They're both remarried and have kids. response:	There they are amidst their complicated family,
context: That's good to hear.\Seriously, I know your boyfriend's there,\but you've seriously got ears all over the hospital.\How often are you there?\Three days a week.\They were such a cute couple.\They're both remarried and have kids.\There they are amidst their complicated family, response:	like leaves in a cold blast, like a boat,
context: Seriously, I know your boyfriend's there,\but you've seriously got ears all over the hospital.\How often are you there?\Three days a week.\They were such a cute couple.\They're both remarried and have kids.\There they are amidst their complicated family,\like leaves in a cold blast, like a boat, response:	their hearts tossed in a storm!
context: but you've seriously got ears all over the hospital.\How often are you there?\Three days a week.\They were such a cute couple.\They're both remarried and have kids.\There they are amidst their complicated family,\like leaves in a cold blast, like a boat,\their hearts tossed in a storm! response:	Go away.
context: How often are you there?\Three days a week.\They were such a cute couple.\They're both remarried and have kids.\There they are amidst their complicated family,\like leaves in a cold blast, like a boat,\their hearts tossed in a storm!\Go away. response:	Friendship punch!
context: Three days a week.\They were such a cute couple.\They're both remarried and have kids.\There they are amidst their complicated family,\like leaves in a cold blast, like a boat,\their hearts tossed in a storm!\Go away.\Friendship punch! response:	I had such a treat today.
context: They were such a cute couple.\They're both remarried and have kids.\There they are amidst their complicated family,\like leaves in a cold blast, like a boat,\their hearts tossed in a storm!\Go away.\Friendship punch!\I had such a treat today. response:	Thanks for having me over.
context: They're both remarried and have kids.\There they are amidst their complicated family,\like leaves in a cold blast, like a boat,\their hearts tossed in a storm!\Go away.\Friendship punch!\I had such a treat today.\Thanks for having me over. response:	See you.
context: There they are amidst their complicated family,\like leaves in a cold blast, like a boat,\their hearts tossed in a storm!\Go away.\Friendship punch!\I had such a treat today.\Thanks for having me over.\See you. response:	I found an interesting place the other day.
context: like leaves in a cold blast, like a boat,\their hearts tossed in a storm!\Go away.\Friendship punch!\I had such a treat today.\Thanks for having me over.\See you.\I found an interesting place the other day. response:	It's nearby.
context: their hearts tossed in a storm!\Go away.\Friendship punch!\I had such a treat today.\Thanks for having me over.\See you.\I found an interesting place the other day.\It's nearby. response:	When I found it, I knew I had to take you there.
context: Go away.\Friendship punch!\I had such a treat today.\Thanks for having me over.\See you.\I found an interesting place the other day.\It's nearby.\When I found it, I knew I had to take you there. response:	I've been meaning to ask you.
context: Friendship punch!\I had such a treat today.\Thanks for having me over.\See you.\I found an interesting place the other day.\It's nearby.\When I found it, I knew I had to take you there.\I've been meaning to ask you. response:	Do you want to go now?
context: I had such a treat today.\Thanks for having me over.\See you.\I found an interesting place the other day.\It's nearby.\When I found it, I knew I had to take you there.\I've been meaning to ask you.\Do you want to go now? response:	Sure.
context: Thanks for having me over.\See you.\I found an interesting place the other day.\It's nearby.\When I found it, I knew I had to take you there.\I've been meaning to ask you.\Do you want to go now?\Sure. response:	Wait here. I'll get ready.
context: See you.\I found an interesting place the other day.\It's nearby.\When I found it, I knew I had to take you there.\I've been meaning to ask you.\Do you want to go now?\Sure.\Wait here. I'll get ready. response:	Thanks for everything today. The meal was delicious.
context: I found an interesting place the other day.\It's nearby.\When I found it, I knew I had to take you there.\I've been meaning to ask you.\Do you want to go now?\Sure.\Wait here. I'll get ready.\Thanks for everything today. The meal was delicious. response:	Say hi to your dad for me. I'll be heading home now.
context: It's nearby.\When I found it, I knew I had to take you there.\I've been meaning to ask you.\Do you want to go now?\Sure.\Wait here. I'll get ready.\Thanks for everything today. The meal was delicious.\Say hi to your dad for me. I'll be heading home now. response:	Bye.
context: When I found it, I knew I had to take you there.\I've been meaning to ask you.\Do you want to go now?\Sure.\Wait here. I'll get ready.\Thanks for everything today. The meal was delicious.\Say hi to your dad for me. I'll be heading home now.\Bye. response:	She still hasn't told me what she wanted to talk to me about.
context: I've been meaning to ask you.\Do you want to go now?\Sure.\Wait here. I'll get ready.\Thanks for everything today. The meal was delicious.\Say hi to your dad for me. I'll be heading home now.\Bye.\She still hasn't told me what she wanted to talk to me about. response:	Yanagi. You haven't made it home yet?
context: Do you want to go now?\Sure.\Wait here. I'll get ready.\Thanks for everything today. The meal was delicious.\Say hi to your dad for me. I'll be heading home now.\Bye.\She still hasn't told me what she wanted to talk to me about.\Yanagi. You haven't made it home yet? response:	I'm resting here.
context: Sure.\Wait here. I'll get ready.\Thanks for everything today. The meal was delicious.\Say hi to your dad for me. I'll be heading home now.\Bye.\She still hasn't told me what she wanted to talk to me about.\Yanagi. You haven't made it home yet?\I'm resting here. response:	This is where I take a break, eat, drink some water,
context: Wait here. I'll get ready.\Thanks for everything today. The meal was delicious.\Say hi to your dad for me. I'll be heading home now.\Bye.\She still hasn't told me what she wanted to talk to me about.\Yanagi. You haven't made it home yet?\I'm resting here.\This is where I take a break, eat, drink some water, response:	and get ready for the rest of the trip.
context: Thanks for everything today. The meal was delicious.\Say hi to your dad for me. I'll be heading home now.\Bye.\She still hasn't told me what she wanted to talk to me about.\Yanagi. You haven't made it home yet?\I'm resting here.\This is where I take a break, eat, drink some water,\and get ready for the rest of the trip. response:	You don't have any water.
context: Say hi to your dad for me. I'll be heading home now.\Bye.\She still hasn't told me what she wanted to talk to me about.\Yanagi. You haven't made it home yet?\I'm resting here.\This is where I take a break, eat, drink some water,\and get ready for the rest of the trip.\You don't have any water. response:	There was something I wanted to tell you.
context: Bye.\She still hasn't told me what she wanted to talk to me about.\Yanagi. You haven't made it home yet?\I'm resting here.\This is where I take a break, eat, drink some water,\and get ready for the rest of the trip.\You don't have any water.\There was something I wanted to tell you. response:	like you.
context: She still hasn't told me what she wanted to talk to me about.\Yanagi. You haven't made it home yet?\I'm resting here.\This is where I take a break, eat, drink some water,\and get ready for the rest of the trip.\You don't have any water.\There was something I wanted to tell you.\like you. response:	I know you like Touko.
context: Yanagi. You haven't made it home yet?\I'm resting here.\This is where I take a break, eat, drink some water,\and get ready for the rest of the trip.\You don't have any water.\There was something I wanted to tell you.\like you.\I know you like Touko. response:	I know you confessed to her, too.
context: I'm resting here.\This is where I take a break, eat, drink some water,\and get ready for the rest of the trip.\You don't have any water.\There was something I wanted to tell you.\like you.\I know you like Touko.\I know you confessed to her, too. response:	I know it's going to be painful for me
context: This is where I take a break, eat, drink some water,\and get ready for the rest of the trip.\You don't have any water.\There was something I wanted to tell you.\like you.\I know you like Touko.\I know you confessed to her, too.\I know it's going to be painful for me response:	to live with you after you reject me.
context: and get ready for the rest of the trip.\You don't have any water.\There was something I wanted to tell you.\like you.\I know you like Touko.\I know you confessed to her, too.\I know it's going to be painful for me\to live with you after you reject me. response:	We're family, as you said.
context: You don't have any water.\There was something I wanted to tell you.\like you.\I know you like Touko.\I know you confessed to her, too.\I know it's going to be painful for me\to live with you after you reject me.\We're family, as you said. response:	I know what your answer is.
context: There was something I wanted to tell you.\like you.\I know you like Touko.\I know you confessed to her, too.\I know it's going to be painful for me\to live with you after you reject me.\We're family, as you said.\I know what your answer is. response:	I mean, I would have been really happy if you gave up Touko for me,
context: like you.\I know you like Touko.\I know you confessed to her, too.\I know it's going to be painful for me\to live with you after you reject me.\We're family, as you said.\I know what your answer is.\I mean, I would have been really happy if you gave up Touko for me, response:	but I would have lost respect for you.
context: I know you like Touko.\I know you confessed to her, too.\I know it's going to be painful for me\to live with you after you reject me.\We're family, as you said.\I know what your answer is.\I mean, I would have been really happy if you gave up Touko for me,\but I would have lost respect for you. response:	Still, I wanted to tell you.
context: I know you confessed to her, too.\I know it's going to be painful for me\to live with you after you reject me.\We're family, as you said.\I know what your answer is.\I mean, I would have been really happy if you gave up Touko for me,\but I would have lost respect for you.\Still, I wanted to tell you. response:	I don't know what's going to happen to us now,
context: I know it's going to be painful for me\to live with you after you reject me.\We're family, as you said.\I know what your answer is.\I mean, I would have been really happy if you gave up Touko for me,\but I would have lost respect for you.\Still, I wanted to tell you.\I don't know what's going to happen to us now, response:	but this is where I move forward.
context: to live with you after you reject me.\We're family, as you said.\I know what your answer is.\I mean, I would have been really happy if you gave up Touko for me,\but I would have lost respect for you.\Still, I wanted to tell you.\I don't know what's going to happen to us now,\but this is where I move forward. response:	I wanted to tell you that here.
context: We're family, as you said.\I know what your answer is.\I mean, I would have been really happy if you gave up Touko for me,\but I would have lost respect for you.\Still, I wanted to tell you.\I don't know what's going to happen to us now,\but this is where I move forward.\I wanted to tell you that here. response:	I'll head home first.
context: I know what your answer is.\I mean, I would have been really happy if you gave up Touko for me,\but I would have lost respect for you.\Still, I wanted to tell you.\I don't know what's going to happen to us now,\but this is where I move forward.\I wanted to tell you that here.\I'll head home first. response:	If I see you there, I hope we can keep things the way they were.
context: I mean, I would have been really happy if you gave up Touko for me,\but I would have lost respect for you.\Still, I wanted to tell you.\I don't know what's going to happen to us now,\but this is where I move forward.\I wanted to tell you that here.\I'll head home first.\If I see you there, I hope we can keep things the way they were. response:	I overheard something some high school girls
context: but I would have lost respect for you.\Still, I wanted to tell you.\I don't know what's going to happen to us now,\but this is where I move forward.\I wanted to tell you that here.\I'll head home first.\If I see you there, I hope we can keep things the way they were.\I overheard something some high school girls response:	said at the station.
context: Still, I wanted to tell you.\I don't know what's going to happen to us now,\but this is where I move forward.\I wanted to tell you that here.\I'll head home first.\If I see you there, I hope we can keep things the way they were.\I overheard something some high school girls\said at the station. response:	One of them said, 1221, year of the Joukyu war.
context: I don't know what's going to happen to us now,\but this is where I move forward.\I wanted to tell you that here.\I'll head home first.\If I see you there, I hope we can keep things the way they were.\I overheard something some high school girls\said at the station.\One of them said, 1221, year of the Joukyu war. response:	High school girls are busy, too.
context: but this is where I move forward.\I wanted to tell you that here.\I'll head home first.\If I see you there, I hope we can keep things the way they were.\I overheard something some high school girls\said at the station.\One of them said, 1221, year of the Joukyu war.\High school girls are busy, too. response:	Hina, can you set up the chopsticks and stuff?
context: I wanted to tell you that here.\I'll head home first.\If I see you there, I hope we can keep things the way they were.\I overheard something some high school girls\said at the station.\One of them said, 1221, year of the Joukyu war.\High school girls are busy, too.\Hina, can you set up the chopsticks and stuff? response:	Okay.
context: I'll head home first.\If I see you there, I hope we can keep things the way they were.\I overheard something some high school girls\said at the station.\One of them said, 1221, year of the Joukyu war.\High school girls are busy, too.\Hina, can you set up the chopsticks and stuff?\Okay. response:	Onee-chan, come help.
context: If I see you there, I hope we can keep things the way they were.\I overheard something some high school girls\said at the station.\One of them said, 1221, year of the Joukyu war.\High school girls are busy, too.\Hina, can you set up the chopsticks and stuff?\Okay.\Onee-chan, come help. response:	Onee-chan, dinner!
context: I overheard something some high school girls\said at the station.\One of them said, 1221, year of the Joukyu war.\High school girls are busy, too.\Hina, can you set up the chopsticks and stuff?\Okay.\Onee-chan, come help.\Onee-chan, dinner! response:	Okay.
context: said at the station.\One of them said, 1221, year of the Joukyu war.\High school girls are busy, too.\Hina, can you set up the chopsticks and stuff?\Okay.\Onee-chan, come help.\Onee-chan, dinner!\Okay. response:	I wanted to tell you myself.
context: One of them said, 1221, year of the Joukyu war.\High school girls are busy, too.\Hina, can you set up the chopsticks and stuff?\Okay.\Onee-chan, come help.\Onee-chan, dinner!\Okay.\I wanted to tell you myself. response:	That doesn't explain anything.
context: High school girls are busy, too.\Hina, can you set up the chopsticks and stuff?\Okay.\Onee-chan, come help.\Onee-chan, dinner!\Okay.\I wanted to tell you myself.\That doesn't explain anything. response:	I'm a total idiot.
context: Hina, can you set up the chopsticks and stuff?\Okay.\Onee-chan, come help.\Onee-chan, dinner!\Okay.\I wanted to tell you myself.\That doesn't explain anything.\I'm a total idiot. response:	What am I?!
context: Okay.\Onee-chan, come help.\Onee-chan, dinner!\Okay.\I wanted to tell you myself.\That doesn't explain anything.\I'm a total idiot.\What am I?! response:	Come to the school yard. Let's put an end to this.
context: Onee-chan, come help.\Onee-chan, dinner!\Okay.\I wanted to tell you myself.\That doesn't explain anything.\I'm a total idiot.\What am I?!\Come to the school yard. Let's put an end to this. response:	Episode 6 Punch