context: Wood Shop response:	Wow, this is...
context: Wood Shop\Wow, this is... response:	Right?
context: Wood Shop\Wow, this is...\Right? response:	Doesn't it look awesome?
context: Wood Shop\Wow, this is...\Right?\Doesn't it look awesome? response:	Ready, and...
context: Wood Shop\Wow, this is...\Right?\Doesn't it look awesome?\Ready, and... response:	We did it!
context: Wood Shop\Wow, this is...\Right?\Doesn't it look awesome?\Ready, and...\We did it! response:	Episode Seven: The Ofunehiki Shakes
context: Wood Shop\Wow, this is...\Right?\Doesn't it look awesome?\Ready, and...\We did it!\Episode Seven: The Ofunehiki Shakes response:	You guys did a great job.
context: Wood Shop\Wow, this is...\Right?\Doesn't it look awesome?\Ready, and...\We did it!\Episode Seven: The Ofunehiki Shakes\You guys did a great job. response:	It's all thanks to me and Miuna.
context: Wow, this is...\Right?\Doesn't it look awesome?\Ready, and...\We did it!\Episode Seven: The Ofunehiki Shakes\You guys did a great job.\It's all thanks to me and Miuna. response:	Really? You're actually saying that?
context: Right?\Doesn't it look awesome?\Ready, and...\We did it!\Episode Seven: The Ofunehiki Shakes\You guys did a great job.\It's all thanks to me and Miuna.\Really? You're actually saying that? response:	This really is amazing.
context: Doesn't it look awesome?\Ready, and...\We did it!\Episode Seven: The Ofunehiki Shakes\You guys did a great job.\It's all thanks to me and Miuna.\Really? You're actually saying that?\This really is amazing. response:	I'm touched.
context: Ready, and...\We did it!\Episode Seven: The Ofunehiki Shakes\You guys did a great job.\It's all thanks to me and Miuna.\Really? You're actually saying that?\This really is amazing.\I'm touched. response:	Right?
context: We did it!\Episode Seven: The Ofunehiki Shakes\You guys did a great job.\It's all thanks to me and Miuna.\Really? You're actually saying that?\This really is amazing.\I'm touched.\Right? response:	We really worked hard.
context: Episode Seven: The Ofunehiki Shakes\You guys did a great job.\It's all thanks to me and Miuna.\Really? You're actually saying that?\This really is amazing.\I'm touched.\Right?\We really worked hard. response:	It was a lot more fun than I thought it'd be.
context: You guys did a great job.\It's all thanks to me and Miuna.\Really? You're actually saying that?\This really is amazing.\I'm touched.\Right?\We really worked hard.\It was a lot more fun than I thought it'd be. response:	All right.
context: It's all thanks to me and Miuna.\Really? You're actually saying that?\This really is amazing.\I'm touched.\Right?\We really worked hard.\It was a lot more fun than I thought it'd be.\All right. response:	This calls for some popsicles.
context: Really? You're actually saying that?\This really is amazing.\I'm touched.\Right?\We really worked hard.\It was a lot more fun than I thought it'd be.\All right.\This calls for some popsicles. response:	Huh?
context: This really is amazing.\I'm touched.\Right?\We really worked hard.\It was a lot more fun than I thought it'd be.\All right.\This calls for some popsicles.\Huh? response:	I'll treat you guys!
context: I'm touched.\Right?\We really worked hard.\It was a lot more fun than I thought it'd be.\All right.\This calls for some popsicles.\Huh?\I'll treat you guys! response:	Do you want Gori Gori-kun pops or Homebase Bars?
context: Right?\We really worked hard.\It was a lot more fun than I thought it'd be.\All right.\This calls for some popsicles.\Huh?\I'll treat you guys!\Do you want Gori Gori-kun pops or Homebase Bars? response:	So cheap!
context: We really worked hard.\It was a lot more fun than I thought it'd be.\All right.\This calls for some popsicles.\Huh?\I'll treat you guys!\Do you want Gori Gori-kun pops or Homebase Bars?\So cheap! response:	Er, Sensei, it's too cold for popsicles today.
context: It was a lot more fun than I thought it'd be.\All right.\This calls for some popsicles.\Huh?\I'll treat you guys!\Do you want Gori Gori-kun pops or Homebase Bars?\So cheap!\Er, Sensei, it's too cold for popsicles today. response:	We even canceled swimming today.
context: All right.\This calls for some popsicles.\Huh?\I'll treat you guys!\Do you want Gori Gori-kun pops or Homebase Bars?\So cheap!\Er, Sensei, it's too cold for popsicles today.\We even canceled swimming today. response:	Right...
context: This calls for some popsicles.\Huh?\I'll treat you guys!\Do you want Gori Gori-kun pops or Homebase Bars?\So cheap!\Er, Sensei, it's too cold for popsicles today.\We even canceled swimming today.\Right... response:	But sadly, they don't sell meat buns this time of year.
context: Huh?\I'll treat you guys!\Do you want Gori Gori-kun pops or Homebase Bars?\So cheap!\Er, Sensei, it's too cold for popsicles today.\We even canceled swimming today.\Right...\But sadly, they don't sell meat buns this time of year. response:	I want to do the Ofunehiki...
context: I'll treat you guys!\Do you want Gori Gori-kun pops or Homebase Bars?\So cheap!\Er, Sensei, it's too cold for popsicles today.\We even canceled swimming today.\Right...\But sadly, they don't sell meat buns this time of year.\I want to do the Ofunehiki... response:	They said that in unison.
context: Do you want Gori Gori-kun pops or Homebase Bars?\So cheap!\Er, Sensei, it's too cold for popsicles today.\We even canceled swimming today.\Right...\But sadly, they don't sell meat buns this time of year.\I want to do the Ofunehiki...\They said that in unison. response:	Hot damn!
context: So cheap!\Er, Sensei, it's too cold for popsicles today.\We even canceled swimming today.\Right...\But sadly, they don't sell meat buns this time of year.\I want to do the Ofunehiki...\They said that in unison.\Hot damn! response:	Talk about close.
context: Er, Sensei, it's too cold for popsicles today.\We even canceled swimming today.\Right...\But sadly, they don't sell meat buns this time of year.\I want to do the Ofunehiki...\They said that in unison.\Hot damn!\Talk about close. response:	They've totally got the hots for each other.
context: We even canceled swimming today.\Right...\But sadly, they don't sell meat buns this time of year.\I want to do the Ofunehiki...\They said that in unison.\Hot damn!\Talk about close.\They've totally got the hots for each other. response:	Th-That's not true! It's not like that!
context: Right...\But sadly, they don't sell meat buns this time of year.\I want to do the Ofunehiki...\They said that in unison.\Hot damn!\Talk about close.\They've totally got the hots for each other.\Th-That's not true! It's not like that! response:	Now, now, trying to play it off.
context: But sadly, they don't sell meat buns this time of year.\I want to do the Ofunehiki...\They said that in unison.\Hot damn!\Talk about close.\They've totally got the hots for each other.\Th-That's not true! It's not like that!\Now, now, trying to play it off. response:	I wonder how far they've gone.
context: I want to do the Ofunehiki...\They said that in unison.\Hot damn!\Talk about close.\They've totally got the hots for each other.\Th-That's not true! It's not like that!\Now, now, trying to play it off.\I wonder how far they've gone. response:	Ow!
context: They said that in unison.\Hot damn!\Talk about close.\They've totally got the hots for each other.\Th-That's not true! It's not like that!\Now, now, trying to play it off.\I wonder how far they've gone.\Ow! response:	That hurt...
context: Hot damn!\Talk about close.\They've totally got the hots for each other.\Th-That's not true! It's not like that!\Now, now, trying to play it off.\I wonder how far they've gone.\Ow!\That hurt... response:	That hurt a lot more than I thought it would...
context: Talk about close.\They've totally got the hots for each other.\Th-That's not true! It's not like that!\Now, now, trying to play it off.\I wonder how far they've gone.\Ow!\That hurt...\That hurt a lot more than I thought it would... response:	Well, we are going to do it in a sense...
context: They've totally got the hots for each other.\Th-That's not true! It's not like that!\Now, now, trying to play it off.\I wonder how far they've gone.\Ow!\That hurt...\That hurt a lot more than I thought it would...\Well, we are going to do it in a sense... response:	No, I don't mean that...
context: Th-That's not true! It's not like that!\Now, now, trying to play it off.\I wonder how far they've gone.\Ow!\That hurt...\That hurt a lot more than I thought it would...\Well, we are going to do it in a sense...\No, I don't mean that... response:	But what you taught us in class that they used to do.
context: Now, now, trying to play it off.\I wonder how far they've gone.\Ow!\That hurt...\That hurt a lot more than I thought it would...\Well, we are going to do it in a sense...\No, I don't mean that...\But what you taught us in class that they used to do. response:	With the sea and the surface working together...
context: I wonder how far they've gone.\Ow!\That hurt...\That hurt a lot more than I thought it would...\Well, we are going to do it in a sense...\No, I don't mean that...\But what you taught us in class that they used to do.\With the sea and the surface working together... response:	Couldn't we do that?
context: Ow!\That hurt...\That hurt a lot more than I thought it would...\Well, we are going to do it in a sense...\No, I don't mean that...\But what you taught us in class that they used to do.\With the sea and the surface working together...\Couldn't we do that? response:	Hey, that sounds like a great idea!
context: That hurt...\That hurt a lot more than I thought it would...\Well, we are going to do it in a sense...\No, I don't mean that...\But what you taught us in class that they used to do.\With the sea and the surface working together...\Couldn't we do that?\Hey, that sounds like a great idea! response:	Since we went through all the trouble, it'd be nice to see a real Ofunehiki.
context: That hurt a lot more than I thought it would...\Well, we are going to do it in a sense...\No, I don't mean that...\But what you taught us in class that they used to do.\With the sea and the surface working together...\Couldn't we do that?\Hey, that sounds like a great idea!\Since we went through all the trouble, it'd be nice to see a real Ofunehiki. response:	But we wouldn't be able to do it without help from Shioshishio...
context: Well, we are going to do it in a sense...\No, I don't mean that...\But what you taught us in class that they used to do.\With the sea and the surface working together...\Couldn't we do that?\Hey, that sounds like a great idea!\Since we went through all the trouble, it'd be nice to see a real Ofunehiki.\But we wouldn't be able to do it without help from Shioshishio... response:	so it'd be a little hard.
context: No, I don't mean that...\But what you taught us in class that they used to do.\With the sea and the surface working together...\Couldn't we do that?\Hey, that sounds like a great idea!\Since we went through all the trouble, it'd be nice to see a real Ofunehiki.\But we wouldn't be able to do it without help from Shioshishio...\so it'd be a little hard. response:	But if we're going to do it, we want to do it right.
context: But what you taught us in class that they used to do.\With the sea and the surface working together...\Couldn't we do that?\Hey, that sounds like a great idea!\Since we went through all the trouble, it'd be nice to see a real Ofunehiki.\But we wouldn't be able to do it without help from Shioshishio...\so it'd be a little hard.\But if we're going to do it, we want to do it right. response:	Right, guys?
context: With the sea and the surface working together...\Couldn't we do that?\Hey, that sounds like a great idea!\Since we went through all the trouble, it'd be nice to see a real Ofunehiki.\But we wouldn't be able to do it without help from Shioshishio...\so it'd be a little hard.\But if we're going to do it, we want to do it right.\Right, guys? response:	Yeah, since we came this far.
context: Couldn't we do that?\Hey, that sounds like a great idea!\Since we went through all the trouble, it'd be nice to see a real Ofunehiki.\But we wouldn't be able to do it without help from Shioshishio...\so it'd be a little hard.\But if we're going to do it, we want to do it right.\Right, guys?\Yeah, since we came this far. response:	Yeah.
context: Hey, that sounds like a great idea!\Since we went through all the trouble, it'd be nice to see a real Ofunehiki.\But we wouldn't be able to do it without help from Shioshishio...\so it'd be a little hard.\But if we're going to do it, we want to do it right.\Right, guys?\Yeah, since we came this far.\Yeah. response:	I understand. I really do understand...
context: Since we went through all the trouble, it'd be nice to see a real Ofunehiki.\But we wouldn't be able to do it without help from Shioshishio...\so it'd be a little hard.\But if we're going to do it, we want to do it right.\Right, guys?\Yeah, since we came this far.\Yeah.\I understand. I really do understand... response:	But because of the disagreements
context: But we wouldn't be able to do it without help from Shioshishio...\so it'd be a little hard.\But if we're going to do it, we want to do it right.\Right, guys?\Yeah, since we came this far.\Yeah.\I understand. I really do understand...\But because of the disagreements response:	Shioshishio village and the Oshiooshi fishery cooperative have,
context: so it'd be a little hard.\But if we're going to do it, we want to do it right.\Right, guys?\Yeah, since we came this far.\Yeah.\I understand. I really do understand...\But because of the disagreements\Shioshishio village and the Oshiooshi fishery cooperative have, response:	they're saying there won't be one this year.
context: But if we're going to do it, we want to do it right.\Right, guys?\Yeah, since we came this far.\Yeah.\I understand. I really do understand...\But because of the disagreements\Shioshishio village and the Oshiooshi fishery cooperative have,\they're saying there won't be one this year. response:	Let's do it!
context: Right, guys?\Yeah, since we came this far.\Yeah.\I understand. I really do understand...\But because of the disagreements\Shioshishio village and the Oshiooshi fishery cooperative have,\they're saying there won't be one this year.\Let's do it! response:	We went through all this trouble making it...
context: Yeah, since we came this far.\Yeah.\I understand. I really do understand...\But because of the disagreements\Shioshishio village and the Oshiooshi fishery cooperative have,\they're saying there won't be one this year.\Let's do it!\We went through all this trouble making it... response:	Let's do it! A real Ofunehiki!
context: Yeah.\I understand. I really do understand...\But because of the disagreements\Shioshishio village and the Oshiooshi fishery cooperative have,\they're saying there won't be one this year.\Let's do it!\We went through all this trouble making it...\Let's do it! A real Ofunehiki! response:	Hey, Hikari...
context: I understand. I really do understand...\But because of the disagreements\Shioshishio village and the Oshiooshi fishery cooperative have,\they're saying there won't be one this year.\Let's do it!\We went through all this trouble making it...\Let's do it! A real Ofunehiki!\Hey, Hikari... response:	Hii-kun!
context: But because of the disagreements\Shioshishio village and the Oshiooshi fishery cooperative have,\they're saying there won't be one this year.\Let's do it!\We went through all this trouble making it...\Let's do it! A real Ofunehiki!\Hey, Hikari...\Hii-kun! response:	I'll do something about Shishio.
context: Shioshishio village and the Oshiooshi fishery cooperative have,\they're saying there won't be one this year.\Let's do it!\We went through all this trouble making it...\Let's do it! A real Ofunehiki!\Hey, Hikari...\Hii-kun!\I'll do something about Shishio. response:	Tsumugu, you be the leader and do something about Oshiooshi.
context: they're saying there won't be one this year.\Let's do it!\We went through all this trouble making it...\Let's do it! A real Ofunehiki!\Hey, Hikari...\Hii-kun!\I'll do something about Shishio.\Tsumugu, you be the leader and do something about Oshiooshi. response:	Hikari...
context: Let's do it!\We went through all this trouble making it...\Let's do it! A real Ofunehiki!\Hey, Hikari...\Hii-kun!\I'll do something about Shishio.\Tsumugu, you be the leader and do something about Oshiooshi.\Hikari... response:	You say that, but I think it'd be pretty hard...
context: We went through all this trouble making it...\Let's do it! A real Ofunehiki!\Hey, Hikari...\Hii-kun!\I'll do something about Shishio.\Tsumugu, you be the leader and do something about Oshiooshi.\Hikari...\You say that, but I think it'd be pretty hard... response:	I know, but...
context: Let's do it! A real Ofunehiki!\Hey, Hikari...\Hii-kun!\I'll do something about Shishio.\Tsumugu, you be the leader and do something about Oshiooshi.\Hikari...\You say that, but I think it'd be pretty hard...\I know, but... response:	I don't like doing things only halfway.
context: Hey, Hikari...\Hii-kun!\I'll do something about Shishio.\Tsumugu, you be the leader and do something about Oshiooshi.\Hikari...\You say that, but I think it'd be pretty hard...\I know, but...\I don't like doing things only halfway. response:	Even if it's hopeless, I want to at least try everything we can do to finish with no regrets.
context: Hii-kun!\I'll do something about Shishio.\Tsumugu, you be the leader and do something about Oshiooshi.\Hikari...\You say that, but I think it'd be pretty hard...\I know, but...\I don't like doing things only halfway.\Even if it's hopeless, I want to at least try everything we can do to finish with no regrets. response:	All right, I'm in!
context: I'll do something about Shishio.\Tsumugu, you be the leader and do something about Oshiooshi.\Hikari...\You say that, but I think it'd be pretty hard...\I know, but...\I don't like doing things only halfway.\Even if it's hopeless, I want to at least try everything we can do to finish with no regrets.\All right, I'm in! response:	Me, too!
context: Tsumugu, you be the leader and do something about Oshiooshi.\Hikari...\You say that, but I think it'd be pretty hard...\I know, but...\I don't like doing things only halfway.\Even if it's hopeless, I want to at least try everything we can do to finish with no regrets.\All right, I'm in!\Me, too! response:	Tsumugu, you're in, right?
context: Hikari...\You say that, but I think it'd be pretty hard...\I know, but...\I don't like doing things only halfway.\Even if it's hopeless, I want to at least try everything we can do to finish with no regrets.\All right, I'm in!\Me, too!\Tsumugu, you're in, right? response:	I don't mind.
context: You say that, but I think it'd be pretty hard...\I know, but...\I don't like doing things only halfway.\Even if it's hopeless, I want to at least try everything we can do to finish with no regrets.\All right, I'm in!\Me, too!\Tsumugu, you're in, right?\I don't mind. response:	Me too!
context: I know, but...\I don't like doing things only halfway.\Even if it's hopeless, I want to at least try everything we can do to finish with no regrets.\All right, I'm in!\Me, too!\Tsumugu, you're in, right?\I don't mind.\Me too! response:	Sounds good to me.
context: I don't like doing things only halfway.\Even if it's hopeless, I want to at least try everything we can do to finish with no regrets.\All right, I'm in!\Me, too!\Tsumugu, you're in, right?\I don't mind.\Me too!\Sounds good to me. response:	Great... This is great!
context: Even if it's hopeless, I want to at least try everything we can do to finish with no regrets.\All right, I'm in!\Me, too!\Tsumugu, you're in, right?\I don't mind.\Me too!\Sounds good to me.\Great... This is great! response:	This will be great!
context: All right, I'm in!\Me, too!\Tsumugu, you're in, right?\I don't mind.\Me too!\Sounds good to me.\Great... This is great!\This will be great! response:	Yeah!
context: Me, too!\Tsumugu, you're in, right?\I don't mind.\Me too!\Sounds good to me.\Great... This is great!\This will be great!\Yeah! response:	This is indeed youth!
context: Tsumugu, you're in, right?\I don't mind.\Me too!\Sounds good to me.\Great... This is great!\This will be great!\Yeah!\This is indeed youth! response:	All right. I'll help out as well.
context: I don't mind.\Me too!\Sounds good to me.\Great... This is great!\This will be great!\Yeah!\This is indeed youth!\All right. I'll help out as well. response:	Let's all do our best!
context: Me too!\Sounds good to me.\Great... This is great!\This will be great!\Yeah!\This is indeed youth!\All right. I'll help out as well.\Let's all do our best! response:	Yeah!
context: Sounds good to me.\Great... This is great!\This will be great!\Yeah!\This is indeed youth!\All right. I'll help out as well.\Let's all do our best!\Yeah! response:	That was great, Hii-kun!
context: Great... This is great!\This will be great!\Yeah!\This is indeed youth!\All right. I'll help out as well.\Let's all do our best!\Yeah!\That was great, Hii-kun! response:	Everyone's so great!
context: This will be great!\Yeah!\This is indeed youth!\All right. I'll help out as well.\Let's all do our best!\Yeah!\That was great, Hii-kun!\Everyone's so great! response:	I'll make sure that the Ofunehiki happens.
context: Yeah!\This is indeed youth!\All right. I'll help out as well.\Let's all do our best!\Yeah!\That was great, Hii-kun!\Everyone's so great!\I'll make sure that the Ofunehiki happens. response:	Yeah!
context: This is indeed youth!\All right. I'll help out as well.\Let's all do our best!\Yeah!\That was great, Hii-kun!\Everyone's so great!\I'll make sure that the Ofunehiki happens.\Yeah! response:	The thing that you and Tsumugu wished for...
context: All right. I'll help out as well.\Let's all do our best!\Yeah!\That was great, Hii-kun!\Everyone's so great!\I'll make sure that the Ofunehiki happens.\Yeah!\The thing that you and Tsumugu wished for... response:	Association to Make the Ofunehiki a Reality
context: Let's all do our best!\Yeah!\That was great, Hii-kun!\Everyone's so great!\I'll make sure that the Ofunehiki happens.\Yeah!\The thing that you and Tsumugu wished for...\Association to Make the Ofunehiki a Reality response:	Please!
context: Yeah!\That was great, Hii-kun!\Everyone's so great!\I'll make sure that the Ofunehiki happens.\Yeah!\The thing that you and Tsumugu wished for...\Association to Make the Ofunehiki a Reality\Please! response:	Let's make the Ofunehiki a reality again this year!
context: That was great, Hii-kun!\Everyone's so great!\I'll make sure that the Ofunehiki happens.\Yeah!\The thing that you and Tsumugu wished for...\Association to Make the Ofunehiki a Reality\Please!\Let's make the Ofunehiki a reality again this year! response:	Please help us get enough signatures!
context: Everyone's so great!\I'll make sure that the Ofunehiki happens.\Yeah!\The thing that you and Tsumugu wished for...\Association to Make the Ofunehiki a Reality\Please!\Let's make the Ofunehiki a reality again this year!\Please help us get enough signatures! response:	Please help us out!
context: I'll make sure that the Ofunehiki happens.\Yeah!\The thing that you and Tsumugu wished for...\Association to Make the Ofunehiki a Reality\Please!\Let's make the Ofunehiki a reality again this year!\Please help us get enough signatures!\Please help us out! response:	Please help us out!
context: Yeah!\The thing that you and Tsumugu wished for...\Association to Make the Ofunehiki a Reality\Please!\Let's make the Ofunehiki a reality again this year!\Please help us get enough signatures!\Please help us out!\Please help us out! response:	All right, we're not going to lose! Right, Miuna?
context: The thing that you and Tsumugu wished for...\Association to Make the Ofunehiki a Reality\Please!\Let's make the Ofunehiki a reality again this year!\Please help us get enough signatures!\Please help us out!\Please help us out!\All right, we're not going to lose! Right, Miuna? response:	Let's make the Ofunehiki a reality this year!
context: Association to Make the Ofunehiki a Reality\Please!\Let's make the Ofunehiki a reality again this year!\Please help us get enough signatures!\Please help us out!\Please help us out!\All right, we're not going to lose! Right, Miuna?\Let's make the Ofunehiki a reality this year! response:	R-Right...
context: Please!\Let's make the Ofunehiki a reality again this year!\Please help us get enough signatures!\Please help us out!\Please help us out!\All right, we're not going to lose! Right, Miuna?\Let's make the Ofunehiki a reality this year!\R-Right... response:	Please help us out!
context: Let's make the Ofunehiki a reality again this year!\Please help us get enough signatures!\Please help us out!\Please help us out!\All right, we're not going to lose! Right, Miuna?\Let's make the Ofunehiki a reality this year!\R-Right...\Please help us out! response:	Please help us o
context: Please help us get enough signatures!\Please help us out!\Please help us out!\All right, we're not going to lose! Right, Miuna?\Let's make the Ofunehiki a reality this year!\R-Right...\Please help us out!\Please help us o response:	You're going to scare people off doing that!
context: Please help us out!\Please help us out!\All right, we're not going to lose! Right, Miuna?\Let's make the Ofunehiki a reality this year!\R-Right...\Please help us out!\Please help us o\You're going to scare people off doing that! response:	Please help us out!
context: Please help us out!\All right, we're not going to lose! Right, Miuna?\Let's make the Ofunehiki a reality this year!\R-Right...\Please help us out!\Please help us o\You're going to scare people off doing that!\Please help us out! response:	We're trying to do the Ofunehiki!
context: All right, we're not going to lose! Right, Miuna?\Let's make the Ofunehiki a reality this year!\R-Right...\Please help us out!\Please help us o\You're going to scare people off doing that!\Please help us out!\We're trying to do the Ofunehiki! response:	Th-The Ofunehiki...
context: Let's make the Ofunehiki a reality this year!\R-Right...\Please help us out!\Please help us o\You're going to scare people off doing that!\Please help us out!\We're trying to do the Ofunehiki!\Th-The Ofunehiki... response:	Here!
context: R-Right...\Please help us out!\Please help us o\You're going to scare people off doing that!\Please help us out!\We're trying to do the Ofunehiki!\Th-The Ofunehiki...\Here! response:	Thank you!
context: Please help us out!\Please help us o\You're going to scare people off doing that!\Please help us out!\We're trying to do the Ofunehiki!\Th-The Ofunehiki...\Here!\Thank you! response:	Good work, keep it up!
context: Please help us o\You're going to scare people off doing that!\Please help us out!\We're trying to do the Ofunehiki!\Th-The Ofunehiki...\Here!\Thank you!\Good work, keep it up! response:	Please help us out!
context: You're going to scare people off doing that!\Please help us out!\We're trying to do the Ofunehiki!\Th-The Ofunehiki...\Here!\Thank you!\Good work, keep it up!\Please help us out! response:	We are Hama Junior High's Association to Make the Ofunehiki a Reality.
context: Please help us out!\We're trying to do the Ofunehiki!\Th-The Ofunehiki...\Here!\Thank you!\Good work, keep it up!\Please help us out!\We are Hama Junior High's Association to Make the Ofunehiki a Reality. response:	Please help us out!
context: We're trying to do the Ofunehiki!\Th-The Ofunehiki...\Here!\Thank you!\Good work, keep it up!\Please help us out!\We are Hama Junior High's Association to Make the Ofunehiki a Reality.\Please help us out! response:	I heard they weren't going to do it this year.
context: Th-The Ofunehiki...\Here!\Thank you!\Good work, keep it up!\Please help us out!\We are Hama Junior High's Association to Make the Ofunehiki a Reality.\Please help us out!\I heard they weren't going to do it this year. response:	As Hama Junior High's volunteers,
context: Here!\Thank you!\Good work, keep it up!\Please help us out!\We are Hama Junior High's Association to Make the Ofunehiki a Reality.\Please help us out!\I heard they weren't going to do it this year.\As Hama Junior High's volunteers, response:	we plan on doing something even bigger than last year!
context: Thank you!\Good work, keep it up!\Please help us out!\We are Hama Junior High's Association to Make the Ofunehiki a Reality.\Please help us out!\I heard they weren't going to do it this year.\As Hama Junior High's volunteers,\we plan on doing something even bigger than last year! response:	Can you middle schoolers manage it by yourselves?
context: Good work, keep it up!\Please help us out!\We are Hama Junior High's Association to Make the Ofunehiki a Reality.\Please help us out!\I heard they weren't going to do it this year.\As Hama Junior High's volunteers,\we plan on doing something even bigger than last year!\Can you middle schoolers manage it by yourselves? response:	Please sign!
context: Please help us out!\We are Hama Junior High's Association to Make the Ofunehiki a Reality.\Please help us out!\I heard they weren't going to do it this year.\As Hama Junior High's volunteers,\we plan on doing something even bigger than last year!\Can you middle schoolers manage it by yourselves?\Please sign! response:	We're serious about this.
context: We are Hama Junior High's Association to Make the Ofunehiki a Reality.\Please help us out!\I heard they weren't going to do it this year.\As Hama Junior High's volunteers,\we plan on doing something even bigger than last year!\Can you middle schoolers manage it by yourselves?\Please sign!\We're serious about this. response:	Please help us out.
context: Please help us out!\I heard they weren't going to do it this year.\As Hama Junior High's volunteers,\we plan on doing something even bigger than last year!\Can you middle schoolers manage it by yourselves?\Please sign!\We're serious about this.\Please help us out. response:	Guess I don't have a choice.
context: I heard they weren't going to do it this year.\As Hama Junior High's volunteers,\we plan on doing something even bigger than last year!\Can you middle schoolers manage it by yourselves?\Please sign!\We're serious about this.\Please help us out.\Guess I don't have a choice. response:	Thank you very much!
context: As Hama Junior High's volunteers,\we plan on doing something even bigger than last year!\Can you middle schoolers manage it by yourselves?\Please sign!\We're serious about this.\Please help us out.\Guess I don't have a choice.\Thank you very much! response:	Hikari's sort of amazing.
context: we plan on doing something even bigger than last year!\Can you middle schoolers manage it by yourselves?\Please sign!\We're serious about this.\Please help us out.\Guess I don't have a choice.\Thank you very much!\Hikari's sort of amazing. response:	Thank you!
context: Can you middle schoolers manage it by yourselves?\Please sign!\We're serious about this.\Please help us out.\Guess I don't have a choice.\Thank you very much!\Hikari's sort of amazing.\Thank you! response:	Why is he so serious about this?
context: Please sign!\We're serious about this.\Please help us out.\Guess I don't have a choice.\Thank you very much!\Hikari's sort of amazing.\Thank you!\Why is he so serious about this? response:	I think he probably wants to get rid of his frustrations so he's going all out.
context: We're serious about this.\Please help us out.\Guess I don't have a choice.\Thank you very much!\Hikari's sort of amazing.\Thank you!\Why is he so serious about this?\I think he probably wants to get rid of his frustrations so he's going all out. response:	To think that Hikari has such a competitive side...
context: Please help us out.\Guess I don't have a choice.\Thank you very much!\Hikari's sort of amazing.\Thank you!\Why is he so serious about this?\I think he probably wants to get rid of his frustrations so he's going all out.\To think that Hikari has such a competitive side... response:	Humans really are pretty deep.
context: Guess I don't have a choice.\Thank you very much!\Hikari's sort of amazing.\Thank you!\Why is he so serious about this?\I think he probably wants to get rid of his frustrations so he's going all out.\To think that Hikari has such a competitive side...\Humans really are pretty deep. response:	Ma'am. Pardon me, Ma'am.
context: Thank you very much!\Hikari's sort of amazing.\Thank you!\Why is he so serious about this?\I think he probably wants to get rid of his frustrations so he's going all out.\To think that Hikari has such a competitive side...\Humans really are pretty deep.\Ma'am. Pardon me, Ma'am. response:	Do you have a moment?
context: Hikari's sort of amazing.\Thank you!\Why is he so serious about this?\I think he probably wants to get rid of his frustrations so he's going all out.\To think that Hikari has such a competitive side...\Humans really are pretty deep.\Ma'am. Pardon me, Ma'am.\Do you have a moment? response:	W-Well, if it's just for a moment...
context: Thank you!\Why is he so serious about this?\I think he probably wants to get rid of his frustrations so he's going all out.\To think that Hikari has such a competitive side...\Humans really are pretty deep.\Ma'am. Pardon me, Ma'am.\Do you have a moment?\W-Well, if it's just for a moment... response:	Talk about deep...
context: Why is he so serious about this?\I think he probably wants to get rid of his frustrations so he's going all out.\To think that Hikari has such a competitive side...\Humans really are pretty deep.\Ma'am. Pardon me, Ma'am.\Do you have a moment?\W-Well, if it's just for a moment...\Talk about deep... response:	I need to try hard, too.
context: I think he probably wants to get rid of his frustrations so he's going all out.\To think that Hikari has such a competitive side...\Humans really are pretty deep.\Ma'am. Pardon me, Ma'am.\Do you have a moment?\W-Well, if it's just for a moment...\Talk about deep...\I need to try hard, too. response:	We're doing the Ofunehiki...
context: To think that Hikari has such a competitive side...\Humans really are pretty deep.\Ma'am. Pardon me, Ma'am.\Do you have a moment?\W-Well, if it's just for a moment...\Talk about deep...\I need to try hard, too.\We're doing the Ofunehiki... response:	I don't think that really suits you.
context: Humans really are pretty deep.\Ma'am. Pardon me, Ma'am.\Do you have a moment?\W-Well, if it's just for a moment...\Talk about deep...\I need to try hard, too.\We're doing the Ofunehiki...\I don't think that really suits you. response:	Huh?
context: Ma'am. Pardon me, Ma'am.\Do you have a moment?\W-Well, if it's just for a moment...\Talk about deep...\I need to try hard, too.\We're doing the Ofunehiki...\I don't think that really suits you.\Huh? response:	Is that really the point here?
context: Do you have a moment?\W-Well, if it's just for a moment...\Talk about deep...\I need to try hard, too.\We're doing the Ofunehiki...\I don't think that really suits you.\Huh?\Is that really the point here? response:	I mean... everyone can only do what they can.
context: W-Well, if it's just for a moment...\Talk about deep...\I need to try hard, too.\We're doing the Ofunehiki...\I don't think that really suits you.\Huh?\Is that really the point here?\I mean... everyone can only do what they can. response:	If you try hard at something you can't do, it only hurts in the end.
context: Talk about deep...\I need to try hard, too.\We're doing the Ofunehiki...\I don't think that really suits you.\Huh?\Is that really the point here?\I mean... everyone can only do what they can.\If you try hard at something you can't do, it only hurts in the end. response:	You're all really going at it.
context: I need to try hard, too.\We're doing the Ofunehiki...\I don't think that really suits you.\Huh?\Is that really the point here?\I mean... everyone can only do what they can.\If you try hard at something you can't do, it only hurts in the end.\You're all really going at it. response:	Pretty impressive.
context: We're doing the Ofunehiki...\I don't think that really suits you.\Huh?\Is that really the point here?\I mean... everyone can only do what they can.\If you try hard at something you can't do, it only hurts in the end.\You're all really going at it.\Pretty impressive. response:	Dad!
context: I don't think that really suits you.\Huh?\Is that really the point here?\I mean... everyone can only do what they can.\If you try hard at something you can't do, it only hurts in the end.\You're all really going at it.\Pretty impressive.\Dad! response:	Akari-san, thank you for talking to the manager for us.
context: Huh?\Is that really the point here?\I mean... everyone can only do what they can.\If you try hard at something you can't do, it only hurts in the end.\You're all really going at it.\Pretty impressive.\Dad!\Akari-san, thank you for talking to the manager for us. response:	Don't worry about it.
context: Is that really the point here?\I mean... everyone can only do what they can.\If you try hard at something you can't do, it only hurts in the end.\You're all really going at it.\Pretty impressive.\Dad!\Akari-san, thank you for talking to the manager for us.\Don't worry about it. response:	Not to mention Sayama-kun, the manager's son, is helping out, too.
context: I mean... everyone can only do what they can.\If you try hard at something you can't do, it only hurts in the end.\You're all really going at it.\Pretty impressive.\Dad!\Akari-san, thank you for talking to the manager for us.\Don't worry about it.\Not to mention Sayama-kun, the manager's son, is helping out, too. response:	And I'd like to see it, too...
context: If you try hard at something you can't do, it only hurts in the end.\You're all really going at it.\Pretty impressive.\Dad!\Akari-san, thank you for talking to the manager for us.\Don't worry about it.\Not to mention Sayama-kun, the manager's son, is helping out, too.\And I'd like to see it, too... response:	A real Ofunehiki.
context: You're all really going at it.\Pretty impressive.\Dad!\Akari-san, thank you for talking to the manager for us.\Don't worry about it.\Not to mention Sayama-kun, the manager's son, is helping out, too.\And I'd like to see it, too...\A real Ofunehiki. response:	Then, could you display these in the store?
context: Pretty impressive.\Dad!\Akari-san, thank you for talking to the manager for us.\Don't worry about it.\Not to mention Sayama-kun, the manager's son, is helping out, too.\And I'd like to see it, too...\A real Ofunehiki.\Then, could you display these in the store? response:	You got it! Leave it to me.
context: Dad!\Akari-san, thank you for talking to the manager for us.\Don't worry about it.\Not to mention Sayama-kun, the manager's son, is helping out, too.\And I'd like to see it, too...\A real Ofunehiki.\Then, could you display these in the store?\You got it! Leave it to me. response:	Give me some of those forms, too.
context: Akari-san, thank you for talking to the manager for us.\Don't worry about it.\Not to mention Sayama-kun, the manager's son, is helping out, too.\And I'd like to see it, too...\A real Ofunehiki.\Then, could you display these in the store?\You got it! Leave it to me.\Give me some of those forms, too. response:	I'll get you some signatures.
context: Don't worry about it.\Not to mention Sayama-kun, the manager's son, is helping out, too.\And I'd like to see it, too...\A real Ofunehiki.\Then, could you display these in the store?\You got it! Leave it to me.\Give me some of those forms, too.\I'll get you some signatures. response:	Could I get some, too?
context: Not to mention Sayama-kun, the manager's son, is helping out, too.\And I'd like to see it, too...\A real Ofunehiki.\Then, could you display these in the store?\You got it! Leave it to me.\Give me some of those forms, too.\I'll get you some signatures.\Could I get some, too? response:	I'll hand them out to people I know.
context: And I'd like to see it, too...\A real Ofunehiki.\Then, could you display these in the store?\You got it! Leave it to me.\Give me some of those forms, too.\I'll get you some signatures.\Could I get some, too?\I'll hand them out to people I know. response:	Are you sure?
context: A real Ofunehiki.\Then, could you display these in the store?\You got it! Leave it to me.\Give me some of those forms, too.\I'll get you some signatures.\Could I get some, too?\I'll hand them out to people I know.\Are you sure? response:	Yeah.
context: Then, could you display these in the store?\You got it! Leave it to me.\Give me some of those forms, too.\I'll get you some signatures.\Could I get some, too?\I'll hand them out to people I know.\Are you sure?\Yeah. response:	I mean, having the people of the surface and sea hand in hand...
context: You got it! Leave it to me.\Give me some of those forms, too.\I'll get you some signatures.\Could I get some, too?\I'll hand them out to people I know.\Are you sure?\Yeah.\I mean, having the people of the surface and sea hand in hand... response:	It sort of hits pretty close to home.
context: Give me some of those forms, too.\I'll get you some signatures.\Could I get some, too?\I'll hand them out to people I know.\Are you sure?\Yeah.\I mean, having the people of the surface and sea hand in hand...\It sort of hits pretty close to home. response:	I want to do the Ofunehiki.
context: I'll get you some signatures.\Could I get some, too?\I'll hand them out to people I know.\Are you sure?\Yeah.\I mean, having the people of the surface and sea hand in hand...\It sort of hits pretty close to home.\I want to do the Ofunehiki. response:	I'm going to make it happen.
context: Could I get some, too?\I'll hand them out to people I know.\Are you sure?\Yeah.\I mean, having the people of the surface and sea hand in hand...\It sort of hits pretty close to home.\I want to do the Ofunehiki.\I'm going to make it happen. response:	I look forward to it.
context: I'll hand them out to people I know.\Are you sure?\Yeah.\I mean, having the people of the surface and sea hand in hand...\It sort of hits pretty close to home.\I want to do the Ofunehiki.\I'm going to make it happen.\I look forward to it. response:	It's not happening.
context: Are you sure?\Yeah.\I mean, having the people of the surface and sea hand in hand...\It sort of hits pretty close to home.\I want to do the Ofunehiki.\I'm going to make it happen.\I look forward to it.\It's not happening. response:	Why not?!
context: Yeah.\I mean, having the people of the surface and sea hand in hand...\It sort of hits pretty close to home.\I want to do the Ofunehiki.\I'm going to make it happen.\I look forward to it.\It's not happening.\Why not?! response:	We got this many signatures!
context: I mean, having the people of the surface and sea hand in hand...\It sort of hits pretty close to home.\I want to do the Ofunehiki.\I'm going to make it happen.\I look forward to it.\It's not happening.\Why not?!\We got this many signatures! response:	You can at least talk to the fishing association!
context: It sort of hits pretty close to home.\I want to do the Ofunehiki.\I'm going to make it happen.\I look forward to it.\It's not happening.\Why not?!\We got this many signatures!\You can at least talk to the fishing association! response:	It doesn't matter how many signatures you get.
context: I want to do the Ofunehiki.\I'm going to make it happen.\I look forward to it.\It's not happening.\Why not?!\We got this many signatures!\You can at least talk to the fishing association!\It doesn't matter how many signatures you get. response:	Let's Do An Ofunehiki This Year!! Association to Make the Ofunehiki A Reality The Ofunehiki is one of our historical traditions!
context: I'm going to make it happen.\I look forward to it.\It's not happening.\Why not?!\We got this many signatures!\You can at least talk to the fishing association!\It doesn't matter how many signatures you get.\Let's Do An Ofunehiki This Year!! Association to Make the Ofunehiki A Reality The Ofunehiki is one of our historical traditions! response:	It was Oshiooshi that said they wouldn't do it this year in the first place.
context: I look forward to it.\It's not happening.\Why not?!\We got this many signatures!\You can at least talk to the fishing association!\It doesn't matter how many signatures you get.\Let's Do An Ofunehiki This Year!! Association to Make the Ofunehiki A Reality The Ofunehiki is one of our historical traditions!\It was Oshiooshi that said they wouldn't do it this year in the first place. response:	B-But...
context: It's not happening.\Why not?!\We got this many signatures!\You can at least talk to the fishing association!\It doesn't matter how many signatures you get.\Let's Do An Ofunehiki This Year!! Association to Make the Ofunehiki A Reality The Ofunehiki is one of our historical traditions!\It was Oshiooshi that said they wouldn't do it this year in the first place.\B-But... response:	Come on, Dad.
context: Why not?!\We got this many signatures!\You can at least talk to the fishing association!\It doesn't matter how many signatures you get.\Let's Do An Ofunehiki This Year!! Association to Make the Ofunehiki A Reality The Ofunehiki is one of our historical traditions!\It was Oshiooshi that said they wouldn't do it this year in the first place.\B-But...\Come on, Dad. response:	This is the first time Hikari's been so serious about asking you for something.
context: We got this many signatures!\You can at least talk to the fishing association!\It doesn't matter how many signatures you get.\Let's Do An Ofunehiki This Year!! Association to Make the Ofunehiki A Reality The Ofunehiki is one of our historical traditions!\It was Oshiooshi that said they wouldn't do it this year in the first place.\B-But...\Come on, Dad.\This is the first time Hikari's been so serious about asking you for something. response:	What kind of parent does it make you if you don't at least listen?
context: You can at least talk to the fishing association!\It doesn't matter how many signatures you get.\Let's Do An Ofunehiki This Year!! Association to Make the Ofunehiki A Reality The Ofunehiki is one of our historical traditions!\It was Oshiooshi that said they wouldn't do it this year in the first place.\B-But...\Come on, Dad.\This is the first time Hikari's been so serious about asking you for something.\What kind of parent does it make you if you don't at least listen? response:	I saw them collecting signatures myself,
context: It doesn't matter how many signatures you get.\Let's Do An Ofunehiki This Year!! Association to Make the Ofunehiki A Reality The Ofunehiki is one of our historical traditions!\It was Oshiooshi that said they wouldn't do it this year in the first place.\B-But...\Come on, Dad.\This is the first time Hikari's been so serious about asking you for something.\What kind of parent does it make you if you don't at least listen?\I saw them collecting signatures myself, response:	and they were working really hard.
context: Let's Do An Ofunehiki This Year!! Association to Make the Ofunehiki A Reality The Ofunehiki is one of our historical traditions!\It was Oshiooshi that said they wouldn't do it this year in the first place.\B-But...\Come on, Dad.\This is the first time Hikari's been so serious about asking you for something.\What kind of parent does it make you if you don't at least listen?\I saw them collecting signatures myself,\and they were working really hard. response:	The people on the surface won't listen.
context: It was Oshiooshi that said they wouldn't do it this year in the first place.\B-But...\Come on, Dad.\This is the first time Hikari's been so serious about asking you for something.\What kind of parent does it make you if you don't at least listen?\I saw them collecting signatures myself,\and they were working really hard.\The people on the surface won't listen. response:	There's no point in talking to them.
context: B-But...\Come on, Dad.\This is the first time Hikari's been so serious about asking you for something.\What kind of parent does it make you if you don't at least listen?\I saw them collecting signatures myself,\and they were working really hard.\The people on the surface won't listen.\There's no point in talking to them. response:	Dad!
context: Come on, Dad.\This is the first time Hikari's been so serious about asking you for something.\What kind of parent does it make you if you don't at least listen?\I saw them collecting signatures myself,\and they were working really hard.\The people on the surface won't listen.\There's no point in talking to them.\Dad! response:	I thought that the guys on the surface were all pigs at first, too...
context: This is the first time Hikari's been so serious about asking you for something.\What kind of parent does it make you if you don't at least listen?\I saw them collecting signatures myself,\and they were working really hard.\The people on the surface won't listen.\There's no point in talking to them.\Dad!\I thought that the guys on the surface were all pigs at first, too... response:	That there's no point in talking to them.
context: What kind of parent does it make you if you don't at least listen?\I saw them collecting signatures myself,\and they were working really hard.\The people on the surface won't listen.\There's no point in talking to them.\Dad!\I thought that the guys on the surface were all pigs at first, too...\That there's no point in talking to them. response:	And they thought of us as fish...
context: I saw them collecting signatures myself,\and they were working really hard.\The people on the surface won't listen.\There's no point in talking to them.\Dad!\I thought that the guys on the surface were all pigs at first, too...\That there's no point in talking to them.\And they thought of us as fish... response:	so we were even.
context: and they were working really hard.\The people on the surface won't listen.\There's no point in talking to them.\Dad!\I thought that the guys on the surface were all pigs at first, too...\That there's no point in talking to them.\And they thought of us as fish...\so we were even. response:	But I was wrong!
context: The people on the surface won't listen.\There's no point in talking to them.\Dad!\I thought that the guys on the surface were all pigs at first, too...\That there's no point in talking to them.\And they thought of us as fish...\so we were even.\But I was wrong! response:	We're not fish, and they're not pigs!
context: There's no point in talking to them.\Dad!\I thought that the guys on the surface were all pigs at first, too...\That there's no point in talking to them.\And they thought of us as fish...\so we were even.\But I was wrong!\We're not fish, and they're not pigs! response:	We're all humans that can communicate with each other!
context: Dad!\I thought that the guys on the surface were all pigs at first, too...\That there's no point in talking to them.\And they thought of us as fish...\so we were even.\But I was wrong!\We're not fish, and they're not pigs!\We're all humans that can communicate with each other! response:	We're really serious about this!
context: I thought that the guys on the surface were all pigs at first, too...\That there's no point in talking to them.\And they thought of us as fish...\so we were even.\But I was wrong!\We're not fish, and they're not pigs!\We're all humans that can communicate with each other!\We're really serious about this! response:	It can be just once!
context: That there's no point in talking to them.\And they thought of us as fish...\so we were even.\But I was wrong!\We're not fish, and they're not pigs!\We're all humans that can communicate with each other!\We're really serious about this!\It can be just once! response:	Please get everyone together and talk to them!
context: And they thought of us as fish...\so we were even.\But I was wrong!\We're not fish, and they're not pigs!\We're all humans that can communicate with each other!\We're really serious about this!\It can be just once!\Please get everyone together and talk to them! response:	You're going to rely on me?
context: so we were even.\But I was wrong!\We're not fish, and they're not pigs!\We're all humans that can communicate with each other!\We're really serious about this!\It can be just once!\Please get everyone together and talk to them!\You're going to rely on me? response:	Then we don't need your help!
context: But I was wrong!\We're not fish, and they're not pigs!\We're all humans that can communicate with each other!\We're really serious about this!\It can be just once!\Please get everyone together and talk to them!\You're going to rely on me?\Then we don't need your help! response:	Just don't get in our way, then!
context: We're not fish, and they're not pigs!\We're all humans that can communicate with each other!\We're really serious about this!\It can be just once!\Please get everyone together and talk to them!\You're going to rely on me?\Then we don't need your help!\Just don't get in our way, then! response:	So everything went okay with the fishery cooperative?
context: We're all humans that can communicate with each other!\We're really serious about this!\It can be just once!\Please get everyone together and talk to them!\You're going to rely on me?\Then we don't need your help!\Just don't get in our way, then!\So everything went okay with the fishery cooperative? response:	It really wasn't that hard.
context: We're really serious about this!\It can be just once!\Please get everyone together and talk to them!\You're going to rely on me?\Then we don't need your help!\Just don't get in our way, then!\So everything went okay with the fishery cooperative?\It really wasn't that hard. response:	Right?
context: It can be just once!\Please get everyone together and talk to them!\You're going to rely on me?\Then we don't need your help!\Just don't get in our way, then!\So everything went okay with the fishery cooperative?\It really wasn't that hard.\Right? response:	Even if people couldn't really talk about the Ofunehiki,
context: Please get everyone together and talk to them!\You're going to rely on me?\Then we don't need your help!\Just don't get in our way, then!\So everything went okay with the fishery cooperative?\It really wasn't that hard.\Right?\Even if people couldn't really talk about the Ofunehiki, response:	they seemed to be concerned about it.
context: You're going to rely on me?\Then we don't need your help!\Just don't get in our way, then!\So everything went okay with the fishery cooperative?\It really wasn't that hard.\Right?\Even if people couldn't really talk about the Ofunehiki,\they seemed to be concerned about it. response:	And what about your end?
context: Then we don't need your help!\Just don't get in our way, then!\So everything went okay with the fishery cooperative?\It really wasn't that hard.\Right?\Even if people couldn't really talk about the Ofunehiki,\they seemed to be concerned about it.\And what about your end? response:	My stupid dad wouldn't listen,
context: Just don't get in our way, then!\So everything went okay with the fishery cooperative?\It really wasn't that hard.\Right?\Even if people couldn't really talk about the Ofunehiki,\they seemed to be concerned about it.\And what about your end?\My stupid dad wouldn't listen, response:	but the Young Men Coalition heard me out.
context: So everything went okay with the fishery cooperative?\It really wasn't that hard.\Right?\Even if people couldn't really talk about the Ofunehiki,\they seemed to be concerned about it.\And what about your end?\My stupid dad wouldn't listen,\but the Young Men Coalition heard me out. response:	If I mention that the people of the surface already agreed to it,
context: It really wasn't that hard.\Right?\Even if people couldn't really talk about the Ofunehiki,\they seemed to be concerned about it.\And what about your end?\My stupid dad wouldn't listen,\but the Young Men Coalition heard me out.\If I mention that the people of the surface already agreed to it, response:	it'll work out somehow.
context: Right?\Even if people couldn't really talk about the Ofunehiki,\they seemed to be concerned about it.\And what about your end?\My stupid dad wouldn't listen,\but the Young Men Coalition heard me out.\If I mention that the people of the surface already agreed to it,\it'll work out somehow. response:	All right. It's finally show time, then!
context: Even if people couldn't really talk about the Ofunehiki,\they seemed to be concerned about it.\And what about your end?\My stupid dad wouldn't listen,\but the Young Men Coalition heard me out.\If I mention that the people of the surface already agreed to it,\it'll work out somehow.\All right. It's finally show time, then! response:	We're gonna do the Ofunehiki!
context: they seemed to be concerned about it.\And what about your end?\My stupid dad wouldn't listen,\but the Young Men Coalition heard me out.\If I mention that the people of the surface already agreed to it,\it'll work out somehow.\All right. It's finally show time, then!\We're gonna do the Ofunehiki! response:	Yeah!
context: And what about your end?\My stupid dad wouldn't listen,\but the Young Men Coalition heard me out.\If I mention that the people of the surface already agreed to it,\it'll work out somehow.\All right. It's finally show time, then!\We're gonna do the Ofunehiki!\Yeah! response:	All right, time for food!
context: My stupid dad wouldn't listen,\but the Young Men Coalition heard me out.\If I mention that the people of the surface already agreed to it,\it'll work out somehow.\All right. It's finally show time, then!\We're gonna do the Ofunehiki!\Yeah!\All right, time for food! response:	Hopefully everything works out.
context: but the Young Men Coalition heard me out.\If I mention that the people of the surface already agreed to it,\it'll work out somehow.\All right. It's finally show time, then!\We're gonna do the Ofunehiki!\Yeah!\All right, time for food!\Hopefully everything works out. response:	If we don't hurry up and eat, there won't be any time to play.
context: If I mention that the people of the surface already agreed to it,\it'll work out somehow.\All right. It's finally show time, then!\We're gonna do the Ofunehiki!\Yeah!\All right, time for food!\Hopefully everything works out.\If we don't hurry up and eat, there won't be any time to play. response:	But they're all so stubborn...
context: it'll work out somehow.\All right. It's finally show time, then!\We're gonna do the Ofunehiki!\Yeah!\All right, time for food!\Hopefully everything works out.\If we don't hurry up and eat, there won't be any time to play.\But they're all so stubborn... response:	Just watch. I'm going to make this happen.
context: All right. It's finally show time, then!\We're gonna do the Ofunehiki!\Yeah!\All right, time for food!\Hopefully everything works out.\If we don't hurry up and eat, there won't be any time to play.\But they're all so stubborn...\Just watch. I'm going to make this happen. response:	Hikari's working really hard...
context: We're gonna do the Ofunehiki!\Yeah!\All right, time for food!\Hopefully everything works out.\If we don't hurry up and eat, there won't be any time to play.\But they're all so stubborn...\Just watch. I'm going to make this happen.\Hikari's working really hard... response:	Yeah...
context: Yeah!\All right, time for food!\Hopefully everything works out.\If we don't hurry up and eat, there won't be any time to play.\But they're all so stubborn...\Just watch. I'm going to make this happen.\Hikari's working really hard...\Yeah... response:	But Hii-kun's sort of... um...
context: All right, time for food!\Hopefully everything works out.\If we don't hurry up and eat, there won't be any time to play.\But they're all so stubborn...\Just watch. I'm going to make this happen.\Hikari's working really hard...\Yeah...\But Hii-kun's sort of... um... response:	Different, isn't he?
context: Hopefully everything works out.\If we don't hurry up and eat, there won't be any time to play.\But they're all so stubborn...\Just watch. I'm going to make this happen.\Hikari's working really hard...\Yeah...\But Hii-kun's sort of... um...\Different, isn't he? response:	Different?
context: If we don't hurry up and eat, there won't be any time to play.\But they're all so stubborn...\Just watch. I'm going to make this happen.\Hikari's working really hard...\Yeah...\But Hii-kun's sort of... um...\Different, isn't he?\Different? response:	Oh, I mean Hii-kun is always trying really hard...
context: But they're all so stubborn...\Just watch. I'm going to make this happen.\Hikari's working really hard...\Yeah...\But Hii-kun's sort of... um...\Different, isn't he?\Different?\Oh, I mean Hii-kun is always trying really hard... response:	But um... this seems to be a different kind of trying hard...
context: Just watch. I'm going to make this happen.\Hikari's working really hard...\Yeah...\But Hii-kun's sort of... um...\Different, isn't he?\Different?\Oh, I mean Hii-kun is always trying really hard...\But um... this seems to be a different kind of trying hard... response:	Um...
context: Hikari's working really hard...\Yeah...\But Hii-kun's sort of... um...\Different, isn't he?\Different?\Oh, I mean Hii-kun is always trying really hard...\But um... this seems to be a different kind of trying hard...\Um... response:	I think...
context: Yeah...\But Hii-kun's sort of... um...\Different, isn't he?\Different?\Oh, I mean Hii-kun is always trying really hard...\But um... this seems to be a different kind of trying hard...\Um...\I think... response:	He's trying to change.
context: But Hii-kun's sort of... um...\Different, isn't he?\Different?\Oh, I mean Hii-kun is always trying really hard...\But um... this seems to be a different kind of trying hard...\Um...\I think...\He's trying to change. response:	Change?!
context: Different, isn't he?\Different?\Oh, I mean Hii-kun is always trying really hard...\But um... this seems to be a different kind of trying hard...\Um...\I think...\He's trying to change.\Change?! response:	I don't want to change.
context: Different?\Oh, I mean Hii-kun is always trying really hard...\But um... this seems to be a different kind of trying hard...\Um...\I think...\He's trying to change.\Change?!\I don't want to change. response:	I want all of us to be together forever.
context: Oh, I mean Hii-kun is always trying really hard...\But um... this seems to be a different kind of trying hard...\Um...\I think...\He's trying to change.\Change?!\I don't want to change.\I want all of us to be together forever. response:	Ch-Change? That's not good!
context: But um... this seems to be a different kind of trying hard...\Um...\I think...\He's trying to change.\Change?!\I don't want to change.\I want all of us to be together forever.\Ch-Change? That's not good! response:	We need to hurry and stop Hii-kun!
context: Um...\I think...\He's trying to change.\Change?!\I don't want to change.\I want all of us to be together forever.\Ch-Change? That's not good!\We need to hurry and stop Hii-kun! response:	Stop him and rewind!
context: I think...\He's trying to change.\Change?!\I don't want to change.\I want all of us to be together forever.\Ch-Change? That's not good!\We need to hurry and stop Hii-kun!\Stop him and rewind! response:	I don't think we can do that.
context: He's trying to change.\Change?!\I don't want to change.\I want all of us to be together forever.\Ch-Change? That's not good!\We need to hurry and stop Hii-kun!\Stop him and rewind!\I don't think we can do that. response:	But...
context: Change?!\I don't want to change.\I want all of us to be together forever.\Ch-Change? That's not good!\We need to hurry and stop Hii-kun!\Stop him and rewind!\I don't think we can do that.\But... response:	Thanks, Manaka.
context: I don't want to change.\I want all of us to be together forever.\Ch-Change? That's not good!\We need to hurry and stop Hii-kun!\Stop him and rewind!\I don't think we can do that.\But...\Thanks, Manaka. response:	Chii-chan...
context: I want all of us to be together forever.\Ch-Change? That's not good!\We need to hurry and stop Hii-kun!\Stop him and rewind!\I don't think we can do that.\But...\Thanks, Manaka.\Chii-chan... response:	There are some things that change even if we don't want them to...
context: Ch-Change? That's not good!\We need to hurry and stop Hii-kun!\Stop him and rewind!\I don't think we can do that.\But...\Thanks, Manaka.\Chii-chan...\There are some things that change even if we don't want them to... response:	But once someone decides they're going to change and work really hard at it,
context: We need to hurry and stop Hii-kun!\Stop him and rewind!\I don't think we can do that.\But...\Thanks, Manaka.\Chii-chan...\There are some things that change even if we don't want them to...\But once someone decides they're going to change and work really hard at it, response:	I don't think even the Sea God could stop them.
context: Stop him and rewind!\I don't think we can do that.\But...\Thanks, Manaka.\Chii-chan...\There are some things that change even if we don't want them to...\But once someone decides they're going to change and work really hard at it,\I don't think even the Sea God could stop them. response:	Wow, they did a great job on this.
context: I don't think we can do that.\But...\Thanks, Manaka.\Chii-chan...\There are some things that change even if we don't want them to...\But once someone decides they're going to change and work really hard at it,\I don't think even the Sea God could stop them.\Wow, they did a great job on this. response:	That's pretty impressive.
context: But...\Thanks, Manaka.\Chii-chan...\There are some things that change even if we don't want them to...\But once someone decides they're going to change and work really hard at it,\I don't think even the Sea God could stop them.\Wow, they did a great job on this.\That's pretty impressive. response:	Not bad at all.
context: Thanks, Manaka.\Chii-chan...\There are some things that change even if we don't want them to...\But once someone decides they're going to change and work really hard at it,\I don't think even the Sea God could stop them.\Wow, they did a great job on this.\That's pretty impressive.\Not bad at all. response:	I think we could actually use this.
context: Chii-chan...\There are some things that change even if we don't want them to...\But once someone decides they're going to change and work really hard at it,\I don't think even the Sea God could stop them.\Wow, they did a great job on this.\That's pretty impressive.\Not bad at all.\I think we could actually use this. response:	Look at all the details.
context: There are some things that change even if we don't want them to...\But once someone decides they're going to change and work really hard at it,\I don't think even the Sea God could stop them.\Wow, they did a great job on this.\That's pretty impressive.\Not bad at all.\I think we could actually use this.\Look at all the details. response:	To think that they were able to get Hikari's dad to come out, too...
context: But once someone decides they're going to change and work really hard at it,\I don't think even the Sea God could stop them.\Wow, they did a great job on this.\That's pretty impressive.\Not bad at all.\I think we could actually use this.\Look at all the details.\To think that they were able to get Hikari's dad to come out, too... response:	I'm getting nervous.
context: I don't think even the Sea God could stop them.\Wow, they did a great job on this.\That's pretty impressive.\Not bad at all.\I think we could actually use this.\Look at all the details.\To think that they were able to get Hikari's dad to come out, too...\I'm getting nervous. response:	Me too. I sort of want to go take a piss.
context: Wow, they did a great job on this.\That's pretty impressive.\Not bad at all.\I think we could actually use this.\Look at all the details.\To think that they were able to get Hikari's dad to come out, too...\I'm getting nervous.\Me too. I sort of want to go take a piss. response:	Then go already, jeez!
context: That's pretty impressive.\Not bad at all.\I think we could actually use this.\Look at all the details.\To think that they were able to get Hikari's dad to come out, too...\I'm getting nervous.\Me too. I sort of want to go take a piss.\Then go already, jeez! response:	They even prepared offerings...
context: Not bad at all.\I think we could actually use this.\Look at all the details.\To think that they were able to get Hikari's dad to come out, too...\I'm getting nervous.\Me too. I sort of want to go take a piss.\Then go already, jeez!\They even prepared offerings... response:	When we were kids, we made all of these little things too, didn't we, Sakishima?
context: I think we could actually use this.\Look at all the details.\To think that they were able to get Hikari's dad to come out, too...\I'm getting nervous.\Me too. I sort of want to go take a piss.\Then go already, jeez!\They even prepared offerings...\When we were kids, we made all of these little things too, didn't we, Sakishima? response:	Why'd you come?
context: Look at all the details.\To think that they were able to get Hikari's dad to come out, too...\I'm getting nervous.\Me too. I sort of want to go take a piss.\Then go already, jeez!\They even prepared offerings...\When we were kids, we made all of these little things too, didn't we, Sakishima?\Why'd you come? response:	You... really made all this?
context: To think that they were able to get Hikari's dad to come out, too...\I'm getting nervous.\Me too. I sort of want to go take a piss.\Then go already, jeez!\They even prepared offerings...\When we were kids, we made all of these little things too, didn't we, Sakishima?\Why'd you come?\You... really made all this? response:	Yeah.
context: I'm getting nervous.\Me too. I sort of want to go take a piss.\Then go already, jeez!\They even prepared offerings...\When we were kids, we made all of these little things too, didn't we, Sakishima?\Why'd you come?\You... really made all this?\Yeah. response:	The four of us and our friends from the surface all worked together.
context: Me too. I sort of want to go take a piss.\Then go already, jeez!\They even prepared offerings...\When we were kids, we made all of these little things too, didn't we, Sakishima?\Why'd you come?\You... really made all this?\Yeah.\The four of us and our friends from the surface all worked together. response:	I see... So that's why.
context: Then go already, jeez!\They even prepared offerings...\When we were kids, we made all of these little things too, didn't we, Sakishima?\Why'd you come?\You... really made all this?\Yeah.\The four of us and our friends from the surface all worked together.\I see... So that's why. response:	Ojoshi-sama's kimono's fold is backwards.
context: They even prepared offerings...\When we were kids, we made all of these little things too, didn't we, Sakishima?\Why'd you come?\You... really made all this?\Yeah.\The four of us and our friends from the surface all worked together.\I see... So that's why.\Ojoshi-sama's kimono's fold is backwards. response:	Huh?
context: When we were kids, we made all of these little things too, didn't we, Sakishima?\Why'd you come?\You... really made all this?\Yeah.\The four of us and our friends from the surface all worked together.\I see... So that's why.\Ojoshi-sama's kimono's fold is backwards.\Huh? response:	What?!
context: Why'd you come?\You... really made all this?\Yeah.\The four of us and our friends from the surface all worked together.\I see... So that's why.\Ojoshi-sama's kimono's fold is backwards.\Huh?\What?! response:	What?!
context: You... really made all this?\Yeah.\The four of us and our friends from the surface all worked together.\I see... So that's why.\Ojoshi-sama's kimono's fold is backwards.\Huh?\What?!\What?! response:	Wh-What are we going to do, Chii-chan?!
context: Yeah.\The four of us and our friends from the surface all worked together.\I see... So that's why.\Ojoshi-sama's kimono's fold is backwards.\Huh?\What?!\What?!\Wh-What are we going to do, Chii-chan?! response:	We sewed it so the left would be in front!
context: The four of us and our friends from the surface all worked together.\I see... So that's why.\Ojoshi-sama's kimono's fold is backwards.\Huh?\What?!\What?!\Wh-What are we going to do, Chii-chan?!\We sewed it so the left would be in front! response:	Ojoshi-sama's going to die!
context: I see... So that's why.\Ojoshi-sama's kimono's fold is backwards.\Huh?\What?!\What?!\Wh-What are we going to do, Chii-chan?!\We sewed it so the left would be in front!\Ojoshi-sama's going to die! response:	Wha Calm down!
context: Ojoshi-sama's kimono's fold is backwards.\Huh?\What?!\What?!\Wh-What are we going to do, Chii-chan?!\We sewed it so the left would be in front!\Ojoshi-sama's going to die!\Wha Calm down! response:	We can fix that in no time.
context: Huh?\What?!\What?!\Wh-What are we going to do, Chii-chan?!\We sewed it so the left would be in front!\Ojoshi-sama's going to die!\Wha Calm down!\We can fix that in no time. response:	Hikari...
context: What?!\What?!\Wh-What are we going to do, Chii-chan?!\We sewed it so the left would be in front!\Ojoshi-sama's going to die!\Wha Calm down!\We can fix that in no time.\Hikari... response:	Talk about a preemptive strike.
context: What?!\Wh-What are we going to do, Chii-chan?!\We sewed it so the left would be in front!\Ojoshi-sama's going to die!\Wha Calm down!\We can fix that in no time.\Hikari...\Talk about a preemptive strike. response:	No worries!
context: Wh-What are we going to do, Chii-chan?!\We sewed it so the left would be in front!\Ojoshi-sama's going to die!\Wha Calm down!\We can fix that in no time.\Hikari...\Talk about a preemptive strike.\No worries! response:	We're just getting started.
context: We sewed it so the left would be in front!\Ojoshi-sama's going to die!\Wha Calm down!\We can fix that in no time.\Hikari...\Talk about a preemptive strike.\No worries!\We're just getting started. response:	It appears that everyone is ready now.
context: Ojoshi-sama's going to die!\Wha Calm down!\We can fix that in no time.\Hikari...\Talk about a preemptive strike.\No worries!\We're just getting started.\It appears that everyone is ready now. response:	I'll be moderating the meeting today.
context: Wha Calm down!\We can fix that in no time.\Hikari...\Talk about a preemptive strike.\No worries!\We're just getting started.\It appears that everyone is ready now.\I'll be moderating the meeting today. response:	So, what do you all think?
context: We can fix that in no time.\Hikari...\Talk about a preemptive strike.\No worries!\We're just getting started.\It appears that everyone is ready now.\I'll be moderating the meeting today.\So, what do you all think? response:	The students worked really hard to make this.
context: Hikari...\Talk about a preemptive strike.\No worries!\We're just getting started.\It appears that everyone is ready now.\I'll be moderating the meeting today.\So, what do you all think?\The students worked really hard to make this. response:	So as their teacher, I'd really like to see their dream come true.
context: Talk about a preemptive strike.\No worries!\We're just getting started.\It appears that everyone is ready now.\I'll be moderating the meeting today.\So, what do you all think?\The students worked really hard to make this.\So as their teacher, I'd really like to see their dream come true. response:	Well, we never objected to doing the Ofunehiki in the first place.
context: No worries!\We're just getting started.\It appears that everyone is ready now.\I'll be moderating the meeting today.\So, what do you all think?\The students worked really hard to make this.\So as their teacher, I'd really like to see their dream come true.\Well, we never objected to doing the Ofunehiki in the first place. response:	Yeah.
context: We're just getting started.\It appears that everyone is ready now.\I'll be moderating the meeting today.\So, what do you all think?\The students worked really hard to make this.\So as their teacher, I'd really like to see their dream come true.\Well, we never objected to doing the Ofunehiki in the first place.\Yeah. response:	And festivals shouldn't be disregarded.
context: It appears that everyone is ready now.\I'll be moderating the meeting today.\So, what do you all think?\The students worked really hard to make this.\So as their teacher, I'd really like to see their dream come true.\Well, we never objected to doing the Ofunehiki in the first place.\Yeah.\And festivals shouldn't be disregarded. response:	And it's not like we're going to neglect the god.
context: I'll be moderating the meeting today.\So, what do you all think?\The students worked really hard to make this.\So as their teacher, I'd really like to see their dream come true.\Well, we never objected to doing the Ofunehiki in the first place.\Yeah.\And festivals shouldn't be disregarded.\And it's not like we're going to neglect the god. response:	Yeah, of course.
context: So, what do you all think?\The students worked really hard to make this.\So as their teacher, I'd really like to see their dream come true.\Well, we never objected to doing the Ofunehiki in the first place.\Yeah.\And festivals shouldn't be disregarded.\And it's not like we're going to neglect the god.\Yeah, of course. response:	Hey, Sakishima.
context: The students worked really hard to make this.\So as their teacher, I'd really like to see their dream come true.\Well, we never objected to doing the Ofunehiki in the first place.\Yeah.\And festivals shouldn't be disregarded.\And it's not like we're going to neglect the god.\Yeah, of course.\Hey, Sakishima. response:	The kids went so far to do this.
context: So as their teacher, I'd really like to see their dream come true.\Well, we never objected to doing the Ofunehiki in the first place.\Yeah.\And festivals shouldn't be disregarded.\And it's not like we're going to neglect the god.\Yeah, of course.\Hey, Sakishima.\The kids went so far to do this. response:	A lot's happened, but why don't we let it go?
context: Well, we never objected to doing the Ofunehiki in the first place.\Yeah.\And festivals shouldn't be disregarded.\And it's not like we're going to neglect the god.\Yeah, of course.\Hey, Sakishima.\The kids went so far to do this.\A lot's happened, but why don't we let it go? response:	Yeah.
context: Yeah.\And festivals shouldn't be disregarded.\And it's not like we're going to neglect the god.\Yeah, of course.\Hey, Sakishima.\The kids went so far to do this.\A lot's happened, but why don't we let it go?\Yeah. response:	Well, go ahead and start.
context: And festivals shouldn't be disregarded.\And it's not like we're going to neglect the god.\Yeah, of course.\Hey, Sakishima.\The kids went so far to do this.\A lot's happened, but why don't we let it go?\Yeah.\Well, go ahead and start. response:	But it's already started...
context: And it's not like we're going to neglect the god.\Yeah, of course.\Hey, Sakishima.\The kids went so far to do this.\A lot's happened, but why don't we let it go?\Yeah.\Well, go ahead and start.\But it's already started... response:	Not that.
context: Yeah, of course.\Hey, Sakishima.\The kids went so far to do this.\A lot's happened, but why don't we let it go?\Yeah.\Well, go ahead and start.\But it's already started...\Not that. response:	I'm saying that we'll listen to your apology now.
context: Hey, Sakishima.\The kids went so far to do this.\A lot's happened, but why don't we let it go?\Yeah.\Well, go ahead and start.\But it's already started...\Not that.\I'm saying that we'll listen to your apology now. response:	What?
context: The kids went so far to do this.\A lot's happened, but why don't we let it go?\Yeah.\Well, go ahead and start.\But it's already started...\Not that.\I'm saying that we'll listen to your apology now.\What? response:	Apology?
context: A lot's happened, but why don't we let it go?\Yeah.\Well, go ahead and start.\But it's already started...\Not that.\I'm saying that we'll listen to your apology now.\What?\Apology? response:	We came all the way here.
context: Yeah.\Well, go ahead and start.\But it's already started...\Not that.\I'm saying that we'll listen to your apology now.\What?\Apology?\We came all the way here. response:	Apologize to your heart's content.
context: Well, go ahead and start.\But it's already started...\Not that.\I'm saying that we'll listen to your apology now.\What?\Apology?\We came all the way here.\Apologize to your heart's content. response:	Our hearts are as wide as the sea.
context: But it's already started...\Not that.\I'm saying that we'll listen to your apology now.\What?\Apology?\We came all the way here.\Apologize to your heart's content.\Our hearts are as wide as the sea. response:	It'll probably be a little rude, but we'll hear it out.
context: Not that.\I'm saying that we'll listen to your apology now.\What?\Apology?\We came all the way here.\Apologize to your heart's content.\Our hearts are as wide as the sea.\It'll probably be a little rude, but we'll hear it out. response:	Why would we have to apologize?
context: I'm saying that we'll listen to your apology now.\What?\Apology?\We came all the way here.\Apologize to your heart's content.\Our hearts are as wide as the sea.\It'll probably be a little rude, but we'll hear it out.\Why would we have to apologize? response:	You're the ones that said you wouldn't do the festival in the first place.
context: What?\Apology?\We came all the way here.\Apologize to your heart's content.\Our hearts are as wide as the sea.\It'll probably be a little rude, but we'll hear it out.\Why would we have to apologize?\You're the ones that said you wouldn't do the festival in the first place. response:	Hold on a second.
context: Apology?\We came all the way here.\Apologize to your heart's content.\Our hearts are as wide as the sea.\It'll probably be a little rude, but we'll hear it out.\Why would we have to apologize?\You're the ones that said you wouldn't do the festival in the first place.\Hold on a second. response:	Are you trying to say you don't remember the last Ofunehiki?
context: We came all the way here.\Apologize to your heart's content.\Our hearts are as wide as the sea.\It'll probably be a little rude, but we'll hear it out.\Why would we have to apologize?\You're the ones that said you wouldn't do the festival in the first place.\Hold on a second.\Are you trying to say you don't remember the last Ofunehiki? response:	You guys were complaining about how there wasn't enough money
context: Apologize to your heart's content.\Our hearts are as wide as the sea.\It'll probably be a little rude, but we'll hear it out.\Why would we have to apologize?\You're the ones that said you wouldn't do the festival in the first place.\Hold on a second.\Are you trying to say you don't remember the last Ofunehiki?\You guys were complaining about how there wasn't enough money response:	or enough people, and you asked to scale things down, didn't you?
context: Our hearts are as wide as the sea.\It'll probably be a little rude, but we'll hear it out.\Why would we have to apologize?\You're the ones that said you wouldn't do the festival in the first place.\Hold on a second.\Are you trying to say you don't remember the last Ofunehiki?\You guys were complaining about how there wasn't enough money\or enough people, and you asked to scale things down, didn't you? response:	Not to mention this happened time after time...
context: It'll probably be a little rude, but we'll hear it out.\Why would we have to apologize?\You're the ones that said you wouldn't do the festival in the first place.\Hold on a second.\Are you trying to say you don't remember the last Ofunehiki?\You guys were complaining about how there wasn't enough money\or enough people, and you asked to scale things down, didn't you?\Not to mention this happened time after time... response:	At that rate,
context: Why would we have to apologize?\You're the ones that said you wouldn't do the festival in the first place.\Hold on a second.\Are you trying to say you don't remember the last Ofunehiki?\You guys were complaining about how there wasn't enough money\or enough people, and you asked to scale things down, didn't you?\Not to mention this happened time after time...\At that rate, response:	even if we hadn't said we weren't going to do it,
context: You're the ones that said you wouldn't do the festival in the first place.\Hold on a second.\Are you trying to say you don't remember the last Ofunehiki?\You guys were complaining about how there wasn't enough money\or enough people, and you asked to scale things down, didn't you?\Not to mention this happened time after time...\At that rate,\even if we hadn't said we weren't going to do it, response:	Hey, this doesn't look very good, does it?
context: Hold on a second.\Are you trying to say you don't remember the last Ofunehiki?\You guys were complaining about how there wasn't enough money\or enough people, and you asked to scale things down, didn't you?\Not to mention this happened time after time...\At that rate,\even if we hadn't said we weren't going to do it,\Hey, this doesn't look very good, does it? response:	you guys would have said it yourselves.
context: Are you trying to say you don't remember the last Ofunehiki?\You guys were complaining about how there wasn't enough money\or enough people, and you asked to scale things down, didn't you?\Not to mention this happened time after time...\At that rate,\even if we hadn't said we weren't going to do it,\Hey, this doesn't look very good, does it?\you guys would have said it yourselves. response:	That's not true!
context: You guys were complaining about how there wasn't enough money\or enough people, and you asked to scale things down, didn't you?\Not to mention this happened time after time...\At that rate,\even if we hadn't said we weren't going to do it,\Hey, this doesn't look very good, does it?\you guys would have said it yourselves.\That's not true! response:	Please wait!
context: or enough people, and you asked to scale things down, didn't you?\Not to mention this happened time after time...\At that rate,\even if we hadn't said we weren't going to do it,\Hey, this doesn't look very good, does it?\you guys would have said it yourselves.\That's not true!\Please wait! response:	This isn't a gathering to say who should apologize or who's at faul
context: Not to mention this happened time after time...\At that rate,\even if we hadn't said we weren't going to do it,\Hey, this doesn't look very good, does it?\you guys would have said it yourselves.\That's not true!\Please wait!\This isn't a gathering to say who should apologize or who's at faul response:	Stay out of it, kid!
context: At that rate,\even if we hadn't said we weren't going to do it,\Hey, this doesn't look very good, does it?\you guys would have said it yourselves.\That's not true!\Please wait!\This isn't a gathering to say who should apologize or who's at faul\Stay out of it, kid! response:	Anyway, you're the ones who called it off first.
context: even if we hadn't said we weren't going to do it,\Hey, this doesn't look very good, does it?\you guys would have said it yourselves.\That's not true!\Please wait!\This isn't a gathering to say who should apologize or who's at faul\Stay out of it, kid!\Anyway, you're the ones who called it off first. response:	It's only natural that you apologize.
context: Hey, this doesn't look very good, does it?\you guys would have said it yourselves.\That's not true!\Please wait!\This isn't a gathering to say who should apologize or who's at faul\Stay out of it, kid!\Anyway, you're the ones who called it off first.\It's only natural that you apologize. response:	Not to mention,
context: you guys would have said it yourselves.\That's not true!\Please wait!\This isn't a gathering to say who should apologize or who's at faul\Stay out of it, kid!\Anyway, you're the ones who called it off first.\It's only natural that you apologize.\Not to mention, response:	the reason we don't have enough people or any money
context: That's not true!\Please wait!\This isn't a gathering to say who should apologize or who's at faul\Stay out of it, kid!\Anyway, you're the ones who called it off first.\It's only natural that you apologize.\Not to mention,\the reason we don't have enough people or any money response:	is because ya'll keep taking them from the top!
context: Please wait!\This isn't a gathering to say who should apologize or who's at faul\Stay out of it, kid!\Anyway, you're the ones who called it off first.\It's only natural that you apologize.\Not to mention,\the reason we don't have enough people or any money\is because ya'll keep taking them from the top! response:	That's right!
context: This isn't a gathering to say who should apologize or who's at faul\Stay out of it, kid!\Anyway, you're the ones who called it off first.\It's only natural that you apologize.\Not to mention,\the reason we don't have enough people or any money\is because ya'll keep taking them from the top!\That's right! response:	Both our fish and our women!
context: Stay out of it, kid!\Anyway, you're the ones who called it off first.\It's only natural that you apologize.\Not to mention,\the reason we don't have enough people or any money\is because ya'll keep taking them from the top!\That's right!\Both our fish and our women! response:	What?
context: Anyway, you're the ones who called it off first.\It's only natural that you apologize.\Not to mention,\the reason we don't have enough people or any money\is because ya'll keep taking them from the top!\That's right!\Both our fish and our women!\What? response:	The reason your women run off is because you guys aren't reliable, isn't it?
context: It's only natural that you apologize.\Not to mention,\the reason we don't have enough people or any money\is because ya'll keep taking them from the top!\That's right!\Both our fish and our women!\What?\The reason your women run off is because you guys aren't reliable, isn't it? response:	You're gonna blame us for that, too?
context: Not to mention,\the reason we don't have enough people or any money\is because ya'll keep taking them from the top!\That's right!\Both our fish and our women!\What?\The reason your women run off is because you guys aren't reliable, isn't it?\You're gonna blame us for that, too? response:	What'd you just say?!
context: the reason we don't have enough people or any money\is because ya'll keep taking them from the top!\That's right!\Both our fish and our women!\What?\The reason your women run off is because you guys aren't reliable, isn't it?\You're gonna blame us for that, too?\What'd you just say?! response:	Looks like it's gonna rain...
context: is because ya'll keep taking them from the top!\That's right!\Both our fish and our women!\What?\The reason your women run off is because you guys aren't reliable, isn't it?\You're gonna blame us for that, too?\What'd you just say?!\Looks like it's gonna rain... response:	You're going to come, too?
context: That's right!\Both our fish and our women!\What?\The reason your women run off is because you guys aren't reliable, isn't it?\You're gonna blame us for that, too?\What'd you just say?!\Looks like it's gonna rain...\You're going to come, too? response:	Yeah.
context: Both our fish and our women!\What?\The reason your women run off is because you guys aren't reliable, isn't it?\You're gonna blame us for that, too?\What'd you just say?!\Looks like it's gonna rain...\You're going to come, too?\Yeah. response:	Hikari worked really hard...
context: What?\The reason your women run off is because you guys aren't reliable, isn't it?\You're gonna blame us for that, too?\What'd you just say?!\Looks like it's gonna rain...\You're going to come, too?\Yeah.\Hikari worked really hard... response:	Also,
context: The reason your women run off is because you guys aren't reliable, isn't it?\You're gonna blame us for that, too?\What'd you just say?!\Looks like it's gonna rain...\You're going to come, too?\Yeah.\Hikari worked really hard...\Also, response:	I really want to show Miuna-chan an actual Ofunehiki.
context: You're gonna blame us for that, too?\What'd you just say?!\Looks like it's gonna rain...\You're going to come, too?\Yeah.\Hikari worked really hard...\Also,\I really want to show Miuna-chan an actual Ofunehiki. response:	Maybe it's because of our roots.
context: What'd you just say?!\Looks like it's gonna rain...\You're going to come, too?\Yeah.\Hikari worked really hard...\Also,\I really want to show Miuna-chan an actual Ofunehiki.\Maybe it's because of our roots. response:	There's that, and if Miuna-chan is ever lost...
context: Looks like it's gonna rain...\You're going to come, too?\Yeah.\Hikari worked really hard...\Also,\I really want to show Miuna-chan an actual Ofunehiki.\Maybe it's because of our roots.\There's that, and if Miuna-chan is ever lost... response:	I thought it could be like a light in her heart.
context: You're going to come, too?\Yeah.\Hikari worked really hard...\Also,\I really want to show Miuna-chan an actual Ofunehiki.\Maybe it's because of our roots.\There's that, and if Miuna-chan is ever lost...\I thought it could be like a light in her heart. response:	Akari...
context: Yeah.\Hikari worked really hard...\Also,\I really want to show Miuna-chan an actual Ofunehiki.\Maybe it's because of our roots.\There's that, and if Miuna-chan is ever lost...\I thought it could be like a light in her heart.\Akari... response:	Thank you...
context: Hikari worked really hard...\Also,\I really want to show Miuna-chan an actual Ofunehiki.\Maybe it's because of our roots.\There's that, and if Miuna-chan is ever lost...\I thought it could be like a light in her heart.\Akari...\Thank you... response:	For thinking about Miuna.
context: Also,\I really want to show Miuna-chan an actual Ofunehiki.\Maybe it's because of our roots.\There's that, and if Miuna-chan is ever lost...\I thought it could be like a light in her heart.\Akari...\Thank you...\For thinking about Miuna. response:	All right, let's go in.
context: I really want to show Miuna-chan an actual Ofunehiki.\Maybe it's because of our roots.\There's that, and if Miuna-chan is ever lost...\I thought it could be like a light in her heart.\Akari...\Thank you...\For thinking about Miuna.\All right, let's go in. response:	The hell are you saying, fish head?
context: Maybe it's because of our roots.\There's that, and if Miuna-chan is ever lost...\I thought it could be like a light in her heart.\Akari...\Thank you...\For thinking about Miuna.\All right, let's go in.\The hell are you saying, fish head? response:	Excuse u
context: There's that, and if Miuna-chan is ever lost...\I thought it could be like a light in her heart.\Akari...\Thank you...\For thinking about Miuna.\All right, let's go in.\The hell are you saying, fish head?\Excuse u response:	Shut up, you pigs!
context: I thought it could be like a light in her heart.\Akari...\Thank you...\For thinking about Miuna.\All right, let's go in.\The hell are you saying, fish head?\Excuse u\Shut up, you pigs! response:	All your squealing's annoying!
context: Akari...\Thank you...\For thinking about Miuna.\All right, let's go in.\The hell are you saying, fish head?\Excuse u\Shut up, you pigs!\All your squealing's annoying! response:	All right then.
context: Thank you...\For thinking about Miuna.\All right, let's go in.\The hell are you saying, fish head?\Excuse u\Shut up, you pigs!\All your squealing's annoying!\All right then. response:	Why don't we settle things once and for all?
context: For thinking about Miuna.\All right, let's go in.\The hell are you saying, fish head?\Excuse u\Shut up, you pigs!\All your squealing's annoying!\All right then.\Why don't we settle things once and for all? response:	What'd you just say?!
context: All right, let's go in.\The hell are you saying, fish head?\Excuse u\Shut up, you pigs!\All your squealing's annoying!\All right then.\Why don't we settle things once and for all?\What'd you just say?! response:	Is this a bad time?
context: The hell are you saying, fish head?\Excuse u\Shut up, you pigs!\All your squealing's annoying!\All right then.\Why don't we settle things once and for all?\What'd you just say?!\Is this a bad time? response:	Whoa.
context: Excuse u\Shut up, you pigs!\All your squealing's annoying!\All right then.\Why don't we settle things once and for all?\What'd you just say?!\Is this a bad time?\Whoa. response:	That sucks.
context: Shut up, you pigs!\All your squealing's annoying!\All right then.\Why don't we settle things once and for all?\What'd you just say?!\Is this a bad time?\Whoa.\That sucks. response:	Itaru-san...
context: All your squealing's annoying!\All right then.\Why don't we settle things once and for all?\What'd you just say?!\Is this a bad time?\Whoa.\That sucks.\Itaru-san... response:	Talk about bad timing...
context: All right then.\Why don't we settle things once and for all?\What'd you just say?!\Is this a bad time?\Whoa.\That sucks.\Itaru-san...\Talk about bad timing... response:	Hey! You're the guy Akari's seeing!
context: Why don't we settle things once and for all?\What'd you just say?!\Is this a bad time?\Whoa.\That sucks.\Itaru-san...\Talk about bad timing...\Hey! You're the guy Akari's seeing! response:	Um...
context: What'd you just say?!\Is this a bad time?\Whoa.\That sucks.\Itaru-san...\Talk about bad timing...\Hey! You're the guy Akari's seeing!\Um... response:	You thief!
context: Is this a bad time?\Whoa.\That sucks.\Itaru-san...\Talk about bad timing...\Hey! You're the guy Akari's seeing!\Um...\You thief! response:	Thie
context: Whoa.\That sucks.\Itaru-san...\Talk about bad timing...\Hey! You're the guy Akari's seeing!\Um...\You thief!\Thie response:	We've got plenty of things we want to say to you!
context: That sucks.\Itaru-san...\Talk about bad timing...\Hey! You're the guy Akari's seeing!\Um...\You thief!\Thie\We've got plenty of things we want to say to you! response:	Get over here!
context: Itaru-san...\Talk about bad timing...\Hey! You're the guy Akari's seeing!\Um...\You thief!\Thie\We've got plenty of things we want to say to you!\Get over here! response:	Hey!
context: Talk about bad timing...\Hey! You're the guy Akari's seeing!\Um...\You thief!\Thie\We've got plenty of things we want to say to you!\Get over here!\Hey! response:	What's going on here? Hikari! Dad!
context: Hey! You're the guy Akari's seeing!\Um...\You thief!\Thie\We've got plenty of things we want to say to you!\Get over here!\Hey!\What's going on here? Hikari! Dad! response:	Would you guys stop already?!
context: Um...\You thief!\Thie\We've got plenty of things we want to say to you!\Get over here!\Hey!\What's going on here? Hikari! Dad!\Would you guys stop already?! response:	You're adults, aren't you?
context: You thief!\Thie\We've got plenty of things we want to say to you!\Get over here!\Hey!\What's going on here? Hikari! Dad!\Would you guys stop already?!\You're adults, aren't you? response:	Why can't you talk things out?!
context: Thie\We've got plenty of things we want to say to you!\Get over here!\Hey!\What's going on here? Hikari! Dad!\Would you guys stop already?!\You're adults, aren't you?\Why can't you talk things out?! response:	Stay out of the way!
context: We've got plenty of things we want to say to you!\Get over here!\Hey!\What's going on here? Hikari! Dad!\Would you guys stop already?!\You're adults, aren't you?\Why can't you talk things out?!\Stay out of the way! response:	Are you satisfied?
context: Get over here!\Hey!\What's going on here? Hikari! Dad!\Would you guys stop already?!\You're adults, aren't you?\Why can't you talk things out?!\Stay out of the way!\Are you satisfied? response:	Looking for Part-Timers!
context: Hey!\What's going on here? Hikari! Dad!\Would you guys stop already?!\You're adults, aren't you?\Why can't you talk things out?!\Stay out of the way!\Are you satisfied?\Looking for Part-Timers! response:	Break up with him.
context: What's going on here? Hikari! Dad!\Would you guys stop already?!\You're adults, aren't you?\Why can't you talk things out?!\Stay out of the way!\Are you satisfied?\Looking for Part-Timers!\Break up with him. response:	As Hikari said, because we're not fish or pigs, we can understand each other...
context: Would you guys stop already?!\You're adults, aren't you?\Why can't you talk things out?!\Stay out of the way!\Are you satisfied?\Looking for Part-Timers!\Break up with him.\As Hikari said, because we're not fish or pigs, we can understand each other... response:	But it's because we can communicate,
context: You're adults, aren't you?\Why can't you talk things out?!\Stay out of the way!\Are you satisfied?\Looking for Part-Timers!\Break up with him.\As Hikari said, because we're not fish or pigs, we can understand each other...\But it's because we can communicate, response:	that we realize there are differences we can never get over.
context: Why can't you talk things out?!\Stay out of the way!\Are you satisfied?\Looking for Part-Timers!\Break up with him.\As Hikari said, because we're not fish or pigs, we can understand each other...\But it's because we can communicate,\that we realize there are differences we can never get over. response:	People from the sea and people from the surface will never see eye to eye.
context: Stay out of the way!\Are you satisfied?\Looking for Part-Timers!\Break up with him.\As Hikari said, because we're not fish or pigs, we can understand each other...\But it's because we can communicate,\that we realize there are differences we can never get over.\People from the sea and people from the surface will never see eye to eye. response:	I always... thought something was different.
context: Are you satisfied?\Looking for Part-Timers!\Break up with him.\As Hikari said, because we're not fish or pigs, we can understand each other...\But it's because we can communicate,\that we realize there are differences we can never get over.\People from the sea and people from the surface will never see eye to eye.\I always... thought something was different. response:	I finally realize what it was.
context: Looking for Part-Timers!\Break up with him.\As Hikari said, because we're not fish or pigs, we can understand each other...\But it's because we can communicate,\that we realize there are differences we can never get over.\People from the sea and people from the surface will never see eye to eye.\I always... thought something was different.\I finally realize what it was. response:	I'm talking about Itaru-san and myself.
context: Break up with him.\As Hikari said, because we're not fish or pigs, we can understand each other...\But it's because we can communicate,\that we realize there are differences we can never get over.\People from the sea and people from the surface will never see eye to eye.\I always... thought something was different.\I finally realize what it was.\I'm talking about Itaru-san and myself. response:	And yet, you always change the subject to the sea and the surface.
context: As Hikari said, because we're not fish or pigs, we can understand each other...\But it's because we can communicate,\that we realize there are differences we can never get over.\People from the sea and people from the surface will never see eye to eye.\I always... thought something was different.\I finally realize what it was.\I'm talking about Itaru-san and myself.\And yet, you always change the subject to the sea and the surface. response:	I asked Mom a long time ago...
context: But it's because we can communicate,\that we realize there are differences we can never get over.\People from the sea and people from the surface will never see eye to eye.\I always... thought something was different.\I finally realize what it was.\I'm talking about Itaru-san and myself.\And yet, you always change the subject to the sea and the surface.\I asked Mom a long time ago... response:	why she married you.
context: that we realize there are differences we can never get over.\People from the sea and people from the surface will never see eye to eye.\I always... thought something was different.\I finally realize what it was.\I'm talking about Itaru-san and myself.\And yet, you always change the subject to the sea and the surface.\I asked Mom a long time ago...\why she married you. response:	She said... the reason was simple.
context: People from the sea and people from the surface will never see eye to eye.\I always... thought something was different.\I finally realize what it was.\I'm talking about Itaru-san and myself.\And yet, you always change the subject to the sea and the surface.\I asked Mom a long time ago...\why she married you.\She said... the reason was simple. response:	She married you just because she loved you.
context: I always... thought something was different.\I finally realize what it was.\I'm talking about Itaru-san and myself.\And yet, you always change the subject to the sea and the surface.\I asked Mom a long time ago...\why she married you.\She said... the reason was simple.\She married you just because she loved you. response:	When I heard that, I was happy.
context: I finally realize what it was.\I'm talking about Itaru-san and myself.\And yet, you always change the subject to the sea and the surface.\I asked Mom a long time ago...\why she married you.\She said... the reason was simple.\She married you just because she loved you.\When I heard that, I was happy. response:	Because of that, I just happened to ask her,
context: I'm talking about Itaru-san and myself.\And yet, you always change the subject to the sea and the surface.\I asked Mom a long time ago...\why she married you.\She said... the reason was simple.\She married you just because she loved you.\When I heard that, I was happy.\Because of that, I just happened to ask her, response:	what if you were from the surface.
context: And yet, you always change the subject to the sea and the surface.\I asked Mom a long time ago...\why she married you.\She said... the reason was simple.\She married you just because she loved you.\When I heard that, I was happy.\Because of that, I just happened to ask her,\what if you were from the surface. response:	And then Mom just smiled and said...
context: I asked Mom a long time ago...\why she married you.\She said... the reason was simple.\She married you just because she loved you.\When I heard that, I was happy.\Because of that, I just happened to ask her,\what if you were from the surface.\And then Mom just smiled and said... response:	Even then, I would have been with your father.
context: why she married you.\She said... the reason was simple.\She married you just because she loved you.\When I heard that, I was happy.\Because of that, I just happened to ask her,\what if you were from the surface.\And then Mom just smiled and said...\Even then, I would have been with your father. response:	I'm going to be Miuna-chan's mother.
context: She said... the reason was simple.\She married you just because she loved you.\When I heard that, I was happy.\Because of that, I just happened to ask her,\what if you were from the surface.\And then Mom just smiled and said...\Even then, I would have been with your father.\I'm going to be Miuna-chan's mother. response:	Are you leaving?
context: She married you just because she loved you.\When I heard that, I was happy.\Because of that, I just happened to ask her,\what if you were from the surface.\And then Mom just smiled and said...\Even then, I would have been with your father.\I'm going to be Miuna-chan's mother.\Are you leaving? response:	Yeah...
context: When I heard that, I was happy.\Because of that, I just happened to ask her,\what if you were from the surface.\And then Mom just smiled and said...\Even then, I would have been with your father.\I'm going to be Miuna-chan's mother.\Are you leaving?\Yeah... response:	I'm sorry, Hikari.
context: Because of that, I just happened to ask her,\what if you were from the surface.\And then Mom just smiled and said...\Even then, I would have been with your father.\I'm going to be Miuna-chan's mother.\Are you leaving?\Yeah...\I'm sorry, Hikari. response:	You don't need to apologize.
context: what if you were from the surface.\And then Mom just smiled and said...\Even then, I would have been with your father.\I'm going to be Miuna-chan's mother.\Are you leaving?\Yeah...\I'm sorry, Hikari.\You don't need to apologize. response:	Because I'm leaving, too.
context: And then Mom just smiled and said...\Even then, I would have been with your father.\I'm going to be Miuna-chan's mother.\Are you leaving?\Yeah...\I'm sorry, Hikari.\You don't need to apologize.\Because I'm leaving, too. response:	But
context: Even then, I would have been with your father.\I'm going to be Miuna-chan's mother.\Are you leaving?\Yeah...\I'm sorry, Hikari.\You don't need to apologize.\Because I'm leaving, too.\But response:	Being left alone with Dad...
context: I'm going to be Miuna-chan's mother.\Are you leaving?\Yeah...\I'm sorry, Hikari.\You don't need to apologize.\Because I'm leaving, too.\But\Being left alone with Dad... response:	I know that there's no way things will be normal.
context: Are you leaving?\Yeah...\I'm sorry, Hikari.\You don't need to apologize.\Because I'm leaving, too.\But\Being left alone with Dad...\I know that there's no way things will be normal. response:	All right.
context: Yeah...\I'm sorry, Hikari.\You don't need to apologize.\Because I'm leaving, too.\But\Being left alone with Dad...\I know that there's no way things will be normal.\All right. response:	I see, so she said she's going to leave.
context: I'm sorry, Hikari.\You don't need to apologize.\Because I'm leaving, too.\But\Being left alone with Dad...\I know that there's no way things will be normal.\All right.\I see, so she said she's going to leave. response:	Look.
context: You don't need to apologize.\Because I'm leaving, too.\But\Being left alone with Dad...\I know that there's no way things will be normal.\All right.\I see, so she said she's going to leave.\Look. response:	The shaking's gotten more pronounced.
context: Because I'm leaving, too.\But\Being left alone with Dad...\I know that there's no way things will be normal.\All right.\I see, so she said she's going to leave.\Look.\The shaking's gotten more pronounced. response:	There isn't much more time.
context: But\Being left alone with Dad...\I know that there's no way things will be normal.\All right.\I see, so she said she's going to leave.\Look.\The shaking's gotten more pronounced.\There isn't much more time. response:	What are you going to do, Tomoru?
context: Being left alone with Dad...\I know that there's no way things will be normal.\All right.\I see, so she said she's going to leave.\Look.\The shaking's gotten more pronounced.\There isn't much more time.\What are you going to do, Tomoru? response:	Uroko-sama.
context: I know that there's no way things will be normal.\All right.\I see, so she said she's going to leave.\Look.\The shaking's gotten more pronounced.\There isn't much more time.\What are you going to do, Tomoru?\Uroko-sama. response:	Are you leaving?
context: All right.\I see, so she said she's going to leave.\Look.\The shaking's gotten more pronounced.\There isn't much more time.\What are you going to do, Tomoru?\Uroko-sama.\Are you leaving? response:	Yes.
context: I see, so she said she's going to leave.\Look.\The shaking's gotten more pronounced.\There isn't much more time.\What are you going to do, Tomoru?\Uroko-sama.\Are you leaving?\Yes. response:	Would you consider changing your mind?
context: Look.\The shaking's gotten more pronounced.\There isn't much more time.\What are you going to do, Tomoru?\Uroko-sama.\Are you leaving?\Yes.\Would you consider changing your mind? response:	I will not.
context: The shaking's gotten more pronounced.\There isn't much more time.\What are you going to do, Tomoru?\Uroko-sama.\Are you leaving?\Yes.\Would you consider changing your mind?\I will not. response:	But you're still under my protection.
context: There isn't much more time.\What are you going to do, Tomoru?\Uroko-sama.\Are you leaving?\Yes.\Would you consider changing your mind?\I will not.\But you're still under my protection. response:	Thank you for everything that you've done for me.
context: What are you going to do, Tomoru?\Uroko-sama.\Are you leaving?\Yes.\Would you consider changing your mind?\I will not.\But you're still under my protection.\Thank you for everything that you've done for me. response:	But I've decided.
context: Uroko-sama.\Are you leaving?\Yes.\Would you consider changing your mind?\I will not.\But you're still under my protection.\Thank you for everything that you've done for me.\But I've decided. response:	I will live life on the surface.
context: Are you leaving?\Yes.\Would you consider changing your mind?\I will not.\But you're still under my protection.\Thank you for everything that you've done for me.\But I've decided.\I will live life on the surface. response:	Thank you.
context: Yes.\Would you consider changing your mind?\I will not.\But you're still under my protection.\Thank you for everything that you've done for me.\But I've decided.\I will live life on the surface.\Thank you. response:	I'm not coming back, either.
context: Would you consider changing your mind?\I will not.\But you're still under my protection.\Thank you for everything that you've done for me.\But I've decided.\I will live life on the surface.\Thank you.\I'm not coming back, either. response:	Apparently everyone in the family is stubborn.
context: I will not.\But you're still under my protection.\Thank you for everything that you've done for me.\But I've decided.\I will live life on the surface.\Thank you.\I'm not coming back, either.\Apparently everyone in the family is stubborn. response:	Good grief.
context: But you're still under my protection.\Thank you for everything that you've done for me.\But I've decided.\I will live life on the surface.\Thank you.\I'm not coming back, either.\Apparently everyone in the family is stubborn.\Good grief. response:	Akari!
context: Thank you for everything that you've done for me.\But I've decided.\I will live life on the surface.\Thank you.\I'm not coming back, either.\Apparently everyone in the family is stubborn.\Good grief.\Akari! response:	Hikari!
context: But I've decided.\I will live life on the surface.\Thank you.\I'm not coming back, either.\Apparently everyone in the family is stubborn.\Good grief.\Akari!\Hikari! response:	Uroko-sama!
context: I will live life on the surface.\Thank you.\I'm not coming back, either.\Apparently everyone in the family is stubborn.\Good grief.\Akari!\Hikari!\Uroko-sama! response:	We must do everything we can.
context: Thank you.\I'm not coming back, either.\Apparently everyone in the family is stubborn.\Good grief.\Akari!\Hikari!\Uroko-sama!\We must do everything we can. response:	Why not give up?
context: I'm not coming back, either.\Apparently everyone in the family is stubborn.\Good grief.\Akari!\Hikari!\Uroko-sama!\We must do everything we can.\Why not give up? response:	No good will come of you going up to the surface.
context: Apparently everyone in the family is stubborn.\Good grief.\Akari!\Hikari!\Uroko-sama!\We must do everything we can.\Why not give up?\No good will come of you going up to the surface. response:	There will!
context: Good grief.\Akari!\Hikari!\Uroko-sama!\We must do everything we can.\Why not give up?\No good will come of you going up to the surface.\There will! response:	There's someone up there who's waiting for me!
context: Akari!\Hikari!\Uroko-sama!\We must do everything we can.\Why not give up?\No good will come of you going up to the surface.\There will!\There's someone up there who's waiting for me! response:	Uroko-sama! Why are you trying to stop us?!
context: Hikari!\Uroko-sama!\We must do everything we can.\Why not give up?\No good will come of you going up to the surface.\There will!\There's someone up there who's waiting for me!\Uroko-sama! Why are you trying to stop us?! response:	Because of a promise.
context: Uroko-sama!\We must do everything we can.\Why not give up?\No good will come of you going up to the surface.\There will!\There's someone up there who's waiting for me!\Uroko-sama! Why are you trying to stop us?!\Because of a promise. response:	A promise?
context: We must do everything we can.\Why not give up?\No good will come of you going up to the surface.\There will!\There's someone up there who's waiting for me!\Uroko-sama! Why are you trying to stop us?!\Because of a promise.\A promise? response:	I have to protect you both...
context: Why not give up?\No good will come of you going up to the surface.\There will!\There's someone up there who's waiting for me!\Uroko-sama! Why are you trying to stop us?!\Because of a promise.\A promise?\I have to protect you both... response:	as you are his descendants.
context: No good will come of you going up to the surface.\There will!\There's someone up there who's waiting for me!\Uroko-sama! Why are you trying to stop us?!\Because of a promise.\A promise?\I have to protect you both...\as you are his descendants. response:	Damn it!
context: There will!\There's someone up there who's waiting for me!\Uroko-sama! Why are you trying to stop us?!\Because of a promise.\A promise?\I have to protect you both...\as you are his descendants.\Damn it! response:	You leave me no choice.
context: There's someone up there who's waiting for me!\Uroko-sama! Why are you trying to stop us?!\Because of a promise.\A promise?\I have to protect you both...\as you are his descendants.\Damn it!\You leave me no choice. response:	What?
context: Uroko-sama! Why are you trying to stop us?!\Because of a promise.\A promise?\I have to protect you both...\as you are his descendants.\Damn it!\You leave me no choice.\What? response:	The water temperature suddenly...
context: Because of a promise.\A promise?\I have to protect you both...\as you are his descendants.\Damn it!\You leave me no choice.\What?\The water temperature suddenly... response:	This isn't good...
context: A promise?\I have to protect you both...\as you are his descendants.\Damn it!\You leave me no choice.\What?\The water temperature suddenly...\This isn't good... response:	At this rate, we'll freeze...
context: I have to protect you both...\as you are his descendants.\Damn it!\You leave me no choice.\What?\The water temperature suddenly...\This isn't good...\At this rate, we'll freeze... response:	Like hell I'm going to give up!
context: as you are his descendants.\Damn it!\You leave me no choice.\What?\The water temperature suddenly...\This isn't good...\At this rate, we'll freeze...\Like hell I'm going to give up! response:	I don't want to be... forced into the flow anymore.
context: Damn it!\You leave me no choice.\What?\The water temperature suddenly...\This isn't good...\At this rate, we'll freeze...\Like hell I'm going to give up!\I don't want to be... forced into the flow anymore. response:	Well, well, they're definitely giving it their all.
context: You leave me no choice.\What?\The water temperature suddenly...\This isn't good...\At this rate, we'll freeze...\Like hell I'm going to give up!\I don't want to be... forced into the flow anymore.\Well, well, they're definitely giving it their all. response:	Uroko-sama!
context: What?\The water temperature suddenly...\This isn't good...\At this rate, we'll freeze...\Like hell I'm going to give up!\I don't want to be... forced into the flow anymore.\Well, well, they're definitely giving it their all.\Uroko-sama! response:	Show some mercy... Please.
context: The water temperature suddenly...\This isn't good...\At this rate, we'll freeze...\Like hell I'm going to give up!\I don't want to be... forced into the flow anymore.\Well, well, they're definitely giving it their all.\Uroko-sama!\Show some mercy... Please. response:	Akari, now!
context: This isn't good...\At this rate, we'll freeze...\Like hell I'm going to give up!\I don't want to be... forced into the flow anymore.\Well, well, they're definitely giving it their all.\Uroko-sama!\Show some mercy... Please.\Akari, now! response:	R-Right!
context: At this rate, we'll freeze...\Like hell I'm going to give up!\I don't want to be... forced into the flow anymore.\Well, well, they're definitely giving it their all.\Uroko-sama!\Show some mercy... Please.\Akari, now!\R-Right! response:	Are you certain?
context: Like hell I'm going to give up!\I don't want to be... forced into the flow anymore.\Well, well, they're definitely giving it their all.\Uroko-sama!\Show some mercy... Please.\Akari, now!\R-Right!\Are you certain? response:	I want a shell from the sea that I love.
context: I don't want to be... forced into the flow anymore.\Well, well, they're definitely giving it their all.\Uroko-sama!\Show some mercy... Please.\Akari, now!\R-Right!\Are you certain?\I want a shell from the sea that I love. response:	I don't want you to go through the same thing, Akari.
context: Well, well, they're definitely giving it their all.\Uroko-sama!\Show some mercy... Please.\Akari, now!\R-Right!\Are you certain?\I want a shell from the sea that I love.\I don't want you to go through the same thing, Akari. response:	I don't care if I can't go back to the sea.
context: Uroko-sama!\Show some mercy... Please.\Akari, now!\R-Right!\Are you certain?\I want a shell from the sea that I love.\I don't want you to go through the same thing, Akari.\I don't care if I can't go back to the sea. response:	What's wrong with those two being together?
context: Show some mercy... Please.\Akari, now!\R-Right!\Are you certain?\I want a shell from the sea that I love.\I don't want you to go through the same thing, Akari.\I don't care if I can't go back to the sea.\What's wrong with those two being together? response:	Episode Eight: Beyond the Wavering Feelings