context: I'm back, Gramps! response:	Is the bath water hot?
context: I'm back, Gramps!\Is the bath water hot? response:	I have to hurry or I'll be late!
context: I'm back, Gramps!\Is the bath water hot?\I have to hurry or I'll be late! response:	Is it so serious that she can't have visitors?
context: I'm back, Gramps!\Is the bath water hot?\I have to hurry or I'll be late!\Is it so serious that she can't have visitors? response:	That voice...
context: I'm back, Gramps!\Is the bath water hot?\I have to hurry or I'll be late!\Is it so serious that she can't have visitors?\That voice... response:	Yes... Kagome is laid up in bed.
context: I'm back, Gramps!\Is the bath water hot?\I have to hurry or I'll be late!\Is it so serious that she can't have visitors?\That voice...\Yes... Kagome is laid up in bed. response:	I see.
context: I'm back, Gramps!\Is the bath water hot?\I have to hurry or I'll be late!\Is it so serious that she can't have visitors?\That voice...\Yes... Kagome is laid up in bed.\I see. response:	Err... This is a hot compress for Kagome...
context: I'm back, Gramps!\Is the bath water hot?\I have to hurry or I'll be late!\Is it so serious that she can't have visitors?\That voice...\Yes... Kagome is laid up in bed.\I see.\Err... This is a hot compress for Kagome... response:	Oh, you're so thoughtful!
context: Is the bath water hot?\I have to hurry or I'll be late!\Is it so serious that she can't have visitors?\That voice...\Yes... Kagome is laid up in bed.\I see.\Err... This is a hot compress for Kagome...\Oh, you're so thoughtful! response:	My... I mean, her neuralgia will get much better with this.
context: I have to hurry or I'll be late!\Is it so serious that she can't have visitors?\That voice...\Yes... Kagome is laid up in bed.\I see.\Err... This is a hot compress for Kagome...\Oh, you're so thoughtful!\My... I mean, her neuralgia will get much better with this. response:	I'll be going then.
context: Is it so serious that she can't have visitors?\That voice...\Yes... Kagome is laid up in bed.\I see.\Err... This is a hot compress for Kagome...\Oh, you're so thoughtful!\My... I mean, her neuralgia will get much better with this.\I'll be going then. response:	Okay, take care.
context: That voice...\Yes... Kagome is laid up in bed.\I see.\Err... This is a hot compress for Kagome...\Oh, you're so thoughtful!\My... I mean, her neuralgia will get much better with this.\I'll be going then.\Okay, take care. response:	Who has neuralgia?
context: Yes... Kagome is laid up in bed.\I see.\Err... This is a hot compress for Kagome...\Oh, you're so thoughtful!\My... I mean, her neuralgia will get much better with this.\I'll be going then.\Okay, take care.\Who has neuralgia? response:	Oh, Kagome! Be happy!
context: I see.\Err... This is a hot compress for Kagome...\Oh, you're so thoughtful!\My... I mean, her neuralgia will get much better with this.\I'll be going then.\Okay, take care.\Who has neuralgia?\Oh, Kagome! Be happy! response:	You're supposed to be disposed today, so you can miss school.
context: Err... This is a hot compress for Kagome...\Oh, you're so thoughtful!\My... I mean, her neuralgia will get much better with this.\I'll be going then.\Okay, take care.\Who has neuralgia?\Oh, Kagome! Be happy!\You're supposed to be disposed today, so you can miss school. response:	What are you saying?! I WANT to go to school desperately!
context: Oh, you're so thoughtful!\My... I mean, her neuralgia will get much better with this.\I'll be going then.\Okay, take care.\Who has neuralgia?\Oh, Kagome! Be happy!\You're supposed to be disposed today, so you can miss school.\What are you saying?! I WANT to go to school desperately! response:	You're a strange one.
context: My... I mean, her neuralgia will get much better with this.\I'll be going then.\Okay, take care.\Who has neuralgia?\Oh, Kagome! Be happy!\You're supposed to be disposed today, so you can miss school.\What are you saying?! I WANT to go to school desperately!\You're a strange one. response:	Only my family knows of my jaunts through the hidden well...
context: I'll be going then.\Okay, take care.\Who has neuralgia?\Oh, Kagome! Be happy!\You're supposed to be disposed today, so you can miss school.\What are you saying?! I WANT to go to school desperately!\You're a strange one.\Only my family knows of my jaunts through the hidden well... response:	into the Feudal States Era.
context: Okay, take care.\Who has neuralgia?\Oh, Kagome! Be happy!\You're supposed to be disposed today, so you can miss school.\What are you saying?! I WANT to go to school desperately!\You're a strange one.\Only my family knows of my jaunts through the hidden well...\into the Feudal States Era. response:	Besides, I doubt that anyone else would believe me if I told them.
context: Who has neuralgia?\Oh, Kagome! Be happy!\You're supposed to be disposed today, so you can miss school.\What are you saying?! I WANT to go to school desperately!\You're a strange one.\Only my family knows of my jaunts through the hidden well...\into the Feudal States Era.\Besides, I doubt that anyone else would believe me if I told them. response:	Huh? You're going to take the math supplement course, too?
context: Oh, Kagome! Be happy!\You're supposed to be disposed today, so you can miss school.\What are you saying?! I WANT to go to school desperately!\You're a strange one.\Only my family knows of my jaunts through the hidden well...\into the Feudal States Era.\Besides, I doubt that anyone else would believe me if I told them.\Huh? You're going to take the math supplement course, too? response:	Teacher told me to.
context: You're supposed to be disposed today, so you can miss school.\What are you saying?! I WANT to go to school desperately!\You're a strange one.\Only my family knows of my jaunts through the hidden well...\into the Feudal States Era.\Besides, I doubt that anyone else would believe me if I told them.\Huh? You're going to take the math supplement course, too?\Teacher told me to. response:	We're used to it, but it's a shock to hear that you need it, too.
context: What are you saying?! I WANT to go to school desperately!\You're a strange one.\Only my family knows of my jaunts through the hidden well...\into the Feudal States Era.\Besides, I doubt that anyone else would believe me if I told them.\Huh? You're going to take the math supplement course, too?\Teacher told me to.\We're used to it, but it's a shock to hear that you need it, too. response:	The high school Hojo is applying to is very difficult to get into.
context: You're a strange one.\Only my family knows of my jaunts through the hidden well...\into the Feudal States Era.\Besides, I doubt that anyone else would believe me if I told them.\Huh? You're going to take the math supplement course, too?\Teacher told me to.\We're used to it, but it's a shock to hear that you need it, too.\The high school Hojo is applying to is very difficult to get into. response:	What? Don't tell me you're seeing Hojo, Kagome?!
context: Only my family knows of my jaunts through the hidden well...\into the Feudal States Era.\Besides, I doubt that anyone else would believe me if I told them.\Huh? You're going to take the math supplement course, too?\Teacher told me to.\We're used to it, but it's a shock to hear that you need it, too.\The high school Hojo is applying to is very difficult to get into.\What? Don't tell me you're seeing Hojo, Kagome?! response:	Stop it! Who has time to go out with boys?!
context: into the Feudal States Era.\Besides, I doubt that anyone else would believe me if I told them.\Huh? You're going to take the math supplement course, too?\Teacher told me to.\We're used to it, but it's a shock to hear that you need it, too.\The high school Hojo is applying to is very difficult to get into.\What? Don't tell me you're seeing Hojo, Kagome?!\Stop it! Who has time to go out with boys?! response:	That's not something you want to brag about.
context: Besides, I doubt that anyone else would believe me if I told them.\Huh? You're going to take the math supplement course, too?\Teacher told me to.\We're used to it, but it's a shock to hear that you need it, too.\The high school Hojo is applying to is very difficult to get into.\What? Don't tell me you're seeing Hojo, Kagome?!\Stop it! Who has time to go out with boys?!\That's not something you want to brag about. response:	Err... Well...
context: Huh? You're going to take the math supplement course, too?\Teacher told me to.\We're used to it, but it's a shock to hear that you need it, too.\The high school Hojo is applying to is very difficult to get into.\What? Don't tell me you're seeing Hojo, Kagome?!\Stop it! Who has time to go out with boys?!\That's not something you want to brag about.\Err... Well... response:	Gee, I don't even know if I'll be able to get into high school!
context: Teacher told me to.\We're used to it, but it's a shock to hear that you need it, too.\The high school Hojo is applying to is very difficult to get into.\What? Don't tell me you're seeing Hojo, Kagome?!\Stop it! Who has time to go out with boys?!\That's not something you want to brag about.\Err... Well...\Gee, I don't even know if I'll be able to get into high school! response:	Not with a life like this!
context: We're used to it, but it's a shock to hear that you need it, too.\The high school Hojo is applying to is very difficult to get into.\What? Don't tell me you're seeing Hojo, Kagome?!\Stop it! Who has time to go out with boys?!\That's not something you want to brag about.\Err... Well...\Gee, I don't even know if I'll be able to get into high school!\Not with a life like this! response:	Oh, look! Fireworks!
context: The high school Hojo is applying to is very difficult to get into.\What? Don't tell me you're seeing Hojo, Kagome?!\Stop it! Who has time to go out with boys?!\That's not something you want to brag about.\Err... Well...\Gee, I don't even know if I'll be able to get into high school!\Not with a life like this!\Oh, look! Fireworks! response:	So pretty!
context: What? Don't tell me you're seeing Hojo, Kagome?!\Stop it! Who has time to go out with boys?!\That's not something you want to brag about.\Err... Well...\Gee, I don't even know if I'll be able to get into high school!\Not with a life like this!\Oh, look! Fireworks!\So pretty! response:	It looks like fun!
context: Stop it! Who has time to go out with boys?!\That's not something you want to brag about.\Err... Well...\Gee, I don't even know if I'll be able to get into high school!\Not with a life like this!\Oh, look! Fireworks!\So pretty!\It looks like fun! response:	Huh?
context: That's not something you want to brag about.\Err... Well...\Gee, I don't even know if I'll be able to get into high school!\Not with a life like this!\Oh, look! Fireworks!\So pretty!\It looks like fun!\Huh? response:	Ha-ha-ha! Serves them right!
context: Err... Well...\Gee, I don't even know if I'll be able to get into high school!\Not with a life like this!\Oh, look! Fireworks!\So pretty!\It looks like fun!\Huh?\Ha-ha-ha! Serves them right! response:	That girl!
context: Gee, I don't even know if I'll be able to get into high school!\Not with a life like this!\Oh, look! Fireworks!\So pretty!\It looks like fun!\Huh?\Ha-ha-ha! Serves them right!\That girl! response:	Hold it!
context: Not with a life like this!\Oh, look! Fireworks!\So pretty!\It looks like fun!\Huh?\Ha-ha-ha! Serves them right!\That girl!\Hold it! response:	What did you do that for?!
context: Oh, look! Fireworks!\So pretty!\It looks like fun!\Huh?\Ha-ha-ha! Serves them right!\That girl!\Hold it!\What did you do that for?! response:	You... You can see me?
context: So pretty!\It looks like fun!\Huh?\Ha-ha-ha! Serves them right!\That girl!\Hold it!\What did you do that for?!\You... You can see me? response:	Who is this girl?
context: It looks like fun!\Huh?\Ha-ha-ha! Serves them right!\That girl!\Hold it!\What did you do that for?!\You... You can see me?\Who is this girl? response:	Where're her shoes?
context: Huh?\Ha-ha-ha! Serves them right!\That girl!\Hold it!\What did you do that for?!\You... You can see me?\Who is this girl?\Where're her shoes? response:	And a down jacket... when it's almost summer?
context: Ha-ha-ha! Serves them right!\That girl!\Hold it!\What did you do that for?!\You... You can see me?\Who is this girl?\Where're her shoes?\And a down jacket... when it's almost summer? response:	Let's go apologize. I'll go with you.
context: That girl!\Hold it!\What did you do that for?!\You... You can see me?\Who is this girl?\Where're her shoes?\And a down jacket... when it's almost summer?\Let's go apologize. I'll go with you. response:	None of your business!
context: Hold it!\What did you do that for?!\You... You can see me?\Who is this girl?\Where're her shoes?\And a down jacket... when it's almost summer?\Let's go apologize. I'll go with you.\None of your business! response:	What's the matter, Kagome?
context: What did you do that for?!\You... You can see me?\Who is this girl?\Where're her shoes?\And a down jacket... when it's almost summer?\Let's go apologize. I'll go with you.\None of your business!\What's the matter, Kagome? response:	Who were you talking to?
context: You... You can see me?\Who is this girl?\Where're her shoes?\And a down jacket... when it's almost summer?\Let's go apologize. I'll go with you.\None of your business!\What's the matter, Kagome?\Who were you talking to? response:	Huh?!
context: Who is this girl?\Where're her shoes?\And a down jacket... when it's almost summer?\Let's go apologize. I'll go with you.\None of your business!\What's the matter, Kagome?\Who were you talking to?\Huh?! response:	Gone... Who was she?
context: Where're her shoes?\And a down jacket... when it's almost summer?\Let's go apologize. I'll go with you.\None of your business!\What's the matter, Kagome?\Who were you talking to?\Huh?!\Gone... Who was she? response:	Myoga, isn't it finished?
context: And a down jacket... when it's almost summer?\Let's go apologize. I'll go with you.\None of your business!\What's the matter, Kagome?\Who were you talking to?\Huh?!\Gone... Who was she?\Myoga, isn't it finished? response:	Not yet.
context: Let's go apologize. I'll go with you.\None of your business!\What's the matter, Kagome?\Who were you talking to?\Huh?!\Gone... Who was she?\Myoga, isn't it finished?\Not yet. response:	Master Inuyasha, if you go out now, you'll be stung to death.
context: None of your business!\What's the matter, Kagome?\Who were you talking to?\Huh?!\Gone... Who was she?\Myoga, isn't it finished?\Not yet.\Master Inuyasha, if you go out now, you'll be stung to death. response:	That sheathe was cracked battling the Thunder Brothers.
context: What's the matter, Kagome?\Who were you talking to?\Huh?!\Gone... Who was she?\Myoga, isn't it finished?\Not yet.\Master Inuyasha, if you go out now, you'll be stung to death.\That sheathe was cracked battling the Thunder Brothers. response:	Let the steel wasps repair it with their special wax.
context: Who were you talking to?\Huh?!\Gone... Who was she?\Myoga, isn't it finished?\Not yet.\Master Inuyasha, if you go out now, you'll be stung to death.\That sheathe was cracked battling the Thunder Brothers.\Let the steel wasps repair it with their special wax. response:	Dang it... It's boring!
context: Huh?!\Gone... Who was she?\Myoga, isn't it finished?\Not yet.\Master Inuyasha, if you go out now, you'll be stung to death.\That sheathe was cracked battling the Thunder Brothers.\Let the steel wasps repair it with their special wax.\Dang it... It's boring! response:	Shut up!
context: Gone... Who was she?\Myoga, isn't it finished?\Not yet.\Master Inuyasha, if you go out now, you'll be stung to death.\That sheathe was cracked battling the Thunder Brothers.\Let the steel wasps repair it with their special wax.\Dang it... It's boring!\Shut up! response:	I came along because I thought Kagome would be here!
context: Myoga, isn't it finished?\Not yet.\Master Inuyasha, if you go out now, you'll be stung to death.\That sheathe was cracked battling the Thunder Brothers.\Let the steel wasps repair it with their special wax.\Dang it... It's boring!\Shut up!\I came along because I thought Kagome would be here! response:	Why must I be stuck alone with you?!
context: Not yet.\Master Inuyasha, if you go out now, you'll be stung to death.\That sheathe was cracked battling the Thunder Brothers.\Let the steel wasps repair it with their special wax.\Dang it... It's boring!\Shut up!\I came along because I thought Kagome would be here!\Why must I be stuck alone with you?! response:	That's my line!
context: Master Inuyasha, if you go out now, you'll be stung to death.\That sheathe was cracked battling the Thunder Brothers.\Let the steel wasps repair it with their special wax.\Dang it... It's boring!\Shut up!\I came along because I thought Kagome would be here!\Why must I be stuck alone with you?!\That's my line! response:	Arghh... Why am I alone with you?!
context: That sheathe was cracked battling the Thunder Brothers.\Let the steel wasps repair it with their special wax.\Dang it... It's boring!\Shut up!\I came along because I thought Kagome would be here!\Why must I be stuck alone with you?!\That's my line!\Arghh... Why am I alone with you?! response:	Don't I count at all?
context: Let the steel wasps repair it with their special wax.\Dang it... It's boring!\Shut up!\I came along because I thought Kagome would be here!\Why must I be stuck alone with you?!\That's my line!\Arghh... Why am I alone with you?!\Don't I count at all? response:	Huh?
context: Dang it... It's boring!\Shut up!\I came along because I thought Kagome would be here!\Why must I be stuck alone with you?!\That's my line!\Arghh... Why am I alone with you?!\Don't I count at all?\Huh? response:	That's...
context: Shut up!\I came along because I thought Kagome would be here!\Why must I be stuck alone with you?!\That's my line!\Arghh... Why am I alone with you?!\Don't I count at all?\Huh?\That's... response:	A goblin!
context: I came along because I thought Kagome would be here!\Why must I be stuck alone with you?!\That's my line!\Arghh... Why am I alone with you?!\Don't I count at all?\Huh?\That's...\A goblin! response:	Shippo... So are you!
context: Why must I be stuck alone with you?!\That's my line!\Arghh... Why am I alone with you?!\Don't I count at all?\Huh?\That's...\A goblin!\Shippo... So are you! response:	That's the Soul Piper.
context: That's my line!\Arghh... Why am I alone with you?!\Don't I count at all?\Huh?\That's...\A goblin!\Shippo... So are you!\That's the Soul Piper. response:	It was born from the souls of departed children.
context: Arghh... Why am I alone with you?!\Don't I count at all?\Huh?\That's...\A goblin!\Shippo... So are you!\That's the Soul Piper.\It was born from the souls of departed children. response:	When a child dies, the Soul Piper plays with that child...
context: Don't I count at all?\Huh?\That's...\A goblin!\Shippo... So are you!\That's the Soul Piper.\It was born from the souls of departed children.\When a child dies, the Soul Piper plays with that child... response:	until the soul is able to rest in peace.
context: Huh?\That's...\A goblin!\Shippo... So are you!\That's the Soul Piper.\It was born from the souls of departed children.\When a child dies, the Soul Piper plays with that child...\until the soul is able to rest in peace. response:	As long as its eyes are closed, it's a peaceful demon.
context: That's...\A goblin!\Shippo... So are you!\That's the Soul Piper.\It was born from the souls of departed children.\When a child dies, the Soul Piper plays with that child...\until the soul is able to rest in peace.\As long as its eyes are closed, it's a peaceful demon. response:	What?! Not when I've come back to this world!
context: A goblin!\Shippo... So are you!\That's the Soul Piper.\It was born from the souls of departed children.\When a child dies, the Soul Piper plays with that child...\until the soul is able to rest in peace.\As long as its eyes are closed, it's a peaceful demon.\What?! Not when I've come back to this world! response:	Jeepers! Why do I have to accompany you...
context: Shippo... So are you!\That's the Soul Piper.\It was born from the souls of departed children.\When a child dies, the Soul Piper plays with that child...\until the soul is able to rest in peace.\As long as its eyes are closed, it's a peaceful demon.\What?! Not when I've come back to this world!\Jeepers! Why do I have to accompany you... response:	to visit YOUR friend in the hospital?!
context: That's the Soul Piper.\It was born from the souls of departed children.\When a child dies, the Soul Piper plays with that child...\until the soul is able to rest in peace.\As long as its eyes are closed, it's a peaceful demon.\What?! Not when I've come back to this world!\Jeepers! Why do I have to accompany you...\to visit YOUR friend in the hospital?! response:	Because the hospital's in the next town...
context: It was born from the souls of departed children.\When a child dies, the Soul Piper plays with that child...\until the soul is able to rest in peace.\As long as its eyes are closed, it's a peaceful demon.\What?! Not when I've come back to this world!\Jeepers! Why do I have to accompany you...\to visit YOUR friend in the hospital?!\Because the hospital's in the next town... response:	and Mom's too busy to take me today.
context: When a child dies, the Soul Piper plays with that child...\until the soul is able to rest in peace.\As long as its eyes are closed, it's a peaceful demon.\What?! Not when I've come back to this world!\Jeepers! Why do I have to accompany you...\to visit YOUR friend in the hospital?!\Because the hospital's in the next town...\and Mom's too busy to take me today. response:	Cripes! Everyone's interfering with my studies!
context: until the soul is able to rest in peace.\As long as its eyes are closed, it's a peaceful demon.\What?! Not when I've come back to this world!\Jeepers! Why do I have to accompany you...\to visit YOUR friend in the hospital?!\Because the hospital's in the next town...\and Mom's too busy to take me today.\Cripes! Everyone's interfering with my studies! response:	Sis...
context: As long as its eyes are closed, it's a peaceful demon.\What?! Not when I've come back to this world!\Jeepers! Why do I have to accompany you...\to visit YOUR friend in the hospital?!\Because the hospital's in the next town...\and Mom's too busy to take me today.\Cripes! Everyone's interfering with my studies!\Sis... response:	What?
context: What?! Not when I've come back to this world!\Jeepers! Why do I have to accompany you...\to visit YOUR friend in the hospital?!\Because the hospital's in the next town...\and Mom's too busy to take me today.\Cripes! Everyone's interfering with my studies!\Sis...\What? response:	Is there such a thing as an evil spirit?
context: Jeepers! Why do I have to accompany you...\to visit YOUR friend in the hospital?!\Because the hospital's in the next town...\and Mom's too busy to take me today.\Cripes! Everyone's interfering with my studies!\Sis...\What?\Is there such a thing as an evil spirit? response:	Huh?
context: to visit YOUR friend in the hospital?!\Because the hospital's in the next town...\and Mom's too busy to take me today.\Cripes! Everyone's interfering with my studies!\Sis...\What?\Is there such a thing as an evil spirit?\Huh? response:	Sota, thank you for coming so often.
context: Because the hospital's in the next town...\and Mom's too busy to take me today.\Cripes! Everyone's interfering with my studies!\Sis...\What?\Is there such a thing as an evil spirit?\Huh?\Sota, thank you for coming so often. response:	Aunty, how is Satoru?
context: and Mom's too busy to take me today.\Cripes! Everyone's interfering with my studies!\Sis...\What?\Is there such a thing as an evil spirit?\Huh?\Sota, thank you for coming so often.\Aunty, how is Satoru? response:	Physically, he's healed.
context: Cripes! Everyone's interfering with my studies!\Sis...\What?\Is there such a thing as an evil spirit?\Huh?\Sota, thank you for coming so often.\Aunty, how is Satoru?\Physically, he's healed. response:	But he's still unconscious.
context: Sis...\What?\Is there such a thing as an evil spirit?\Huh?\Sota, thank you for coming so often.\Aunty, how is Satoru?\Physically, he's healed.\But he's still unconscious. response:	Here...
context: What?\Is there such a thing as an evil spirit?\Huh?\Sota, thank you for coming so often.\Aunty, how is Satoru?\Physically, he's healed.\But he's still unconscious.\Here... response:	Thank you so much for worrying about Satoru.
context: Is there such a thing as an evil spirit?\Huh?\Sota, thank you for coming so often.\Aunty, how is Satoru?\Physically, he's healed.\But he's still unconscious.\Here...\Thank you so much for worrying about Satoru. response:	Burn scars?
context: Huh?\Sota, thank you for coming so often.\Aunty, how is Satoru?\Physically, he's healed.\But he's still unconscious.\Here...\Thank you so much for worrying about Satoru.\Burn scars? response:	Oh these...
context: Sota, thank you for coming so often.\Aunty, how is Satoru?\Physically, he's healed.\But he's still unconscious.\Here...\Thank you so much for worrying about Satoru.\Burn scars?\Oh these... response:	I got them from the fire six months ago.
context: Aunty, how is Satoru?\Physically, he's healed.\But he's still unconscious.\Here...\Thank you so much for worrying about Satoru.\Burn scars?\Oh these...\I got them from the fire six months ago. response:	Oh, I'm sorry!
context: Physically, he's healed.\But he's still unconscious.\Here...\Thank you so much for worrying about Satoru.\Burn scars?\Oh these...\I got them from the fire six months ago.\Oh, I'm sorry! response:	That's how Satoru...
context: But he's still unconscious.\Here...\Thank you so much for worrying about Satoru.\Burn scars?\Oh these...\I got them from the fire six months ago.\Oh, I'm sorry!\That's how Satoru... response:	Huh?!
context: Here...\Thank you so much for worrying about Satoru.\Burn scars?\Oh these...\I got them from the fire six months ago.\Oh, I'm sorry!\That's how Satoru...\Huh?! response:	The girl at the park...!
context: Thank you so much for worrying about Satoru.\Burn scars?\Oh these...\I got them from the fire six months ago.\Oh, I'm sorry!\That's how Satoru...\Huh?!\The girl at the park...! response:	She disappeared!
context: Burn scars?\Oh these...\I got them from the fire six months ago.\Oh, I'm sorry!\That's how Satoru...\Huh?!\The girl at the park...!\She disappeared! response:	Again... Why must this happen?
context: Oh these...\I got them from the fire six months ago.\Oh, I'm sorry!\That's how Satoru...\Huh?!\The girl at the park...!\She disappeared!\Again... Why must this happen? response:	Who is she anyway?
context: I got them from the fire six months ago.\Oh, I'm sorry!\That's how Satoru...\Huh?!\The girl at the park...!\She disappeared!\Again... Why must this happen?\Who is she anyway? response:	I can't ignore this.
context: Oh, I'm sorry!\That's how Satoru...\Huh?!\The girl at the park...!\She disappeared!\Again... Why must this happen?\Who is she anyway?\I can't ignore this. response:	Darn, foiled again!
context: That's how Satoru...\Huh?!\The girl at the park...!\She disappeared!\Again... Why must this happen?\Who is she anyway?\I can't ignore this.\Darn, foiled again! response:	You mentioned an evil spirit. What did you mean, Sota?
context: Huh?!\The girl at the park...!\She disappeared!\Again... Why must this happen?\Who is she anyway?\I can't ignore this.\Darn, foiled again!\You mentioned an evil spirit. What did you mean, Sota? response:	I thought maybe an evil spirit was after Satoru...
context: The girl at the park...!\She disappeared!\Again... Why must this happen?\Who is she anyway?\I can't ignore this.\Darn, foiled again!\You mentioned an evil spirit. What did you mean, Sota?\I thought maybe an evil spirit was after Satoru... response:	Satoru has been in a coma since the fire six months ago.
context: She disappeared!\Again... Why must this happen?\Who is she anyway?\I can't ignore this.\Darn, foiled again!\You mentioned an evil spirit. What did you mean, Sota?\I thought maybe an evil spirit was after Satoru...\Satoru has been in a coma since the fire six months ago. response:	At first, all my classmates went to visit him at the hospital.
context: Again... Why must this happen?\Who is she anyway?\I can't ignore this.\Darn, foiled again!\You mentioned an evil spirit. What did you mean, Sota?\I thought maybe an evil spirit was after Satoru...\Satoru has been in a coma since the fire six months ago.\At first, all my classmates went to visit him at the hospital. response:	But...
context: Who is she anyway?\I can't ignore this.\Darn, foiled again!\You mentioned an evil spirit. What did you mean, Sota?\I thought maybe an evil spirit was after Satoru...\Satoru has been in a coma since the fire six months ago.\At first, all my classmates went to visit him at the hospital.\But... response:	weird things happened on their way home...
context: I can't ignore this.\Darn, foiled again!\You mentioned an evil spirit. What did you mean, Sota?\I thought maybe an evil spirit was after Satoru...\Satoru has been in a coma since the fire six months ago.\At first, all my classmates went to visit him at the hospital.\But...\weird things happened on their way home... response:	like falling down the stairs...
context: Darn, foiled again!\You mentioned an evil spirit. What did you mean, Sota?\I thought maybe an evil spirit was after Satoru...\Satoru has been in a coma since the fire six months ago.\At first, all my classmates went to visit him at the hospital.\But...\weird things happened on their way home...\like falling down the stairs... response:	or barely missing getting hit by a car...
context: You mentioned an evil spirit. What did you mean, Sota?\I thought maybe an evil spirit was after Satoru...\Satoru has been in a coma since the fire six months ago.\At first, all my classmates went to visit him at the hospital.\But...\weird things happened on their way home...\like falling down the stairs...\or barely missing getting hit by a car... response:	After these things kept happening, the kids stayed away.
context: I thought maybe an evil spirit was after Satoru...\Satoru has been in a coma since the fire six months ago.\At first, all my classmates went to visit him at the hospital.\But...\weird things happened on their way home...\like falling down the stairs...\or barely missing getting hit by a car...\After these things kept happening, the kids stayed away. response:	In that fire six months ago, she died...
context: Satoru has been in a coma since the fire six months ago.\At first, all my classmates went to visit him at the hospital.\But...\weird things happened on their way home...\like falling down the stairs...\or barely missing getting hit by a car...\After these things kept happening, the kids stayed away.\In that fire six months ago, she died... response:	Satoru's older sister.
context: At first, all my classmates went to visit him at the hospital.\But...\weird things happened on their way home...\like falling down the stairs...\or barely missing getting hit by a car...\After these things kept happening, the kids stayed away.\In that fire six months ago, she died...\Satoru's older sister. response:	Her name was Mayu.
context: But...\weird things happened on their way home...\like falling down the stairs...\or barely missing getting hit by a car...\After these things kept happening, the kids stayed away.\In that fire six months ago, she died...\Satoru's older sister.\Her name was Mayu. response:	- Is that the place? - Uh-huh...
context: weird things happened on their way home...\like falling down the stairs...\or barely missing getting hit by a car...\After these things kept happening, the kids stayed away.\In that fire six months ago, she died...\Satoru's older sister.\Her name was Mayu.\- Is that the place? - Uh-huh... response:	Whenever they tried to clean up after the fire...
context: like falling down the stairs...\or barely missing getting hit by a car...\After these things kept happening, the kids stayed away.\In that fire six months ago, she died...\Satoru's older sister.\Her name was Mayu.\- Is that the place? - Uh-huh...\Whenever they tried to clean up after the fire... response:	an accident would happen.
context: or barely missing getting hit by a car...\After these things kept happening, the kids stayed away.\In that fire six months ago, she died...\Satoru's older sister.\Her name was Mayu.\- Is that the place? - Uh-huh...\Whenever they tried to clean up after the fire...\an accident would happen. response:	So it's been like that for six months now.
context: After these things kept happening, the kids stayed away.\In that fire six months ago, she died...\Satoru's older sister.\Her name was Mayu.\- Is that the place? - Uh-huh...\Whenever they tried to clean up after the fire...\an accident would happen.\So it's been like that for six months now. response:	Watch out!
context: In that fire six months ago, she died...\Satoru's older sister.\Her name was Mayu.\- Is that the place? - Uh-huh...\Whenever they tried to clean up after the fire...\an accident would happen.\So it's been like that for six months now.\Watch out! response:	I knew it! There is an evil spirit!?
context: Satoru's older sister.\Her name was Mayu.\- Is that the place? - Uh-huh...\Whenever they tried to clean up after the fire...\an accident would happen.\So it's been like that for six months now.\Watch out!\I knew it! There is an evil spirit!? response:	Sota!
context: Her name was Mayu.\- Is that the place? - Uh-huh...\Whenever they tried to clean up after the fire...\an accident would happen.\So it's been like that for six months now.\Watch out!\I knew it! There is an evil spirit!?\Sota! response:	Huh?! Watch out!
context: - Is that the place? - Uh-huh...\Whenever they tried to clean up after the fire...\an accident would happen.\So it's been like that for six months now.\Watch out!\I knew it! There is an evil spirit!?\Sota!\Huh?! Watch out! response:	Stupid! I'm already dead.
context: Whenever they tried to clean up after the fire...\an accident would happen.\So it's been like that for six months now.\Watch out!\I knew it! There is an evil spirit!?\Sota!\Huh?! Watch out!\Stupid! I'm already dead. response:	You're Mayu, aren't you?
context: an accident would happen.\So it's been like that for six months now.\Watch out!\I knew it! There is an evil spirit!?\Sota!\Huh?! Watch out!\Stupid! I'm already dead.\You're Mayu, aren't you? response:	Why do you do these things?
context: So it's been like that for six months now.\Watch out!\I knew it! There is an evil spirit!?\Sota!\Huh?! Watch out!\Stupid! I'm already dead.\You're Mayu, aren't you?\Why do you do these things? response:	Aren't you Satoru's sister?
context: Watch out!\I knew it! There is an evil spirit!?\Sota!\Huh?! Watch out!\Stupid! I'm already dead.\You're Mayu, aren't you?\Why do you do these things?\Aren't you Satoru's sister? response:	Satoru, ! I'll kill him!
context: I knew it! There is an evil spirit!?\Sota!\Huh?! Watch out!\Stupid! I'm already dead.\You're Mayu, aren't you?\Why do you do these things?\Aren't you Satoru's sister?\Satoru, ! I'll kill him! response:	Mom hated me!
context: Sota!\Huh?! Watch out!\Stupid! I'm already dead.\You're Mayu, aren't you?\Why do you do these things?\Aren't you Satoru's sister?\Satoru, ! I'll kill him!\Mom hated me! response:	That's why she abandoned me!
context: Huh?! Watch out!\Stupid! I'm already dead.\You're Mayu, aren't you?\Why do you do these things?\Aren't you Satoru's sister?\Satoru, ! I'll kill him!\Mom hated me!\That's why she abandoned me! response:	She never wanted me!
context: Stupid! I'm already dead.\You're Mayu, aren't you?\Why do you do these things?\Aren't you Satoru's sister?\Satoru, ! I'll kill him!\Mom hated me!\That's why she abandoned me!\She never wanted me! response:	Mayu... She seems so nice. Don't make her unhappy anymore.
context: You're Mayu, aren't you?\Why do you do these things?\Aren't you Satoru's sister?\Satoru, ! I'll kill him!\Mom hated me!\That's why she abandoned me!\She never wanted me!\Mayu... She seems so nice. Don't make her unhappy anymore. response:	Be quiet!
context: Why do you do these things?\Aren't you Satoru's sister?\Satoru, ! I'll kill him!\Mom hated me!\That's why she abandoned me!\She never wanted me!\Mayu... She seems so nice. Don't make her unhappy anymore.\Be quiet! response:	If you keep interfering, I'll kill you, too!
context: Aren't you Satoru's sister?\Satoru, ! I'll kill him!\Mom hated me!\That's why she abandoned me!\She never wanted me!\Mayu... She seems so nice. Don't make her unhappy anymore.\Be quiet!\If you keep interfering, I'll kill you, too! response:	Huh?!
context: Satoru, ! I'll kill him!\Mom hated me!\That's why she abandoned me!\She never wanted me!\Mayu... She seems so nice. Don't make her unhappy anymore.\Be quiet!\If you keep interfering, I'll kill you, too!\Huh?! response:	Huh?
context: Mom hated me!\That's why she abandoned me!\She never wanted me!\Mayu... She seems so nice. Don't make her unhappy anymore.\Be quiet!\If you keep interfering, I'll kill you, too!\Huh?!\Huh? response:	Until my eyes...
context: That's why she abandoned me!\She never wanted me!\Mayu... She seems so nice. Don't make her unhappy anymore.\Be quiet!\If you keep interfering, I'll kill you, too!\Huh?!\Huh?\Until my eyes... response:	are open?
context: She never wanted me!\Mayu... She seems so nice. Don't make her unhappy anymore.\Be quiet!\If you keep interfering, I'll kill you, too!\Huh?!\Huh?\Until my eyes...\are open? response:	Until my eyes are open? What does that mean?
context: Mayu... She seems so nice. Don't make her unhappy anymore.\Be quiet!\If you keep interfering, I'll kill you, too!\Huh?!\Huh?\Until my eyes...\are open?\Until my eyes are open? What does that mean? response:	So that demon is called the Soul Piper?
context: Be quiet!\If you keep interfering, I'll kill you, too!\Huh?!\Huh?\Until my eyes...\are open?\Until my eyes are open? What does that mean?\So that demon is called the Soul Piper? response:	Uh-huh... So you have it in your world, too?
context: If you keep interfering, I'll kill you, too!\Huh?!\Huh?\Until my eyes...\are open?\Until my eyes are open? What does that mean?\So that demon is called the Soul Piper?\Uh-huh... So you have it in your world, too? response:	It's supposed to console the souls of dead children.
context: Huh?!\Huh?\Until my eyes...\are open?\Until my eyes are open? What does that mean?\So that demon is called the Soul Piper?\Uh-huh... So you have it in your world, too?\It's supposed to console the souls of dead children. response:	It plays its flute until the souls find peace.
context: Huh?\Until my eyes...\are open?\Until my eyes are open? What does that mean?\So that demon is called the Soul Piper?\Uh-huh... So you have it in your world, too?\It's supposed to console the souls of dead children.\It plays its flute until the souls find peace. response:	And if the soul cannot find peace?
context: Until my eyes...\are open?\Until my eyes are open? What does that mean?\So that demon is called the Soul Piper?\Uh-huh... So you have it in your world, too?\It's supposed to console the souls of dead children.\It plays its flute until the souls find peace.\And if the soul cannot find peace? response:	If the soul has regrets or harbors a grudge...
context: are open?\Until my eyes are open? What does that mean?\So that demon is called the Soul Piper?\Uh-huh... So you have it in your world, too?\It's supposed to console the souls of dead children.\It plays its flute until the souls find peace.\And if the soul cannot find peace?\If the soul has regrets or harbors a grudge... response:	Then that spirit becomes an evil spirit.
context: Until my eyes are open? What does that mean?\So that demon is called the Soul Piper?\Uh-huh... So you have it in your world, too?\It's supposed to console the souls of dead children.\It plays its flute until the souls find peace.\And if the soul cannot find peace?\If the soul has regrets or harbors a grudge...\Then that spirit becomes an evil spirit. response:	Evil spirit?!
context: So that demon is called the Soul Piper?\Uh-huh... So you have it in your world, too?\It's supposed to console the souls of dead children.\It plays its flute until the souls find peace.\And if the soul cannot find peace?\If the soul has regrets or harbors a grudge...\Then that spirit becomes an evil spirit.\Evil spirit?! response:	When regrets turn to rage and hatred in a spirit...
context: Uh-huh... So you have it in your world, too?\It's supposed to console the souls of dead children.\It plays its flute until the souls find peace.\And if the soul cannot find peace?\If the soul has regrets or harbors a grudge...\Then that spirit becomes an evil spirit.\Evil spirit?!\When regrets turn to rage and hatred in a spirit... response:	it becomes evil.
context: It's supposed to console the souls of dead children.\It plays its flute until the souls find peace.\And if the soul cannot find peace?\If the soul has regrets or harbors a grudge...\Then that spirit becomes an evil spirit.\Evil spirit?!\When regrets turn to rage and hatred in a spirit...\it becomes evil. response:	Upon becoming an evil spirit...
context: It plays its flute until the souls find peace.\And if the soul cannot find peace?\If the soul has regrets or harbors a grudge...\Then that spirit becomes an evil spirit.\Evil spirit?!\When regrets turn to rage and hatred in a spirit...\it becomes evil.\Upon becoming an evil spirit... response:	the Soul Piper hurls it into the depths of hell.
context: And if the soul cannot find peace?\If the soul has regrets or harbors a grudge...\Then that spirit becomes an evil spirit.\Evil spirit?!\When regrets turn to rage and hatred in a spirit...\it becomes evil.\Upon becoming an evil spirit...\the Soul Piper hurls it into the depths of hell. response:	When the Soul Piper's eyes are fully open, it's too late.
context: If the soul has regrets or harbors a grudge...\Then that spirit becomes an evil spirit.\Evil spirit?!\When regrets turn to rage and hatred in a spirit...\it becomes evil.\Upon becoming an evil spirit...\the Soul Piper hurls it into the depths of hell.\When the Soul Piper's eyes are fully open, it's too late. response:	I won't allow that!
context: Then that spirit becomes an evil spirit.\Evil spirit?!\When regrets turn to rage and hatred in a spirit...\it becomes evil.\Upon becoming an evil spirit...\the Soul Piper hurls it into the depths of hell.\When the Soul Piper's eyes are fully open, it's too late.\I won't allow that! response:	Mayu must find peace!
context: Evil spirit?!\When regrets turn to rage and hatred in a spirit...\it becomes evil.\Upon becoming an evil spirit...\the Soul Piper hurls it into the depths of hell.\When the Soul Piper's eyes are fully open, it's too late.\I won't allow that!\Mayu must find peace! response:	Forget it, Kagome!
context: When regrets turn to rage and hatred in a spirit...\it becomes evil.\Upon becoming an evil spirit...\the Soul Piper hurls it into the depths of hell.\When the Soul Piper's eyes are fully open, it's too late.\I won't allow that!\Mayu must find peace!\Forget it, Kagome! response:	Ghosts are different from demons.
context: it becomes evil.\Upon becoming an evil spirit...\the Soul Piper hurls it into the depths of hell.\When the Soul Piper's eyes are fully open, it's too late.\I won't allow that!\Mayu must find peace!\Forget it, Kagome!\Ghosts are different from demons. response:	You can't just slay them.
context: Upon becoming an evil spirit...\the Soul Piper hurls it into the depths of hell.\When the Soul Piper's eyes are fully open, it's too late.\I won't allow that!\Mayu must find peace!\Forget it, Kagome!\Ghosts are different from demons.\You can't just slay them. response:	One misstep and you'll regret it.
context: the Soul Piper hurls it into the depths of hell.\When the Soul Piper's eyes are fully open, it's too late.\I won't allow that!\Mayu must find peace!\Forget it, Kagome!\Ghosts are different from demons.\You can't just slay them.\One misstep and you'll regret it. response:	But I can't ignore it!
context: When the Soul Piper's eyes are fully open, it's too late.\I won't allow that!\Mayu must find peace!\Forget it, Kagome!\Ghosts are different from demons.\You can't just slay them.\One misstep and you'll regret it.\But I can't ignore it! response:	I come from a shrine family!
context: I won't allow that!\Mayu must find peace!\Forget it, Kagome!\Ghosts are different from demons.\You can't just slay them.\One misstep and you'll regret it.\But I can't ignore it!\I come from a shrine family! response:	There must be something I can do!
context: Mayu must find peace!\Forget it, Kagome!\Ghosts are different from demons.\You can't just slay them.\One misstep and you'll regret it.\But I can't ignore it!\I come from a shrine family!\There must be something I can do! response:	Kagome is already gone. Fool!
context: Forget it, Kagome!\Ghosts are different from demons.\You can't just slay them.\One misstep and you'll regret it.\But I can't ignore it!\I come from a shrine family!\There must be something I can do!\Kagome is already gone. Fool! response:	I can't ignore her.
context: Ghosts are different from demons.\You can't just slay them.\One misstep and you'll regret it.\But I can't ignore it!\I come from a shrine family!\There must be something I can do!\Kagome is already gone. Fool!\I can't ignore her. response:	That girl has so much sadness in her.
context: You can't just slay them.\One misstep and you'll regret it.\But I can't ignore it!\I come from a shrine family!\There must be something I can do!\Kagome is already gone. Fool!\I can't ignore her.\That girl has so much sadness in her. response:	Mom, I want a cotton kimono with goldfish on it.
context: One misstep and you'll regret it.\But I can't ignore it!\I come from a shrine family!\There must be something I can do!\Kagome is already gone. Fool!\I can't ignore her.\That girl has so much sadness in her.\Mom, I want a cotton kimono with goldfish on it. response:	When the summer comes, I'll go to the fairs...
context: But I can't ignore it!\I come from a shrine family!\There must be something I can do!\Kagome is already gone. Fool!\I can't ignore her.\That girl has so much sadness in her.\Mom, I want a cotton kimono with goldfish on it.\When the summer comes, I'll go to the fairs... response:	and catch lots and lots of his goldfish friends.
context: I come from a shrine family!\There must be something I can do!\Kagome is already gone. Fool!\I can't ignore her.\That girl has so much sadness in her.\Mom, I want a cotton kimono with goldfish on it.\When the summer comes, I'll go to the fairs...\and catch lots and lots of his goldfish friends. response:	I want to wear my cotton kimono then.
context: There must be something I can do!\Kagome is already gone. Fool!\I can't ignore her.\That girl has so much sadness in her.\Mom, I want a cotton kimono with goldfish on it.\When the summer comes, I'll go to the fairs...\and catch lots and lots of his goldfish friends.\I want to wear my cotton kimono then. response:	Mayu, summer's a long ways off.
context: Kagome is already gone. Fool!\I can't ignore her.\That girl has so much sadness in her.\Mom, I want a cotton kimono with goldfish on it.\When the summer comes, I'll go to the fairs...\and catch lots and lots of his goldfish friends.\I want to wear my cotton kimono then.\Mayu, summer's a long ways off. response:	That's okay. Promise?
context: I can't ignore her.\That girl has so much sadness in her.\Mom, I want a cotton kimono with goldfish on it.\When the summer comes, I'll go to the fairs...\and catch lots and lots of his goldfish friends.\I want to wear my cotton kimono then.\Mayu, summer's a long ways off.\That's okay. Promise? response:	All right!
context: That girl has so much sadness in her.\Mom, I want a cotton kimono with goldfish on it.\When the summer comes, I'll go to the fairs...\and catch lots and lots of his goldfish friends.\I want to wear my cotton kimono then.\Mayu, summer's a long ways off.\That's okay. Promise?\All right! response:	When Mom leaves the hospital tonight...
context: Mom, I want a cotton kimono with goldfish on it.\When the summer comes, I'll go to the fairs...\and catch lots and lots of his goldfish friends.\I want to wear my cotton kimono then.\Mayu, summer's a long ways off.\That's okay. Promise?\All right!\When Mom leaves the hospital tonight... response:	I'm going to kill her dear, little Satoru.
context: When the summer comes, I'll go to the fairs...\and catch lots and lots of his goldfish friends.\I want to wear my cotton kimono then.\Mayu, summer's a long ways off.\That's okay. Promise?\All right!\When Mom leaves the hospital tonight...\I'm going to kill her dear, little Satoru. response:	You're going home now?
context: and catch lots and lots of his goldfish friends.\I want to wear my cotton kimono then.\Mayu, summer's a long ways off.\That's okay. Promise?\All right!\When Mom leaves the hospital tonight...\I'm going to kill her dear, little Satoru.\You're going home now? response:	Yes. I'll see you again tomorrow.
context: I want to wear my cotton kimono then.\Mayu, summer's a long ways off.\That's okay. Promise?\All right!\When Mom leaves the hospital tonight...\I'm going to kill her dear, little Satoru.\You're going home now?\Yes. I'll see you again tomorrow. response:	Take care.
context: Mayu, summer's a long ways off.\That's okay. Promise?\All right!\When Mom leaves the hospital tonight...\I'm going to kill her dear, little Satoru.\You're going home now?\Yes. I'll see you again tomorrow.\Take care. response:	Excuse me...
context: That's okay. Promise?\All right!\When Mom leaves the hospital tonight...\I'm going to kill her dear, little Satoru.\You're going home now?\Yes. I'll see you again tomorrow.\Take care.\Excuse me... response:	Oh, you're Sota's sister?
context: All right!\When Mom leaves the hospital tonight...\I'm going to kill her dear, little Satoru.\You're going home now?\Yes. I'll see you again tomorrow.\Take care.\Excuse me...\Oh, you're Sota's sister? response:	Umm... About Satoru's late sister...
context: When Mom leaves the hospital tonight...\I'm going to kill her dear, little Satoru.\You're going home now?\Yes. I'll see you again tomorrow.\Take care.\Excuse me...\Oh, you're Sota's sister?\Umm... About Satoru's late sister... response:	We've been waiting for you! Please go around!
context: I'm going to kill her dear, little Satoru.\You're going home now?\Yes. I'll see you again tomorrow.\Take care.\Excuse me...\Oh, you're Sota's sister?\Umm... About Satoru's late sister...\We've been waiting for you! Please go around! response:	That day...
context: You're going home now?\Yes. I'll see you again tomorrow.\Take care.\Excuse me...\Oh, you're Sota's sister?\Umm... About Satoru's late sister...\We've been waiting for you! Please go around!\That day... response:	Stupid Mommy!
context: Yes. I'll see you again tomorrow.\Take care.\Excuse me...\Oh, you're Sota's sister?\Umm... About Satoru's late sister...\We've been waiting for you! Please go around!\That day...\Stupid Mommy! response:	Why didn't you come to the Open House?!
context: Take care.\Excuse me...\Oh, you're Sota's sister?\Umm... About Satoru's late sister...\We've been waiting for you! Please go around!\That day...\Stupid Mommy!\Why didn't you come to the Open House?! response:	It couldn't be helped.
context: Excuse me...\Oh, you're Sota's sister?\Umm... About Satoru's late sister...\We've been waiting for you! Please go around!\That day...\Stupid Mommy!\Why didn't you come to the Open House?!\It couldn't be helped. response:	Satoru's temperature shot up.
context: Oh, you're Sota's sister?\Umm... About Satoru's late sister...\We've been waiting for you! Please go around!\That day...\Stupid Mommy!\Why didn't you come to the Open House?!\It couldn't be helped.\Satoru's temperature shot up. response:	All you care about is Satoru!
context: Umm... About Satoru's late sister...\We've been waiting for you! Please go around!\That day...\Stupid Mommy!\Why didn't you come to the Open House?!\It couldn't be helped.\Satoru's temperature shot up.\All you care about is Satoru! response:	Mayu!
context: We've been waiting for you! Please go around!\That day...\Stupid Mommy!\Why didn't you come to the Open House?!\It couldn't be helped.\Satoru's temperature shot up.\All you care about is Satoru!\Mayu! response:	I hate you and Satoru!
context: That day...\Stupid Mommy!\Why didn't you come to the Open House?!\It couldn't be helped.\Satoru's temperature shot up.\All you care about is Satoru!\Mayu!\I hate you and Satoru! response:	Mayu, just a minute!
context: Stupid Mommy!\Why didn't you come to the Open House?!\It couldn't be helped.\Satoru's temperature shot up.\All you care about is Satoru!\Mayu!\I hate you and Satoru!\Mayu, just a minute! response:	Mayu!
context: Why didn't you come to the Open House?!\It couldn't be helped.\Satoru's temperature shot up.\All you care about is Satoru!\Mayu!\I hate you and Satoru!\Mayu, just a minute!\Mayu! response:	We always had arguments like that.
context: It couldn't be helped.\Satoru's temperature shot up.\All you care about is Satoru!\Mayu!\I hate you and Satoru!\Mayu, just a minute!\Mayu!\We always had arguments like that. response:	On that day, when Mayu ran off...
context: Satoru's temperature shot up.\All you care about is Satoru!\Mayu!\I hate you and Satoru!\Mayu, just a minute!\Mayu!\We always had arguments like that.\On that day, when Mayu ran off... response:	I thought, Oh, there she goes again.
context: All you care about is Satoru!\Mayu!\I hate you and Satoru!\Mayu, just a minute!\Mayu!\We always had arguments like that.\On that day, when Mayu ran off...\I thought, Oh, there she goes again. response:	But...
context: Mayu!\I hate you and Satoru!\Mayu, just a minute!\Mayu!\We always had arguments like that.\On that day, when Mayu ran off...\I thought, Oh, there she goes again.\But... response:	If I had known that Mayu was inside the apartment...
context: I hate you and Satoru!\Mayu, just a minute!\Mayu!\We always had arguments like that.\On that day, when Mayu ran off...\I thought, Oh, there she goes again.\But...\If I had known that Mayu was inside the apartment... response:	A child! Poor thing!
context: Mayu, just a minute!\Mayu!\We always had arguments like that.\On that day, when Mayu ran off...\I thought, Oh, there she goes again.\But...\If I had known that Mayu was inside the apartment...\A child! Poor thing! response:	If I had known, I would have gone back...
context: Mayu!\We always had arguments like that.\On that day, when Mayu ran off...\I thought, Oh, there she goes again.\But...\If I had known that Mayu was inside the apartment...\A child! Poor thing!\If I had known, I would have gone back... response:	If I had only known!
context: We always had arguments like that.\On that day, when Mayu ran off...\I thought, Oh, there she goes again.\But...\If I had known that Mayu was inside the apartment...\A child! Poor thing!\If I had known, I would have gone back...\If I had only known! response:	She wasn't aware that Mayu was inside during the fire.
context: On that day, when Mayu ran off...\I thought, Oh, there she goes again.\But...\If I had known that Mayu was inside the apartment...\A child! Poor thing!\If I had known, I would have gone back...\If I had only known!\She wasn't aware that Mayu was inside during the fire. response:	That's Satoru's room!
context: I thought, Oh, there she goes again.\But...\If I had known that Mayu was inside the apartment...\A child! Poor thing!\If I had known, I would have gone back...\If I had only known!\She wasn't aware that Mayu was inside during the fire.\That's Satoru's room! response:	Mayu!
context: But...\If I had known that Mayu was inside the apartment...\A child! Poor thing!\If I had known, I would have gone back...\If I had only known!\She wasn't aware that Mayu was inside during the fire.\That's Satoru's room!\Mayu! response:	Mayu, stop!
context: If I had known that Mayu was inside the apartment...\A child! Poor thing!\If I had known, I would have gone back...\If I had only known!\She wasn't aware that Mayu was inside during the fire.\That's Satoru's room!\Mayu!\Mayu, stop! response:	M-Mayu!
context: A child! Poor thing!\If I had known, I would have gone back...\If I had only known!\She wasn't aware that Mayu was inside during the fire.\That's Satoru's room!\Mayu!\Mayu, stop!\M-Mayu! response:	Why?!
context: If I had known, I would have gone back...\If I had only known!\She wasn't aware that Mayu was inside during the fire.\That's Satoru's room!\Mayu!\Mayu, stop!\M-Mayu!\Why?! response:	Quiet!
context: If I had only known!\She wasn't aware that Mayu was inside during the fire.\That's Satoru's room!\Mayu!\Mayu, stop!\M-Mayu!\Why?!\Quiet! response:	Mayu, think hard!
context: She wasn't aware that Mayu was inside during the fire.\That's Satoru's room!\Mayu!\Mayu, stop!\M-Mayu!\Why?!\Quiet!\Mayu, think hard! response:	Did your mother really abandon you?
context: That's Satoru's room!\Mayu!\Mayu, stop!\M-Mayu!\Why?!\Quiet!\Mayu, think hard!\Did your mother really abandon you? response:	Maybe she didn't know you were inside the apartment during that fire?
context: Mayu!\Mayu, stop!\M-Mayu!\Why?!\Quiet!\Mayu, think hard!\Did your mother really abandon you?\Maybe she didn't know you were inside the apartment during that fire? response:	Brrr... It was cold!
context: Mayu, stop!\M-Mayu!\Why?!\Quiet!\Mayu, think hard!\Did your mother really abandon you?\Maybe she didn't know you were inside the apartment during that fire?\Brrr... It was cold! response:	Sis... You're not supposed to hang things above the heater...
context: M-Mayu!\Why?!\Quiet!\Mayu, think hard!\Did your mother really abandon you?\Maybe she didn't know you were inside the apartment during that fire?\Brrr... It was cold!\Sis... You're not supposed to hang things above the heater... response:	when Mom is not at home.
context: Why?!\Quiet!\Mayu, think hard!\Did your mother really abandon you?\Maybe she didn't know you were inside the apartment during that fire?\Brrr... It was cold!\Sis... You're not supposed to hang things above the heater...\when Mom is not at home. response:	Oh, be quiet!
context: Quiet!\Mayu, think hard!\Did your mother really abandon you?\Maybe she didn't know you were inside the apartment during that fire?\Brrr... It was cold!\Sis... You're not supposed to hang things above the heater...\when Mom is not at home.\Oh, be quiet! response:	Don't you dare tell Mom that I'm hiding here.
context: Mayu, think hard!\Did your mother really abandon you?\Maybe she didn't know you were inside the apartment during that fire?\Brrr... It was cold!\Sis... You're not supposed to hang things above the heater...\when Mom is not at home.\Oh, be quiet!\Don't you dare tell Mom that I'm hiding here. response:	I want to make her worry!
context: Did your mother really abandon you?\Maybe she didn't know you were inside the apartment during that fire?\Brrr... It was cold!\Sis... You're not supposed to hang things above the heater...\when Mom is not at home.\Oh, be quiet!\Don't you dare tell Mom that I'm hiding here.\I want to make her worry! response:	That muffler caught on fire!
context: Maybe she didn't know you were inside the apartment during that fire?\Brrr... It was cold!\Sis... You're not supposed to hang things above the heater...\when Mom is not at home.\Oh, be quiet!\Don't you dare tell Mom that I'm hiding here.\I want to make her worry!\That muffler caught on fire! response:	It's all my fault.
context: Brrr... It was cold!\Sis... You're not supposed to hang things above the heater...\when Mom is not at home.\Oh, be quiet!\Don't you dare tell Mom that I'm hiding here.\I want to make her worry!\That muffler caught on fire!\It's all my fault. response:	Mom's not to blame.
context: Sis... You're not supposed to hang things above the heater...\when Mom is not at home.\Oh, be quiet!\Don't you dare tell Mom that I'm hiding here.\I want to make her worry!\That muffler caught on fire!\It's all my fault.\Mom's not to blame. response:	Even Satoru...
context: when Mom is not at home.\Oh, be quiet!\Don't you dare tell Mom that I'm hiding here.\I want to make her worry!\That muffler caught on fire!\It's all my fault.\Mom's not to blame.\Even Satoru... response:	Mayu...
context: Oh, be quiet!\Don't you dare tell Mom that I'm hiding here.\I want to make her worry!\That muffler caught on fire!\It's all my fault.\Mom's not to blame.\Even Satoru...\Mayu... response:	Satoru!
context: Don't you dare tell Mom that I'm hiding here.\I want to make her worry!\That muffler caught on fire!\It's all my fault.\Mom's not to blame.\Even Satoru...\Mayu...\Satoru! response:	Huh?!
context: I want to make her worry!\That muffler caught on fire!\It's all my fault.\Mom's not to blame.\Even Satoru...\Mayu...\Satoru!\Huh?! response:	He fell!
context: That muffler caught on fire!\It's all my fault.\Mom's not to blame.\Even Satoru...\Mayu...\Satoru!\Huh?!\He fell! response:	Cripes! I can't stand to watch you!
context: It's all my fault.\Mom's not to blame.\Even Satoru...\Mayu...\Satoru!\Huh?!\He fell!\Cripes! I can't stand to watch you! response:	Inuyasha!
context: Mom's not to blame.\Even Satoru...\Mayu...\Satoru!\Huh?!\He fell!\Cripes! I can't stand to watch you!\Inuyasha! response:	You came!
context: Even Satoru...\Mayu...\Satoru!\Huh?!\He fell!\Cripes! I can't stand to watch you!\Inuyasha!\You came! response:	Didn't I tell you not to get involved?
context: Mayu...\Satoru!\Huh?!\He fell!\Cripes! I can't stand to watch you!\Inuyasha!\You came!\Didn't I tell you not to get involved? response:	It's too late for that little kid.
context: Satoru!\Huh?!\He fell!\Cripes! I can't stand to watch you!\Inuyasha!\You came!\Didn't I tell you not to get involved?\It's too late for that little kid. response:	Making her realize the truth doesn't mean she'll find peace.
context: Huh?!\He fell!\Cripes! I can't stand to watch you!\Inuyasha!\You came!\Didn't I tell you not to get involved?\It's too late for that little kid.\Making her realize the truth doesn't mean she'll find peace. response:	It ain't that simple!
context: He fell!\Cripes! I can't stand to watch you!\Inuyasha!\You came!\Didn't I tell you not to get involved?\It's too late for that little kid.\Making her realize the truth doesn't mean she'll find peace.\It ain't that simple! response:	Huh?! The eyes!
context: Cripes! I can't stand to watch you!\Inuyasha!\You came!\Didn't I tell you not to get involved?\It's too late for that little kid.\Making her realize the truth doesn't mean she'll find peace.\It ain't that simple!\Huh?! The eyes! response:	Aghh! What's this?!
context: Inuyasha!\You came!\Didn't I tell you not to get involved?\It's too late for that little kid.\Making her realize the truth doesn't mean she'll find peace.\It ain't that simple!\Huh?! The eyes!\Aghh! What's this?! response:	No! No!
context: You came!\Didn't I tell you not to get involved?\It's too late for that little kid.\Making her realize the truth doesn't mean she'll find peace.\It ain't that simple!\Huh?! The eyes!\Aghh! What's this?!\No! No! response:	Remember this! I don't know anything about ghosts!
context: Didn't I tell you not to get involved?\It's too late for that little kid.\Making her realize the truth doesn't mean she'll find peace.\It ain't that simple!\Huh?! The eyes!\Aghh! What's this?!\No! No!\Remember this! I don't know anything about ghosts! response:	So you work it out!
context: It's too late for that little kid.\Making her realize the truth doesn't mean she'll find peace.\It ain't that simple!\Huh?! The eyes!\Aghh! What's this?!\No! No!\Remember this! I don't know anything about ghosts!\So you work it out! response:	I must help Mayu find peace before she falls into hell.
context: Making her realize the truth doesn't mean she'll find peace.\It ain't that simple!\Huh?! The eyes!\Aghh! What's this?!\No! No!\Remember this! I don't know anything about ghosts!\So you work it out!\I must help Mayu find peace before she falls into hell. response:	This is what Myoga said...
context: It ain't that simple!\Huh?! The eyes!\Aghh! What's this?!\No! No!\Remember this! I don't know anything about ghosts!\So you work it out!\I must help Mayu find peace before she falls into hell.\This is what Myoga said... response:	the Soul Piper takes the spirit to the spot where the death occurred...
context: Huh?! The eyes!\Aghh! What's this?!\No! No!\Remember this! I don't know anything about ghosts!\So you work it out!\I must help Mayu find peace before she falls into hell.\This is what Myoga said...\the Soul Piper takes the spirit to the spot where the death occurred... response:	then drags it down into hell!
context: Aghh! What's this?!\No! No!\Remember this! I don't know anything about ghosts!\So you work it out!\I must help Mayu find peace before she falls into hell.\This is what Myoga said...\the Soul Piper takes the spirit to the spot where the death occurred...\then drags it down into hell! response:	Look over there! Seems pretty dangerous to me!
context: No! No!\Remember this! I don't know anything about ghosts!\So you work it out!\I must help Mayu find peace before she falls into hell.\This is what Myoga said...\the Soul Piper takes the spirit to the spot where the death occurred...\then drags it down into hell!\Look over there! Seems pretty dangerous to me! response:	Inuyasha, let me off here.
context: Remember this! I don't know anything about ghosts!\So you work it out!\I must help Mayu find peace before she falls into hell.\This is what Myoga said...\the Soul Piper takes the spirit to the spot where the death occurred...\then drags it down into hell!\Look over there! Seems pretty dangerous to me!\Inuyasha, let me off here. response:	Fool! Did you really think you can manage alone?
context: So you work it out!\I must help Mayu find peace before she falls into hell.\This is what Myoga said...\the Soul Piper takes the spirit to the spot where the death occurred...\then drags it down into hell!\Look over there! Seems pretty dangerous to me!\Inuyasha, let me off here.\Fool! Did you really think you can manage alone? response:	No wonder they say that...
context: I must help Mayu find peace before she falls into hell.\This is what Myoga said...\the Soul Piper takes the spirit to the spot where the death occurred...\then drags it down into hell!\Look over there! Seems pretty dangerous to me!\Inuyasha, let me off here.\Fool! Did you really think you can manage alone?\No wonder they say that... response:	there's nothing scarier than an ignoramus!
context: This is what Myoga said...\the Soul Piper takes the spirit to the spot where the death occurred...\then drags it down into hell!\Look over there! Seems pretty dangerous to me!\Inuyasha, let me off here.\Fool! Did you really think you can manage alone?\No wonder they say that...\there's nothing scarier than an ignoramus! response:	Oh that's right... This is where humans get sucked into hell.
context: the Soul Piper takes the spirit to the spot where the death occurred...\then drags it down into hell!\Look over there! Seems pretty dangerous to me!\Inuyasha, let me off here.\Fool! Did you really think you can manage alone?\No wonder they say that...\there's nothing scarier than an ignoramus!\Oh that's right... This is where humans get sucked into hell. response:	Only humans like Kagome can proceed any further.
context: then drags it down into hell!\Look over there! Seems pretty dangerous to me!\Inuyasha, let me off here.\Fool! Did you really think you can manage alone?\No wonder they say that...\there's nothing scarier than an ignoramus!\Oh that's right... This is where humans get sucked into hell.\Only humans like Kagome can proceed any further. response:	Damn! This is one time I'm totally helpless!
context: Look over there! Seems pretty dangerous to me!\Inuyasha, let me off here.\Fool! Did you really think you can manage alone?\No wonder they say that...\there's nothing scarier than an ignoramus!\Oh that's right... This is where humans get sucked into hell.\Only humans like Kagome can proceed any further.\Damn! This is one time I'm totally helpless! response:	It's pitch black. Where am I?
context: Inuyasha, let me off here.\Fool! Did you really think you can manage alone?\No wonder they say that...\there's nothing scarier than an ignoramus!\Oh that's right... This is where humans get sucked into hell.\Only humans like Kagome can proceed any further.\Damn! This is one time I'm totally helpless!\It's pitch black. Where am I? response:	A light?
context: Fool! Did you really think you can manage alone?\No wonder they say that...\there's nothing scarier than an ignoramus!\Oh that's right... This is where humans get sucked into hell.\Only humans like Kagome can proceed any further.\Damn! This is one time I'm totally helpless!\It's pitch black. Where am I?\A light? response:	Huh?! You're conscious!
context: No wonder they say that...\there's nothing scarier than an ignoramus!\Oh that's right... This is where humans get sucked into hell.\Only humans like Kagome can proceed any further.\Damn! This is one time I'm totally helpless!\It's pitch black. Where am I?\A light?\Huh?! You're conscious! response:	Umm... What happened?
context: there's nothing scarier than an ignoramus!\Oh that's right... This is where humans get sucked into hell.\Only humans like Kagome can proceed any further.\Damn! This is one time I'm totally helpless!\It's pitch black. Where am I?\A light?\Huh?! You're conscious!\Umm... What happened? response:	Never mind... Look at Satoru!
context: Oh that's right... This is where humans get sucked into hell.\Only humans like Kagome can proceed any further.\Damn! This is one time I'm totally helpless!\It's pitch black. Where am I?\A light?\Huh?! You're conscious!\Umm... What happened?\Never mind... Look at Satoru! response:	Huh?!
context: Only humans like Kagome can proceed any further.\Damn! This is one time I'm totally helpless!\It's pitch black. Where am I?\A light?\Huh?! You're conscious!\Umm... What happened?\Never mind... Look at Satoru!\Huh?! response:	Satoru!
context: Damn! This is one time I'm totally helpless!\It's pitch black. Where am I?\A light?\Huh?! You're conscious!\Umm... What happened?\Never mind... Look at Satoru!\Huh?!\Satoru! response:	Mom...
context: It's pitch black. Where am I?\A light?\Huh?! You're conscious!\Umm... What happened?\Never mind... Look at Satoru!\Huh?!\Satoru!\Mom... response:	Mom... Umm...
context: A light?\Huh?! You're conscious!\Umm... What happened?\Never mind... Look at Satoru!\Huh?!\Satoru!\Mom...\Mom... Umm... response:	Sis is inside the closet.
context: Huh?! You're conscious!\Umm... What happened?\Never mind... Look at Satoru!\Huh?!\Satoru!\Mom...\Mom... Umm...\Sis is inside the closet. response:	Please hurry and get her!
context: Umm... What happened?\Never mind... Look at Satoru!\Huh?!\Satoru!\Mom...\Mom... Umm...\Sis is inside the closet.\Please hurry and get her! response:	This is how I died.
context: Never mind... Look at Satoru!\Huh?!\Satoru!\Mom...\Mom... Umm...\Sis is inside the closet.\Please hurry and get her!\This is how I died. response:	I couldn't be saved...
context: Huh?!\Satoru!\Mom...\Mom... Umm...\Sis is inside the closet.\Please hurry and get her!\This is how I died.\I couldn't be saved... response:	Mayu!
context: Satoru!\Mom...\Mom... Umm...\Sis is inside the closet.\Please hurry and get her!\This is how I died.\I couldn't be saved...\Mayu! response:	Mayu!
context: Mom...\Mom... Umm...\Sis is inside the closet.\Please hurry and get her!\This is how I died.\I couldn't be saved...\Mayu!\Mayu! response:	Who is that?! Mom?!
context: Mom... Umm...\Sis is inside the closet.\Please hurry and get her!\This is how I died.\I couldn't be saved...\Mayu!\Mayu!\Who is that?! Mom?! response:	Where are you?!
context: Sis is inside the closet.\Please hurry and get her!\This is how I died.\I couldn't be saved...\Mayu!\Mayu!\Who is that?! Mom?!\Where are you?! response:	Answer!
context: Please hurry and get her!\This is how I died.\I couldn't be saved...\Mayu!\Mayu!\Who is that?! Mom?!\Where are you?!\Answer! response:	Mayu!
context: This is how I died.\I couldn't be saved...\Mayu!\Mayu!\Who is that?! Mom?!\Where are you?!\Answer!\Mayu! response:	Hurry! Let's get out of here!
context: I couldn't be saved...\Mayu!\Mayu!\Who is that?! Mom?!\Where are you?!\Answer!\Mayu!\Hurry! Let's get out of here! response:	Are you crazy?! I'm already dead!
context: Mayu!\Mayu!\Who is that?! Mom?!\Where are you?!\Answer!\Mayu!\Hurry! Let's get out of here!\Are you crazy?! I'm already dead! response:	I don't have a home anymore!
context: Mayu!\Who is that?! Mom?!\Where are you?!\Answer!\Mayu!\Hurry! Let's get out of here!\Are you crazy?! I'm already dead!\I don't have a home anymore! response:	Mayu!
context: Who is that?! Mom?!\Where are you?!\Answer!\Mayu!\Hurry! Let's get out of here!\Are you crazy?! I'm already dead!\I don't have a home anymore!\Mayu! response:	Mayu!
context: Where are you?!\Answer!\Mayu!\Hurry! Let's get out of here!\Are you crazy?! I'm already dead!\I don't have a home anymore!\Mayu!\Mayu! response:	You're going home, Mayu.
context: Answer!\Mayu!\Hurry! Let's get out of here!\Are you crazy?! I'm already dead!\I don't have a home anymore!\Mayu!\Mayu!\You're going home, Mayu. response:	You're going home and make peace with your mother.
context: Mayu!\Hurry! Let's get out of here!\Are you crazy?! I'm already dead!\I don't have a home anymore!\Mayu!\Mayu!\You're going home, Mayu.\You're going home and make peace with your mother. response:	Your mother loves you so very much!
context: Hurry! Let's get out of here!\Are you crazy?! I'm already dead!\I don't have a home anymore!\Mayu!\Mayu!\You're going home, Mayu.\You're going home and make peace with your mother.\Your mother loves you so very much! response:	Is it okay if you never see her again?
context: Are you crazy?! I'm already dead!\I don't have a home anymore!\Mayu!\Mayu!\You're going home, Mayu.\You're going home and make peace with your mother.\Your mother loves you so very much!\Is it okay if you never see her again? response:	She's not angry?
context: I don't have a home anymore!\Mayu!\Mayu!\You're going home, Mayu.\You're going home and make peace with your mother.\Your mother loves you so very much!\Is it okay if you never see her again?\She's not angry? response:	Mom's not angry at me?
context: Mayu!\Mayu!\You're going home, Mayu.\You're going home and make peace with your mother.\Your mother loves you so very much!\Is it okay if you never see her again?\She's not angry?\Mom's not angry at me? response:	Don't you worry. She's your mother!
context: Mayu!\You're going home, Mayu.\You're going home and make peace with your mother.\Your mother loves you so very much!\Is it okay if you never see her again?\She's not angry?\Mom's not angry at me?\Don't you worry. She's your mother! response:	Try to remember...
context: You're going home, Mayu.\You're going home and make peace with your mother.\Your mother loves you so very much!\Is it okay if you never see her again?\She's not angry?\Mom's not angry at me?\Don't you worry. She's your mother!\Try to remember... response:	about your mother...
context: You're going home and make peace with your mother.\Your mother loves you so very much!\Is it okay if you never see her again?\She's not angry?\Mom's not angry at me?\Don't you worry. She's your mother!\Try to remember...\about your mother... response:	Mom!
context: Your mother loves you so very much!\Is it okay if you never see her again?\She's not angry?\Mom's not angry at me?\Don't you worry. She's your mother!\Try to remember...\about your mother...\Mom! response:	I want to see you one more time, so I can say I'm sorry!
context: Is it okay if you never see her again?\She's not angry?\Mom's not angry at me?\Don't you worry. She's your mother!\Try to remember...\about your mother...\Mom!\I want to see you one more time, so I can say I'm sorry! response:	I wanted to make up with you!
context: She's not angry?\Mom's not angry at me?\Don't you worry. She's your mother!\Try to remember...\about your mother...\Mom!\I want to see you one more time, so I can say I'm sorry!\I wanted to make up with you! response:	Mayu...
context: Mom's not angry at me?\Don't you worry. She's your mother!\Try to remember...\about your mother...\Mom!\I want to see you one more time, so I can say I'm sorry!\I wanted to make up with you!\Mayu... response:	Mommy!
context: Don't you worry. She's your mother!\Try to remember...\about your mother...\Mom!\I want to see you one more time, so I can say I'm sorry!\I wanted to make up with you!\Mayu...\Mommy! response:	Mayu!
context: Try to remember...\about your mother...\Mom!\I want to see you one more time, so I can say I'm sorry!\I wanted to make up with you!\Mayu...\Mommy!\Mayu! response:	Mommy!
context: about your mother...\Mom!\I want to see you one more time, so I can say I'm sorry!\I wanted to make up with you!\Mayu...\Mommy!\Mayu!\Mommy! response:	I'm sorry...
context: Mom!\I want to see you one more time, so I can say I'm sorry!\I wanted to make up with you!\Mayu...\Mommy!\Mayu!\Mommy!\I'm sorry... response:	Mayu...
context: I want to see you one more time, so I can say I'm sorry!\I wanted to make up with you!\Mayu...\Mommy!\Mayu!\Mommy!\I'm sorry...\Mayu... response:	I have to go now.
context: I wanted to make up with you!\Mayu...\Mommy!\Mayu!\Mommy!\I'm sorry...\Mayu...\I have to go now. response:	I hope it worked.
context: Mayu...\Mommy!\Mayu!\Mommy!\I'm sorry...\Mayu...\I have to go now.\I hope it worked. response:	Cripes! You get into such scrapes!
context: Mommy!\Mayu!\Mommy!\I'm sorry...\Mayu...\I have to go now.\I hope it worked.\Cripes! You get into such scrapes! response:	One wrong move and you'd have been dragged into hell...
context: Mayu!\Mommy!\I'm sorry...\Mayu...\I have to go now.\I hope it worked.\Cripes! You get into such scrapes!\One wrong move and you'd have been dragged into hell... response:	with that impish evil spirit!
context: Mommy!\I'm sorry...\Mayu...\I have to go now.\I hope it worked.\Cripes! You get into such scrapes!\One wrong move and you'd have been dragged into hell...\with that impish evil spirit! response:	Evil spirit...
context: I'm sorry...\Mayu...\I have to go now.\I hope it worked.\Cripes! You get into such scrapes!\One wrong move and you'd have been dragged into hell...\with that impish evil spirit!\Evil spirit... response:	One week later, Satoru was released from the hospital.
context: Mayu...\I have to go now.\I hope it worked.\Cripes! You get into such scrapes!\One wrong move and you'd have been dragged into hell...\with that impish evil spirit!\Evil spirit...\One week later, Satoru was released from the hospital. response:	Kagome!
context: I have to go now.\I hope it worked.\Cripes! You get into such scrapes!\One wrong move and you'd have been dragged into hell...\with that impish evil spirit!\Evil spirit...\One week later, Satoru was released from the hospital.\Kagome! response:	Mayu!
context: I hope it worked.\Cripes! You get into such scrapes!\One wrong move and you'd have been dragged into hell...\with that impish evil spirit!\Evil spirit...\One week later, Satoru was released from the hospital.\Kagome!\Mayu! response:	I wanted to thank you before I left.
context: Cripes! You get into such scrapes!\One wrong move and you'd have been dragged into hell...\with that impish evil spirit!\Evil spirit...\One week later, Satoru was released from the hospital.\Kagome!\Mayu!\I wanted to thank you before I left. response:	Such a pretty cotton kimono!
context: One wrong move and you'd have been dragged into hell...\with that impish evil spirit!\Evil spirit...\One week later, Satoru was released from the hospital.\Kagome!\Mayu!\I wanted to thank you before I left.\Such a pretty cotton kimono! response:	Mom sewed it for me.
context: with that impish evil spirit!\Evil spirit...\One week later, Satoru was released from the hospital.\Kagome!\Mayu!\I wanted to thank you before I left.\Such a pretty cotton kimono!\Mom sewed it for me. response:	Thanks for everything. Bye-bye!
context: Evil spirit...\One week later, Satoru was released from the hospital.\Kagome!\Mayu!\I wanted to thank you before I left.\Such a pretty cotton kimono!\Mom sewed it for me.\Thanks for everything. Bye-bye! response:	Mayu, you weren't meant to be an evil spirit.
context: One week later, Satoru was released from the hospital.\Kagome!\Mayu!\I wanted to thank you before I left.\Such a pretty cotton kimono!\Mom sewed it for me.\Thanks for everything. Bye-bye!\Mayu, you weren't meant to be an evil spirit. response:	You were just a little girl who loved her mother very much.
context: Kagome!\Mayu!\I wanted to thank you before I left.\Such a pretty cotton kimono!\Mom sewed it for me.\Thanks for everything. Bye-bye!\Mayu, you weren't meant to be an evil spirit.\You were just a little girl who loved her mother very much. response:	Inuyasha... Half-demon and half-human.
context: Mayu!\I wanted to thank you before I left.\Such a pretty cotton kimono!\Mom sewed it for me.\Thanks for everything. Bye-bye!\Mayu, you weren't meant to be an evil spirit.\You were just a little girl who loved her mother very much.\Inuyasha... Half-demon and half-human. response:	Inuyasha's goal is to gather the fragments of the Sacred Jewel...
context: I wanted to thank you before I left.\Such a pretty cotton kimono!\Mom sewed it for me.\Thanks for everything. Bye-bye!\Mayu, you weren't meant to be an evil spirit.\You were just a little girl who loved her mother very much.\Inuyasha... Half-demon and half-human.\Inuyasha's goal is to gather the fragments of the Sacred Jewel... response:	to become a full-fledged demon.
context: Such a pretty cotton kimono!\Mom sewed it for me.\Thanks for everything. Bye-bye!\Mayu, you weren't meant to be an evil spirit.\You were just a little girl who loved her mother very much.\Inuyasha... Half-demon and half-human.\Inuyasha's goal is to gather the fragments of the Sacred Jewel...\to become a full-fledged demon. response:	During our search for the fragments...
context: Mom sewed it for me.\Thanks for everything. Bye-bye!\Mayu, you weren't meant to be an evil spirit.\You were just a little girl who loved her mother very much.\Inuyasha... Half-demon and half-human.\Inuyasha's goal is to gather the fragments of the Sacred Jewel...\to become a full-fledged demon.\During our search for the fragments... response:	we come to the rescue of a girl named Nazuna.
context: Thanks for everything. Bye-bye!\Mayu, you weren't meant to be an evil spirit.\You were just a little girl who loved her mother very much.\Inuyasha... Half-demon and half-human.\Inuyasha's goal is to gather the fragments of the Sacred Jewel...\to become a full-fledged demon.\During our search for the fragments...\we come to the rescue of a girl named Nazuna. response:	She takes us to spend the night at an old temple.
context: Mayu, you weren't meant to be an evil spirit.\You were just a little girl who loved her mother very much.\Inuyasha... Half-demon and half-human.\Inuyasha's goal is to gather the fragments of the Sacred Jewel...\to become a full-fledged demon.\During our search for the fragments...\we come to the rescue of a girl named Nazuna.\She takes us to spend the night at an old temple. response:	The Spider Lord lurks in the shadows... Is it a trap?
context: You were just a little girl who loved her mother very much.\Inuyasha... Half-demon and half-human.\Inuyasha's goal is to gather the fragments of the Sacred Jewel...\to become a full-fledged demon.\During our search for the fragments...\we come to the rescue of a girl named Nazuna.\She takes us to spend the night at an old temple.\The Spider Lord lurks in the shadows... Is it a trap? response:	But on this moonless night, a secret weakness is revealed!
context: Inuyasha... Half-demon and half-human.\Inuyasha's goal is to gather the fragments of the Sacred Jewel...\to become a full-fledged demon.\During our search for the fragments...\we come to the rescue of a girl named Nazuna.\She takes us to spend the night at an old temple.\The Spider Lord lurks in the shadows... Is it a trap?\But on this moonless night, a secret weakness is revealed! response:	The Mystery of the New Moon and the Black-haired Inuyasha!
context: Inuyasha's goal is to gather the fragments of the Sacred Jewel...\to become a full-fledged demon.\During our search for the fragments...\we come to the rescue of a girl named Nazuna.\She takes us to spend the night at an old temple.\The Spider Lord lurks in the shadows... Is it a trap?\But on this moonless night, a secret weakness is revealed!\The Mystery of the New Moon and the Black-haired Inuyasha! response:	Don't miss it!