context: Sesshomaru had denounced the half-demon Inuyasha response:	as a disgrace to his clan and despised the human race...
context: Sesshomaru had denounced the half-demon Inuyasha\as a disgrace to his clan and despised the human race... response:	But Jaken, Sesshomaru's henchman, definitely had a human girl with him.
context: Sesshomaru had denounced the half-demon Inuyasha\as a disgrace to his clan and despised the human race...\But Jaken, Sesshomaru's henchman, definitely had a human girl with him. response:	Lord Sesshomaru!
context: Sesshomaru had denounced the half-demon Inuyasha\as a disgrace to his clan and despised the human race...\But Jaken, Sesshomaru's henchman, definitely had a human girl with him.\Lord Sesshomaru! response:	Rin has been kidnapped!
context: Sesshomaru had denounced the half-demon Inuyasha\as a disgrace to his clan and despised the human race...\But Jaken, Sesshomaru's henchman, definitely had a human girl with him.\Lord Sesshomaru!\Rin has been kidnapped! response:	One of Naraku's incarnations named Kagura appeared...
context: Sesshomaru had denounced the half-demon Inuyasha\as a disgrace to his clan and despised the human race...\But Jaken, Sesshomaru's henchman, definitely had a human girl with him.\Lord Sesshomaru!\Rin has been kidnapped!\One of Naraku's incarnations named Kagura appeared... response:	out of the blue...
context: Sesshomaru had denounced the half-demon Inuyasha\as a disgrace to his clan and despised the human race...\But Jaken, Sesshomaru's henchman, definitely had a human girl with him.\Lord Sesshomaru!\Rin has been kidnapped!\One of Naraku's incarnations named Kagura appeared...\out of the blue... response:	Let me reassure you, Lord Sesshomaru.
context: Sesshomaru had denounced the half-demon Inuyasha\as a disgrace to his clan and despised the human race...\But Jaken, Sesshomaru's henchman, definitely had a human girl with him.\Lord Sesshomaru!\Rin has been kidnapped!\One of Naraku's incarnations named Kagura appeared...\out of the blue...\Let me reassure you, Lord Sesshomaru. response:	If you heed my request,
context: as a disgrace to his clan and despised the human race...\But Jaken, Sesshomaru's henchman, definitely had a human girl with him.\Lord Sesshomaru!\Rin has been kidnapped!\One of Naraku's incarnations named Kagura appeared...\out of the blue...\Let me reassure you, Lord Sesshomaru.\If you heed my request, response:	I shall return Rin in one piece.
context: But Jaken, Sesshomaru's henchman, definitely had a human girl with him.\Lord Sesshomaru!\Rin has been kidnapped!\One of Naraku's incarnations named Kagura appeared...\out of the blue...\Let me reassure you, Lord Sesshomaru.\If you heed my request,\I shall return Rin in one piece. response:	Y-You are Naraku!
context: Lord Sesshomaru!\Rin has been kidnapped!\One of Naraku's incarnations named Kagura appeared...\out of the blue...\Let me reassure you, Lord Sesshomaru.\If you heed my request,\I shall return Rin in one piece.\Y-You are Naraku! response:	Just a little more...
context: Rin has been kidnapped!\One of Naraku's incarnations named Kagura appeared...\out of the blue...\Let me reassure you, Lord Sesshomaru.\If you heed my request,\I shall return Rin in one piece.\Y-You are Naraku!\Just a little more... response:	Soon you will be absorbed...
context: One of Naraku's incarnations named Kagura appeared...\out of the blue...\Let me reassure you, Lord Sesshomaru.\If you heed my request,\I shall return Rin in one piece.\Y-You are Naraku!\Just a little more...\Soon you will be absorbed... response:	and become one with my flesh!
context: out of the blue...\Let me reassure you, Lord Sesshomaru.\If you heed my request,\I shall return Rin in one piece.\Y-You are Naraku!\Just a little more...\Soon you will be absorbed...\and become one with my flesh! response:	We follow the trail of the Sacred Jewel shards.
context: Let me reassure you, Lord Sesshomaru.\If you heed my request,\I shall return Rin in one piece.\Y-You are Naraku!\Just a little more...\Soon you will be absorbed...\and become one with my flesh!\We follow the trail of the Sacred Jewel shards. response:	That's right!
context: If you heed my request,\I shall return Rin in one piece.\Y-You are Naraku!\Just a little more...\Soon you will be absorbed...\and become one with my flesh!\We follow the trail of the Sacred Jewel shards.\That's right! response:	Kohaku, Sango's youngerbrother, has a single shard
context: I shall return Rin in one piece.\Y-You are Naraku!\Just a little more...\Soon you will be absorbed...\and become one with my flesh!\We follow the trail of the Sacred Jewel shards.\That's right!\Kohaku, Sango's youngerbrother, has a single shard response:	which was imbedded in his back by Naraku.
context: Y-You are Naraku!\Just a little more...\Soon you will be absorbed...\and become one with my flesh!\We follow the trail of the Sacred Jewel shards.\That's right!\Kohaku, Sango's youngerbrother, has a single shard\which was imbedded in his back by Naraku. response:	Inuyasha headed out alone forNaraku's castle.
context: Just a little more...\Soon you will be absorbed...\and become one with my flesh!\We follow the trail of the Sacred Jewel shards.\That's right!\Kohaku, Sango's youngerbrother, has a single shard\which was imbedded in his back by Naraku.\Inuyasha headed out alone forNaraku's castle. response:	Miasma and toxic fumes... this has gotta be it!
context: Soon you will be absorbed...\and become one with my flesh!\We follow the trail of the Sacred Jewel shards.\That's right!\Kohaku, Sango's youngerbrother, has a single shard\which was imbedded in his back by Naraku.\Inuyasha headed out alone forNaraku's castle.\Miasma and toxic fumes... this has gotta be it! response:	This is Naraku's barrier!
context: and become one with my flesh!\We follow the trail of the Sacred Jewel shards.\That's right!\Kohaku, Sango's youngerbrother, has a single shard\which was imbedded in his back by Naraku.\Inuyasha headed out alone forNaraku's castle.\Miasma and toxic fumes... this has gotta be it!\This is Naraku's barrier! response:	Tetsusaiga!
context: We follow the trail of the Sacred Jewel shards.\That's right!\Kohaku, Sango's youngerbrother, has a single shard\which was imbedded in his back by Naraku.\Inuyasha headed out alone forNaraku's castle.\Miasma and toxic fumes... this has gotta be it!\This is Naraku's barrier!\Tetsusaiga! response:	I can see it! Naraku's castle!
context: That's right!\Kohaku, Sango's youngerbrother, has a single shard\which was imbedded in his back by Naraku.\Inuyasha headed out alone forNaraku's castle.\Miasma and toxic fumes... this has gotta be it!\This is Naraku's barrier!\Tetsusaiga!\I can see it! Naraku's castle! response:	He's coming.
context: Kohaku, Sango's youngerbrother, has a single shard\which was imbedded in his back by Naraku.\Inuyasha headed out alone forNaraku's castle.\Miasma and toxic fumes... this has gotta be it!\This is Naraku's barrier!\Tetsusaiga!\I can see it! Naraku's castle!\He's coming. response:	That Kagura... She must have failed.
context: which was imbedded in his back by Naraku.\Inuyasha headed out alone forNaraku's castle.\Miasma and toxic fumes... this has gotta be it!\This is Naraku's barrier!\Tetsusaiga!\I can see it! Naraku's castle!\He's coming.\That Kagura... She must have failed. response:	Naraku, you seem preoccupied with what's beyond the castle walls.
context: Inuyasha headed out alone forNaraku's castle.\Miasma and toxic fumes... this has gotta be it!\This is Naraku's barrier!\Tetsusaiga!\I can see it! Naraku's castle!\He's coming.\That Kagura... She must have failed.\Naraku, you seem preoccupied with what's beyond the castle walls. response:	Lord Sesshomaru, I no longerhave time to dally with you.
context: Miasma and toxic fumes... this has gotta be it!\This is Naraku's barrier!\Tetsusaiga!\I can see it! Naraku's castle!\He's coming.\That Kagura... She must have failed.\Naraku, you seem preoccupied with what's beyond the castle walls.\Lord Sesshomaru, I no longerhave time to dally with you. response:	Yourpower...
context: This is Naraku's barrier!\Tetsusaiga!\I can see it! Naraku's castle!\He's coming.\That Kagura... She must have failed.\Naraku, you seem preoccupied with what's beyond the castle walls.\Lord Sesshomaru, I no longerhave time to dally with you.\Yourpower... response:	Every bit of yourdemon power...
context: Tetsusaiga!\I can see it! Naraku's castle!\He's coming.\That Kagura... She must have failed.\Naraku, you seem preoccupied with what's beyond the castle walls.\Lord Sesshomaru, I no longerhave time to dally with you.\Yourpower...\Every bit of yourdemon power... response:	shall be wholly consumed by me.
context: I can see it! Naraku's castle!\He's coming.\That Kagura... She must have failed.\Naraku, you seem preoccupied with what's beyond the castle walls.\Lord Sesshomaru, I no longerhave time to dally with you.\Yourpower...\Every bit of yourdemon power...\shall be wholly consumed by me. response:	L-Lord Sesshomaru!
context: He's coming.\That Kagura... She must have failed.\Naraku, you seem preoccupied with what's beyond the castle walls.\Lord Sesshomaru, I no longerhave time to dally with you.\Yourpower...\Every bit of yourdemon power...\shall be wholly consumed by me.\L-Lord Sesshomaru! response:	T-This is terrible! Lord Sesshomaru!
context: That Kagura... She must have failed.\Naraku, you seem preoccupied with what's beyond the castle walls.\Lord Sesshomaru, I no longerhave time to dally with you.\Yourpower...\Every bit of yourdemon power...\shall be wholly consumed by me.\L-Lord Sesshomaru!\T-This is terrible! Lord Sesshomaru! response:	Staff ofTwo Heads...!
context: Naraku, you seem preoccupied with what's beyond the castle walls.\Lord Sesshomaru, I no longerhave time to dally with you.\Yourpower...\Every bit of yourdemon power...\shall be wholly consumed by me.\L-Lord Sesshomaru!\T-This is terrible! Lord Sesshomaru!\Staff ofTwo Heads...! response:	Huh?! Why is this happening?!
context: Lord Sesshomaru, I no longerhave time to dally with you.\Yourpower...\Every bit of yourdemon power...\shall be wholly consumed by me.\L-Lord Sesshomaru!\T-This is terrible! Lord Sesshomaru!\Staff ofTwo Heads...!\Huh?! Why is this happening?! response:	S-Stop!
context: Yourpower...\Every bit of yourdemon power...\shall be wholly consumed by me.\L-Lord Sesshomaru!\T-This is terrible! Lord Sesshomaru!\Staff ofTwo Heads...!\Huh?! Why is this happening?!\S-Stop! response:	Will he be all right?
context: Every bit of yourdemon power...\shall be wholly consumed by me.\L-Lord Sesshomaru!\T-This is terrible! Lord Sesshomaru!\Staff ofTwo Heads...!\Huh?! Why is this happening?!\S-Stop!\Will he be all right? response:	This can't be happening!
context: shall be wholly consumed by me.\L-Lord Sesshomaru!\T-This is terrible! Lord Sesshomaru!\Staff ofTwo Heads...!\Huh?! Why is this happening?!\S-Stop!\Will he be all right?\This can't be happening! response:	Lord Sesshomaru has been!
context: L-Lord Sesshomaru!\T-This is terrible! Lord Sesshomaru!\Staff ofTwo Heads...!\Huh?! Why is this happening?!\S-Stop!\Will he be all right?\This can't be happening!\Lord Sesshomaru has been! response:	Lord Sesshomaru...
context: T-This is terrible! Lord Sesshomaru!\Staff ofTwo Heads...!\Huh?! Why is this happening?!\S-Stop!\Will he be all right?\This can't be happening!\Lord Sesshomaru has been!\Lord Sesshomaru... response:	I've finally obtained the powers of a full-fledged demon!
context: Staff ofTwo Heads...!\Huh?! Why is this happening?!\S-Stop!\Will he be all right?\This can't be happening!\Lord Sesshomaru has been!\Lord Sesshomaru...\I've finally obtained the powers of a full-fledged demon! response:	Naraku!
context: Huh?! Why is this happening?!\S-Stop!\Will he be all right?\This can't be happening!\Lord Sesshomaru has been!\Lord Sesshomaru...\I've finally obtained the powers of a full-fledged demon!\Naraku! response:	Is that yourtrue form?!
context: S-Stop!\Will he be all right?\This can't be happening!\Lord Sesshomaru has been!\Lord Sesshomaru...\I've finally obtained the powers of a full-fledged demon!\Naraku!\Is that yourtrue form?! response:	Inuyasha!
context: Will he be all right?\This can't be happening!\Lord Sesshomaru has been!\Lord Sesshomaru...\I've finally obtained the powers of a full-fledged demon!\Naraku!\Is that yourtrue form?!\Inuyasha! response:	Take this! Wind Scar!
context: This can't be happening!\Lord Sesshomaru has been!\Lord Sesshomaru...\I've finally obtained the powers of a full-fledged demon!\Naraku!\Is that yourtrue form?!\Inuyasha!\Take this! Wind Scar! response:	I think not!
context: Lord Sesshomaru has been!\Lord Sesshomaru...\I've finally obtained the powers of a full-fledged demon!\Naraku!\Is that yourtrue form?!\Inuyasha!\Take this! Wind Scar!\I think not! response:	My barrier!?
context: Lord Sesshomaru...\I've finally obtained the powers of a full-fledged demon!\Naraku!\Is that yourtrue form?!\Inuyasha!\Take this! Wind Scar!\I think not!\My barrier!? response:	I've found you, Naraku!
context: I've finally obtained the powers of a full-fledged demon!\Naraku!\Is that yourtrue form?!\Inuyasha!\Take this! Wind Scar!\I think not!\My barrier!?\I've found you, Naraku! response:	Today, I shall kill you!
context: Naraku!\Is that yourtrue form?!\Inuyasha!\Take this! Wind Scar!\I think not!\My barrier!?\I've found you, Naraku!\Today, I shall kill you! response:	Hmph! Don't make me laugh!
context: Is that yourtrue form?!\Inuyasha!\Take this! Wind Scar!\I think not!\My barrier!?\I've found you, Naraku!\Today, I shall kill you!\Hmph! Don't make me laugh! response:	Kill me, you say?
context: Inuyasha!\Take this! Wind Scar!\I think not!\My barrier!?\I've found you, Naraku!\Today, I shall kill you!\Hmph! Don't make me laugh!\Kill me, you say? response:	Yes! Right now, Inuyasha can defeat Naraku.
context: Take this! Wind Scar!\I think not!\My barrier!?\I've found you, Naraku!\Today, I shall kill you!\Hmph! Don't make me laugh!\Kill me, you say?\Yes! Right now, Inuyasha can defeat Naraku. response:	Huh?
context: I think not!\My barrier!?\I've found you, Naraku!\Today, I shall kill you!\Hmph! Don't make me laugh!\Kill me, you say?\Yes! Right now, Inuyasha can defeat Naraku.\Huh? response:	That's!
context: My barrier!?\I've found you, Naraku!\Today, I shall kill you!\Hmph! Don't make me laugh!\Kill me, you say?\Yes! Right now, Inuyasha can defeat Naraku.\Huh?\That's! response:	So Naraku has already engulfed Sesshomaru's body.
context: I've found you, Naraku!\Today, I shall kill you!\Hmph! Don't make me laugh!\Kill me, you say?\Yes! Right now, Inuyasha can defeat Naraku.\Huh?\That's!\So Naraku has already engulfed Sesshomaru's body. response:	That means...
context: Today, I shall kill you!\Hmph! Don't make me laugh!\Kill me, you say?\Yes! Right now, Inuyasha can defeat Naraku.\Huh?\That's!\So Naraku has already engulfed Sesshomaru's body.\That means... response:	Naraku must be destroyed before
context: Hmph! Don't make me laugh!\Kill me, you say?\Yes! Right now, Inuyasha can defeat Naraku.\Huh?\That's!\So Naraku has already engulfed Sesshomaru's body.\That means...\Naraku must be destroyed before response:	he has a chance to absorb the demon power.
context: Kill me, you say?\Yes! Right now, Inuyasha can defeat Naraku.\Huh?\That's!\So Naraku has already engulfed Sesshomaru's body.\That means...\Naraku must be destroyed before\he has a chance to absorb the demon power. response:	It'll be too late once Naraku totally absorbs it, Inuyasha!
context: Yes! Right now, Inuyasha can defeat Naraku.\Huh?\That's!\So Naraku has already engulfed Sesshomaru's body.\That means...\Naraku must be destroyed before\he has a chance to absorb the demon power.\It'll be too late once Naraku totally absorbs it, Inuyasha! response:	I miscalculated.
context: Huh?\That's!\So Naraku has already engulfed Sesshomaru's body.\That means...\Naraku must be destroyed before\he has a chance to absorb the demon power.\It'll be too late once Naraku totally absorbs it, Inuyasha!\I miscalculated. response:	I did not expect Inuyasha to come this far.
context: That's!\So Naraku has already engulfed Sesshomaru's body.\That means...\Naraku must be destroyed before\he has a chance to absorb the demon power.\It'll be too late once Naraku totally absorbs it, Inuyasha!\I miscalculated.\I did not expect Inuyasha to come this far. response:	Inuyasha!
context: So Naraku has already engulfed Sesshomaru's body.\That means...\Naraku must be destroyed before\he has a chance to absorb the demon power.\It'll be too late once Naraku totally absorbs it, Inuyasha!\I miscalculated.\I did not expect Inuyasha to come this far.\Inuyasha! response:	So you're able to break through my barrier.
context: That means...\Naraku must be destroyed before\he has a chance to absorb the demon power.\It'll be too late once Naraku totally absorbs it, Inuyasha!\I miscalculated.\I did not expect Inuyasha to come this far.\Inuyasha!\So you're able to break through my barrier. response:	Naraku, you bastard!
context: Naraku must be destroyed before\he has a chance to absorb the demon power.\It'll be too late once Naraku totally absorbs it, Inuyasha!\I miscalculated.\I did not expect Inuyasha to come this far.\Inuyasha!\So you're able to break through my barrier.\Naraku, you bastard! response:	You won't get away this time!
context: he has a chance to absorb the demon power.\It'll be too late once Naraku totally absorbs it, Inuyasha!\I miscalculated.\I did not expect Inuyasha to come this far.\Inuyasha!\So you're able to break through my barrier.\Naraku, you bastard!\You won't get away this time! response:	Prepare to die!
context: It'll be too late once Naraku totally absorbs it, Inuyasha!\I miscalculated.\I did not expect Inuyasha to come this far.\Inuyasha!\So you're able to break through my barrier.\Naraku, you bastard!\You won't get away this time!\Prepare to die! response:	You seem to have become a bit stronger.
context: I miscalculated.\I did not expect Inuyasha to come this far.\Inuyasha!\So you're able to break through my barrier.\Naraku, you bastard!\You won't get away this time!\Prepare to die!\You seem to have become a bit stronger. response:	But you're still no match forme.
context: I did not expect Inuyasha to come this far.\Inuyasha!\So you're able to break through my barrier.\Naraku, you bastard!\You won't get away this time!\Prepare to die!\You seem to have become a bit stronger.\But you're still no match forme. response:	Take this!
context: Inuyasha!\So you're able to break through my barrier.\Naraku, you bastard!\You won't get away this time!\Prepare to die!\You seem to have become a bit stronger.\But you're still no match forme.\Take this! response:	No problem!
context: So you're able to break through my barrier.\Naraku, you bastard!\You won't get away this time!\Prepare to die!\You seem to have become a bit stronger.\But you're still no match forme.\Take this!\No problem! response:	I'm not done yet!
context: Naraku, you bastard!\You won't get away this time!\Prepare to die!\You seem to have become a bit stronger.\But you're still no match forme.\Take this!\No problem!\I'm not done yet! response:	Why you...!
context: You won't get away this time!\Prepare to die!\You seem to have become a bit stronger.\But you're still no match forme.\Take this!\No problem!\I'm not done yet!\Why you...! response:	Naraku!
context: Prepare to die!\You seem to have become a bit stronger.\But you're still no match forme.\Take this!\No problem!\I'm not done yet!\Why you...!\Naraku! response:	W-What?!
context: You seem to have become a bit stronger.\But you're still no match forme.\Take this!\No problem!\I'm not done yet!\Why you...!\Naraku!\W-What?! response:	What's this?
context: But you're still no match forme.\Take this!\No problem!\I'm not done yet!\Why you...!\Naraku!\W-What?!\What's this? response:	I'll engulf you, just like I did Sesshomaru.
context: Take this!\No problem!\I'm not done yet!\Why you...!\Naraku!\W-What?!\What's this?\I'll engulf you, just like I did Sesshomaru. response:	W-What?!
context: No problem!\I'm not done yet!\Why you...!\Naraku!\W-What?!\What's this?\I'll engulf you, just like I did Sesshomaru.\W-What?! response:	Sesshomaru?
context: I'm not done yet!\Why you...!\Naraku!\W-What?!\What's this?\I'll engulf you, just like I did Sesshomaru.\W-What?!\Sesshomaru? response:	Naraku's still too much forhim.
context: Why you...!\Naraku!\W-What?!\What's this?\I'll engulf you, just like I did Sesshomaru.\W-What?!\Sesshomaru?\Naraku's still too much forhim. response:	You're too late, Inuyasha.
context: Naraku!\W-What?!\What's this?\I'll engulf you, just like I did Sesshomaru.\W-What?!\Sesshomaru?\Naraku's still too much forhim.\You're too late, Inuyasha. response:	Sesshomaru is already part of my flesh.
context: W-What?!\What's this?\I'll engulf you, just like I did Sesshomaru.\W-What?!\Sesshomaru?\Naraku's still too much forhim.\You're too late, Inuyasha.\Sesshomaru is already part of my flesh. response:	I don't know whatgood your half-demon powerwill do.
context: What's this?\I'll engulf you, just like I did Sesshomaru.\W-What?!\Sesshomaru?\Naraku's still too much forhim.\You're too late, Inuyasha.\Sesshomaru is already part of my flesh.\I don't know whatgood your half-demon powerwill do. response:	But I'll absorb you into me as well.
context: I'll engulf you, just like I did Sesshomaru.\W-What?!\Sesshomaru?\Naraku's still too much forhim.\You're too late, Inuyasha.\Sesshomaru is already part of my flesh.\I don't know whatgood your half-demon powerwill do.\But I'll absorb you into me as well. response:	Don't put me in the same class as that Sesshomaru!
context: W-What?!\Sesshomaru?\Naraku's still too much forhim.\You're too late, Inuyasha.\Sesshomaru is already part of my flesh.\I don't know whatgood your half-demon powerwill do.\But I'll absorb you into me as well.\Don't put me in the same class as that Sesshomaru! response:	Wha...!
context: Sesshomaru?\Naraku's still too much forhim.\You're too late, Inuyasha.\Sesshomaru is already part of my flesh.\I don't know whatgood your half-demon powerwill do.\But I'll absorb you into me as well.\Don't put me in the same class as that Sesshomaru!\Wha...! response:	This is it! No mercy!
context: Naraku's still too much forhim.\You're too late, Inuyasha.\Sesshomaru is already part of my flesh.\I don't know whatgood your half-demon powerwill do.\But I'll absorb you into me as well.\Don't put me in the same class as that Sesshomaru!\Wha...!\This is it! No mercy! response:	Take this!
context: You're too late, Inuyasha.\Sesshomaru is already part of my flesh.\I don't know whatgood your half-demon powerwill do.\But I'll absorb you into me as well.\Don't put me in the same class as that Sesshomaru!\Wha...!\This is it! No mercy!\Take this! response:	What?!
context: Sesshomaru is already part of my flesh.\I don't know whatgood your half-demon powerwill do.\But I'll absorb you into me as well.\Don't put me in the same class as that Sesshomaru!\Wha...!\This is it! No mercy!\Take this!\What?! response:	Lord Sesshomaru!
context: I don't know whatgood your half-demon powerwill do.\But I'll absorb you into me as well.\Don't put me in the same class as that Sesshomaru!\Wha...!\This is it! No mercy!\Take this!\What?!\Lord Sesshomaru! response:	Sesshomaru!
context: But I'll absorb you into me as well.\Don't put me in the same class as that Sesshomaru!\Wha...!\This is it! No mercy!\Take this!\What?!\Lord Sesshomaru!\Sesshomaru! response:	Huh?!
context: Don't put me in the same class as that Sesshomaru!\Wha...!\This is it! No mercy!\Take this!\What?!\Lord Sesshomaru!\Sesshomaru!\Huh?! response:	Lord Sesshomaru!
context: Wha...!\This is it! No mercy!\Take this!\What?!\Lord Sesshomaru!\Sesshomaru!\Huh?!\Lord Sesshomaru! response:	Naraku...
context: This is it! No mercy!\Take this!\What?!\Lord Sesshomaru!\Sesshomaru!\Huh?!\Lord Sesshomaru!\Naraku... response:	Such irony.
context: Take this!\What?!\Lord Sesshomaru!\Sesshomaru!\Huh?!\Lord Sesshomaru!\Naraku...\Such irony. response:	That the flesh which bound me
context: What?!\Lord Sesshomaru!\Sesshomaru!\Huh?!\Lord Sesshomaru!\Naraku...\Such irony.\That the flesh which bound me response:	would shield me against Inuyasha's Wind Scar.
context: Lord Sesshomaru!\Sesshomaru!\Huh?!\Lord Sesshomaru!\Naraku...\Such irony.\That the flesh which bound me\would shield me against Inuyasha's Wind Scar. response:	Move! Naraku's mine!
context: Sesshomaru!\Huh?!\Lord Sesshomaru!\Naraku...\Such irony.\That the flesh which bound me\would shield me against Inuyasha's Wind Scar.\Move! Naraku's mine! response:	No, he is my prey.
context: Huh?!\Lord Sesshomaru!\Naraku...\Such irony.\That the flesh which bound me\would shield me against Inuyasha's Wind Scar.\Move! Naraku's mine!\No, he is my prey. response:	I shall absorb the both of you!
context: Lord Sesshomaru!\Naraku...\Such irony.\That the flesh which bound me\would shield me against Inuyasha's Wind Scar.\Move! Naraku's mine!\No, he is my prey.\I shall absorb the both of you! response:	What?!
context: Naraku...\Such irony.\That the flesh which bound me\would shield me against Inuyasha's Wind Scar.\Move! Naraku's mine!\No, he is my prey.\I shall absorb the both of you!\What?! response:	Die!
context: Such irony.\That the flesh which bound me\would shield me against Inuyasha's Wind Scar.\Move! Naraku's mine!\No, he is my prey.\I shall absorb the both of you!\What?!\Die! response:	You won't be able to escape my attacks forever.
context: That the flesh which bound me\would shield me against Inuyasha's Wind Scar.\Move! Naraku's mine!\No, he is my prey.\I shall absorb the both of you!\What?!\Die!\You won't be able to escape my attacks forever. response:	You're one persistent bastard!
context: would shield me against Inuyasha's Wind Scar.\Move! Naraku's mine!\No, he is my prey.\I shall absorb the both of you!\What?!\Die!\You won't be able to escape my attacks forever.\You're one persistent bastard! response:	Take this and... die!
context: Move! Naraku's mine!\No, he is my prey.\I shall absorb the both of you!\What?!\Die!\You won't be able to escape my attacks forever.\You're one persistent bastard!\Take this and... die! response:	What?!
context: No, he is my prey.\I shall absorb the both of you!\What?!\Die!\You won't be able to escape my attacks forever.\You're one persistent bastard!\Take this and... die!\What?! response:	Finishing blow!
context: I shall absorb the both of you!\What?!\Die!\You won't be able to escape my attacks forever.\You're one persistent bastard!\Take this and... die!\What?!\Finishing blow! response:	I said he's mine!
context: What?!\Die!\You won't be able to escape my attacks forever.\You're one persistent bastard!\Take this and... die!\What?!\Finishing blow!\I said he's mine! response:	What?!
context: Die!\You won't be able to escape my attacks forever.\You're one persistent bastard!\Take this and... die!\What?!\Finishing blow!\I said he's mine!\What?! response:	A miasma!
context: You won't be able to escape my attacks forever.\You're one persistent bastard!\Take this and... die!\What?!\Finishing blow!\I said he's mine!\What?!\A miasma! response:	Lord Sesshomaru. I shall retreat tonight.
context: You're one persistent bastard!\Take this and... die!\What?!\Finishing blow!\I said he's mine!\What?!\A miasma!\Lord Sesshomaru. I shall retreat tonight. response:	Fool!
context: Take this and... die!\What?!\Finishing blow!\I said he's mine!\What?!\A miasma!\Lord Sesshomaru. I shall retreat tonight.\Fool! response:	Don't think you can escape from me!
context: What?!\Finishing blow!\I said he's mine!\What?!\A miasma!\Lord Sesshomaru. I shall retreat tonight.\Fool!\Don't think you can escape from me! response:	Lord Sesshomaru...
context: Finishing blow!\I said he's mine!\What?!\A miasma!\Lord Sesshomaru. I shall retreat tonight.\Fool!\Don't think you can escape from me!\Lord Sesshomaru... response:	Instead of transforming and coming after me,
context: I said he's mine!\What?!\A miasma!\Lord Sesshomaru. I shall retreat tonight.\Fool!\Don't think you can escape from me!\Lord Sesshomaru...\Instead of transforming and coming after me, response:	you should hurry to yourlittle girl companion.
context: What?!\A miasma!\Lord Sesshomaru. I shall retreat tonight.\Fool!\Don't think you can escape from me!\Lord Sesshomaru...\Instead of transforming and coming after me,\you should hurry to yourlittle girl companion. response:	Kohaku?
context: A miasma!\Lord Sesshomaru. I shall retreat tonight.\Fool!\Don't think you can escape from me!\Lord Sesshomaru...\Instead of transforming and coming after me,\you should hurry to yourlittle girl companion.\Kohaku? response:	What's the matter?
context: Lord Sesshomaru. I shall retreat tonight.\Fool!\Don't think you can escape from me!\Lord Sesshomaru...\Instead of transforming and coming after me,\you should hurry to yourlittle girl companion.\Kohaku?\What's the matter? response:	Girl companion? What's he talking about?
context: Fool!\Don't think you can escape from me!\Lord Sesshomaru...\Instead of transforming and coming after me,\you should hurry to yourlittle girl companion.\Kohaku?\What's the matter?\Girl companion? What's he talking about? response:	Rin is currently with one named Kohaku.
context: Don't think you can escape from me!\Lord Sesshomaru...\Instead of transforming and coming after me,\you should hurry to yourlittle girl companion.\Kohaku?\What's the matter?\Girl companion? What's he talking about?\Rin is currently with one named Kohaku. response:	Kohaku?!
context: Lord Sesshomaru...\Instead of transforming and coming after me,\you should hurry to yourlittle girl companion.\Kohaku?\What's the matter?\Girl companion? What's he talking about?\Rin is currently with one named Kohaku.\Kohaku?! response:	Inuyasha, you should know what that means.
context: Instead of transforming and coming after me,\you should hurry to yourlittle girl companion.\Kohaku?\What's the matter?\Girl companion? What's he talking about?\Rin is currently with one named Kohaku.\Kohaku?!\Inuyasha, you should know what that means. response:	Kohaku...
context: you should hurry to yourlittle girl companion.\Kohaku?\What's the matter?\Girl companion? What's he talking about?\Rin is currently with one named Kohaku.\Kohaku?!\Inuyasha, you should know what that means.\Kohaku... response:	Sesshomaru's full-fledged demon power...
context: Kohaku?\What's the matter?\Girl companion? What's he talking about?\Rin is currently with one named Kohaku.\Kohaku?!\Inuyasha, you should know what that means.\Kohaku...\Sesshomaru's full-fledged demon power... response:	I was within grasp of it all!
context: What's the matter?\Girl companion? What's he talking about?\Rin is currently with one named Kohaku.\Kohaku?!\Inuyasha, you should know what that means.\Kohaku...\Sesshomaru's full-fledged demon power...\I was within grasp of it all! response:	But I miscalculated Inuyasha!
context: Girl companion? What's he talking about?\Rin is currently with one named Kohaku.\Kohaku?!\Inuyasha, you should know what that means.\Kohaku...\Sesshomaru's full-fledged demon power...\I was within grasp of it all!\But I miscalculated Inuyasha! response:	I didn't expect him to become this strong.
context: Rin is currently with one named Kohaku.\Kohaku?!\Inuyasha, you should know what that means.\Kohaku...\Sesshomaru's full-fledged demon power...\I was within grasp of it all!\But I miscalculated Inuyasha!\I didn't expect him to become this strong. response:	That Naraku... He's a tough one to deal with.
context: Kohaku?!\Inuyasha, you should know what that means.\Kohaku...\Sesshomaru's full-fledged demon power...\I was within grasp of it all!\But I miscalculated Inuyasha!\I didn't expect him to become this strong.\That Naraku... He's a tough one to deal with. response:	It's gone.
context: Inuyasha, you should know what that means.\Kohaku...\Sesshomaru's full-fledged demon power...\I was within grasp of it all!\But I miscalculated Inuyasha!\I didn't expect him to become this strong.\That Naraku... He's a tough one to deal with.\It's gone. response:	Every scent, every clue of Naraku is gone.
context: Kohaku...\Sesshomaru's full-fledged demon power...\I was within grasp of it all!\But I miscalculated Inuyasha!\I didn't expect him to become this strong.\That Naraku... He's a tough one to deal with.\It's gone.\Every scent, every clue of Naraku is gone. response:	Even though he's badly injured. Where could he have gone?
context: Sesshomaru's full-fledged demon power...\I was within grasp of it all!\But I miscalculated Inuyasha!\I didn't expect him to become this strong.\That Naraku... He's a tough one to deal with.\It's gone.\Every scent, every clue of Naraku is gone.\Even though he's badly injured. Where could he have gone? response:	Hey Sesshomaru!
context: I was within grasp of it all!\But I miscalculated Inuyasha!\I didn't expect him to become this strong.\That Naraku... He's a tough one to deal with.\It's gone.\Every scent, every clue of Naraku is gone.\Even though he's badly injured. Where could he have gone?\Hey Sesshomaru! response:	Did Naraku take a hostage?
context: But I miscalculated Inuyasha!\I didn't expect him to become this strong.\That Naraku... He's a tough one to deal with.\It's gone.\Every scent, every clue of Naraku is gone.\Even though he's badly injured. Where could he have gone?\Hey Sesshomaru!\Did Naraku take a hostage? response:	Is this Rin a friend of yours?
context: I didn't expect him to become this strong.\That Naraku... He's a tough one to deal with.\It's gone.\Every scent, every clue of Naraku is gone.\Even though he's badly injured. Where could he have gone?\Hey Sesshomaru!\Did Naraku take a hostage?\Is this Rin a friend of yours? response:	So Rin was abducted in order to buy time to escape.
context: That Naraku... He's a tough one to deal with.\It's gone.\Every scent, every clue of Naraku is gone.\Even though he's badly injured. Where could he have gone?\Hey Sesshomaru!\Did Naraku take a hostage?\Is this Rin a friend of yours?\So Rin was abducted in order to buy time to escape. response:	Naraku...
context: It's gone.\Every scent, every clue of Naraku is gone.\Even though he's badly injured. Where could he have gone?\Hey Sesshomaru!\Did Naraku take a hostage?\Is this Rin a friend of yours?\So Rin was abducted in order to buy time to escape.\Naraku... response:	He's becoming more and more cunning.
context: Every scent, every clue of Naraku is gone.\Even though he's badly injured. Where could he have gone?\Hey Sesshomaru!\Did Naraku take a hostage?\Is this Rin a friend of yours?\So Rin was abducted in order to buy time to escape.\Naraku...\He's becoming more and more cunning. response:	H-Hey!
context: Even though he's badly injured. Where could he have gone?\Hey Sesshomaru!\Did Naraku take a hostage?\Is this Rin a friend of yours?\So Rin was abducted in order to buy time to escape.\Naraku...\He's becoming more and more cunning.\H-Hey! response:	L-Lord Sesshomaru!
context: Hey Sesshomaru!\Did Naraku take a hostage?\Is this Rin a friend of yours?\So Rin was abducted in order to buy time to escape.\Naraku...\He's becoming more and more cunning.\H-Hey!\L-Lord Sesshomaru! response:	Don't leave me...!
context: Did Naraku take a hostage?\Is this Rin a friend of yours?\So Rin was abducted in order to buy time to escape.\Naraku...\He's becoming more and more cunning.\H-Hey!\L-Lord Sesshomaru!\Don't leave me...! response:	Hey!
context: Is this Rin a friend of yours?\So Rin was abducted in order to buy time to escape.\Naraku...\He's becoming more and more cunning.\H-Hey!\L-Lord Sesshomaru!\Don't leave me...!\Hey! response:	l-Inuyasha!
context: So Rin was abducted in order to buy time to escape.\Naraku...\He's becoming more and more cunning.\H-Hey!\L-Lord Sesshomaru!\Don't leave me...!\Hey!\l-Inuyasha! response:	Damn right! Jaken, explain.
context: Naraku...\He's becoming more and more cunning.\H-Hey!\L-Lord Sesshomaru!\Don't leave me...!\Hey!\l-Inuyasha!\Damn right! Jaken, explain. response:	What happened between Naraku and Sesshomaru?
context: He's becoming more and more cunning.\H-Hey!\L-Lord Sesshomaru!\Don't leave me...!\Hey!\l-Inuyasha!\Damn right! Jaken, explain.\What happened between Naraku and Sesshomaru? response:	If I tell you, it's a long story.
context: H-Hey!\L-Lord Sesshomaru!\Don't leave me...!\Hey!\l-Inuyasha!\Damn right! Jaken, explain.\What happened between Naraku and Sesshomaru?\If I tell you, it's a long story. response:	So make it short.
context: L-Lord Sesshomaru!\Don't leave me...!\Hey!\l-Inuyasha!\Damn right! Jaken, explain.\What happened between Naraku and Sesshomaru?\If I tell you, it's a long story.\So make it short. response:	They're coming!
context: Don't leave me...!\Hey!\l-Inuyasha!\Damn right! Jaken, explain.\What happened between Naraku and Sesshomaru?\If I tell you, it's a long story.\So make it short.\They're coming! response:	Hiraikotsu!
context: Hey!\l-Inuyasha!\Damn right! Jaken, explain.\What happened between Naraku and Sesshomaru?\If I tell you, it's a long story.\So make it short.\They're coming!\Hiraikotsu! response:	I see... They don't want us to get nearthat mansion.
context: l-Inuyasha!\Damn right! Jaken, explain.\What happened between Naraku and Sesshomaru?\If I tell you, it's a long story.\So make it short.\They're coming!\Hiraikotsu!\I see... They don't want us to get nearthat mansion. response:	That's...
context: Damn right! Jaken, explain.\What happened between Naraku and Sesshomaru?\If I tell you, it's a long story.\So make it short.\They're coming!\Hiraikotsu!\I see... They don't want us to get nearthat mansion.\That's... response:	It IS Kohaku!
context: What happened between Naraku and Sesshomaru?\If I tell you, it's a long story.\So make it short.\They're coming!\Hiraikotsu!\I see... They don't want us to get nearthat mansion.\That's...\It IS Kohaku! response:	With a little girl!
context: If I tell you, it's a long story.\So make it short.\They're coming!\Hiraikotsu!\I see... They don't want us to get nearthat mansion.\That's...\It IS Kohaku!\With a little girl! response:	That girl...
context: So make it short.\They're coming!\Hiraikotsu!\I see... They don't want us to get nearthat mansion.\That's...\It IS Kohaku!\With a little girl!\That girl... response:	I've seen her before.
context: They're coming!\Hiraikotsu!\I see... They don't want us to get nearthat mansion.\That's...\It IS Kohaku!\With a little girl!\That girl...\I've seen her before. response:	Kohaku!
context: Hiraikotsu!\I see... They don't want us to get nearthat mansion.\That's...\It IS Kohaku!\With a little girl!\That girl...\I've seen her before.\Kohaku! response:	Damn! Get out of my way!
context: I see... They don't want us to get nearthat mansion.\That's...\It IS Kohaku!\With a little girl!\That girl...\I've seen her before.\Kohaku!\Damn! Get out of my way! response:	We have to go after them!
context: That's...\It IS Kohaku!\With a little girl!\That girl...\I've seen her before.\Kohaku!\Damn! Get out of my way!\We have to go after them! response:	Kagome!
context: It IS Kohaku!\With a little girl!\That girl...\I've seen her before.\Kohaku!\Damn! Get out of my way!\We have to go after them!\Kagome! response:	Iron-reaver, Soul-stealer!
context: With a little girl!\That girl...\I've seen her before.\Kohaku!\Damn! Get out of my way!\We have to go after them!\Kagome!\Iron-reaver, Soul-stealer! response:	Inuyasha!
context: That girl...\I've seen her before.\Kohaku!\Damn! Get out of my way!\We have to go after them!\Kagome!\Iron-reaver, Soul-stealer!\Inuyasha! response:	Kagome!
context: I've seen her before.\Kohaku!\Damn! Get out of my way!\We have to go after them!\Kagome!\Iron-reaver, Soul-stealer!\Inuyasha!\Kagome! response:	Kohaku was here, wasn't he?
context: Kohaku!\Damn! Get out of my way!\We have to go after them!\Kagome!\Iron-reaver, Soul-stealer!\Inuyasha!\Kagome!\Kohaku was here, wasn't he? response:	We can still catch him.
context: Damn! Get out of my way!\We have to go after them!\Kagome!\Iron-reaver, Soul-stealer!\Inuyasha!\Kagome!\Kohaku was here, wasn't he?\We can still catch him. response:	I can sense the Sacred Jewel shard close by.
context: We have to go after them!\Kagome!\Iron-reaver, Soul-stealer!\Inuyasha!\Kagome!\Kohaku was here, wasn't he?\We can still catch him.\I can sense the Sacred Jewel shard close by. response:	Inuyasha!
context: Kagome!\Iron-reaver, Soul-stealer!\Inuyasha!\Kagome!\Kohaku was here, wasn't he?\We can still catch him.\I can sense the Sacred Jewel shard close by.\Inuyasha! response:	I'm going ahead! The fasterthe better!
context: Iron-reaver, Soul-stealer!\Inuyasha!\Kagome!\Kohaku was here, wasn't he?\We can still catch him.\I can sense the Sacred Jewel shard close by.\Inuyasha!\I'm going ahead! The fasterthe better! response:	Kohaku's mind is controlled by Naraku.
context: Inuyasha!\Kagome!\Kohaku was here, wasn't he?\We can still catch him.\I can sense the Sacred Jewel shard close by.\Inuyasha!\I'm going ahead! The fasterthe better!\Kohaku's mind is controlled by Naraku. response:	Yeah! Naraku probably made a hypnotic suggestion to him...
context: Kagome!\Kohaku was here, wasn't he?\We can still catch him.\I can sense the Sacred Jewel shard close by.\Inuyasha!\I'm going ahead! The fasterthe better!\Kohaku's mind is controlled by Naraku.\Yeah! Naraku probably made a hypnotic suggestion to him... response:	to kill the hostage.
context: Kohaku was here, wasn't he?\We can still catch him.\I can sense the Sacred Jewel shard close by.\Inuyasha!\I'm going ahead! The fasterthe better!\Kohaku's mind is controlled by Naraku.\Yeah! Naraku probably made a hypnotic suggestion to him...\to kill the hostage. response:	In orderto buy time to escape from Sesshomaru,
context: We can still catch him.\I can sense the Sacred Jewel shard close by.\Inuyasha!\I'm going ahead! The fasterthe better!\Kohaku's mind is controlled by Naraku.\Yeah! Naraku probably made a hypnotic suggestion to him...\to kill the hostage.\In orderto buy time to escape from Sesshomaru, response:	Naraku had the girl kidnapped.
context: I can sense the Sacred Jewel shard close by.\Inuyasha!\I'm going ahead! The fasterthe better!\Kohaku's mind is controlled by Naraku.\Yeah! Naraku probably made a hypnotic suggestion to him...\to kill the hostage.\In orderto buy time to escape from Sesshomaru,\Naraku had the girl kidnapped. response:	Then...
context: Inuyasha!\I'm going ahead! The fasterthe better!\Kohaku's mind is controlled by Naraku.\Yeah! Naraku probably made a hypnotic suggestion to him...\to kill the hostage.\In orderto buy time to escape from Sesshomaru,\Naraku had the girl kidnapped.\Then... response:	the child with Kohaku is Sesshomaru's?
context: I'm going ahead! The fasterthe better!\Kohaku's mind is controlled by Naraku.\Yeah! Naraku probably made a hypnotic suggestion to him...\to kill the hostage.\In orderto buy time to escape from Sesshomaru,\Naraku had the girl kidnapped.\Then...\the child with Kohaku is Sesshomaru's? response:	He considers humans no better than worms.
context: Kohaku's mind is controlled by Naraku.\Yeah! Naraku probably made a hypnotic suggestion to him...\to kill the hostage.\In orderto buy time to escape from Sesshomaru,\Naraku had the girl kidnapped.\Then...\the child with Kohaku is Sesshomaru's?\He considers humans no better than worms. response:	So I can't believe that he'd have a mortal at his side.
context: Yeah! Naraku probably made a hypnotic suggestion to him...\to kill the hostage.\In orderto buy time to escape from Sesshomaru,\Naraku had the girl kidnapped.\Then...\the child with Kohaku is Sesshomaru's?\He considers humans no better than worms.\So I can't believe that he'd have a mortal at his side. response:	But there's no way he'd let Kohaku live...
context: to kill the hostage.\In orderto buy time to escape from Sesshomaru,\Naraku had the girl kidnapped.\Then...\the child with Kohaku is Sesshomaru's?\He considers humans no better than worms.\So I can't believe that he'd have a mortal at his side.\But there's no way he'd let Kohaku live... response:	not afterwhat Naraku did.
context: In orderto buy time to escape from Sesshomaru,\Naraku had the girl kidnapped.\Then...\the child with Kohaku is Sesshomaru's?\He considers humans no better than worms.\So I can't believe that he'd have a mortal at his side.\But there's no way he'd let Kohaku live...\not afterwhat Naraku did. response:	Sesshomaru will kill Kohaku!
context: Naraku had the girl kidnapped.\Then...\the child with Kohaku is Sesshomaru's?\He considers humans no better than worms.\So I can't believe that he'd have a mortal at his side.\But there's no way he'd let Kohaku live...\not afterwhat Naraku did.\Sesshomaru will kill Kohaku! response:	Sango's younger brother...
context: Then...\the child with Kohaku is Sesshomaru's?\He considers humans no better than worms.\So I can't believe that he'd have a mortal at his side.\But there's no way he'd let Kohaku live...\not afterwhat Naraku did.\Sesshomaru will kill Kohaku!\Sango's younger brother... response:	Killed by your olderbrother?
context: the child with Kohaku is Sesshomaru's?\He considers humans no better than worms.\So I can't believe that he'd have a mortal at his side.\But there's no way he'd let Kohaku live...\not afterwhat Naraku did.\Sesshomaru will kill Kohaku!\Sango's younger brother...\Killed by your olderbrother? response:	Whatever the case, it'll only end up in tragedy.
context: He considers humans no better than worms.\So I can't believe that he'd have a mortal at his side.\But there's no way he'd let Kohaku live...\not afterwhat Naraku did.\Sesshomaru will kill Kohaku!\Sango's younger brother...\Killed by your olderbrother?\Whatever the case, it'll only end up in tragedy. response:	We have to reach Kohaku before Sesshomaru.
context: So I can't believe that he'd have a mortal at his side.\But there's no way he'd let Kohaku live...\not afterwhat Naraku did.\Sesshomaru will kill Kohaku!\Sango's younger brother...\Killed by your olderbrother?\Whatever the case, it'll only end up in tragedy.\We have to reach Kohaku before Sesshomaru. response:	Right!
context: But there's no way he'd let Kohaku live...\not afterwhat Naraku did.\Sesshomaru will kill Kohaku!\Sango's younger brother...\Killed by your olderbrother?\Whatever the case, it'll only end up in tragedy.\We have to reach Kohaku before Sesshomaru.\Right! response:	I'm the only one who can stop Sesshomaru.
context: not afterwhat Naraku did.\Sesshomaru will kill Kohaku!\Sango's younger brother...\Killed by your olderbrother?\Whatever the case, it'll only end up in tragedy.\We have to reach Kohaku before Sesshomaru.\Right!\I'm the only one who can stop Sesshomaru. response:	Tell me, why did we run away?
context: Sesshomaru will kill Kohaku!\Sango's younger brother...\Killed by your olderbrother?\Whatever the case, it'll only end up in tragedy.\We have to reach Kohaku before Sesshomaru.\Right!\I'm the only one who can stop Sesshomaru.\Tell me, why did we run away? response:	Someone was outside the mansion.
context: Sango's younger brother...\Killed by your olderbrother?\Whatever the case, it'll only end up in tragedy.\We have to reach Kohaku before Sesshomaru.\Right!\I'm the only one who can stop Sesshomaru.\Tell me, why did we run away?\Someone was outside the mansion. response:	Where are we going?
context: Killed by your olderbrother?\Whatever the case, it'll only end up in tragedy.\We have to reach Kohaku before Sesshomaru.\Right!\I'm the only one who can stop Sesshomaru.\Tell me, why did we run away?\Someone was outside the mansion.\Where are we going? response:	Tell me, Kohaku!
context: Whatever the case, it'll only end up in tragedy.\We have to reach Kohaku before Sesshomaru.\Right!\I'm the only one who can stop Sesshomaru.\Tell me, why did we run away?\Someone was outside the mansion.\Where are we going?\Tell me, Kohaku! response:	Huh?
context: We have to reach Kohaku before Sesshomaru.\Right!\I'm the only one who can stop Sesshomaru.\Tell me, why did we run away?\Someone was outside the mansion.\Where are we going?\Tell me, Kohaku!\Huh? response:	Kill her!
context: Right!\I'm the only one who can stop Sesshomaru.\Tell me, why did we run away?\Someone was outside the mansion.\Where are we going?\Tell me, Kohaku!\Huh?\Kill her! response:	K-Kohaku...
context: I'm the only one who can stop Sesshomaru.\Tell me, why did we run away?\Someone was outside the mansion.\Where are we going?\Tell me, Kohaku!\Huh?\Kill her!\K-Kohaku... response:	W-What's wrong with you, Kohaku?!
context: Tell me, why did we run away?\Someone was outside the mansion.\Where are we going?\Tell me, Kohaku!\Huh?\Kill her!\K-Kohaku...\W-What's wrong with you, Kohaku?! response:	Kill her!
context: Someone was outside the mansion.\Where are we going?\Tell me, Kohaku!\Huh?\Kill her!\K-Kohaku...\W-What's wrong with you, Kohaku?!\Kill her! response:	So... You turn yourblade towards me now?
context: Where are we going?\Tell me, Kohaku!\Huh?\Kill her!\K-Kohaku...\W-What's wrong with you, Kohaku?!\Kill her!\So... You turn yourblade towards me now? response:	Kohaku!
context: Tell me, Kohaku!\Huh?\Kill her!\K-Kohaku...\W-What's wrong with you, Kohaku?!\Kill her!\So... You turn yourblade towards me now?\Kohaku! response:	Why you...!
context: Huh?\Kill her!\K-Kohaku...\W-What's wrong with you, Kohaku?!\Kill her!\So... You turn yourblade towards me now?\Kohaku!\Why you...! response:	What're you doing, fool?!
context: Kill her!\K-Kohaku...\W-What's wrong with you, Kohaku?!\Kill her!\So... You turn yourblade towards me now?\Kohaku!\Why you...!\What're you doing, fool?! response:	She's all right. She just fainted.
context: K-Kohaku...\W-What's wrong with you, Kohaku?!\Kill her!\So... You turn yourblade towards me now?\Kohaku!\Why you...!\What're you doing, fool?!\She's all right. She just fainted. response:	We made it in time!
context: W-What's wrong with you, Kohaku?!\Kill her!\So... You turn yourblade towards me now?\Kohaku!\Why you...!\What're you doing, fool?!\She's all right. She just fainted.\We made it in time! response:	You heard her, Sesshomaru.
context: Kill her!\So... You turn yourblade towards me now?\Kohaku!\Why you...!\What're you doing, fool?!\She's all right. She just fainted.\We made it in time!\You heard her, Sesshomaru. response:	So don't lay a hand on Kohaku.
context: So... You turn yourblade towards me now?\Kohaku!\Why you...!\What're you doing, fool?!\She's all right. She just fainted.\We made it in time!\You heard her, Sesshomaru.\So don't lay a hand on Kohaku. response:	It's useless, Inuyasha.
context: Kohaku!\Why you...!\What're you doing, fool?!\She's all right. She just fainted.\We made it in time!\You heard her, Sesshomaru.\So don't lay a hand on Kohaku.\It's useless, Inuyasha. response:	Even if you intervene,
context: Why you...!\What're you doing, fool?!\She's all right. She just fainted.\We made it in time!\You heard her, Sesshomaru.\So don't lay a hand on Kohaku.\It's useless, Inuyasha.\Even if you intervene, response:	that boy seems compelled to die by my hands.
context: What're you doing, fool?!\She's all right. She just fainted.\We made it in time!\You heard her, Sesshomaru.\So don't lay a hand on Kohaku.\It's useless, Inuyasha.\Even if you intervene,\that boy seems compelled to die by my hands. response:	This must be anotherhypnotic suggestion by Naraku...
context: She's all right. She just fainted.\We made it in time!\You heard her, Sesshomaru.\So don't lay a hand on Kohaku.\It's useless, Inuyasha.\Even if you intervene,\that boy seems compelled to die by my hands.\This must be anotherhypnotic suggestion by Naraku... response:	to attack Sesshomaru and be killed.
context: We made it in time!\You heard her, Sesshomaru.\So don't lay a hand on Kohaku.\It's useless, Inuyasha.\Even if you intervene,\that boy seems compelled to die by my hands.\This must be anotherhypnotic suggestion by Naraku...\to attack Sesshomaru and be killed. response:	You disarmed the boy.
context: You heard her, Sesshomaru.\So don't lay a hand on Kohaku.\It's useless, Inuyasha.\Even if you intervene,\that boy seems compelled to die by my hands.\This must be anotherhypnotic suggestion by Naraku...\to attack Sesshomaru and be killed.\You disarmed the boy. response:	Inuyasha, I didn't think you had such strong feelings forme, your brother.
context: So don't lay a hand on Kohaku.\It's useless, Inuyasha.\Even if you intervene,\that boy seems compelled to die by my hands.\This must be anotherhypnotic suggestion by Naraku...\to attack Sesshomaru and be killed.\You disarmed the boy.\Inuyasha, I didn't think you had such strong feelings forme, your brother. response:	In yourdreams!
context: It's useless, Inuyasha.\Even if you intervene,\that boy seems compelled to die by my hands.\This must be anotherhypnotic suggestion by Naraku...\to attack Sesshomaru and be killed.\You disarmed the boy.\Inuyasha, I didn't think you had such strong feelings forme, your brother.\In yourdreams! response:	If you don't let him go, I'll kill you!
context: Even if you intervene,\that boy seems compelled to die by my hands.\This must be anotherhypnotic suggestion by Naraku...\to attack Sesshomaru and be killed.\You disarmed the boy.\Inuyasha, I didn't think you had such strong feelings forme, your brother.\In yourdreams!\If you don't let him go, I'll kill you! response:	Stop, Sesshomaru!
context: that boy seems compelled to die by my hands.\This must be anotherhypnotic suggestion by Naraku...\to attack Sesshomaru and be killed.\You disarmed the boy.\Inuyasha, I didn't think you had such strong feelings forme, your brother.\In yourdreams!\If you don't let him go, I'll kill you!\Stop, Sesshomaru! response:	Enough, Sesshomaru!
context: This must be anotherhypnotic suggestion by Naraku...\to attack Sesshomaru and be killed.\You disarmed the boy.\Inuyasha, I didn't think you had such strong feelings forme, your brother.\In yourdreams!\If you don't let him go, I'll kill you!\Stop, Sesshomaru!\Enough, Sesshomaru! response:	This boy...
context: to attack Sesshomaru and be killed.\You disarmed the boy.\Inuyasha, I didn't think you had such strong feelings forme, your brother.\In yourdreams!\If you don't let him go, I'll kill you!\Stop, Sesshomaru!\Enough, Sesshomaru!\This boy... response:	He has no suffering... has no fear.
context: You disarmed the boy.\Inuyasha, I didn't think you had such strong feelings forme, your brother.\In yourdreams!\If you don't let him go, I'll kill you!\Stop, Sesshomaru!\Enough, Sesshomaru!\This boy...\He has no suffering... has no fear. response:	I don't like... his eyes.
context: Inuyasha, I didn't think you had such strong feelings forme, your brother.\In yourdreams!\If you don't let him go, I'll kill you!\Stop, Sesshomaru!\Enough, Sesshomaru!\This boy...\He has no suffering... has no fear.\I don't like... his eyes. response:	Oh, you're conscious.
context: In yourdreams!\If you don't let him go, I'll kill you!\Stop, Sesshomaru!\Enough, Sesshomaru!\This boy...\He has no suffering... has no fear.\I don't like... his eyes.\Oh, you're conscious. response:	Lord Sesshomaru!
context: If you don't let him go, I'll kill you!\Stop, Sesshomaru!\Enough, Sesshomaru!\This boy...\He has no suffering... has no fear.\I don't like... his eyes.\Oh, you're conscious.\Lord Sesshomaru! response:	Huh?
context: Stop, Sesshomaru!\Enough, Sesshomaru!\This boy...\He has no suffering... has no fear.\I don't like... his eyes.\Oh, you're conscious.\Lord Sesshomaru!\Huh? response:	Kohaku...
context: Enough, Sesshomaru!\This boy...\He has no suffering... has no fear.\I don't like... his eyes.\Oh, you're conscious.\Lord Sesshomaru!\Huh?\Kohaku... response:	Aren't you going afterhim?
context: This boy...\He has no suffering... has no fear.\I don't like... his eyes.\Oh, you're conscious.\Lord Sesshomaru!\Huh?\Kohaku...\Aren't you going afterhim? response:	Kagura?!
context: He has no suffering... has no fear.\I don't like... his eyes.\Oh, you're conscious.\Lord Sesshomaru!\Huh?\Kohaku...\Aren't you going afterhim?\Kagura?! response:	Um... thank you... forforgiving Kohaku.
context: I don't like... his eyes.\Oh, you're conscious.\Lord Sesshomaru!\Huh?\Kohaku...\Aren't you going afterhim?\Kagura?!\Um... thank you... forforgiving Kohaku. response:	That boy tried to die at my hands.
context: Oh, you're conscious.\Lord Sesshomaru!\Huh?\Kohaku...\Aren't you going afterhim?\Kagura?!\Um... thank you... forforgiving Kohaku.\That boy tried to die at my hands. response:	Sesshomaru, you... knew?
context: Lord Sesshomaru!\Huh?\Kohaku...\Aren't you going afterhim?\Kagura?!\Um... thank you... forforgiving Kohaku.\That boy tried to die at my hands.\Sesshomaru, you... knew? response:	I don't want to play into Naraku's treacherous hands. That's all.
context: Huh?\Kohaku...\Aren't you going afterhim?\Kagura?!\Um... thank you... forforgiving Kohaku.\That boy tried to die at my hands.\Sesshomaru, you... knew?\I don't want to play into Naraku's treacherous hands. That's all. response:	Good bye!
context: Kohaku...\Aren't you going afterhim?\Kagura?!\Um... thank you... forforgiving Kohaku.\That boy tried to die at my hands.\Sesshomaru, you... knew?\I don't want to play into Naraku's treacherous hands. That's all.\Good bye! response:	She went with him.
context: Aren't you going afterhim?\Kagura?!\Um... thank you... forforgiving Kohaku.\That boy tried to die at my hands.\Sesshomaru, you... knew?\I don't want to play into Naraku's treacherous hands. That's all.\Good bye!\She went with him. response:	I see...
context: Kagura?!\Um... thank you... forforgiving Kohaku.\That boy tried to die at my hands.\Sesshomaru, you... knew?\I don't want to play into Naraku's treacherous hands. That's all.\Good bye!\She went with him.\I see... response:	So Kohaku went away again.
context: Um... thank you... forforgiving Kohaku.\That boy tried to die at my hands.\Sesshomaru, you... knew?\I don't want to play into Naraku's treacherous hands. That's all.\Good bye!\She went with him.\I see...\So Kohaku went away again. response:	Forgive me!
context: That boy tried to die at my hands.\Sesshomaru, you... knew?\I don't want to play into Naraku's treacherous hands. That's all.\Good bye!\She went with him.\I see...\So Kohaku went away again.\Forgive me! response:	If I had killed Naraku, Kohaku would also...
context: Sesshomaru, you... knew?\I don't want to play into Naraku's treacherous hands. That's all.\Good bye!\She went with him.\I see...\So Kohaku went away again.\Forgive me!\If I had killed Naraku, Kohaku would also... response:	No, if we had stopped him...
context: I don't want to play into Naraku's treacherous hands. That's all.\Good bye!\She went with him.\I see...\So Kohaku went away again.\Forgive me!\If I had killed Naraku, Kohaku would also...\No, if we had stopped him... response:	It can't be helped.
context: Good bye!\She went with him.\I see...\So Kohaku went away again.\Forgive me!\If I had killed Naraku, Kohaku would also...\No, if we had stopped him...\It can't be helped. response:	As long as he's alive.
context: She went with him.\I see...\So Kohaku went away again.\Forgive me!\If I had killed Naraku, Kohaku would also...\No, if we had stopped him...\It can't be helped.\As long as he's alive. response:	That Naraku... Where'd he disappearto?
context: I see...\So Kohaku went away again.\Forgive me!\If I had killed Naraku, Kohaku would also...\No, if we had stopped him...\It can't be helped.\As long as he's alive.\That Naraku... Where'd he disappearto? response:	With a wound that serious,
context: So Kohaku went away again.\Forgive me!\If I had killed Naraku, Kohaku would also...\No, if we had stopped him...\It can't be helped.\As long as he's alive.\That Naraku... Where'd he disappearto?\With a wound that serious, response:	he can't be able to put up a strong barrier.
context: Forgive me!\If I had killed Naraku, Kohaku would also...\No, if we had stopped him...\It can't be helped.\As long as he's alive.\That Naraku... Where'd he disappearto?\With a wound that serious,\he can't be able to put up a strong barrier. response:	Just where?
context: If I had killed Naraku, Kohaku would also...\No, if we had stopped him...\It can't be helped.\As long as he's alive.\That Naraku... Where'd he disappearto?\With a wound that serious,\he can't be able to put up a strong barrier.\Just where? response:	Did Naraku lift the barrier, leaving the castle visible?
context: No, if we had stopped him...\It can't be helped.\As long as he's alive.\That Naraku... Where'd he disappearto?\With a wound that serious,\he can't be able to put up a strong barrier.\Just where?\Did Naraku lift the barrier, leaving the castle visible? response:	That means... that this castle has been abandoned.
context: It can't be helped.\As long as he's alive.\That Naraku... Where'd he disappearto?\With a wound that serious,\he can't be able to put up a strong barrier.\Just where?\Did Naraku lift the barrier, leaving the castle visible?\That means... that this castle has been abandoned. response:	That he is hiding himself somewhere else.
context: As long as he's alive.\That Naraku... Where'd he disappearto?\With a wound that serious,\he can't be able to put up a strong barrier.\Just where?\Did Naraku lift the barrier, leaving the castle visible?\That means... that this castle has been abandoned.\That he is hiding himself somewhere else. response:	Strange...
context: That Naraku... Where'd he disappearto?\With a wound that serious,\he can't be able to put up a strong barrier.\Just where?\Did Naraku lift the barrier, leaving the castle visible?\That means... that this castle has been abandoned.\That he is hiding himself somewhere else.\Strange... response:	No matterwhere he moved to,
context: With a wound that serious,\he can't be able to put up a strong barrier.\Just where?\Did Naraku lift the barrier, leaving the castle visible?\That means... that this castle has been abandoned.\That he is hiding himself somewhere else.\Strange...\No matterwhere he moved to, response:	I was always able to sense his barrier.
context: he can't be able to put up a strong barrier.\Just where?\Did Naraku lift the barrier, leaving the castle visible?\That means... that this castle has been abandoned.\That he is hiding himself somewhere else.\Strange...\No matterwhere he moved to,\I was always able to sense his barrier. response:	Yet...
context: Just where?\Did Naraku lift the barrier, leaving the castle visible?\That means... that this castle has been abandoned.\That he is hiding himself somewhere else.\Strange...\No matterwhere he moved to,\I was always able to sense his barrier.\Yet... response:	As though he disappeared into thin air,
context: Did Naraku lift the barrier, leaving the castle visible?\That means... that this castle has been abandoned.\That he is hiding himself somewhere else.\Strange...\No matterwhere he moved to,\I was always able to sense his barrier.\Yet...\As though he disappeared into thin air, response:	there's no trace of Naraku.
context: That means... that this castle has been abandoned.\That he is hiding himself somewhere else.\Strange...\No matterwhere he moved to,\I was always able to sense his barrier.\Yet...\As though he disappeared into thin air,\there's no trace of Naraku. response:	There's something to this.
context: That he is hiding himself somewhere else.\Strange...\No matterwhere he moved to,\I was always able to sense his barrier.\Yet...\As though he disappeared into thin air,\there's no trace of Naraku.\There's something to this. response:	Damn that Naraku!
context: Strange...\No matterwhere he moved to,\I was always able to sense his barrier.\Yet...\As though he disappeared into thin air,\there's no trace of Naraku.\There's something to this.\Damn that Naraku! response:	Afterwe almost had him cornered!
context: No matterwhere he moved to,\I was always able to sense his barrier.\Yet...\As though he disappeared into thin air,\there's no trace of Naraku.\There's something to this.\Damn that Naraku!\Afterwe almost had him cornered! response:	Is it really okay to return to the present age?
context: I was always able to sense his barrier.\Yet...\As though he disappeared into thin air,\there's no trace of Naraku.\There's something to this.\Damn that Naraku!\Afterwe almost had him cornered!\Is it really okay to return to the present age? response:	Hey! Kagome! Haven't we changed places?
context: Yet...\As though he disappeared into thin air,\there's no trace of Naraku.\There's something to this.\Damn that Naraku!\Afterwe almost had him cornered!\Is it really okay to return to the present age?\Hey! Kagome! Haven't we changed places? response:	You're right! How'll we do the preview?
context: As though he disappeared into thin air,\there's no trace of Naraku.\There's something to this.\Damn that Naraku!\Afterwe almost had him cornered!\Is it really okay to return to the present age?\Hey! Kagome! Haven't we changed places?\You're right! How'll we do the preview? response:	We've got no choice, just do it.
context: there's no trace of Naraku.\There's something to this.\Damn that Naraku!\Afterwe almost had him cornered!\Is it really okay to return to the present age?\Hey! Kagome! Haven't we changed places?\You're right! How'll we do the preview?\We've got no choice, just do it. response:	Next on Inuyasha: Gap Between the Ages
context: There's something to this.\Damn that Naraku!\Afterwe almost had him cornered!\Is it really okay to return to the present age?\Hey! Kagome! Haven't we changed places?\You're right! How'll we do the preview?\We've got no choice, just do it.\Next on Inuyasha: Gap Between the Ages response:	Look forward to it!
context: Damn that Naraku!\Afterwe almost had him cornered!\Is it really okay to return to the present age?\Hey! Kagome! Haven't we changed places?\You're right! How'll we do the preview?\We've got no choice, just do it.\Next on Inuyasha: Gap Between the Ages\Look forward to it! response:	Hey, I ain't taking no test!
context: Afterwe almost had him cornered!\Is it really okay to return to the present age?\Hey! Kagome! Haven't we changed places?\You're right! How'll we do the preview?\We've got no choice, just do it.\Next on Inuyasha: Gap Between the Ages\Look forward to it!\Hey, I ain't taking no test! response:	Oh, we're back to normal.