context: Hanasaku Iroha response:	Mom,
context: Hanasaku Iroha\Mom, response:	I'm not actually your child.
context: Hanasaku Iroha\Mom,\I'm not actually your child. response:	Your friend, an ailing jazz singer,
context: Hanasaku Iroha\Mom,\I'm not actually your child.\Your friend, an ailing jazz singer, response:	had a child with an American soldier who arrived at port.
context: Hanasaku Iroha\Mom,\I'm not actually your child.\Your friend, an ailing jazz singer,\had a child with an American soldier who arrived at port. response:	First of all, I don't have female friends.
context: Hanasaku Iroha\Mom,\I'm not actually your child.\Your friend, an ailing jazz singer,\had a child with an American soldier who arrived at port.\First of all, I don't have female friends. response:	Secondly, that's not something a child confesses to their mother.
context: Hanasaku Iroha\Mom,\I'm not actually your child.\Your friend, an ailing jazz singer,\had a child with an American soldier who arrived at port.\First of all, I don't have female friends.\Secondly, that's not something a child confesses to their mother. response:	Was worth a shot.
context: Hanasaku Iroha\Mom,\I'm not actually your child.\Your friend, an ailing jazz singer,\had a child with an American soldier who arrived at port.\First of all, I don't have female friends.\Secondly, that's not something a child confesses to their mother.\Was worth a shot. response:	Little miss Ohana, do you know how babies are made?
context: Mom,\I'm not actually your child.\Your friend, an ailing jazz singer,\had a child with an American soldier who arrived at port.\First of all, I don't have female friends.\Secondly, that's not something a child confesses to their mother.\Was worth a shot.\Little miss Ohana, do you know how babies are made? response:	I prefer the stork theory over the cabbage patch theory.
context: I'm not actually your child.\Your friend, an ailing jazz singer,\had a child with an American soldier who arrived at port.\First of all, I don't have female friends.\Secondly, that's not something a child confesses to their mother.\Was worth a shot.\Little miss Ohana, do you know how babies are made?\I prefer the stork theory over the cabbage patch theory. response:	Same here.
context: Your friend, an ailing jazz singer,\had a child with an American soldier who arrived at port.\First of all, I don't have female friends.\Secondly, that's not something a child confesses to their mother.\Was worth a shot.\Little miss Ohana, do you know how babies are made?\I prefer the stork theory over the cabbage patch theory.\Same here. response:	Digging up babies from a cabbage patch sounds quite deranged.
context: had a child with an American soldier who arrived at port.\First of all, I don't have female friends.\Secondly, that's not something a child confesses to their mother.\Was worth a shot.\Little miss Ohana, do you know how babies are made?\I prefer the stork theory over the cabbage patch theory.\Same here.\Digging up babies from a cabbage patch sounds quite deranged. response:	Crap, a deadline reminder call!
context: First of all, I don't have female friends.\Secondly, that's not something a child confesses to their mother.\Was worth a shot.\Little miss Ohana, do you know how babies are made?\I prefer the stork theory over the cabbage patch theory.\Same here.\Digging up babies from a cabbage patch sounds quite deranged.\Crap, a deadline reminder call! response:	Quick! Get it!
context: Secondly, that's not something a child confesses to their mother.\Was worth a shot.\Little miss Ohana, do you know how babies are made?\I prefer the stork theory over the cabbage patch theory.\Same here.\Digging up babies from a cabbage patch sounds quite deranged.\Crap, a deadline reminder call!\Quick! Get it! response:	Me?
context: Was worth a shot.\Little miss Ohana, do you know how babies are made?\I prefer the stork theory over the cabbage patch theory.\Same here.\Digging up babies from a cabbage patch sounds quite deranged.\Crap, a deadline reminder call!\Quick! Get it!\Me? response:	Just do it!
context: Little miss Ohana, do you know how babies are made?\I prefer the stork theory over the cabbage patch theory.\Same here.\Digging up babies from a cabbage patch sounds quite deranged.\Crap, a deadline reminder call!\Quick! Get it!\Me?\Just do it! response:	But my hands are wet!
context: I prefer the stork theory over the cabbage patch theory.\Same here.\Digging up babies from a cabbage patch sounds quite deranged.\Crap, a deadline reminder call!\Quick! Get it!\Me?\Just do it!\But my hands are wet! response:	Hello, Matsumae residence.
context: Same here.\Digging up babies from a cabbage patch sounds quite deranged.\Crap, a deadline reminder call!\Quick! Get it!\Me?\Just do it!\But my hands are wet!\Hello, Matsumae residence. response:	Oh, hi.
context: Digging up babies from a cabbage patch sounds quite deranged.\Crap, a deadline reminder call!\Quick! Get it!\Me?\Just do it!\But my hands are wet!\Hello, Matsumae residence.\Oh, hi. response:	It's your boyfriend.
context: Crap, a deadline reminder call!\Quick! Get it!\Me?\Just do it!\But my hands are wet!\Hello, Matsumae residence.\Oh, hi.\It's your boyfriend. response:	What?
context: Quick! Get it!\Me?\Just do it!\But my hands are wet!\Hello, Matsumae residence.\Oh, hi.\It's your boyfriend.\What? response:	Sorry, honey!
context: Me?\Just do it!\But my hands are wet!\Hello, Matsumae residence.\Oh, hi.\It's your boyfriend.\What?\Sorry, honey! response:	I've been so busy!
context: Just do it!\But my hands are wet!\Hello, Matsumae residence.\Oh, hi.\It's your boyfriend.\What?\Sorry, honey!\I've been so busy! response:	The editors are being so mean to me!
context: But my hands are wet!\Hello, Matsumae residence.\Oh, hi.\It's your boyfriend.\What?\Sorry, honey!\I've been so busy!\The editors are being so mean to me! response:	Are you coming over tonight?
context: Hello, Matsumae residence.\Oh, hi.\It's your boyfriend.\What?\Sorry, honey!\I've been so busy!\The editors are being so mean to me!\Are you coming over tonight? response:	What? If we need to talk, let's do it over a drink.
context: Oh, hi.\It's your boyfriend.\What?\Sorry, honey!\I've been so busy!\The editors are being so mean to me!\Are you coming over tonight?\What? If we need to talk, let's do it over a drink. response:	There will be dinner.
context: It's your boyfriend.\What?\Sorry, honey!\I've been so busy!\The editors are being so mean to me!\Are you coming over tonight?\What? If we need to talk, let's do it over a drink.\There will be dinner. response:	Episode 1: It's Spring, I'm 16, and I'm Still a Bud
context: What?\Sorry, honey!\I've been so busy!\The editors are being so mean to me!\Are you coming over tonight?\What? If we need to talk, let's do it over a drink.\There will be dinner.\Episode 1: It's Spring, I'm 16, and I'm Still a Bud response:	Made by Ohana.
context: Sorry, honey!\I've been so busy!\The editors are being so mean to me!\Are you coming over tonight?\What? If we need to talk, let's do it over a drink.\There will be dinner.\Episode 1: It's Spring, I'm 16, and I'm Still a Bud\Made by Ohana. response:	Ko, I've got a question.
context: I've been so busy!\The editors are being so mean to me!\Are you coming over tonight?\What? If we need to talk, let's do it over a drink.\There will be dinner.\Episode 1: It's Spring, I'm 16, and I'm Still a Bud\Made by Ohana.\Ko, I've got a question. response:	Yeah?
context: The editors are being so mean to me!\Are you coming over tonight?\What? If we need to talk, let's do it over a drink.\There will be dinner.\Episode 1: It's Spring, I'm 16, and I'm Still a Bud\Made by Ohana.\Ko, I've got a question.\Yeah? response:	How do you eat the corn kernels in canned soup?
context: Are you coming over tonight?\What? If we need to talk, let's do it over a drink.\There will be dinner.\Episode 1: It's Spring, I'm 16, and I'm Still a Bud\Made by Ohana.\Ko, I've got a question.\Yeah?\How do you eat the corn kernels in canned soup? response:	They always get stuck to the bottom.
context: What? If we need to talk, let's do it over a drink.\There will be dinner.\Episode 1: It's Spring, I'm 16, and I'm Still a Bud\Made by Ohana.\Ko, I've got a question.\Yeah?\How do you eat the corn kernels in canned soup?\They always get stuck to the bottom. response:	You look so ridiculous right now.
context: There will be dinner.\Episode 1: It's Spring, I'm 16, and I'm Still a Bud\Made by Ohana.\Ko, I've got a question.\Yeah?\How do you eat the corn kernels in canned soup?\They always get stuck to the bottom.\You look so ridiculous right now. response:	Can'h geh'em ouh...!
context: Episode 1: It's Spring, I'm 16, and I'm Still a Bud\Made by Ohana.\Ko, I've got a question.\Yeah?\How do you eat the corn kernels in canned soup?\They always get stuck to the bottom.\You look so ridiculous right now.\Can'h geh'em ouh...! response:	Why don't you just pour some water in the can?
context: Made by Ohana.\Ko, I've got a question.\Yeah?\How do you eat the corn kernels in canned soup?\They always get stuck to the bottom.\You look so ridiculous right now.\Can'h geh'em ouh...!\Why don't you just pour some water in the can? response:	You weirdo!
context: Ko, I've got a question.\Yeah?\How do you eat the corn kernels in canned soup?\They always get stuck to the bottom.\You look so ridiculous right now.\Can'h geh'em ouh...!\Why don't you just pour some water in the can?\You weirdo! response:	That would ruin the taste!
context: Yeah?\How do you eat the corn kernels in canned soup?\They always get stuck to the bottom.\You look so ridiculous right now.\Can'h geh'em ouh...!\Why don't you just pour some water in the can?\You weirdo!\That would ruin the taste! response:	The corn's as good as gone.
context: How do you eat the corn kernels in canned soup?\They always get stuck to the bottom.\You look so ridiculous right now.\Can'h geh'em ouh...!\Why don't you just pour some water in the can?\You weirdo!\That would ruin the taste!\The corn's as good as gone. response:	Well, you could dump the water into another cup,
context: They always get stuck to the bottom.\You look so ridiculous right now.\Can'h geh'em ouh...!\Why don't you just pour some water in the can?\You weirdo!\That would ruin the taste!\The corn's as good as gone.\Well, you could dump the water into another cup, response:	and just eat the corn with chopsticks.
context: You look so ridiculous right now.\Can'h geh'em ouh...!\Why don't you just pour some water in the can?\You weirdo!\That would ruin the taste!\The corn's as good as gone.\Well, you could dump the water into another cup,\and just eat the corn with chopsticks. response:	Here I thought your plan was lazy and crude,
context: Can'h geh'em ouh...!\Why don't you just pour some water in the can?\You weirdo!\That would ruin the taste!\The corn's as good as gone.\Well, you could dump the water into another cup,\and just eat the corn with chopsticks.\Here I thought your plan was lazy and crude, response:	but it's actually quite patient and elaborate.
context: Why don't you just pour some water in the can?\You weirdo!\That would ruin the taste!\The corn's as good as gone.\Well, you could dump the water into another cup,\and just eat the corn with chopsticks.\Here I thought your plan was lazy and crude,\but it's actually quite patient and elaborate. response:	Hush.
context: You weirdo!\That would ruin the taste!\The corn's as good as gone.\Well, you could dump the water into another cup,\and just eat the corn with chopsticks.\Here I thought your plan was lazy and crude,\but it's actually quite patient and elaborate.\Hush. response:	Ko's so patient! Ko's so patient!
context: That would ruin the taste!\The corn's as good as gone.\Well, you could dump the water into another cup,\and just eat the corn with chopsticks.\Here I thought your plan was lazy and crude,\but it's actually quite patient and elaborate.\Hush.\Ko's so patient! Ko's so patient! response:	Have you chosen your junior year electives yet?
context: The corn's as good as gone.\Well, you could dump the water into another cup,\and just eat the corn with chopsticks.\Here I thought your plan was lazy and crude,\but it's actually quite patient and elaborate.\Hush.\Ko's so patient! Ko's so patient!\Have you chosen your junior year electives yet? response:	Nope.
context: Well, you could dump the water into another cup,\and just eat the corn with chopsticks.\Here I thought your plan was lazy and crude,\but it's actually quite patient and elaborate.\Hush.\Ko's so patient! Ko's so patient!\Have you chosen your junior year electives yet?\Nope. response:	What career will you pursue after graduation?
context: and just eat the corn with chopsticks.\Here I thought your plan was lazy and crude,\but it's actually quite patient and elaborate.\Hush.\Ko's so patient! Ko's so patient!\Have you chosen your junior year electives yet?\Nope.\What career will you pursue after graduation? response:	Don't wanna decide yet.
context: Here I thought your plan was lazy and crude,\but it's actually quite patient and elaborate.\Hush.\Ko's so patient! Ko's so patient!\Have you chosen your junior year electives yet?\Nope.\What career will you pursue after graduation?\Don't wanna decide yet. response:	You really play everything by ear, don't you.
context: but it's actually quite patient and elaborate.\Hush.\Ko's so patient! Ko's so patient!\Have you chosen your junior year electives yet?\Nope.\What career will you pursue after graduation?\Don't wanna decide yet.\You really play everything by ear, don't you. response:	Keep that up, and you'll ruin yourself.
context: Hush.\Ko's so patient! Ko's so patient!\Have you chosen your junior year electives yet?\Nope.\What career will you pursue after graduation?\Don't wanna decide yet.\You really play everything by ear, don't you.\Keep that up, and you'll ruin yourself. response:	Ruin myself, huh? I like it.
context: Ko's so patient! Ko's so patient!\Have you chosen your junior year electives yet?\Nope.\What career will you pursue after graduation?\Don't wanna decide yet.\You really play everything by ear, don't you.\Keep that up, and you'll ruin yourself.\Ruin myself, huh? I like it. response:	Sounds dramatic.
context: Have you chosen your junior year electives yet?\Nope.\What career will you pursue after graduation?\Don't wanna decide yet.\You really play everything by ear, don't you.\Keep that up, and you'll ruin yourself.\Ruin myself, huh? I like it.\Sounds dramatic. response:	Excuse me?
context: Nope.\What career will you pursue after graduation?\Don't wanna decide yet.\You really play everything by ear, don't you.\Keep that up, and you'll ruin yourself.\Ruin myself, huh? I like it.\Sounds dramatic.\Excuse me? response:	What boring scenery.
context: What career will you pursue after graduation?\Don't wanna decide yet.\You really play everything by ear, don't you.\Keep that up, and you'll ruin yourself.\Ruin myself, huh? I like it.\Sounds dramatic.\Excuse me?\What boring scenery. response:	A mere fraction of sky is visible;
context: Don't wanna decide yet.\You really play everything by ear, don't you.\Keep that up, and you'll ruin yourself.\Ruin myself, huh? I like it.\Sounds dramatic.\Excuse me?\What boring scenery.\A mere fraction of sky is visible; response:	the rest blocked by tall buildings.
context: You really play everything by ear, don't you.\Keep that up, and you'll ruin yourself.\Ruin myself, huh? I like it.\Sounds dramatic.\Excuse me?\What boring scenery.\A mere fraction of sky is visible;\the rest blocked by tall buildings. response:	A transient escape on a packed train,
context: Keep that up, and you'll ruin yourself.\Ruin myself, huh? I like it.\Sounds dramatic.\Excuse me?\What boring scenery.\A mere fraction of sky is visible;\the rest blocked by tall buildings.\A transient escape on a packed train, response:	as the sunset dyes the city vermillion.
context: Ruin myself, huh? I like it.\Sounds dramatic.\Excuse me?\What boring scenery.\A mere fraction of sky is visible;\the rest blocked by tall buildings.\A transient escape on a packed train,\as the sunset dyes the city vermillion. response:	Hey, that sounds pretty cool.
context: Sounds dramatic.\Excuse me?\What boring scenery.\A mere fraction of sky is visible;\the rest blocked by tall buildings.\A transient escape on a packed train,\as the sunset dyes the city vermillion.\Hey, that sounds pretty cool. response:	But it isn't.
context: Excuse me?\What boring scenery.\A mere fraction of sky is visible;\the rest blocked by tall buildings.\A transient escape on a packed train,\as the sunset dyes the city vermillion.\Hey, that sounds pretty cool.\But it isn't. response:	I may not act like it, but I'm actually pretty pragmatic.
context: What boring scenery.\A mere fraction of sky is visible;\the rest blocked by tall buildings.\A transient escape on a packed train,\as the sunset dyes the city vermillion.\Hey, that sounds pretty cool.\But it isn't.\I may not act like it, but I'm actually pretty pragmatic. response:	I don't live with the greatest role model.
context: A mere fraction of sky is visible;\the rest blocked by tall buildings.\A transient escape on a packed train,\as the sunset dyes the city vermillion.\Hey, that sounds pretty cool.\But it isn't.\I may not act like it, but I'm actually pretty pragmatic.\I don't live with the greatest role model. response:	Yeah, your mom is quite the woman.
context: the rest blocked by tall buildings.\A transient escape on a packed train,\as the sunset dyes the city vermillion.\Hey, that sounds pretty cool.\But it isn't.\I may not act like it, but I'm actually pretty pragmatic.\I don't live with the greatest role model.\Yeah, your mom is quite the woman. response:	So, even if I don't decide on what to do right away,
context: A transient escape on a packed train,\as the sunset dyes the city vermillion.\Hey, that sounds pretty cool.\But it isn't.\I may not act like it, but I'm actually pretty pragmatic.\I don't live with the greatest role model.\Yeah, your mom is quite the woman.\So, even if I don't decide on what to do right away, response:	I think I'll end up finding a stable job,
context: as the sunset dyes the city vermillion.\Hey, that sounds pretty cool.\But it isn't.\I may not act like it, but I'm actually pretty pragmatic.\I don't live with the greatest role model.\Yeah, your mom is quite the woman.\So, even if I don't decide on what to do right away,\I think I'll end up finding a stable job, response:	getting married around age 26,
context: Hey, that sounds pretty cool.\But it isn't.\I may not act like it, but I'm actually pretty pragmatic.\I don't live with the greatest role model.\Yeah, your mom is quite the woman.\So, even if I don't decide on what to do right away,\I think I'll end up finding a stable job,\getting married around age 26, response:	then buying a plot at the cemetery in block 3 once I get old.
context: But it isn't.\I may not act like it, but I'm actually pretty pragmatic.\I don't live with the greatest role model.\Yeah, your mom is quite the woman.\So, even if I don't decide on what to do right away,\I think I'll end up finding a stable job,\getting married around age 26,\then buying a plot at the cemetery in block 3 once I get old. response:	My dad told me gravestones there can be pretty pricey.
context: I may not act like it, but I'm actually pretty pragmatic.\I don't live with the greatest role model.\Yeah, your mom is quite the woman.\So, even if I don't decide on what to do right away,\I think I'll end up finding a stable job,\getting married around age 26,\then buying a plot at the cemetery in block 3 once I get old.\My dad told me gravestones there can be pretty pricey. response:	If you can afford one, you should be fine
context: I don't live with the greatest role model.\Yeah, your mom is quite the woman.\So, even if I don't decide on what to do right away,\I think I'll end up finding a stable job,\getting married around age 26,\then buying a plot at the cemetery in block 3 once I get old.\My dad told me gravestones there can be pretty pricey.\If you can afford one, you should be fine response:	You lose! Later!
context: Yeah, your mom is quite the woman.\So, even if I don't decide on what to do right away,\I think I'll end up finding a stable job,\getting married around age 26,\then buying a plot at the cemetery in block 3 once I get old.\My dad told me gravestones there can be pretty pricey.\If you can afford one, you should be fine\You lose! Later! response:	Hey!
context: So, even if I don't decide on what to do right away,\I think I'll end up finding a stable job,\getting married around age 26,\then buying a plot at the cemetery in block 3 once I get old.\My dad told me gravestones there can be pretty pricey.\If you can afford one, you should be fine\You lose! Later!\Hey! response:	Got any plans for spring break?
context: I think I'll end up finding a stable job,\getting married around age 26,\then buying a plot at the cemetery in block 3 once I get old.\My dad told me gravestones there can be pretty pricey.\If you can afford one, you should be fine\You lose! Later!\Hey!\Got any plans for spring break? response:	Nope!
context: getting married around age 26,\then buying a plot at the cemetery in block 3 once I get old.\My dad told me gravestones there can be pretty pricey.\If you can afford one, you should be fine\You lose! Later!\Hey!\Got any plans for spring break?\Nope! response:	Never mind!
context: then buying a plot at the cemetery in block 3 once I get old.\My dad told me gravestones there can be pretty pricey.\If you can afford one, you should be fine\You lose! Later!\Hey!\Got any plans for spring break?\Nope!\Never mind! response:	I do like this time of day, though.
context: My dad told me gravestones there can be pretty pricey.\If you can afford one, you should be fine\You lose! Later!\Hey!\Got any plans for spring break?\Nope!\Never mind!\I do like this time of day, though. response:	Lights flicker on, one by one,
context: If you can afford one, you should be fine\You lose! Later!\Hey!\Got any plans for spring break?\Nope!\Never mind!\I do like this time of day, though.\Lights flicker on, one by one, response:	illuminating my path.
context: You lose! Later!\Hey!\Got any plans for spring break?\Nope!\Never mind!\I do like this time of day, though.\Lights flicker on, one by one,\illuminating my path. response:	I hope they also light the way to my future.
context: Hey!\Got any plans for spring break?\Nope!\Never mind!\I do like this time of day, though.\Lights flicker on, one by one,\illuminating my path.\I hope they also light the way to my future. response:	And I hope that, at the end of that path,
context: Got any plans for spring break?\Nope!\Never mind!\I do like this time of day, though.\Lights flicker on, one by one,\illuminating my path.\I hope they also light the way to my future.\And I hope that, at the end of that path, response:	I'll have changed for the better.
context: Nope!\Never mind!\I do like this time of day, though.\Lights flicker on, one by one,\illuminating my path.\I hope they also light the way to my future.\And I hope that, at the end of that path,\I'll have changed for the better. response:	I'm home.
context: Never mind!\I do like this time of day, though.\Lights flicker on, one by one,\illuminating my path.\I hope they also light the way to my future.\And I hope that, at the end of that path,\I'll have changed for the better.\I'm home. response:	What the heck?!
context: I do like this time of day, though.\Lights flicker on, one by one,\illuminating my path.\I hope they also light the way to my future.\And I hope that, at the end of that path,\I'll have changed for the better.\I'm home.\What the heck?! response:	Great! You're finally home!
context: Lights flicker on, one by one,\illuminating my path.\I hope they also light the way to my future.\And I hope that, at the end of that path,\I'll have changed for the better.\I'm home.\What the heck?!\Great! You're finally home! response:	What's going on?
context: illuminating my path.\I hope they also light the way to my future.\And I hope that, at the end of that path,\I'll have changed for the better.\I'm home.\What the heck?!\Great! You're finally home!\What's going on? response:	Listen.
context: I hope they also light the way to my future.\And I hope that, at the end of that path,\I'll have changed for the better.\I'm home.\What the heck?!\Great! You're finally home!\What's going on?\Listen. response:	He's fallen into debt.
context: And I hope that, at the end of that path,\I'll have changed for the better.\I'm home.\What the heck?!\Great! You're finally home!\What's going on?\Listen.\He's fallen into debt. response:	So you're doing a moonlight flit?!
context: I'll have changed for the better.\I'm home.\What the heck?!\Great! You're finally home!\What's going on?\Listen.\He's fallen into debt.\So you're doing a moonlight flit?! response:	Well you see, he gave them our address!
context: I'm home.\What the heck?!\Great! You're finally home!\What's going on?\Listen.\He's fallen into debt.\So you're doing a moonlight flit?!\Well you see, he gave them our address! response:	Yeah, sorry about that.
context: What the heck?!\Great! You're finally home!\What's going on?\Listen.\He's fallen into debt.\So you're doing a moonlight flit?!\Well you see, he gave them our address!\Yeah, sorry about that. response:	And when are you running away?
context: Great! You're finally home!\What's going on?\Listen.\He's fallen into debt.\So you're doing a moonlight flit?!\Well you see, he gave them our address!\Yeah, sorry about that.\And when are you running away? response:	Tonight.
context: What's going on?\Listen.\He's fallen into debt.\So you're doing a moonlight flit?!\Well you see, he gave them our address!\Yeah, sorry about that.\And when are you running away?\Tonight. response:	Strike while the iron's hot!
context: Listen.\He's fallen into debt.\So you're doing a moonlight flit?!\Well you see, he gave them our address!\Yeah, sorry about that.\And when are you running away?\Tonight.\Strike while the iron's hot! response:	Though there's nothing hot about this.
context: He's fallen into debt.\So you're doing a moonlight flit?!\Well you see, he gave them our address!\Yeah, sorry about that.\And when are you running away?\Tonight.\Strike while the iron's hot!\Though there's nothing hot about this. response:	Oh, shut up!
context: So you're doing a moonlight flit?!\Well you see, he gave them our address!\Yeah, sorry about that.\And when are you running away?\Tonight.\Strike while the iron's hot!\Though there's nothing hot about this.\Oh, shut up! response:	This is all your fault, you know!
context: Well you see, he gave them our address!\Yeah, sorry about that.\And when are you running away?\Tonight.\Strike while the iron's hot!\Though there's nothing hot about this.\Oh, shut up!\This is all your fault, you know! response:	It's like I'm living in a soap opera.
context: Yeah, sorry about that.\And when are you running away?\Tonight.\Strike while the iron's hot!\Though there's nothing hot about this.\Oh, shut up!\This is all your fault, you know!\It's like I'm living in a soap opera. response:	I feel a nosebleed coming!
context: And when are you running away?\Tonight.\Strike while the iron's hot!\Though there's nothing hot about this.\Oh, shut up!\This is all your fault, you know!\It's like I'm living in a soap opera.\I feel a nosebleed coming! response:	That sensitive nose of yours.
context: Tonight.\Strike while the iron's hot!\Though there's nothing hot about this.\Oh, shut up!\This is all your fault, you know!\It's like I'm living in a soap opera.\I feel a nosebleed coming!\That sensitive nose of yours. response:	But maybe this is a chance for me to reinvent myself.
context: Strike while the iron's hot!\Though there's nothing hot about this.\Oh, shut up!\This is all your fault, you know!\It's like I'm living in a soap opera.\I feel a nosebleed coming!\That sensitive nose of yours.\But maybe this is a chance for me to reinvent myself. response:	So, are we fleeing north or south?
context: Though there's nothing hot about this.\Oh, shut up!\This is all your fault, you know!\It's like I'm living in a soap opera.\I feel a nosebleed coming!\That sensitive nose of yours.\But maybe this is a chance for me to reinvent myself.\So, are we fleeing north or south? response:	Huh?
context: Oh, shut up!\This is all your fault, you know!\It's like I'm living in a soap opera.\I feel a nosebleed coming!\That sensitive nose of yours.\But maybe this is a chance for me to reinvent myself.\So, are we fleeing north or south?\Huh? response:	Why?
context: This is all your fault, you know!\It's like I'm living in a soap opera.\I feel a nosebleed coming!\That sensitive nose of yours.\But maybe this is a chance for me to reinvent myself.\So, are we fleeing north or south?\Huh?\Why? response:	Well, if we're going somewhere cold,
context: It's like I'm living in a soap opera.\I feel a nosebleed coming!\That sensitive nose of yours.\But maybe this is a chance for me to reinvent myself.\So, are we fleeing north or south?\Huh?\Why?\Well, if we're going somewhere cold, response:	I'll need to buy some more warm clothes.
context: I feel a nosebleed coming!\That sensitive nose of yours.\But maybe this is a chance for me to reinvent myself.\So, are we fleeing north or south?\Huh?\Why?\Well, if we're going somewhere cold,\I'll need to buy some more warm clothes. response:	But if we're going somewhere warm, then maybe I should get a sundress?
context: That sensitive nose of yours.\But maybe this is a chance for me to reinvent myself.\So, are we fleeing north or south?\Huh?\Why?\Well, if we're going somewhere cold,\I'll need to buy some more warm clothes.\But if we're going somewhere warm, then maybe I should get a sundress? response:	What kind of parent runs away with their kid?
context: But maybe this is a chance for me to reinvent myself.\So, are we fleeing north or south?\Huh?\Why?\Well, if we're going somewhere cold,\I'll need to buy some more warm clothes.\But if we're going somewhere warm, then maybe I should get a sundress?\What kind of parent runs away with their kid? response:	What kind of parent runs away without their kid?
context: So, are we fleeing north or south?\Huh?\Why?\Well, if we're going somewhere cold,\I'll need to buy some more warm clothes.\But if we're going somewhere warm, then maybe I should get a sundress?\What kind of parent runs away with their kid?\What kind of parent runs away without their kid? response:	Here.
context: Huh?\Why?\Well, if we're going somewhere cold,\I'll need to buy some more warm clothes.\But if we're going somewhere warm, then maybe I should get a sundress?\What kind of parent runs away with their kid?\What kind of parent runs away without their kid?\Here. response:	Kissuisou
context: Why?\Well, if we're going somewhere cold,\I'll need to buy some more warm clothes.\But if we're going somewhere warm, then maybe I should get a sundress?\What kind of parent runs away with their kid?\What kind of parent runs away without their kid?\Here.\Kissuisou response:	You're free to go!
context: Well, if we're going somewhere cold,\I'll need to buy some more warm clothes.\But if we're going somewhere warm, then maybe I should get a sundress?\What kind of parent runs away with their kid?\What kind of parent runs away without their kid?\Here.\Kissuisou\You're free to go! response:	Okay!
context: I'll need to buy some more warm clothes.\But if we're going somewhere warm, then maybe I should get a sundress?\What kind of parent runs away with their kid?\What kind of parent runs away without their kid?\Here.\Kissuisou\You're free to go!\Okay! response:	Hey!
context: But if we're going somewhere warm, then maybe I should get a sundress?\What kind of parent runs away with their kid?\What kind of parent runs away without their kid?\Here.\Kissuisou\You're free to go!\Okay!\Hey! response:	Are you serious?!
context: What kind of parent runs away with their kid?\What kind of parent runs away without their kid?\Here.\Kissuisou\You're free to go!\Okay!\Hey!\Are you serious?! response:	Yeah. I'm going to my grandma's by myself.
context: What kind of parent runs away without their kid?\Here.\Kissuisou\You're free to go!\Okay!\Hey!\Are you serious?!\Yeah. I'm going to my grandma's by myself. response:	I'll be going to school there, too.
context: Here.\Kissuisou\You're free to go!\Okay!\Hey!\Are you serious?!\Yeah. I'm going to my grandma's by myself.\I'll be going to school there, too. response:	O-Ohana!
context: Kissuisou\You're free to go!\Okay!\Hey!\Are you serious?!\Yeah. I'm going to my grandma's by myself.\I'll be going to school there, too.\O-Ohana! response:	Don't look so pessimistic!
context: You're free to go!\Okay!\Hey!\Are you serious?!\Yeah. I'm going to my grandma's by myself.\I'll be going to school there, too.\O-Ohana!\Don't look so pessimistic! response:	What kind of face is that?
context: Okay!\Hey!\Are you serious?!\Yeah. I'm going to my grandma's by myself.\I'll be going to school there, too.\O-Ohana!\Don't look so pessimistic!\What kind of face is that? response:	Huh?
context: Hey!\Are you serious?!\Yeah. I'm going to my grandma's by myself.\I'll be going to school there, too.\O-Ohana!\Don't look so pessimistic!\What kind of face is that?\Huh? response:	Since Grandma and Mom are on bad terms,
context: Are you serious?!\Yeah. I'm going to my grandma's by myself.\I'll be going to school there, too.\O-Ohana!\Don't look so pessimistic!\What kind of face is that?\Huh?\Since Grandma and Mom are on bad terms, response:	I don't know a single thing about her.
context: Yeah. I'm going to my grandma's by myself.\I'll be going to school there, too.\O-Ohana!\Don't look so pessimistic!\What kind of face is that?\Huh?\Since Grandma and Mom are on bad terms,\I don't know a single thing about her. response:	But doesn't living in a hot spring inn sound dramatic?
context: I'll be going to school there, too.\O-Ohana!\Don't look so pessimistic!\What kind of face is that?\Huh?\Since Grandma and Mom are on bad terms,\I don't know a single thing about her.\But doesn't living in a hot spring inn sound dramatic? response:	Though, personally, I think a moonlight flit would've been more fun.
context: O-Ohana!\Don't look so pessimistic!\What kind of face is that?\Huh?\Since Grandma and Mom are on bad terms,\I don't know a single thing about her.\But doesn't living in a hot spring inn sound dramatic?\Though, personally, I think a moonlight flit would've been more fun. response:	Ko?
context: Don't look so pessimistic!\What kind of face is that?\Huh?\Since Grandma and Mom are on bad terms,\I don't know a single thing about her.\But doesn't living in a hot spring inn sound dramatic?\Though, personally, I think a moonlight flit would've been more fun.\Ko? response:	I'm the kind of guy who reaches the corn by flooding it with water.
context: What kind of face is that?\Huh?\Since Grandma and Mom are on bad terms,\I don't know a single thing about her.\But doesn't living in a hot spring inn sound dramatic?\Though, personally, I think a moonlight flit would've been more fun.\Ko?\I'm the kind of guy who reaches the corn by flooding it with water. response:	Yeah, that was pretty original.
context: Huh?\Since Grandma and Mom are on bad terms,\I don't know a single thing about her.\But doesn't living in a hot spring inn sound dramatic?\Though, personally, I think a moonlight flit would've been more fun.\Ko?\I'm the kind of guy who reaches the corn by flooding it with water.\Yeah, that was pretty original. response:	I do things in a roundabout way.
context: Since Grandma and Mom are on bad terms,\I don't know a single thing about her.\But doesn't living in a hot spring inn sound dramatic?\Though, personally, I think a moonlight flit would've been more fun.\Ko?\I'm the kind of guy who reaches the corn by flooding it with water.\Yeah, that was pretty original.\I do things in a roundabout way. response:	So as your best friend, I figured someday you'd...
context: I don't know a single thing about her.\But doesn't living in a hot spring inn sound dramatic?\Though, personally, I think a moonlight flit would've been more fun.\Ko?\I'm the kind of guy who reaches the corn by flooding it with water.\Yeah, that was pretty original.\I do things in a roundabout way.\So as your best friend, I figured someday you'd... response:	Guess not.
context: But doesn't living in a hot spring inn sound dramatic?\Though, personally, I think a moonlight flit would've been more fun.\Ko?\I'm the kind of guy who reaches the corn by flooding it with water.\Yeah, that was pretty original.\I do things in a roundabout way.\So as your best friend, I figured someday you'd...\Guess not. response:	I can see now that I was wrong.
context: Though, personally, I think a moonlight flit would've been more fun.\Ko?\I'm the kind of guy who reaches the corn by flooding it with water.\Yeah, that was pretty original.\I do things in a roundabout way.\So as your best friend, I figured someday you'd...\Guess not.\I can see now that I was wrong. response:	I thought if we were always together, you'd figure out how I feel about you.
context: Ko?\I'm the kind of guy who reaches the corn by flooding it with water.\Yeah, that was pretty original.\I do things in a roundabout way.\So as your best friend, I figured someday you'd...\Guess not.\I can see now that I was wrong.\I thought if we were always together, you'd figure out how I feel about you. response:	Sorry, Ko, could you be a bit clearer
context: I'm the kind of guy who reaches the corn by flooding it with water.\Yeah, that was pretty original.\I do things in a roundabout way.\So as your best friend, I figured someday you'd...\Guess not.\I can see now that I was wrong.\I thought if we were always together, you'd figure out how I feel about you.\Sorry, Ko, could you be a bit clearer response:	I'll say it now: I like you!
context: Yeah, that was pretty original.\I do things in a roundabout way.\So as your best friend, I figured someday you'd...\Guess not.\I can see now that I was wrong.\I thought if we were always together, you'd figure out how I feel about you.\Sorry, Ko, could you be a bit clearer\I'll say it now: I like you! response:	What?
context: I do things in a roundabout way.\So as your best friend, I figured someday you'd...\Guess not.\I can see now that I was wrong.\I thought if we were always together, you'd figure out how I feel about you.\Sorry, Ko, could you be a bit clearer\I'll say it now: I like you!\What? response:	I've always liked you, Ohana Matsumae!
context: So as your best friend, I figured someday you'd...\Guess not.\I can see now that I was wrong.\I thought if we were always together, you'd figure out how I feel about you.\Sorry, Ko, could you be a bit clearer\I'll say it now: I like you!\What?\I've always liked you, Ohana Matsumae! response:	Huh?
context: Guess not.\I can see now that I was wrong.\I thought if we were always together, you'd figure out how I feel about you.\Sorry, Ko, could you be a bit clearer\I'll say it now: I like you!\What?\I've always liked you, Ohana Matsumae!\Huh? response:	What?
context: I can see now that I was wrong.\I thought if we were always together, you'd figure out how I feel about you.\Sorry, Ko, could you be a bit clearer\I'll say it now: I like you!\What?\I've always liked you, Ohana Matsumae!\Huh?\What? response:	W-Wait, you like me? What does that
context: I thought if we were always together, you'd figure out how I feel about you.\Sorry, Ko, could you be a bit clearer\I'll say it now: I like you!\What?\I've always liked you, Ohana Matsumae!\Huh?\What?\W-Wait, you like me? What does that response:	Just go.
context: Sorry, Ko, could you be a bit clearer\I'll say it now: I like you!\What?\I've always liked you, Ohana Matsumae!\Huh?\What?\W-Wait, you like me? What does that\Just go. response:	What?
context: I'll say it now: I like you!\What?\I've always liked you, Ohana Matsumae!\Huh?\What?\W-Wait, you like me? What does that\Just go.\What? response:	Get out of here!
context: What?\I've always liked you, Ohana Matsumae!\Huh?\What?\W-Wait, you like me? What does that\Just go.\What?\Get out of here! response:	Hang on, Ko
context: I've always liked you, Ohana Matsumae!\Huh?\What?\W-Wait, you like me? What does that\Just go.\What?\Get out of here!\Hang on, Ko response:	He left before I did.
context: Huh?\What?\W-Wait, you like me? What does that\Just go.\What?\Get out of here!\Hang on, Ko\He left before I did. response:	The scenery outside reflects the feelings in my heart.
context: What?\W-Wait, you like me? What does that\Just go.\What?\Get out of here!\Hang on, Ko\He left before I did.\The scenery outside reflects the feelings in my heart. response:	I never expected anything from Mom in the first place,
context: W-Wait, you like me? What does that\Just go.\What?\Get out of here!\Hang on, Ko\He left before I did.\The scenery outside reflects the feelings in my heart.\I never expected anything from Mom in the first place, response:	and I've always wanted to be someone else.
context: Just go.\What?\Get out of here!\Hang on, Ko\He left before I did.\The scenery outside reflects the feelings in my heart.\I never expected anything from Mom in the first place,\and I've always wanted to be someone else. response:	But after seeing a different side of Ko...
context: What?\Get out of here!\Hang on, Ko\He left before I did.\The scenery outside reflects the feelings in my heart.\I never expected anything from Mom in the first place,\and I've always wanted to be someone else.\But after seeing a different side of Ko... response:	He didn't come to see me off.
context: Get out of here!\Hang on, Ko\He left before I did.\The scenery outside reflects the feelings in my heart.\I never expected anything from Mom in the first place,\and I've always wanted to be someone else.\But after seeing a different side of Ko...\He didn't come to see me off. response:	Care for a piece of candy?
context: Hang on, Ko\He left before I did.\The scenery outside reflects the feelings in my heart.\I never expected anything from Mom in the first place,\and I've always wanted to be someone else.\But after seeing a different side of Ko...\He didn't come to see me off.\Care for a piece of candy? response:	Yes, thank you!
context: He left before I did.\The scenery outside reflects the feelings in my heart.\I never expected anything from Mom in the first place,\and I've always wanted to be someone else.\But after seeing a different side of Ko...\He didn't come to see me off.\Care for a piece of candy?\Yes, thank you! response:	I've always wanted to meet an elderly woman who gives out candy!
context: The scenery outside reflects the feelings in my heart.\I never expected anything from Mom in the first place,\and I've always wanted to be someone else.\But after seeing a different side of Ko...\He didn't come to see me off.\Care for a piece of candy?\Yes, thank you!\I've always wanted to meet an elderly woman who gives out candy! response:	Really, now?
context: I never expected anything from Mom in the first place,\and I've always wanted to be someone else.\But after seeing a different side of Ko...\He didn't come to see me off.\Care for a piece of candy?\Yes, thank you!\I've always wanted to meet an elderly woman who gives out candy!\Really, now? response:	This is so yummy!
context: and I've always wanted to be someone else.\But after seeing a different side of Ko...\He didn't come to see me off.\Care for a piece of candy?\Yes, thank you!\I've always wanted to meet an elderly woman who gives out candy!\Really, now?\This is so yummy! response:	Wow!
context: But after seeing a different side of Ko...\He didn't come to see me off.\Care for a piece of candy?\Yes, thank you!\I've always wanted to meet an elderly woman who gives out candy!\Really, now?\This is so yummy!\Wow! response:	I've never seen such a vast ocean before!
context: He didn't come to see me off.\Care for a piece of candy?\Yes, thank you!\I've always wanted to meet an elderly woman who gives out candy!\Really, now?\This is so yummy!\Wow!\I've never seen such a vast ocean before! response:	That so?
context: Care for a piece of candy?\Yes, thank you!\I've always wanted to meet an elderly woman who gives out candy!\Really, now?\This is so yummy!\Wow!\I've never seen such a vast ocean before!\That so? response:	With the way I was feeling,
context: Yes, thank you!\I've always wanted to meet an elderly woman who gives out candy!\Really, now?\This is so yummy!\Wow!\I've never seen such a vast ocean before!\That so?\With the way I was feeling, response:	I was actually content being in the tunnel.
context: I've always wanted to meet an elderly woman who gives out candy!\Really, now?\This is so yummy!\Wow!\I've never seen such a vast ocean before!\That so?\With the way I was feeling,\I was actually content being in the tunnel. response:	But now that we're out, I can't help feeling excited!
context: Really, now?\This is so yummy!\Wow!\I've never seen such a vast ocean before!\That so?\With the way I was feeling,\I was actually content being in the tunnel.\But now that we're out, I can't help feeling excited! response:	Wow!
context: This is so yummy!\Wow!\I've never seen such a vast ocean before!\That so?\With the way I was feeling,\I was actually content being in the tunnel.\But now that we're out, I can't help feeling excited!\Wow! response:	Kissuisou
context: Wow!\I've never seen such a vast ocean before!\That so?\With the way I was feeling,\I was actually content being in the tunnel.\But now that we're out, I can't help feeling excited!\Wow!\Kissuisou response:	Amazing!
context: I've never seen such a vast ocean before!\That so?\With the way I was feeling,\I was actually content being in the tunnel.\But now that we're out, I can't help feeling excited!\Wow!\Kissuisou\Amazing! response:	What a grand stage!
context: That so?\With the way I was feeling,\I was actually content being in the tunnel.\But now that we're out, I can't help feeling excited!\Wow!\Kissuisou\Amazing!\What a grand stage! response:	It's like I'm in a movie!
context: With the way I was feeling,\I was actually content being in the tunnel.\But now that we're out, I can't help feeling excited!\Wow!\Kissuisou\Amazing!\What a grand stage!\It's like I'm in a movie! response:	Weeds...
context: I was actually content being in the tunnel.\But now that we're out, I can't help feeling excited!\Wow!\Kissuisou\Amazing!\What a grand stage!\It's like I'm in a movie!\Weeds... response:	You don't belong here.
context: But now that we're out, I can't help feeling excited!\Wow!\Kissuisou\Amazing!\What a grand stage!\It's like I'm in a movie!\Weeds...\You don't belong here. response:	You're ruining the image of my fairy-tale perfect hot spring inn.
context: Wow!\Kissuisou\Amazing!\What a grand stage!\It's like I'm in a movie!\Weeds...\You don't belong here.\You're ruining the image of my fairy-tale perfect hot spring inn. response:	Yes, it really was a fairy tale.
context: Kissuisou\Amazing!\What a grand stage!\It's like I'm in a movie!\Weeds...\You don't belong here.\You're ruining the image of my fairy-tale perfect hot spring inn.\Yes, it really was a fairy tale. response:	A pretty girl reached out her hand to me and...
context: Amazing!\What a grand stage!\It's like I'm in a movie!\Weeds...\You don't belong here.\You're ruining the image of my fairy-tale perfect hot spring inn.\Yes, it really was a fairy tale.\A pretty girl reached out her hand to me and... response:	Die.
context: What a grand stage!\It's like I'm in a movie!\Weeds...\You don't belong here.\You're ruining the image of my fairy-tale perfect hot spring inn.\Yes, it really was a fairy tale.\A pretty girl reached out her hand to me and...\Die. response:	Sorry, you surprised me.
context: It's like I'm in a movie!\Weeds...\You don't belong here.\You're ruining the image of my fairy-tale perfect hot spring inn.\Yes, it really was a fairy tale.\A pretty girl reached out her hand to me and...\Die.\Sorry, you surprised me. response:	Could you repeat that?
context: Weeds...\You don't belong here.\You're ruining the image of my fairy-tale perfect hot spring inn.\Yes, it really was a fairy tale.\A pretty girl reached out her hand to me and...\Die.\Sorry, you surprised me.\Could you repeat that? response:	Die.
context: You don't belong here.\You're ruining the image of my fairy-tale perfect hot spring inn.\Yes, it really was a fairy tale.\A pretty girl reached out her hand to me and...\Die.\Sorry, you surprised me.\Could you repeat that?\Die. response:	Stop that, Minchi!
context: You're ruining the image of my fairy-tale perfect hot spring inn.\Yes, it really was a fairy tale.\A pretty girl reached out her hand to me and...\Die.\Sorry, you surprised me.\Could you repeat that?\Die.\Stop that, Minchi! response:	You can't go around wishing death on a complete stranger!
context: Yes, it really was a fairy tale.\A pretty girl reached out her hand to me and...\Die.\Sorry, you surprised me.\Could you repeat that?\Die.\Stop that, Minchi!\You can't go around wishing death on a complete stranger! response:	U-Umm...
context: A pretty girl reached out her hand to me and...\Die.\Sorry, you surprised me.\Could you repeat that?\Die.\Stop that, Minchi!\You can't go around wishing death on a complete stranger!\U-Umm... response:	I-I apologize.
context: Die.\Sorry, you surprised me.\Could you repeat that?\Die.\Stop that, Minchi!\You can't go around wishing death on a complete stranger!\U-Umm...\I-I apologize. response:	Those are actually wild rocamboles Minchi's been growing.
context: Sorry, you surprised me.\Could you repeat that?\Die.\Stop that, Minchi!\You can't go around wishing death on a complete stranger!\U-Umm...\I-I apologize.\Those are actually wild rocamboles Minchi's been growing. response:	Rocamboles?
context: Could you repeat that?\Die.\Stop that, Minchi!\You can't go around wishing death on a complete stranger!\U-Umm...\I-I apologize.\Those are actually wild rocamboles Minchi's been growing.\Rocamboles? response:	Minchi?
context: Die.\Stop that, Minchi!\You can't go around wishing death on a complete stranger!\U-Umm...\I-I apologize.\Those are actually wild rocamboles Minchi's been growing.\Rocamboles?\Minchi? response:	They're edible.
context: Stop that, Minchi!\You can't go around wishing death on a complete stranger!\U-Umm...\I-I apologize.\Those are actually wild rocamboles Minchi's been growing.\Rocamboles?\Minchi?\They're edible. response:	Rocampoes? Minchi?
context: You can't go around wishing death on a complete stranger!\U-Umm...\I-I apologize.\Those are actually wild rocamboles Minchi's been growing.\Rocamboles?\Minchi?\They're edible.\Rocampoes? Minchi? response:	Rocam boles!
context: U-Umm...\I-I apologize.\Those are actually wild rocamboles Minchi's been growing.\Rocamboles?\Minchi?\They're edible.\Rocampoes? Minchi?\Rocam boles! response:	Mi-Minchi!
context: I-I apologize.\Those are actually wild rocamboles Minchi's been growing.\Rocamboles?\Minchi?\They're edible.\Rocampoes? Minchi?\Rocam boles!\Mi-Minchi! response:	You must be Ohana.
context: Those are actually wild rocamboles Minchi's been growing.\Rocamboles?\Minchi?\They're edible.\Rocampoes? Minchi?\Rocam boles!\Mi-Minchi!\You must be Ohana. response:	Are you my grandmother?
context: Rocamboles?\Minchi?\They're edible.\Rocampoes? Minchi?\Rocam boles!\Mi-Minchi!\You must be Ohana.\Are you my grandmother? response:	Catch.
context: Minchi?\They're edible.\Rocampoes? Minchi?\Rocam boles!\Mi-Minchi!\You must be Ohana.\Are you my grandmother?\Catch. response:	Another elderly lady who hands out candy?
context: They're edible.\Rocampoes? Minchi?\Rocam boles!\Mi-Minchi!\You must be Ohana.\Are you my grandmother?\Catch.\Another elderly lady who hands out candy? response:	Here.
context: Rocampoes? Minchi?\Rocam boles!\Mi-Minchi!\You must be Ohana.\Are you my grandmother?\Catch.\Another elderly lady who hands out candy?\Here. response:	Huh?
context: Rocam boles!\Mi-Minchi!\You must be Ohana.\Are you my grandmother?\Catch.\Another elderly lady who hands out candy?\Here.\Huh? response:	Hanasaku Iroha
context: Mi-Minchi!\You must be Ohana.\Are you my grandmother?\Catch.\Another elderly lady who hands out candy?\Here.\Huh?\Hanasaku Iroha response:	Listen up.
context: You must be Ohana.\Are you my grandmother?\Catch.\Another elderly lady who hands out candy?\Here.\Huh?\Hanasaku Iroha\Listen up. response:	As of today, you are an employee of this establishment.
context: Are you my grandmother?\Catch.\Another elderly lady who hands out candy?\Here.\Huh?\Hanasaku Iroha\Listen up.\As of today, you are an employee of this establishment. response:	An employee?
context: Catch.\Another elderly lady who hands out candy?\Here.\Huh?\Hanasaku Iroha\Listen up.\As of today, you are an employee of this establishment.\An employee? response:	Not your granddaughter?
context: Another elderly lady who hands out candy?\Here.\Huh?\Hanasaku Iroha\Listen up.\As of today, you are an employee of this establishment.\An employee?\Not your granddaughter? response:	You're the daughter of the girl I disowned.
context: Here.\Huh?\Hanasaku Iroha\Listen up.\As of today, you are an employee of this establishment.\An employee?\Not your granddaughter?\You're the daughter of the girl I disowned. response:	You're worth cats and dogs to me.
context: Huh?\Hanasaku Iroha\Listen up.\As of today, you are an employee of this establishment.\An employee?\Not your granddaughter?\You're the daughter of the girl I disowned.\You're worth cats and dogs to me. response:	You'll earn your keep.
context: Hanasaku Iroha\Listen up.\As of today, you are an employee of this establishment.\An employee?\Not your granddaughter?\You're the daughter of the girl I disowned.\You're worth cats and dogs to me.\You'll earn your keep. response:	Oh! Are you training me to become the next manager
context: Listen up.\As of today, you are an employee of this establishment.\An employee?\Not your granddaughter?\You're the daughter of the girl I disowned.\You're worth cats and dogs to me.\You'll earn your keep.\Oh! Are you training me to become the next manager response:	Nwah, I'm having you take care of random chores.
context: As of today, you are an employee of this establishment.\An employee?\Not your granddaughter?\You're the daughter of the girl I disowned.\You're worth cats and dogs to me.\You'll earn your keep.\Oh! Are you training me to become the next manager\Nwah, I'm having you take care of random chores. response:	Nwah?
context: An employee?\Not your granddaughter?\You're the daughter of the girl I disowned.\You're worth cats and dogs to me.\You'll earn your keep.\Oh! Are you training me to become the next manager\Nwah, I'm having you take care of random chores.\Nwah? response:	You can do whatever you want after you graduate high school.
context: Not your granddaughter?\You're the daughter of the girl I disowned.\You're worth cats and dogs to me.\You'll earn your keep.\Oh! Are you training me to become the next manager\Nwah, I'm having you take care of random chores.\Nwah?\You can do whatever you want after you graduate high school. response:	You will be paid for your work here.
context: You're the daughter of the girl I disowned.\You're worth cats and dogs to me.\You'll earn your keep.\Oh! Are you training me to become the next manager\Nwah, I'm having you take care of random chores.\Nwah?\You can do whatever you want after you graduate high school.\You will be paid for your work here. response:	At the same time...
context: You're worth cats and dogs to me.\You'll earn your keep.\Oh! Are you training me to become the next manager\Nwah, I'm having you take care of random chores.\Nwah?\You can do whatever you want after you graduate high school.\You will be paid for your work here.\At the same time... response:	At the same time?
context: You'll earn your keep.\Oh! Are you training me to become the next manager\Nwah, I'm having you take care of random chores.\Nwah?\You can do whatever you want after you graduate high school.\You will be paid for your work here.\At the same time...\At the same time? response:	Any blunders will be docked from your wages.
context: Oh! Are you training me to become the next manager\Nwah, I'm having you take care of random chores.\Nwah?\You can do whatever you want after you graduate high school.\You will be paid for your work here.\At the same time...\At the same time?\Any blunders will be docked from your wages. response:	Be grateful I'm feeding you
context: Nwah, I'm having you take care of random chores.\Nwah?\You can do whatever you want after you graduate high school.\You will be paid for your work here.\At the same time...\At the same time?\Any blunders will be docked from your wages.\Be grateful I'm feeding you response:	and putting a roof over your head, in this day and age.
context: Nwah?\You can do whatever you want after you graduate high school.\You will be paid for your work here.\At the same time...\At the same time?\Any blunders will be docked from your wages.\Be grateful I'm feeding you\and putting a roof over your head, in this day and age. response:	I wanted a grandmother who hands out candy...
context: You can do whatever you want after you graduate high school.\You will be paid for your work here.\At the same time...\At the same time?\Any blunders will be docked from your wages.\Be grateful I'm feeding you\and putting a roof over your head, in this day and age.\I wanted a grandmother who hands out candy... response:	Oh, you'll be here soon?
context: You will be paid for your work here.\At the same time...\At the same time?\Any blunders will be docked from your wages.\Be grateful I'm feeding you\and putting a roof over your head, in this day and age.\I wanted a grandmother who hands out candy...\Oh, you'll be here soon? response:	Yeah?
context: At the same time...\At the same time?\Any blunders will be docked from your wages.\Be grateful I'm feeding you\and putting a roof over your head, in this day and age.\I wanted a grandmother who hands out candy...\Oh, you'll be here soon?\Yeah? response:	Okay.
context: At the same time?\Any blunders will be docked from your wages.\Be grateful I'm feeding you\and putting a roof over your head, in this day and age.\I wanted a grandmother who hands out candy...\Oh, you'll be here soon?\Yeah?\Okay. response:	Huh?
context: Any blunders will be docked from your wages.\Be grateful I'm feeding you\and putting a roof over your head, in this day and age.\I wanted a grandmother who hands out candy...\Oh, you'll be here soon?\Yeah?\Okay.\Huh? response:	Hello?
context: Be grateful I'm feeding you\and putting a roof over your head, in this day and age.\I wanted a grandmother who hands out candy...\Oh, you'll be here soon?\Yeah?\Okay.\Huh?\Hello? response:	Sis?!
context: and putting a roof over your head, in this day and age.\I wanted a grandmother who hands out candy...\Oh, you'll be here soon?\Yeah?\Okay.\Huh?\Hello?\Sis?! response:	Oh, you must be Ohana!
context: I wanted a grandmother who hands out candy...\Oh, you'll be here soon?\Yeah?\Okay.\Huh?\Hello?\Sis?!\Oh, you must be Ohana! response:	Wow, nice to meet
context: Oh, you'll be here soon?\Yeah?\Okay.\Huh?\Hello?\Sis?!\Oh, you must be Ohana!\Wow, nice to meet response:	Would you mind getting off me?
context: Yeah?\Okay.\Huh?\Hello?\Sis?!\Oh, you must be Ohana!\Wow, nice to meet\Would you mind getting off me? response:	Oh, oops, my apologies.
context: Okay.\Huh?\Hello?\Sis?!\Oh, you must be Ohana!\Wow, nice to meet\Would you mind getting off me?\Oh, oops, my apologies. response:	The more I look at you, the more I see the resemblance.
context: Huh?\Hello?\Sis?!\Oh, you must be Ohana!\Wow, nice to meet\Would you mind getting off me?\Oh, oops, my apologies.\The more I look at you, the more I see the resemblance. response:	Those evil eyes always scheming ways to screw me over.
context: Hello?\Sis?!\Oh, you must be Ohana!\Wow, nice to meet\Would you mind getting off me?\Oh, oops, my apologies.\The more I look at you, the more I see the resemblance.\Those evil eyes always scheming ways to screw me over. response:	Those sharp canines always looking to leave bite marks in me.
context: Sis?!\Oh, you must be Ohana!\Wow, nice to meet\Would you mind getting off me?\Oh, oops, my apologies.\The more I look at you, the more I see the resemblance.\Those evil eyes always scheming ways to screw me over.\Those sharp canines always looking to leave bite marks in me. response:	Um, are you my mom's brother?
context: Oh, you must be Ohana!\Wow, nice to meet\Would you mind getting off me?\Oh, oops, my apologies.\The more I look at you, the more I see the resemblance.\Those evil eyes always scheming ways to screw me over.\Those sharp canines always looking to leave bite marks in me.\Um, are you my mom's brother? response:	Yeah. I may use you to work off my long-standing grudge.
context: Wow, nice to meet\Would you mind getting off me?\Oh, oops, my apologies.\The more I look at you, the more I see the resemblance.\Those evil eyes always scheming ways to screw me over.\Those sharp canines always looking to leave bite marks in me.\Um, are you my mom's brother?\Yeah. I may use you to work off my long-standing grudge. response:	Nah, just teasin'!
context: Would you mind getting off me?\Oh, oops, my apologies.\The more I look at you, the more I see the resemblance.\Those evil eyes always scheming ways to screw me over.\Those sharp canines always looking to leave bite marks in me.\Um, are you my mom's brother?\Yeah. I may use you to work off my long-standing grudge.\Nah, just teasin'! response:	Hey, so you're Ohana?
context: Oh, oops, my apologies.\The more I look at you, the more I see the resemblance.\Those evil eyes always scheming ways to screw me over.\Those sharp canines always looking to leave bite marks in me.\Um, are you my mom's brother?\Yeah. I may use you to work off my long-standing grudge.\Nah, just teasin'!\Hey, so you're Ohana? response:	Y-Yeah.
context: The more I look at you, the more I see the resemblance.\Those evil eyes always scheming ways to screw me over.\Those sharp canines always looking to leave bite marks in me.\Um, are you my mom's brother?\Yeah. I may use you to work off my long-standing grudge.\Nah, just teasin'!\Hey, so you're Ohana?\Y-Yeah. response:	I have a million questions for you!
context: Those evil eyes always scheming ways to screw me over.\Those sharp canines always looking to leave bite marks in me.\Um, are you my mom's brother?\Yeah. I may use you to work off my long-standing grudge.\Nah, just teasin'!\Hey, so you're Ohana?\Y-Yeah.\I have a million questions for you! response:	What's Satsuki like?
context: Those sharp canines always looking to leave bite marks in me.\Um, are you my mom's brother?\Yeah. I may use you to work off my long-standing grudge.\Nah, just teasin'!\Hey, so you're Ohana?\Y-Yeah.\I have a million questions for you!\What's Satsuki like? response:	I've heard she's quite the call girl.
context: Um, are you my mom's brother?\Yeah. I may use you to work off my long-standing grudge.\Nah, just teasin'!\Hey, so you're Ohana?\Y-Yeah.\I have a million questions for you!\What's Satsuki like?\I've heard she's quite the call girl. response:	Does she walk around the house naked, too?
context: Yeah. I may use you to work off my long-standing grudge.\Nah, just teasin'!\Hey, so you're Ohana?\Y-Yeah.\I have a million questions for you!\What's Satsuki like?\I've heard she's quite the call girl.\Does she walk around the house naked, too? response:	Umm...
context: Nah, just teasin'!\Hey, so you're Ohana?\Y-Yeah.\I have a million questions for you!\What's Satsuki like?\I've heard she's quite the call girl.\Does she walk around the house naked, too?\Umm... response:	Oh! I'm Tomoe, the head waitress.
context: Hey, so you're Ohana?\Y-Yeah.\I have a million questions for you!\What's Satsuki like?\I've heard she's quite the call girl.\Does she walk around the house naked, too?\Umm...\Oh! I'm Tomoe, the head waitress. response:	Your superior, I suppose.
context: Y-Yeah.\I have a million questions for you!\What's Satsuki like?\I've heard she's quite the call girl.\Does she walk around the house naked, too?\Umm...\Oh! I'm Tomoe, the head waitress.\Your superior, I suppose. response:	I'll teach you anything you want to know,
context: I have a million questions for you!\What's Satsuki like?\I've heard she's quite the call girl.\Does she walk around the house naked, too?\Umm...\Oh! I'm Tomoe, the head waitress.\Your superior, I suppose.\I'll teach you anything you want to know, response:	but you'll need to share info in return.
context: What's Satsuki like?\I've heard she's quite the call girl.\Does she walk around the house naked, too?\Umm...\Oh! I'm Tomoe, the head waitress.\Your superior, I suppose.\I'll teach you anything you want to know,\but you'll need to share info in return. response:	O-Okay.
context: I've heard she's quite the call girl.\Does she walk around the house naked, too?\Umm...\Oh! I'm Tomoe, the head waitress.\Your superior, I suppose.\I'll teach you anything you want to know,\but you'll need to share info in return.\O-Okay. response:	That's a nice car.
context: Does she walk around the house naked, too?\Umm...\Oh! I'm Tomoe, the head waitress.\Your superior, I suppose.\I'll teach you anything you want to know,\but you'll need to share info in return.\O-Okay.\That's a nice car. response:	She's apparently a management consultant.
context: Umm...\Oh! I'm Tomoe, the head waitress.\Your superior, I suppose.\I'll teach you anything you want to know,\but you'll need to share info in return.\O-Okay.\That's a nice car.\She's apparently a management consultant. response:	Our Enishi just can't say no to her.
context: Oh! I'm Tomoe, the head waitress.\Your superior, I suppose.\I'll teach you anything you want to know,\but you'll need to share info in return.\O-Okay.\That's a nice car.\She's apparently a management consultant.\Our Enishi just can't say no to her. response:	The sloppy coward.
context: Your superior, I suppose.\I'll teach you anything you want to know,\but you'll need to share info in return.\O-Okay.\That's a nice car.\She's apparently a management consultant.\Our Enishi just can't say no to her.\The sloppy coward. response:	Is Satsuki like that, too?
context: I'll teach you anything you want to know,\but you'll need to share info in return.\O-Okay.\That's a nice car.\She's apparently a management consultant.\Our Enishi just can't say no to her.\The sloppy coward.\Is Satsuki like that, too? response:	Sloppy from the waist down, I mean.
context: but you'll need to share info in return.\O-Okay.\That's a nice car.\She's apparently a management consultant.\Our Enishi just can't say no to her.\The sloppy coward.\Is Satsuki like that, too?\Sloppy from the waist down, I mean. response:	Well...
context: O-Okay.\That's a nice car.\She's apparently a management consultant.\Our Enishi just can't say no to her.\The sloppy coward.\Is Satsuki like that, too?\Sloppy from the waist down, I mean.\Well... response:	That's beanman.
context: That's a nice car.\She's apparently a management consultant.\Our Enishi just can't say no to her.\The sloppy coward.\Is Satsuki like that, too?\Sloppy from the waist down, I mean.\Well...\That's beanman. response:	He's in charge of building maintenance.
context: She's apparently a management consultant.\Our Enishi just can't say no to her.\The sloppy coward.\Is Satsuki like that, too?\Sloppy from the waist down, I mean.\Well...\That's beanman.\He's in charge of building maintenance. response:	Is he nicknamed that because he's small?
context: Our Enishi just can't say no to her.\The sloppy coward.\Is Satsuki like that, too?\Sloppy from the waist down, I mean.\Well...\That's beanman.\He's in charge of building maintenance.\Is he nicknamed that because he's small? response:	No, he shares his last name, Denroku, with a company that sells beans.
context: The sloppy coward.\Is Satsuki like that, too?\Sloppy from the waist down, I mean.\Well...\That's beanman.\He's in charge of building maintenance.\Is he nicknamed that because he's small?\No, he shares his last name, Denroku, with a company that sells beans. response:	That's Tohru, the assistant chef.
context: Is Satsuki like that, too?\Sloppy from the waist down, I mean.\Well...\That's beanman.\He's in charge of building maintenance.\Is he nicknamed that because he's small?\No, he shares his last name, Denroku, with a company that sells beans.\That's Tohru, the assistant chef. response:	And the one back there's the head cook, Mr. Ren.
context: Sloppy from the waist down, I mean.\Well...\That's beanman.\He's in charge of building maintenance.\Is he nicknamed that because he's small?\No, he shares his last name, Denroku, with a company that sells beans.\That's Tohru, the assistant chef.\And the one back there's the head cook, Mr. Ren. response:	He has a crew cut?!
context: Well...\That's beanman.\He's in charge of building maintenance.\Is he nicknamed that because he's small?\No, he shares his last name, Denroku, with a company that sells beans.\That's Tohru, the assistant chef.\And the one back there's the head cook, Mr. Ren.\He has a crew cut?! response:	They looked busy, so I'll introduce you later.
context: That's beanman.\He's in charge of building maintenance.\Is he nicknamed that because he's small?\No, he shares his last name, Denroku, with a company that sells beans.\That's Tohru, the assistant chef.\And the one back there's the head cook, Mr. Ren.\He has a crew cut?!\They looked busy, so I'll introduce you later. response:	Who am I forgetting?
context: He's in charge of building maintenance.\Is he nicknamed that because he's small?\No, he shares his last name, Denroku, with a company that sells beans.\That's Tohru, the assistant chef.\And the one back there's the head cook, Mr. Ren.\He has a crew cut?!\They looked busy, so I'll introduce you later.\Who am I forgetting? response:	Oh, you're sixteen, right?
context: Is he nicknamed that because he's small?\No, he shares his last name, Denroku, with a company that sells beans.\That's Tohru, the assistant chef.\And the one back there's the head cook, Mr. Ren.\He has a crew cut?!\They looked busy, so I'll introduce you later.\Who am I forgetting?\Oh, you're sixteen, right? response:	Yeah.
context: No, he shares his last name, Denroku, with a company that sells beans.\That's Tohru, the assistant chef.\And the one back there's the head cook, Mr. Ren.\He has a crew cut?!\They looked busy, so I'll introduce you later.\Who am I forgetting?\Oh, you're sixteen, right?\Yeah. response:	In that case...
context: That's Tohru, the assistant chef.\And the one back there's the head cook, Mr. Ren.\He has a crew cut?!\They looked busy, so I'll introduce you later.\Who am I forgetting?\Oh, you're sixteen, right?\Yeah.\In that case... response:	Okay, I'll be right there.
context: And the one back there's the head cook, Mr. Ren.\He has a crew cut?!\They looked busy, so I'll introduce you later.\Who am I forgetting?\Oh, you're sixteen, right?\Yeah.\In that case...\Okay, I'll be right there. response:	Great timing, girls!
context: He has a crew cut?!\They looked busy, so I'll introduce you later.\Who am I forgetting?\Oh, you're sixteen, right?\Yeah.\In that case...\Okay, I'll be right there.\Great timing, girls! response:	The girl who told me to die.
context: They looked busy, so I'll introduce you later.\Who am I forgetting?\Oh, you're sixteen, right?\Yeah.\In that case...\Okay, I'll be right there.\Great timing, girls!\The girl who told me to die. response:	Oh, you've already met?
context: Who am I forgetting?\Oh, you're sixteen, right?\Yeah.\In that case...\Okay, I'll be right there.\Great timing, girls!\The girl who told me to die.\Oh, you've already met? response:	No, not exactly.
context: Oh, you're sixteen, right?\Yeah.\In that case...\Okay, I'll be right there.\Great timing, girls!\The girl who told me to die.\Oh, you've already met?\No, not exactly. response:	Hi.
context: Yeah.\In that case...\Okay, I'll be right there.\Great timing, girls!\The girl who told me to die.\Oh, you've already met?\No, not exactly.\Hi. response:	Well then, that saves time!
context: In that case...\Okay, I'll be right there.\Great timing, girls!\The girl who told me to die.\Oh, you've already met?\No, not exactly.\Hi.\Well then, that saves time! response:	Their names are Minko and Nako.
context: Okay, I'll be right there.\Great timing, girls!\The girl who told me to die.\Oh, you've already met?\No, not exactly.\Hi.\Well then, that saves time!\Their names are Minko and Nako. response:	Since you're all the same age,
context: Great timing, girls!\The girl who told me to die.\Oh, you've already met?\No, not exactly.\Hi.\Well then, that saves time!\Their names are Minko and Nako.\Since you're all the same age, response:	do you mind giving her a quick tour?
context: The girl who told me to die.\Oh, you've already met?\No, not exactly.\Hi.\Well then, that saves time!\Their names are Minko and Nako.\Since you're all the same age,\do you mind giving her a quick tour? response:	Thanks in advance!
context: Oh, you've already met?\No, not exactly.\Hi.\Well then, that saves time!\Their names are Minko and Nako.\Since you're all the same age,\do you mind giving her a quick tour?\Thanks in advance! response:	H-Hi.
context: No, not exactly.\Hi.\Well then, that saves time!\Their names are Minko and Nako.\Since you're all the same age,\do you mind giving her a quick tour?\Thanks in advance!\H-Hi. response:	Thanks, Nako.
context: Hi.\Well then, that saves time!\Their names are Minko and Nako.\Since you're all the same age,\do you mind giving her a quick tour?\Thanks in advance!\H-Hi.\Thanks, Nako. response:	Huh?
context: Well then, that saves time!\Their names are Minko and Nako.\Since you're all the same age,\do you mind giving her a quick tour?\Thanks in advance!\H-Hi.\Thanks, Nako.\Huh? response:	She obviously doesn't like me.
context: Their names are Minko and Nako.\Since you're all the same age,\do you mind giving her a quick tour?\Thanks in advance!\H-Hi.\Thanks, Nako.\Huh?\She obviously doesn't like me. response:	I was sort of expecting an, of course she does!
context: Since you're all the same age,\do you mind giving her a quick tour?\Thanks in advance!\H-Hi.\Thanks, Nako.\Huh?\She obviously doesn't like me.\I was sort of expecting an, of course she does! response:	Even if it was a lie.
context: do you mind giving her a quick tour?\Thanks in advance!\H-Hi.\Thanks, Nako.\Huh?\She obviously doesn't like me.\I was sort of expecting an, of course she does!\Even if it was a lie. response:	Th-That's the high school.
context: Thanks in advance!\H-Hi.\Thanks, Nako.\Huh?\She obviously doesn't like me.\I was sort of expecting an, of course she does!\Even if it was a lie.\Th-That's the high school. response:	Minchi and I go there.
context: H-Hi.\Thanks, Nako.\Huh?\She obviously doesn't like me.\I was sort of expecting an, of course she does!\Even if it was a lie.\Th-That's the high school.\Minchi and I go there. response:	Huh? Where?
context: Thanks, Nako.\Huh?\She obviously doesn't like me.\I was sort of expecting an, of course she does!\Even if it was a lie.\Th-That's the high school.\Minchi and I go there.\Huh? Where? response:	Oh, so you two work here part-time?
context: Huh?\She obviously doesn't like me.\I was sort of expecting an, of course she does!\Even if it was a lie.\Th-That's the high school.\Minchi and I go there.\Huh? Where?\Oh, so you two work here part-time? response:	I do. Minchi lives here, though.
context: She obviously doesn't like me.\I was sort of expecting an, of course she does!\Even if it was a lie.\Th-That's the high school.\Minchi and I go there.\Huh? Where?\Oh, so you two work here part-time?\I do. Minchi lives here, though. response:	Oh yeah, there was a school uniform hanging in my room!
context: I was sort of expecting an, of course she does!\Even if it was a lie.\Th-That's the high school.\Minchi and I go there.\Huh? Where?\Oh, so you two work here part-time?\I do. Minchi lives here, though.\Oh yeah, there was a school uniform hanging in my room! response:	Maybe we're roommates!
context: Even if it was a lie.\Th-That's the high school.\Minchi and I go there.\Huh? Where?\Oh, so you two work here part-time?\I do. Minchi lives here, though.\Oh yeah, there was a school uniform hanging in my room!\Maybe we're roommates! response:	I'm not sure.
context: Th-That's the high school.\Minchi and I go there.\Huh? Where?\Oh, so you two work here part-time?\I do. Minchi lives here, though.\Oh yeah, there was a school uniform hanging in my room!\Maybe we're roommates!\I'm not sure. response:	Ah, that uniform was really cute.
context: Minchi and I go there.\Huh? Where?\Oh, so you two work here part-time?\I do. Minchi lives here, though.\Oh yeah, there was a school uniform hanging in my room!\Maybe we're roommates!\I'm not sure.\Ah, that uniform was really cute. response:	Yeah?
context: Huh? Where?\Oh, so you two work here part-time?\I do. Minchi lives here, though.\Oh yeah, there was a school uniform hanging in my room!\Maybe we're roommates!\I'm not sure.\Ah, that uniform was really cute.\Yeah? response:	The colors were certainly unique.
context: Oh, so you two work here part-time?\I do. Minchi lives here, though.\Oh yeah, there was a school uniform hanging in my room!\Maybe we're roommates!\I'm not sure.\Ah, that uniform was really cute.\Yeah?\The colors were certainly unique. response:	You think so?
context: I do. Minchi lives here, though.\Oh yeah, there was a school uniform hanging in my room!\Maybe we're roommates!\I'm not sure.\Ah, that uniform was really cute.\Yeah?\The colors were certainly unique.\You think so? response:	Should we head back?
context: Oh yeah, there was a school uniform hanging in my room!\Maybe we're roommates!\I'm not sure.\Ah, that uniform was really cute.\Yeah?\The colors were certainly unique.\You think so?\Should we head back? response:	Well, this isn't exactly what I'd imagined.
context: Maybe we're roommates!\I'm not sure.\Ah, that uniform was really cute.\Yeah?\The colors were certainly unique.\You think so?\Should we head back?\Well, this isn't exactly what I'd imagined. response:	Then again, I wasn't even sure what to expect.
context: I'm not sure.\Ah, that uniform was really cute.\Yeah?\The colors were certainly unique.\You think so?\Should we head back?\Well, this isn't exactly what I'd imagined.\Then again, I wasn't even sure what to expect. response:	You dimwit!
context: Ah, that uniform was really cute.\Yeah?\The colors were certainly unique.\You think so?\Should we head back?\Well, this isn't exactly what I'd imagined.\Then again, I wasn't even sure what to expect.\You dimwit! response:	Why'd you peel the skin so thick?!
context: Yeah?\The colors were certainly unique.\You think so?\Should we head back?\Well, this isn't exactly what I'd imagined.\Then again, I wasn't even sure what to expect.\You dimwit!\Why'd you peel the skin so thick?! response:	I'm sorry.
context: The colors were certainly unique.\You think so?\Should we head back?\Well, this isn't exactly what I'd imagined.\Then again, I wasn't even sure what to expect.\You dimwit!\Why'd you peel the skin so thick?!\I'm sorry. response:	Ever considered what the farmers who grew these went through?
context: You think so?\Should we head back?\Well, this isn't exactly what I'd imagined.\Then again, I wasn't even sure what to expect.\You dimwit!\Why'd you peel the skin so thick?!\I'm sorry.\Ever considered what the farmers who grew these went through? response:	I'm sorry.
context: Should we head back?\Well, this isn't exactly what I'd imagined.\Then again, I wasn't even sure what to expect.\You dimwit!\Why'd you peel the skin so thick?!\I'm sorry.\Ever considered what the farmers who grew these went through?\I'm sorry. response:	And what about your poor grandmother,
context: Well, this isn't exactly what I'd imagined.\Then again, I wasn't even sure what to expect.\You dimwit!\Why'd you peel the skin so thick?!\I'm sorry.\Ever considered what the farmers who grew these went through?\I'm sorry.\And what about your poor grandmother, response:	who make dishes out of the skins?
context: Then again, I wasn't even sure what to expect.\You dimwit!\Why'd you peel the skin so thick?!\I'm sorry.\Ever considered what the farmers who grew these went through?\I'm sorry.\And what about your poor grandmother,\who make dishes out of the skins? response:	My grandmother doesn't live with me...
context: You dimwit!\Why'd you peel the skin so thick?!\I'm sorry.\Ever considered what the farmers who grew these went through?\I'm sorry.\And what about your poor grandmother,\who make dishes out of the skins?\My grandmother doesn't live with me... response:	Just use your imagination, idiot!
context: Why'd you peel the skin so thick?!\I'm sorry.\Ever considered what the farmers who grew these went through?\I'm sorry.\And what about your poor grandmother,\who make dishes out of the skins?\My grandmother doesn't live with me...\Just use your imagination, idiot! response:	I'm sorry.
context: I'm sorry.\Ever considered what the farmers who grew these went through?\I'm sorry.\And what about your poor grandmother,\who make dishes out of the skins?\My grandmother doesn't live with me...\Just use your imagination, idiot!\I'm sorry. response:	Excuse me?
context: Ever considered what the farmers who grew these went through?\I'm sorry.\And what about your poor grandmother,\who make dishes out of the skins?\My grandmother doesn't live with me...\Just use your imagination, idiot!\I'm sorry.\Excuse me? response:	Oh, are you the manager's granddaughter?
context: I'm sorry.\And what about your poor grandmother,\who make dishes out of the skins?\My grandmother doesn't live with me...\Just use your imagination, idiot!\I'm sorry.\Excuse me?\Oh, are you the manager's granddaughter? response:	I think you're being too hard on her.
context: And what about your poor grandmother,\who make dishes out of the skins?\My grandmother doesn't live with me...\Just use your imagination, idiot!\I'm sorry.\Excuse me?\Oh, are you the manager's granddaughter?\I think you're being too hard on her. response:	Yelling at someone doesn't help them improve, you know.
context: who make dishes out of the skins?\My grandmother doesn't live with me...\Just use your imagination, idiot!\I'm sorry.\Excuse me?\Oh, are you the manager's granddaughter?\I think you're being too hard on her.\Yelling at someone doesn't help them improve, you know. response:	What?! Y
context: My grandmother doesn't live with me...\Just use your imagination, idiot!\I'm sorry.\Excuse me?\Oh, are you the manager's granddaughter?\I think you're being too hard on her.\Yelling at someone doesn't help them improve, you know.\What?! Y response:	Mind your own business!
context: Just use your imagination, idiot!\I'm sorry.\Excuse me?\Oh, are you the manager's granddaughter?\I think you're being too hard on her.\Yelling at someone doesn't help them improve, you know.\What?! Y\Mind your own business! response:	It's fine.
context: I'm sorry.\Excuse me?\Oh, are you the manager's granddaughter?\I think you're being too hard on her.\Yelling at someone doesn't help them improve, you know.\What?! Y\Mind your own business!\It's fine. response:	Do a little more working, and a little less talking.
context: Excuse me?\Oh, are you the manager's granddaughter?\I think you're being too hard on her.\Yelling at someone doesn't help them improve, you know.\What?! Y\Mind your own business!\It's fine.\Do a little more working, and a little less talking. response:	I'm sorry.
context: Oh, are you the manager's granddaughter?\I think you're being too hard on her.\Yelling at someone doesn't help them improve, you know.\What?! Y\Mind your own business!\It's fine.\Do a little more working, and a little less talking.\I'm sorry. response:	Hey, do you mind letting us do our thing?
context: I think you're being too hard on her.\Yelling at someone doesn't help them improve, you know.\What?! Y\Mind your own business!\It's fine.\Do a little more working, and a little less talking.\I'm sorry.\Hey, do you mind letting us do our thing? response:	We have our own rules here.
context: Yelling at someone doesn't help them improve, you know.\What?! Y\Mind your own business!\It's fine.\Do a little more working, and a little less talking.\I'm sorry.\Hey, do you mind letting us do our thing?\We have our own rules here. response:	Man, am I beat!
context: What?! Y\Mind your own business!\It's fine.\Do a little more working, and a little less talking.\I'm sorry.\Hey, do you mind letting us do our thing?\We have our own rules here.\Man, am I beat! response:	My life's taken a turn for the weird.
context: Mind your own business!\It's fine.\Do a little more working, and a little less talking.\I'm sorry.\Hey, do you mind letting us do our thing?\We have our own rules here.\Man, am I beat!\My life's taken a turn for the weird. response:	But I guess I've got nowhere else to go.
context: It's fine.\Do a little more working, and a little less talking.\I'm sorry.\Hey, do you mind letting us do our thing?\We have our own rules here.\Man, am I beat!\My life's taken a turn for the weird.\But I guess I've got nowhere else to go. response:	I wonder if she's still working.
context: Do a little more working, and a little less talking.\I'm sorry.\Hey, do you mind letting us do our thing?\We have our own rules here.\Man, am I beat!\My life's taken a turn for the weird.\But I guess I've got nowhere else to go.\I wonder if she's still working. response:	Ko!
context: I'm sorry.\Hey, do you mind letting us do our thing?\We have our own rules here.\Man, am I beat!\My life's taken a turn for the weird.\But I guess I've got nowhere else to go.\I wonder if she's still working.\Ko! response:	From: Satsuki Good luck, Ohana!
context: Hey, do you mind letting us do our thing?\We have our own rules here.\Man, am I beat!\My life's taken a turn for the weird.\But I guess I've got nowhere else to go.\I wonder if she's still working.\Ko!\From: Satsuki Good luck, Ohana! response:	Good luck?
context: We have our own rules here.\Man, am I beat!\My life's taken a turn for the weird.\But I guess I've got nowhere else to go.\I wonder if she's still working.\Ko!\From: Satsuki Good luck, Ohana!\Good luck? response:	You make it sound so easy.
context: Man, am I beat!\My life's taken a turn for the weird.\But I guess I've got nowhere else to go.\I wonder if she's still working.\Ko!\From: Satsuki Good luck, Ohana!\Good luck?\You make it sound so easy. response:	It's a bit awkward for me to contact Ko.
context: My life's taken a turn for the weird.\But I guess I've got nowhere else to go.\I wonder if she's still working.\Ko!\From: Satsuki Good luck, Ohana!\Good luck?\You make it sound so easy.\It's a bit awkward for me to contact Ko. response:	The drama I'd been longing for so badly...
context: But I guess I've got nowhere else to go.\I wonder if she's still working.\Ko!\From: Satsuki Good luck, Ohana!\Good luck?\You make it sound so easy.\It's a bit awkward for me to contact Ko.\The drama I'd been longing for so badly... response:	M-My back.
context: I wonder if she's still working.\Ko!\From: Satsuki Good luck, Ohana!\Good luck?\You make it sound so easy.\It's a bit awkward for me to contact Ko.\The drama I'd been longing for so badly...\M-My back. response:	No way.
context: Ko!\From: Satsuki Good luck, Ohana!\Good luck?\You make it sound so easy.\It's a bit awkward for me to contact Ko.\The drama I'd been longing for so badly...\M-My back.\No way. response:	She went to sleep after I did,
context: From: Satsuki Good luck, Ohana!\Good luck?\You make it sound so easy.\It's a bit awkward for me to contact Ko.\The drama I'd been longing for so badly...\M-My back.\No way.\She went to sleep after I did, response:	and got up earlier than me.
context: Good luck?\You make it sound so easy.\It's a bit awkward for me to contact Ko.\The drama I'd been longing for so badly...\M-My back.\No way.\She went to sleep after I did,\and got up earlier than me. response:	There's no way someone can sleep well on such a moldy bed.
context: You make it sound so easy.\It's a bit awkward for me to contact Ko.\The drama I'd been longing for so badly...\M-My back.\No way.\She went to sleep after I did,\and got up earlier than me.\There's no way someone can sleep well on such a moldy bed. response:	There... we go.
context: It's a bit awkward for me to contact Ko.\The drama I'd been longing for so badly...\M-My back.\No way.\She went to sleep after I did,\and got up earlier than me.\There's no way someone can sleep well on such a moldy bed.\There... we go. response:	Okay.
context: The drama I'd been longing for so badly...\M-My back.\No way.\She went to sleep after I did,\and got up earlier than me.\There's no way someone can sleep well on such a moldy bed.\There... we go.\Okay. response:	New here?
context: M-My back.\No way.\She went to sleep after I did,\and got up earlier than me.\There's no way someone can sleep well on such a moldy bed.\There... we go.\Okay.\New here? response:	Yeah, I am.
context: No way.\She went to sleep after I did,\and got up earlier than me.\There's no way someone can sleep well on such a moldy bed.\There... we go.\Okay.\New here?\Yeah, I am. response:	Pleased to make your acquaintance.
context: She went to sleep after I did,\and got up earlier than me.\There's no way someone can sleep well on such a moldy bed.\There... we go.\Okay.\New here?\Yeah, I am.\Pleased to make your acquaintance. response:	What on earth?!
context: and got up earlier than me.\There's no way someone can sleep well on such a moldy bed.\There... we go.\Okay.\New here?\Yeah, I am.\Pleased to make your acquaintance.\What on earth?! response:	Honey!
context: There's no way someone can sleep well on such a moldy bed.\There... we go.\Okay.\New here?\Yeah, I am.\Pleased to make your acquaintance.\What on earth?!\Honey! response:	My deepest apologies.
context: There... we go.\Okay.\New here?\Yeah, I am.\Pleased to make your acquaintance.\What on earth?!\Honey!\My deepest apologies. response:	Please, it's all right. You don't need to bow.
context: Okay.\New here?\Yeah, I am.\Pleased to make your acquaintance.\What on earth?!\Honey!\My deepest apologies.\Please, it's all right. You don't need to bow. response:	Right?
context: New here?\Yeah, I am.\Pleased to make your acquaintance.\What on earth?!\Honey!\My deepest apologies.\Please, it's all right. You don't need to bow.\Right? response:	Right! It was just a falling futon.
context: Yeah, I am.\Pleased to make your acquaintance.\What on earth?!\Honey!\My deepest apologies.\Please, it's all right. You don't need to bow.\Right?\Right! It was just a falling futon. response:	Ohana!
context: Pleased to make your acquaintance.\What on earth?!\Honey!\My deepest apologies.\Please, it's all right. You don't need to bow.\Right?\Right! It was just a falling futon.\Ohana! response:	I-I'm really sorry. I didn't notice
context: What on earth?!\Honey!\My deepest apologies.\Please, it's all right. You don't need to bow.\Right?\Right! It was just a falling futon.\Ohana!\I-I'm really sorry. I didn't notice response:	My sincerest apologies!
context: Honey!\My deepest apologies.\Please, it's all right. You don't need to bow.\Right?\Right! It was just a falling futon.\Ohana!\I-I'm really sorry. I didn't notice\My sincerest apologies! response:	M-My sincerest apologies!
context: My deepest apologies.\Please, it's all right. You don't need to bow.\Right?\Right! It was just a falling futon.\Ohana!\I-I'm really sorry. I didn't notice\My sincerest apologies!\M-My sincerest apologies! response:	No one was hurt.
context: Please, it's all right. You don't need to bow.\Right?\Right! It was just a falling futon.\Ohana!\I-I'm really sorry. I didn't notice\My sincerest apologies!\M-My sincerest apologies!\No one was hurt. response:	Please don't worry about it.
context: Right?\Right! It was just a falling futon.\Ohana!\I-I'm really sorry. I didn't notice\My sincerest apologies!\M-My sincerest apologies!\No one was hurt.\Please don't worry about it. response:	If you'll excuse us.
context: Right! It was just a falling futon.\Ohana!\I-I'm really sorry. I didn't notice\My sincerest apologies!\M-My sincerest apologies!\No one was hurt.\Please don't worry about it.\If you'll excuse us. response:	Um...
context: Ohana!\I-I'm really sorry. I didn't notice\My sincerest apologies!\M-My sincerest apologies!\No one was hurt.\Please don't worry about it.\If you'll excuse us.\Um... response:	Come with me.
context: I-I'm really sorry. I didn't notice\My sincerest apologies!\M-My sincerest apologies!\No one was hurt.\Please don't worry about it.\If you'll excuse us.\Um...\Come with me. response:	Tomoe, summon Minko as well.
context: My sincerest apologies!\M-My sincerest apologies!\No one was hurt.\Please don't worry about it.\If you'll excuse us.\Um...\Come with me.\Tomoe, summon Minko as well. response:	Y-Yes, ma'am!
context: M-My sincerest apologies!\No one was hurt.\Please don't worry about it.\If you'll excuse us.\Um...\Come with me.\Tomoe, summon Minko as well.\Y-Yes, ma'am! response:	Minko's futon was really squashed,
context: No one was hurt.\Please don't worry about it.\If you'll excuse us.\Um...\Come with me.\Tomoe, summon Minko as well.\Y-Yes, ma'am!\Minko's futon was really squashed, response:	so I wanted to hang it outside for her.
context: Please don't worry about it.\If you'll excuse us.\Um...\Come with me.\Tomoe, summon Minko as well.\Y-Yes, ma'am!\Minko's futon was really squashed,\so I wanted to hang it outside for her. response:	At the front of the inn, where our customers enter?
context: If you'll excuse us.\Um...\Come with me.\Tomoe, summon Minko as well.\Y-Yes, ma'am!\Minko's futon was really squashed,\so I wanted to hang it outside for her.\At the front of the inn, where our customers enter? response:	Y-Yes.
context: Um...\Come with me.\Tomoe, summon Minko as well.\Y-Yes, ma'am!\Minko's futon was really squashed,\so I wanted to hang it outside for her.\At the front of the inn, where our customers enter?\Y-Yes. response:	There wasn't much light in the back,
context: Come with me.\Tomoe, summon Minko as well.\Y-Yes, ma'am!\Minko's futon was really squashed,\so I wanted to hang it outside for her.\At the front of the inn, where our customers enter?\Y-Yes.\There wasn't much light in the back, response:	and I wanted to hang it out in the sun.
context: Tomoe, summon Minko as well.\Y-Yes, ma'am!\Minko's futon was really squashed,\so I wanted to hang it outside for her.\At the front of the inn, where our customers enter?\Y-Yes.\There wasn't much light in the back,\and I wanted to hang it out in the sun. response:	At an inn, customers always come first.
context: Y-Yes, ma'am!\Minko's futon was really squashed,\so I wanted to hang it outside for her.\At the front of the inn, where our customers enter?\Y-Yes.\There wasn't much light in the back,\and I wanted to hang it out in the sun.\At an inn, customers always come first. response:	You come last.
context: Minko's futon was really squashed,\so I wanted to hang it outside for her.\At the front of the inn, where our customers enter?\Y-Yes.\There wasn't much light in the back,\and I wanted to hang it out in the sun.\At an inn, customers always come first.\You come last. response:	No.
context: so I wanted to hang it outside for her.\At the front of the inn, where our customers enter?\Y-Yes.\There wasn't much light in the back,\and I wanted to hang it out in the sun.\At an inn, customers always come first.\You come last.\No. response:	Even after that.
context: At the front of the inn, where our customers enter?\Y-Yes.\There wasn't much light in the back,\and I wanted to hang it out in the sun.\At an inn, customers always come first.\You come last.\No.\Even after that. response:	What? Why?
context: Y-Yes.\There wasn't much light in the back,\and I wanted to hang it out in the sun.\At an inn, customers always come first.\You come last.\No.\Even after that.\What? Why? response:	I agree that customers are important,
context: There wasn't much light in the back,\and I wanted to hang it out in the sun.\At an inn, customers always come first.\You come last.\No.\Even after that.\What? Why?\I agree that customers are important, response:	but I also think it's important to reward people who work hard.
context: and I wanted to hang it out in the sun.\At an inn, customers always come first.\You come last.\No.\Even after that.\What? Why?\I agree that customers are important,\but I also think it's important to reward people who work hard. response:	Excuse us.
context: At an inn, customers always come first.\You come last.\No.\Even after that.\What? Why?\I agree that customers are important,\but I also think it's important to reward people who work hard.\Excuse us. response:	Come here, Minko.
context: You come last.\No.\Even after that.\What? Why?\I agree that customers are important,\but I also think it's important to reward people who work hard.\Excuse us.\Come here, Minko. response:	Yes, ma'am.
context: No.\Even after that.\What? Why?\I agree that customers are important,\but I also think it's important to reward people who work hard.\Excuse us.\Come here, Minko.\Yes, ma'am. response:	This girl inconvenienced a customer while trying to hang your futon.
context: Even after that.\What? Why?\I agree that customers are important,\but I also think it's important to reward people who work hard.\Excuse us.\Come here, Minko.\Yes, ma'am.\This girl inconvenienced a customer while trying to hang your futon. response:	Aren't you old enough to take care of yourself?
context: What? Why?\I agree that customers are important,\but I also think it's important to reward people who work hard.\Excuse us.\Come here, Minko.\Yes, ma'am.\This girl inconvenienced a customer while trying to hang your futon.\Aren't you old enough to take care of yourself? response:	I'm sorry.
context: I agree that customers are important,\but I also think it's important to reward people who work hard.\Excuse us.\Come here, Minko.\Yes, ma'am.\This girl inconvenienced a customer while trying to hang your futon.\Aren't you old enough to take care of yourself?\I'm sorry. response:	G-Grandma!
context: but I also think it's important to reward people who work hard.\Excuse us.\Come here, Minko.\Yes, ma'am.\This girl inconvenienced a customer while trying to hang your futon.\Aren't you old enough to take care of yourself?\I'm sorry.\G-Grandma! response:	Do not call me that.
context: Excuse us.\Come here, Minko.\Yes, ma'am.\This girl inconvenienced a customer while trying to hang your futon.\Aren't you old enough to take care of yourself?\I'm sorry.\G-Grandma!\Do not call me that. response:	Madam Manager, I'm the one at fault here!
context: Come here, Minko.\Yes, ma'am.\This girl inconvenienced a customer while trying to hang your futon.\Aren't you old enough to take care of yourself?\I'm sorry.\G-Grandma!\Do not call me that.\Madam Manager, I'm the one at fault here! response:	You're being unreasonable!
context: Yes, ma'am.\This girl inconvenienced a customer while trying to hang your futon.\Aren't you old enough to take care of yourself?\I'm sorry.\G-Grandma!\Do not call me that.\Madam Manager, I'm the one at fault here!\You're being unreasonable! response:	How would it look if I slapped a customer like this?
context: This girl inconvenienced a customer while trying to hang your futon.\Aren't you old enough to take care of yourself?\I'm sorry.\G-Grandma!\Do not call me that.\Madam Manager, I'm the one at fault here!\You're being unreasonable!\How would it look if I slapped a customer like this? response:	Far worse than unreasonable, of course.
context: Aren't you old enough to take care of yourself?\I'm sorry.\G-Grandma!\Do not call me that.\Madam Manager, I'm the one at fault here!\You're being unreasonable!\How would it look if I slapped a customer like this?\Far worse than unreasonable, of course. response:	And you did just that.
context: I'm sorry.\G-Grandma!\Do not call me that.\Madam Manager, I'm the one at fault here!\You're being unreasonable!\How would it look if I slapped a customer like this?\Far worse than unreasonable, of course.\And you did just that. response:	Life here revolves around our customers.
context: G-Grandma!\Do not call me that.\Madam Manager, I'm the one at fault here!\You're being unreasonable!\How would it look if I slapped a customer like this?\Far worse than unreasonable, of course.\And you did just that.\Life here revolves around our customers. response:	This is a basic principle. If you can't accept that, you shouldn't be here.
context: Do not call me that.\Madam Manager, I'm the one at fault here!\You're being unreasonable!\How would it look if I slapped a customer like this?\Far worse than unreasonable, of course.\And you did just that.\Life here revolves around our customers.\This is a basic principle. If you can't accept that, you shouldn't be here. response:	I understand.
context: Madam Manager, I'm the one at fault here!\You're being unreasonable!\How would it look if I slapped a customer like this?\Far worse than unreasonable, of course.\And you did just that.\Life here revolves around our customers.\This is a basic principle. If you can't accept that, you shouldn't be here.\I understand. response:	But then...
context: You're being unreasonable!\How would it look if I slapped a customer like this?\Far worse than unreasonable, of course.\And you did just that.\Life here revolves around our customers.\This is a basic principle. If you can't accept that, you shouldn't be here.\I understand.\But then... response:	Hit me, too.
context: How would it look if I slapped a customer like this?\Far worse than unreasonable, of course.\And you did just that.\Life here revolves around our customers.\This is a basic principle. If you can't accept that, you shouldn't be here.\I understand.\But then...\Hit me, too. response:	I hate that someone who works so hard was slapped,
context: Far worse than unreasonable, of course.\And you did just that.\Life here revolves around our customers.\This is a basic principle. If you can't accept that, you shouldn't be here.\I understand.\But then...\Hit me, too.\I hate that someone who works so hard was slapped, response:	and customers were inconvenienced,
context: And you did just that.\Life here revolves around our customers.\This is a basic principle. If you can't accept that, you shouldn't be here.\I understand.\But then...\Hit me, too.\I hate that someone who works so hard was slapped,\and customers were inconvenienced, response:	all because of me!
context: Life here revolves around our customers.\This is a basic principle. If you can't accept that, you shouldn't be here.\I understand.\But then...\Hit me, too.\I hate that someone who works so hard was slapped,\and customers were inconvenienced,\all because of me! response:	Th-Thank you very much!
context: This is a basic principle. If you can't accept that, you shouldn't be here.\I understand.\But then...\Hit me, too.\I hate that someone who works so hard was slapped,\and customers were inconvenienced,\all because of me!\Th-Thank you very much! response:	I-I'm really sorry!
context: I understand.\But then...\Hit me, too.\I hate that someone who works so hard was slapped,\and customers were inconvenienced,\all because of me!\Th-Thank you very much!\I-I'm really sorry! response:	It was my fault.
context: But then...\Hit me, too.\I hate that someone who works so hard was slapped,\and customers were inconvenienced,\all because of me!\Th-Thank you very much!\I-I'm really sorry!\It was my fault. response:	I honestly don't care.
context: Hit me, too.\I hate that someone who works so hard was slapped,\and customers were inconvenienced,\all because of me!\Th-Thank you very much!\I-I'm really sorry!\It was my fault.\I honestly don't care. response:	I just can't believe her!
context: I hate that someone who works so hard was slapped,\and customers were inconvenienced,\all because of me!\Th-Thank you very much!\I-I'm really sorry!\It was my fault.\I honestly don't care.\I just can't believe her! response:	She must be going senile.
context: and customers were inconvenienced,\all because of me!\Th-Thank you very much!\I-I'm really sorry!\It was my fault.\I honestly don't care.\I just can't believe her!\She must be going senile. response:	I can't believe you.
context: all because of me!\Th-Thank you very much!\I-I'm really sorry!\It was my fault.\I honestly don't care.\I just can't believe her!\She must be going senile.\I can't believe you. response:	Do you understand what it means to work here?
context: Th-Thank you very much!\I-I'm really sorry!\It was my fault.\I honestly don't care.\I just can't believe her!\She must be going senile.\I can't believe you.\Do you understand what it means to work here? response:	Or the concept of work, itself?
context: I-I'm really sorry!\It was my fault.\I honestly don't care.\I just can't believe her!\She must be going senile.\I can't believe you.\Do you understand what it means to work here?\Or the concept of work, itself? response:	Well, I didn't come here to work...
context: It was my fault.\I honestly don't care.\I just can't believe her!\She must be going senile.\I can't believe you.\Do you understand what it means to work here?\Or the concept of work, itself?\Well, I didn't come here to work... response:	And
context: I honestly don't care.\I just can't believe her!\She must be going senile.\I can't believe you.\Do you understand what it means to work here?\Or the concept of work, itself?\Well, I didn't come here to work...\And response:	You know what,
context: I just can't believe her!\She must be going senile.\I can't believe you.\Do you understand what it means to work here?\Or the concept of work, itself?\Well, I didn't come here to work...\And\You know what, response:	just die.
context: She must be going senile.\I can't believe you.\Do you understand what it means to work here?\Or the concept of work, itself?\Well, I didn't come here to work...\And\You know what,\just die. response:	And we're back to that...
context: I can't believe you.\Do you understand what it means to work here?\Or the concept of work, itself?\Well, I didn't come here to work...\And\You know what,\just die.\And we're back to that... response:	Look at her, toiling away.
context: Do you understand what it means to work here?\Or the concept of work, itself?\Well, I didn't come here to work...\And\You know what,\just die.\And we're back to that...\Look at her, toiling away. response:	Oh, hello?
context: Or the concept of work, itself?\Well, I didn't come here to work...\And\You know what,\just die.\And we're back to that...\Look at her, toiling away.\Oh, hello? response:	Enishi here.
context: Well, I didn't come here to work...\And\You know what,\just die.\And we're back to that...\Look at her, toiling away.\Oh, hello?\Enishi here. response:	I didn't come here to work.
context: And\You know what,\just die.\And we're back to that...\Look at her, toiling away.\Oh, hello?\Enishi here.\I didn't come here to work. response:	But...
context: You know what,\just die.\And we're back to that...\Look at her, toiling away.\Oh, hello?\Enishi here.\I didn't come here to work.\But... response:	I've never been more upset in my life.