context: It's so peaceful. response:	I'll say... All the battles we go through seem like a dream.
context: It's so peaceful.\I'll say... All the battles we go through seem like a dream. response:	Huh?
context: It's so peaceful.\I'll say... All the battles we go through seem like a dream.\Huh? response:	I sense the Sacred Jewel.
context: It's so peaceful.\I'll say... All the battles we go through seem like a dream.\Huh?\I sense the Sacred Jewel. response:	What?!
context: It's so peaceful.\I'll say... All the battles we go through seem like a dream.\Huh?\I sense the Sacred Jewel.\What?! response:	And it's getting closer!
context: It's so peaceful.\I'll say... All the battles we go through seem like a dream.\Huh?\I sense the Sacred Jewel.\What?!\And it's getting closer! response:	Hi!
context: It's so peaceful.\I'll say... All the battles we go through seem like a dream.\Huh?\I sense the Sacred Jewel.\What?!\And it's getting closer!\Hi! response:	Koga!
context: It's so peaceful.\I'll say... All the battles we go through seem like a dream.\Huh?\I sense the Sacred Jewel.\What?!\And it's getting closer!\Hi!\Koga! response:	I caught your scent, Kagome, and came to see you.
context: I'll say... All the battles we go through seem like a dream.\Huh?\I sense the Sacred Jewel.\What?!\And it's getting closer!\Hi!\Koga!\I caught your scent, Kagome, and came to see you. response:	How've you been?
context: Huh?\I sense the Sacred Jewel.\What?!\And it's getting closer!\Hi!\Koga!\I caught your scent, Kagome, and came to see you.\How've you been? response:	Whaddya want, wolf cub?
context: I sense the Sacred Jewel.\What?!\And it's getting closer!\Hi!\Koga!\I caught your scent, Kagome, and came to see you.\How've you been?\Whaddya want, wolf cub? response:	Inuyasha, don't pick a fight.
context: What?!\And it's getting closer!\Hi!\Koga!\I caught your scent, Kagome, and came to see you.\How've you been?\Whaddya want, wolf cub?\Inuyasha, don't pick a fight. response:	Shaddup... depending on the way it goes, I'll kill'im!
context: And it's getting closer!\Hi!\Koga!\I caught your scent, Kagome, and came to see you.\How've you been?\Whaddya want, wolf cub?\Inuyasha, don't pick a fight.\Shaddup... depending on the way it goes, I'll kill'im! response:	Every time I see you, you're always so angry and arrogant.
context: Hi!\Koga!\I caught your scent, Kagome, and came to see you.\How've you been?\Whaddya want, wolf cub?\Inuyasha, don't pick a fight.\Shaddup... depending on the way it goes, I'll kill'im!\Every time I see you, you're always so angry and arrogant. response:	Kagome, don't you get tired with a guy like him?
context: Koga!\I caught your scent, Kagome, and came to see you.\How've you been?\Whaddya want, wolf cub?\Inuyasha, don't pick a fight.\Shaddup... depending on the way it goes, I'll kill'im!\Every time I see you, you're always so angry and arrogant.\Kagome, don't you get tired with a guy like him? response:	- Hey... - Why you...
context: I caught your scent, Kagome, and came to see you.\How've you been?\Whaddya want, wolf cub?\Inuyasha, don't pick a fight.\Shaddup... depending on the way it goes, I'll kill'im!\Every time I see you, you're always so angry and arrogant.\Kagome, don't you get tired with a guy like him?\- Hey... - Why you... response:	Hey, Koga!
context: How've you been?\Whaddya want, wolf cub?\Inuyasha, don't pick a fight.\Shaddup... depending on the way it goes, I'll kill'im!\Every time I see you, you're always so angry and arrogant.\Kagome, don't you get tired with a guy like him?\- Hey... - Why you...\Hey, Koga! response:	Don't be rude!
context: Whaddya want, wolf cub?\Inuyasha, don't pick a fight.\Shaddup... depending on the way it goes, I'll kill'im!\Every time I see you, you're always so angry and arrogant.\Kagome, don't you get tired with a guy like him?\- Hey... - Why you...\Hey, Koga!\Don't be rude! response:	Inuyasha is just nervous, thinking you'll steal Kagome away from him.
context: Inuyasha, don't pick a fight.\Shaddup... depending on the way it goes, I'll kill'im!\Every time I see you, you're always so angry and arrogant.\Kagome, don't you get tired with a guy like him?\- Hey... - Why you...\Hey, Koga!\Don't be rude!\Inuyasha is just nervous, thinking you'll steal Kagome away from him. response:	If you think he's always like this, you're wrong...
context: Shaddup... depending on the way it goes, I'll kill'im!\Every time I see you, you're always so angry and arrogant.\Kagome, don't you get tired with a guy like him?\- Hey... - Why you...\Hey, Koga!\Don't be rude!\Inuyasha is just nervous, thinking you'll steal Kagome away from him.\If you think he's always like this, you're wrong... response:	Shippo. Wrong thing to say.
context: Every time I see you, you're always so angry and arrogant.\Kagome, don't you get tired with a guy like him?\- Hey... - Why you...\Hey, Koga!\Don't be rude!\Inuyasha is just nervous, thinking you'll steal Kagome away from him.\If you think he's always like this, you're wrong...\Shippo. Wrong thing to say. response:	You're really wound up tight, huh?
context: Kagome, don't you get tired with a guy like him?\- Hey... - Why you...\Hey, Koga!\Don't be rude!\Inuyasha is just nervous, thinking you'll steal Kagome away from him.\If you think he's always like this, you're wrong...\Shippo. Wrong thing to say.\You're really wound up tight, huh? response:	Tell me where Naraku's castle is?!
context: - Hey... - Why you...\Hey, Koga!\Don't be rude!\Inuyasha is just nervous, thinking you'll steal Kagome away from him.\If you think he's always like this, you're wrong...\Shippo. Wrong thing to say.\You're really wound up tight, huh?\Tell me where Naraku's castle is?! response:	Stupid! If we knew that, we wouldn't be in this bind!
context: Hey, Koga!\Don't be rude!\Inuyasha is just nervous, thinking you'll steal Kagome away from him.\If you think he's always like this, you're wrong...\Shippo. Wrong thing to say.\You're really wound up tight, huh?\Tell me where Naraku's castle is?!\Stupid! If we knew that, we wouldn't be in this bind! response:	Don't you know then?
context: Don't be rude!\Inuyasha is just nervous, thinking you'll steal Kagome away from him.\If you think he's always like this, you're wrong...\Shippo. Wrong thing to say.\You're really wound up tight, huh?\Tell me where Naraku's castle is?!\Stupid! If we knew that, we wouldn't be in this bind!\Don't you know then? response:	Naraku has a barrier around his castle.
context: Inuyasha is just nervous, thinking you'll steal Kagome away from him.\If you think he's always like this, you're wrong...\Shippo. Wrong thing to say.\You're really wound up tight, huh?\Tell me where Naraku's castle is?!\Stupid! If we knew that, we wouldn't be in this bind!\Don't you know then?\Naraku has a barrier around his castle. response:	Why don't you let us avenge your comrades' deaths...
context: If you think he's always like this, you're wrong...\Shippo. Wrong thing to say.\You're really wound up tight, huh?\Tell me where Naraku's castle is?!\Stupid! If we knew that, we wouldn't be in this bind!\Don't you know then?\Naraku has a barrier around his castle.\Why don't you let us avenge your comrades' deaths... response:	and hand over the Sacred Jewel fragments you have in both your legs...
context: Shippo. Wrong thing to say.\You're really wound up tight, huh?\Tell me where Naraku's castle is?!\Stupid! If we knew that, we wouldn't be in this bind!\Don't you know then?\Naraku has a barrier around his castle.\Why don't you let us avenge your comrades' deaths...\and hand over the Sacred Jewel fragments you have in both your legs... response:	and just go back to your nest!
context: You're really wound up tight, huh?\Tell me where Naraku's castle is?!\Stupid! If we knew that, we wouldn't be in this bind!\Don't you know then?\Naraku has a barrier around his castle.\Why don't you let us avenge your comrades' deaths...\and hand over the Sacred Jewel fragments you have in both your legs...\and just go back to your nest! response:	What's the matter, dogface?
context: Tell me where Naraku's castle is?!\Stupid! If we knew that, we wouldn't be in this bind!\Don't you know then?\Naraku has a barrier around his castle.\Why don't you let us avenge your comrades' deaths...\and hand over the Sacred Jewel fragments you have in both your legs...\and just go back to your nest!\What's the matter, dogface? response:	You seem awfully clumsy in handling your sword.
context: Stupid! If we knew that, we wouldn't be in this bind!\Don't you know then?\Naraku has a barrier around his castle.\Why don't you let us avenge your comrades' deaths...\and hand over the Sacred Jewel fragments you have in both your legs...\and just go back to your nest!\What's the matter, dogface?\You seem awfully clumsy in handling your sword. response:	Damn!
context: Don't you know then?\Naraku has a barrier around his castle.\Why don't you let us avenge your comrades' deaths...\and hand over the Sacred Jewel fragments you have in both your legs...\and just go back to your nest!\What's the matter, dogface?\You seem awfully clumsy in handling your sword.\Damn! response:	The Tetsusaiga is still too heavy for him.
context: Naraku has a barrier around his castle.\Why don't you let us avenge your comrades' deaths...\and hand over the Sacred Jewel fragments you have in both your legs...\and just go back to your nest!\What's the matter, dogface?\You seem awfully clumsy in handling your sword.\Damn!\The Tetsusaiga is still too heavy for him. response:	Well, it won't become light so quickly.
context: Why don't you let us avenge your comrades' deaths...\and hand over the Sacred Jewel fragments you have in both your legs...\and just go back to your nest!\What's the matter, dogface?\You seem awfully clumsy in handling your sword.\Damn!\The Tetsusaiga is still too heavy for him.\Well, it won't become light so quickly. response:	Don't run away!
context: and hand over the Sacred Jewel fragments you have in both your legs...\and just go back to your nest!\What's the matter, dogface?\You seem awfully clumsy in handling your sword.\Damn!\The Tetsusaiga is still too heavy for him.\Well, it won't become light so quickly.\Don't run away! response:	Sorry, but I have no time to spar with you now.
context: and just go back to your nest!\What's the matter, dogface?\You seem awfully clumsy in handling your sword.\Damn!\The Tetsusaiga is still too heavy for him.\Well, it won't become light so quickly.\Don't run away!\Sorry, but I have no time to spar with you now. response:	Hey! Come back here!
context: What's the matter, dogface?\You seem awfully clumsy in handling your sword.\Damn!\The Tetsusaiga is still too heavy for him.\Well, it won't become light so quickly.\Don't run away!\Sorry, but I have no time to spar with you now.\Hey! Come back here! response:	Dogface! I'll leave Kagome in your care until I kill that Naraku!
context: You seem awfully clumsy in handling your sword.\Damn!\The Tetsusaiga is still too heavy for him.\Well, it won't become light so quickly.\Don't run away!\Sorry, but I have no time to spar with you now.\Hey! Come back here!\Dogface! I'll leave Kagome in your care until I kill that Naraku! response:	Don't you dare lay one finger on her!
context: Damn!\The Tetsusaiga is still too heavy for him.\Well, it won't become light so quickly.\Don't run away!\Sorry, but I have no time to spar with you now.\Hey! Come back here!\Dogface! I'll leave Kagome in your care until I kill that Naraku!\Don't you dare lay one finger on her! response:	W-what?!
context: The Tetsusaiga is still too heavy for him.\Well, it won't become light so quickly.\Don't run away!\Sorry, but I have no time to spar with you now.\Hey! Come back here!\Dogface! I'll leave Kagome in your care until I kill that Naraku!\Don't you dare lay one finger on her!\W-what?! response:	Even when he runs away, he's so confident.
context: Well, it won't become light so quickly.\Don't run away!\Sorry, but I have no time to spar with you now.\Hey! Come back here!\Dogface! I'll leave Kagome in your care until I kill that Naraku!\Don't you dare lay one finger on her!\W-what?!\Even when he runs away, he's so confident. response:	Inuyasha! Don't get so riled up.
context: Don't run away!\Sorry, but I have no time to spar with you now.\Hey! Come back here!\Dogface! I'll leave Kagome in your care until I kill that Naraku!\Don't you dare lay one finger on her!\W-what?!\Even when he runs away, he's so confident.\Inuyasha! Don't get so riled up. response:	When did I get riled up?!
context: Sorry, but I have no time to spar with you now.\Hey! Come back here!\Dogface! I'll leave Kagome in your care until I kill that Naraku!\Don't you dare lay one finger on her!\W-what?!\Even when he runs away, he's so confident.\Inuyasha! Don't get so riled up.\When did I get riled up?! response:	I'm happy that he's jealous...
context: Hey! Come back here!\Dogface! I'll leave Kagome in your care until I kill that Naraku!\Don't you dare lay one finger on her!\W-what?!\Even when he runs away, he's so confident.\Inuyasha! Don't get so riled up.\When did I get riled up?!\I'm happy that he's jealous... response:	but he could at least be a little more kind.
context: Dogface! I'll leave Kagome in your care until I kill that Naraku!\Don't you dare lay one finger on her!\W-what?!\Even when he runs away, he's so confident.\Inuyasha! Don't get so riled up.\When did I get riled up?!\I'm happy that he's jealous...\but he could at least be a little more kind. response:	This is so tiring.
context: Don't you dare lay one finger on her!\W-what?!\Even when he runs away, he's so confident.\Inuyasha! Don't get so riled up.\When did I get riled up?!\I'm happy that he's jealous...\but he could at least be a little more kind.\This is so tiring. response:	W-wha...!
context: W-what?!\Even when he runs away, he's so confident.\Inuyasha! Don't get so riled up.\When did I get riled up?!\I'm happy that he's jealous...\but he could at least be a little more kind.\This is so tiring.\W-wha...! response:	Does being with me really tire you out?
context: Even when he runs away, he's so confident.\Inuyasha! Don't get so riled up.\When did I get riled up?!\I'm happy that he's jealous...\but he could at least be a little more kind.\This is so tiring.\W-wha...!\Does being with me really tire you out? response:	Why are you so depressed?
context: Inuyasha! Don't get so riled up.\When did I get riled up?!\I'm happy that he's jealous...\but he could at least be a little more kind.\This is so tiring.\W-wha...!\Does being with me really tire you out?\Why are you so depressed? response:	Don't worry about what Koga said.
context: When did I get riled up?!\I'm happy that he's jealous...\but he could at least be a little more kind.\This is so tiring.\W-wha...!\Does being with me really tire you out?\Why are you so depressed?\Don't worry about what Koga said. response:	He's worried about what you said, Kagome.
context: I'm happy that he's jealous...\but he could at least be a little more kind.\This is so tiring.\W-wha...!\Does being with me really tire you out?\Why are you so depressed?\Don't worry about what Koga said.\He's worried about what you said, Kagome. response:	Uh-huh...
context: but he could at least be a little more kind.\This is so tiring.\W-wha...!\Does being with me really tire you out?\Why are you so depressed?\Don't worry about what Koga said.\He's worried about what you said, Kagome.\Uh-huh... response:	Huh?
context: This is so tiring.\W-wha...!\Does being with me really tire you out?\Why are you so depressed?\Don't worry about what Koga said.\He's worried about what you said, Kagome.\Uh-huh...\Huh? response:	Huh? What's that?
context: W-wha...!\Does being with me really tire you out?\Why are you so depressed?\Don't worry about what Koga said.\He's worried about what you said, Kagome.\Uh-huh...\Huh?\Huh? What's that? response:	Insects?
context: Does being with me really tire you out?\Why are you so depressed?\Don't worry about what Koga said.\He's worried about what you said, Kagome.\Uh-huh...\Huh?\Huh? What's that?\Insects? response:	K-Koga!
context: Why are you so depressed?\Don't worry about what Koga said.\He's worried about what you said, Kagome.\Uh-huh...\Huh?\Huh? What's that?\Insects?\K-Koga! response:	This is the smell!
context: Don't worry about what Koga said.\He's worried about what you said, Kagome.\Uh-huh...\Huh?\Huh? What's that?\Insects?\K-Koga!\This is the smell! response:	The same smell as Kagura!
context: He's worried about what you said, Kagome.\Uh-huh...\Huh?\Huh? What's that?\Insects?\K-Koga!\This is the smell!\The same smell as Kagura! response:	No mistake about it!
context: Uh-huh...\Huh?\Huh? What's that?\Insects?\K-Koga!\This is the smell!\The same smell as Kagura!\No mistake about it! response:	Oh...
context: Huh?\Huh? What's that?\Insects?\K-Koga!\This is the smell!\The same smell as Kagura!\No mistake about it!\Oh... response:	The young leader of the Wolf-Demon Tribe.
context: Huh? What's that?\Insects?\K-Koga!\This is the smell!\The same smell as Kagura!\No mistake about it!\Oh...\The young leader of the Wolf-Demon Tribe. response:	You followed my scent before Inuyasha could.
context: Insects?\K-Koga!\This is the smell!\The same smell as Kagura!\No mistake about it!\Oh...\The young leader of the Wolf-Demon Tribe.\You followed my scent before Inuyasha could. response:	You... are Naraku?!
context: K-Koga!\This is the smell!\The same smell as Kagura!\No mistake about it!\Oh...\The young leader of the Wolf-Demon Tribe.\You followed my scent before Inuyasha could.\You... are Naraku?! response:	The same smell as that woman Kagura.
context: This is the smell!\The same smell as Kagura!\No mistake about it!\Oh...\The young leader of the Wolf-Demon Tribe.\You followed my scent before Inuyasha could.\You... are Naraku?!\The same smell as that woman Kagura. response:	He must be Naraku!
context: The same smell as Kagura!\No mistake about it!\Oh...\The young leader of the Wolf-Demon Tribe.\You followed my scent before Inuyasha could.\You... are Naraku?!\The same smell as that woman Kagura.\He must be Naraku! response:	I'll never forget...
context: No mistake about it!\Oh...\The young leader of the Wolf-Demon Tribe.\You followed my scent before Inuyasha could.\You... are Naraku?!\The same smell as that woman Kagura.\He must be Naraku!\I'll never forget... response:	the wrath of my comrades who were killed by you.
context: Oh...\The young leader of the Wolf-Demon Tribe.\You followed my scent before Inuyasha could.\You... are Naraku?!\The same smell as that woman Kagura.\He must be Naraku!\I'll never forget...\the wrath of my comrades who were killed by you. response:	I'll avenge them right here!
context: The young leader of the Wolf-Demon Tribe.\You followed my scent before Inuyasha could.\You... are Naraku?!\The same smell as that woman Kagura.\He must be Naraku!\I'll never forget...\the wrath of my comrades who were killed by you.\I'll avenge them right here! response:	Too bad...
context: You followed my scent before Inuyasha could.\You... are Naraku?!\The same smell as that woman Kagura.\He must be Naraku!\I'll never forget...\the wrath of my comrades who were killed by you.\I'll avenge them right here!\Too bad... response:	but you can be fodder for my new incarnation.
context: You... are Naraku?!\The same smell as that woman Kagura.\He must be Naraku!\I'll never forget...\the wrath of my comrades who were killed by you.\I'll avenge them right here!\Too bad...\but you can be fodder for my new incarnation. response:	A cage?
context: The same smell as that woman Kagura.\He must be Naraku!\I'll never forget...\the wrath of my comrades who were killed by you.\I'll avenge them right here!\Too bad...\but you can be fodder for my new incarnation.\A cage? response:	but you couldn't have timed it better.
context: He must be Naraku!\I'll never forget...\the wrath of my comrades who were killed by you.\I'll avenge them right here!\Too bad...\but you can be fodder for my new incarnation.\A cage?\but you couldn't have timed it better. response:	I'll get revenge for my comrades!
context: I'll never forget...\the wrath of my comrades who were killed by you.\I'll avenge them right here!\Too bad...\but you can be fodder for my new incarnation.\A cage?\but you couldn't have timed it better.\I'll get revenge for my comrades! response:	Koga... he will be your opponent.
context: the wrath of my comrades who were killed by you.\I'll avenge them right here!\Too bad...\but you can be fodder for my new incarnation.\A cage?\but you couldn't have timed it better.\I'll get revenge for my comrades!\Koga... he will be your opponent. response:	Come on out, Juromaru.
context: I'll avenge them right here!\Too bad...\but you can be fodder for my new incarnation.\A cage?\but you couldn't have timed it better.\I'll get revenge for my comrades!\Koga... he will be your opponent.\Come on out, Juromaru. response:	W- what is he...?
context: Too bad...\but you can be fodder for my new incarnation.\A cage?\but you couldn't have timed it better.\I'll get revenge for my comrades!\Koga... he will be your opponent.\Come on out, Juromaru.\W- what is he...? response:	Humph, so be it! I'll take him first!
context: but you can be fodder for my new incarnation.\A cage?\but you couldn't have timed it better.\I'll get revenge for my comrades!\Koga... he will be your opponent.\Come on out, Juromaru.\W- what is he...?\Humph, so be it! I'll take him first! response:	I'll beat the hell out of both of you!
context: A cage?\but you couldn't have timed it better.\I'll get revenge for my comrades!\Koga... he will be your opponent.\Come on out, Juromaru.\W- what is he...?\Humph, so be it! I'll take him first!\I'll beat the hell out of both of you! response:	Naraku, what's wrong?
context: but you couldn't have timed it better.\I'll get revenge for my comrades!\Koga... he will be your opponent.\Come on out, Juromaru.\W- what is he...?\Humph, so be it! I'll take him first!\I'll beat the hell out of both of you!\Naraku, what's wrong? response:	Hurry up and take off his shackles!
context: I'll get revenge for my comrades!\Koga... he will be your opponent.\Come on out, Juromaru.\W- what is he...?\Humph, so be it! I'll take him first!\I'll beat the hell out of both of you!\Naraku, what's wrong?\Hurry up and take off his shackles! response:	For you, he's fine just as he is.
context: Koga... he will be your opponent.\Come on out, Juromaru.\W- what is he...?\Humph, so be it! I'll take him first!\I'll beat the hell out of both of you!\Naraku, what's wrong?\Hurry up and take off his shackles!\For you, he's fine just as he is. response:	Well then... here I come!
context: Come on out, Juromaru.\W- what is he...?\Humph, so be it! I'll take him first!\I'll beat the hell out of both of you!\Naraku, what's wrong?\Hurry up and take off his shackles!\For you, he's fine just as he is.\Well then... here I come! response:	Take that!
context: W- what is he...?\Humph, so be it! I'll take him first!\I'll beat the hell out of both of you!\Naraku, what's wrong?\Hurry up and take off his shackles!\For you, he's fine just as he is.\Well then... here I come!\Take that! response:	Why you!
context: Humph, so be it! I'll take him first!\I'll beat the hell out of both of you!\Naraku, what's wrong?\Hurry up and take off his shackles!\For you, he's fine just as he is.\Well then... here I come!\Take that!\Why you! response:	He's fast... I'm afraid he might be faster than I am.
context: I'll beat the hell out of both of you!\Naraku, what's wrong?\Hurry up and take off his shackles!\For you, he's fine just as he is.\Well then... here I come!\Take that!\Why you!\He's fast... I'm afraid he might be faster than I am. response:	No...but what's this chill in the air?
context: Naraku, what's wrong?\Hurry up and take off his shackles!\For you, he's fine just as he is.\Well then... here I come!\Take that!\Why you!\He's fast... I'm afraid he might be faster than I am.\No...but what's this chill in the air? response:	Huh?
context: Hurry up and take off his shackles!\For you, he's fine just as he is.\Well then... here I come!\Take that!\Why you!\He's fast... I'm afraid he might be faster than I am.\No...but what's this chill in the air?\Huh? response:	The bit in his mouth...
context: For you, he's fine just as he is.\Well then... here I come!\Take that!\Why you!\He's fast... I'm afraid he might be faster than I am.\No...but what's this chill in the air?\Huh?\The bit in his mouth... response:	It's Naraku's smell!
context: Well then... here I come!\Take that!\Why you!\He's fast... I'm afraid he might be faster than I am.\No...but what's this chill in the air?\Huh?\The bit in his mouth...\It's Naraku's smell! response:	Wait, Inuyasha!
context: Take that!\Why you!\He's fast... I'm afraid he might be faster than I am.\No...but what's this chill in the air?\Huh?\The bit in his mouth...\It's Naraku's smell!\Wait, Inuyasha! response:	Don't go off on your own!
context: Why you!\He's fast... I'm afraid he might be faster than I am.\No...but what's this chill in the air?\Huh?\The bit in his mouth...\It's Naraku's smell!\Wait, Inuyasha!\Don't go off on your own! response:	Good grief! You can't even wield the Tetsusaiga sufficiently!
context: He's fast... I'm afraid he might be faster than I am.\No...but what's this chill in the air?\Huh?\The bit in his mouth...\It's Naraku's smell!\Wait, Inuyasha!\Don't go off on your own!\Good grief! You can't even wield the Tetsusaiga sufficiently! response:	Shaddup!
context: No...but what's this chill in the air?\Huh?\The bit in his mouth...\It's Naraku's smell!\Wait, Inuyasha!\Don't go off on your own!\Good grief! You can't even wield the Tetsusaiga sufficiently!\Shaddup! response:	It's not only Naraku I smell!
context: Huh?\The bit in his mouth...\It's Naraku's smell!\Wait, Inuyasha!\Don't go off on your own!\Good grief! You can't even wield the Tetsusaiga sufficiently!\Shaddup!\It's not only Naraku I smell! response:	I catch the smell of that pesky Koga as well!
context: The bit in his mouth...\It's Naraku's smell!\Wait, Inuyasha!\Don't go off on your own!\Good grief! You can't even wield the Tetsusaiga sufficiently!\Shaddup!\It's not only Naraku I smell!\I catch the smell of that pesky Koga as well! response:	I'm the one who's gonna destroy Naraku!
context: It's Naraku's smell!\Wait, Inuyasha!\Don't go off on your own!\Good grief! You can't even wield the Tetsusaiga sufficiently!\Shaddup!\It's not only Naraku I smell!\I catch the smell of that pesky Koga as well!\I'm the one who's gonna destroy Naraku! response:	I won't let Koga get ahead of me!
context: Wait, Inuyasha!\Don't go off on your own!\Good grief! You can't even wield the Tetsusaiga sufficiently!\Shaddup!\It's not only Naraku I smell!\I catch the smell of that pesky Koga as well!\I'm the one who's gonna destroy Naraku!\I won't let Koga get ahead of me! response:	Koga!
context: Don't go off on your own!\Good grief! You can't even wield the Tetsusaiga sufficiently!\Shaddup!\It's not only Naraku I smell!\I catch the smell of that pesky Koga as well!\I'm the one who's gonna destroy Naraku!\I won't let Koga get ahead of me!\Koga! response:	What're you doing?!
context: Good grief! You can't even wield the Tetsusaiga sufficiently!\Shaddup!\It's not only Naraku I smell!\I catch the smell of that pesky Koga as well!\I'm the one who's gonna destroy Naraku!\I won't let Koga get ahead of me!\Koga!\What're you doing?! response:	Shaddup! I'm busy right now!
context: Shaddup!\It's not only Naraku I smell!\I catch the smell of that pesky Koga as well!\I'm the one who's gonna destroy Naraku!\I won't let Koga get ahead of me!\Koga!\What're you doing?!\Shaddup! I'm busy right now! response:	What?!
context: It's not only Naraku I smell!\I catch the smell of that pesky Koga as well!\I'm the one who's gonna destroy Naraku!\I won't let Koga get ahead of me!\Koga!\What're you doing?!\Shaddup! I'm busy right now!\What?! response:	He's caught up with me!
context: I catch the smell of that pesky Koga as well!\I'm the one who's gonna destroy Naraku!\I won't let Koga get ahead of me!\Koga!\What're you doing?!\Shaddup! I'm busy right now!\What?!\He's caught up with me! response:	Koga! You're running away!
context: I'm the one who's gonna destroy Naraku!\I won't let Koga get ahead of me!\Koga!\What're you doing?!\Shaddup! I'm busy right now!\What?!\He's caught up with me!\Koga! You're running away! response:	Damn, he's gone!
context: I won't let Koga get ahead of me!\Koga!\What're you doing?!\Shaddup! I'm busy right now!\What?!\He's caught up with me!\Koga! You're running away!\Damn, he's gone! response:	So you've finally come, Inuyasha.
context: Koga!\What're you doing?!\Shaddup! I'm busy right now!\What?!\He's caught up with me!\Koga! You're running away!\Damn, he's gone!\So you've finally come, Inuyasha. response:	Naraku!
context: What're you doing?!\Shaddup! I'm busy right now!\What?!\He's caught up with me!\Koga! You're running away!\Damn, he's gone!\So you've finally come, Inuyasha.\Naraku! response:	Naraku!
context: Shaddup! I'm busy right now!\What?!\He's caught up with me!\Koga! You're running away!\Damn, he's gone!\So you've finally come, Inuyasha.\Naraku!\Naraku! response:	Koga realized he couldn't win and ran off.
context: What?!\He's caught up with me!\Koga! You're running away!\Damn, he's gone!\So you've finally come, Inuyasha.\Naraku!\Naraku!\Koga realized he couldn't win and ran off. response:	He's smarter than I thought.
context: He's caught up with me!\Koga! You're running away!\Damn, he's gone!\So you've finally come, Inuyasha.\Naraku!\Naraku!\Koga realized he couldn't win and ran off.\He's smarter than I thought. response:	That is another one of Naraku's incarnations.
context: Koga! You're running away!\Damn, he's gone!\So you've finally come, Inuyasha.\Naraku!\Naraku!\Koga realized he couldn't win and ran off.\He's smarter than I thought.\That is another one of Naraku's incarnations. response:	Juromaru, I'll remove your seal.
context: Damn, he's gone!\So you've finally come, Inuyasha.\Naraku!\Naraku!\Koga realized he couldn't win and ran off.\He's smarter than I thought.\That is another one of Naraku's incarnations.\Juromaru, I'll remove your seal. response:	Fight to your heart's content.
context: So you've finally come, Inuyasha.\Naraku!\Naraku!\Koga realized he couldn't win and ran off.\He's smarter than I thought.\That is another one of Naraku's incarnations.\Juromaru, I'll remove your seal.\Fight to your heart's content. response:	- Huh?! - Huh?
context: Naraku!\Naraku!\Koga realized he couldn't win and ran off.\He's smarter than I thought.\That is another one of Naraku's incarnations.\Juromaru, I'll remove your seal.\Fight to your heart's content.\- Huh?! - Huh? response:	Just what is he...?
context: Naraku!\Koga realized he couldn't win and ran off.\He's smarter than I thought.\That is another one of Naraku's incarnations.\Juromaru, I'll remove your seal.\Fight to your heart's content.\- Huh?! - Huh?\Just what is he...? response:	Once the bit is removed...
context: Koga realized he couldn't win and ran off.\He's smarter than I thought.\That is another one of Naraku's incarnations.\Juromaru, I'll remove your seal.\Fight to your heart's content.\- Huh?! - Huh?\Just what is he...?\Once the bit is removed... response:	Juromaru is unstoppable...
context: He's smarter than I thought.\That is another one of Naraku's incarnations.\Juromaru, I'll remove your seal.\Fight to your heart's content.\- Huh?! - Huh?\Just what is he...?\Once the bit is removed...\Juromaru is unstoppable... response:	until he kills every living thing around him.
context: That is another one of Naraku's incarnations.\Juromaru, I'll remove your seal.\Fight to your heart's content.\- Huh?! - Huh?\Just what is he...?\Once the bit is removed...\Juromaru is unstoppable...\until he kills every living thing around him. response:	W- what is this Juromaru?
context: Juromaru, I'll remove your seal.\Fight to your heart's content.\- Huh?! - Huh?\Just what is he...?\Once the bit is removed...\Juromaru is unstoppable...\until he kills every living thing around him.\W- what is this Juromaru? response:	He gives me the creeps!
context: Fight to your heart's content.\- Huh?! - Huh?\Just what is he...?\Once the bit is removed...\Juromaru is unstoppable...\until he kills every living thing around him.\W- what is this Juromaru?\He gives me the creeps! response:	It's probably just a demon puppet, but...
context: - Huh?! - Huh?\Just what is he...?\Once the bit is removed...\Juromaru is unstoppable...\until he kills every living thing around him.\W- what is this Juromaru?\He gives me the creeps!\It's probably just a demon puppet, but... response:	he just slashed the head of Naraku who's supposed to be an ally.
context: Just what is he...?\Once the bit is removed...\Juromaru is unstoppable...\until he kills every living thing around him.\W- what is this Juromaru?\He gives me the creeps!\It's probably just a demon puppet, but...\he just slashed the head of Naraku who's supposed to be an ally. response:	Can't he tell the difference?
context: Once the bit is removed...\Juromaru is unstoppable...\until he kills every living thing around him.\W- what is this Juromaru?\He gives me the creeps!\It's probably just a demon puppet, but...\he just slashed the head of Naraku who's supposed to be an ally.\Can't he tell the difference? response:	That's why he was shackled and bridled.
context: Juromaru is unstoppable...\until he kills every living thing around him.\W- what is this Juromaru?\He gives me the creeps!\It's probably just a demon puppet, but...\he just slashed the head of Naraku who's supposed to be an ally.\Can't he tell the difference?\That's why he was shackled and bridled. response:	Why you...!
context: until he kills every living thing around him.\W- what is this Juromaru?\He gives me the creeps!\It's probably just a demon puppet, but...\he just slashed the head of Naraku who's supposed to be an ally.\Can't he tell the difference?\That's why he was shackled and bridled.\Why you...! response:	What's with him?
context: W- what is this Juromaru?\He gives me the creeps!\It's probably just a demon puppet, but...\he just slashed the head of Naraku who's supposed to be an ally.\Can't he tell the difference?\That's why he was shackled and bridled.\Why you...!\What's with him? response:	He's taking my blows straight on.
context: He gives me the creeps!\It's probably just a demon puppet, but...\he just slashed the head of Naraku who's supposed to be an ally.\Can't he tell the difference?\That's why he was shackled and bridled.\Why you...!\What's with him?\He's taking my blows straight on. response:	Is this a trap?
context: It's probably just a demon puppet, but...\he just slashed the head of Naraku who's supposed to be an ally.\Can't he tell the difference?\That's why he was shackled and bridled.\Why you...!\What's with him?\He's taking my blows straight on.\Is this a trap? response:	No...
context: he just slashed the head of Naraku who's supposed to be an ally.\Can't he tell the difference?\That's why he was shackled and bridled.\Why you...!\What's with him?\He's taking my blows straight on.\Is this a trap?\No... response:	No matter how I look at it...
context: Can't he tell the difference?\That's why he was shackled and bridled.\Why you...!\What's with him?\He's taking my blows straight on.\Is this a trap?\No...\No matter how I look at it... response:	he's not capable of thinking up sly tricks to fight.
context: That's why he was shackled and bridled.\Why you...!\What's with him?\He's taking my blows straight on.\Is this a trap?\No...\No matter how I look at it...\he's not capable of thinking up sly tricks to fight. response:	If that's the case...
context: Why you...!\What's with him?\He's taking my blows straight on.\Is this a trap?\No...\No matter how I look at it...\he's not capable of thinking up sly tricks to fight.\If that's the case... response:	I'll just deliver a finishing blow!
context: What's with him?\He's taking my blows straight on.\Is this a trap?\No...\No matter how I look at it...\he's not capable of thinking up sly tricks to fight.\If that's the case...\I'll just deliver a finishing blow! response:	Iron-Reaver, Soul-Stealer!
context: He's taking my blows straight on.\Is this a trap?\No...\No matter how I look at it...\he's not capable of thinking up sly tricks to fight.\If that's the case...\I'll just deliver a finishing blow!\Iron-Reaver, Soul-Stealer! response:	They're evenly matched!
context: Is this a trap?\No...\No matter how I look at it...\he's not capable of thinking up sly tricks to fight.\If that's the case...\I'll just deliver a finishing blow!\Iron-Reaver, Soul-Stealer!\They're evenly matched! response:	Inuyasha!
context: No...\No matter how I look at it...\he's not capable of thinking up sly tricks to fight.\If that's the case...\I'll just deliver a finishing blow!\Iron-Reaver, Soul-Stealer!\They're evenly matched!\Inuyasha! response:	What was that just now?!
context: No matter how I look at it...\he's not capable of thinking up sly tricks to fight.\If that's the case...\I'll just deliver a finishing blow!\Iron-Reaver, Soul-Stealer!\They're evenly matched!\Inuyasha!\What was that just now?! response:	He elongated his arms!
context: he's not capable of thinking up sly tricks to fight.\If that's the case...\I'll just deliver a finishing blow!\Iron-Reaver, Soul-Stealer!\They're evenly matched!\Inuyasha!\What was that just now?!\He elongated his arms! response:	He can transform his body?!
context: If that's the case...\I'll just deliver a finishing blow!\Iron-Reaver, Soul-Stealer!\They're evenly matched!\Inuyasha!\What was that just now?!\He elongated his arms!\He can transform his body?! response:	Did you find Naraku?
context: I'll just deliver a finishing blow!\Iron-Reaver, Soul-Stealer!\They're evenly matched!\Inuyasha!\What was that just now?!\He elongated his arms!\He can transform his body?!\Did you find Naraku? response:	Why did you return?
context: Iron-Reaver, Soul-Stealer!\They're evenly matched!\Inuyasha!\What was that just now?!\He elongated his arms!\He can transform his body?!\Did you find Naraku?\Why did you return? response:	Or did you run away?
context: They're evenly matched!\Inuyasha!\What was that just now?!\He elongated his arms!\He can transform his body?!\Did you find Naraku?\Why did you return?\Or did you run away? response:	Just my instinct.
context: Inuyasha!\What was that just now?!\He elongated his arms!\He can transform his body?!\Did you find Naraku?\Why did you return?\Or did you run away?\Just my instinct. response:	Naraku is one thing...
context: What was that just now?!\He elongated his arms!\He can transform his body?!\Did you find Naraku?\Why did you return?\Or did you run away?\Just my instinct.\Naraku is one thing... response:	but that thing he brought along looked so dumb.
context: He elongated his arms!\He can transform his body?!\Did you find Naraku?\Why did you return?\Or did you run away?\Just my instinct.\Naraku is one thing...\but that thing he brought along looked so dumb. response:	I got a really bad feeling about him.
context: He can transform his body?!\Did you find Naraku?\Why did you return?\Or did you run away?\Just my instinct.\Naraku is one thing...\but that thing he brought along looked so dumb.\I got a really bad feeling about him. response:	I trust my instincts.
context: Did you find Naraku?\Why did you return?\Or did you run away?\Just my instinct.\Naraku is one thing...\but that thing he brought along looked so dumb.\I got a really bad feeling about him.\I trust my instincts. response:	He's probably being beaten to a pulp by that Juromaru.
context: Why did you return?\Or did you run away?\Just my instinct.\Naraku is one thing...\but that thing he brought along looked so dumb.\I got a really bad feeling about him.\I trust my instincts.\He's probably being beaten to a pulp by that Juromaru. response:	You saw Inuyasha?
context: Or did you run away?\Just my instinct.\Naraku is one thing...\but that thing he brought along looked so dumb.\I got a really bad feeling about him.\I trust my instincts.\He's probably being beaten to a pulp by that Juromaru.\You saw Inuyasha? response:	Well yeah...
context: Just my instinct.\Naraku is one thing...\but that thing he brought along looked so dumb.\I got a really bad feeling about him.\I trust my instincts.\He's probably being beaten to a pulp by that Juromaru.\You saw Inuyasha?\Well yeah... response:	Umm... Koga...
context: Naraku is one thing...\but that thing he brought along looked so dumb.\I got a really bad feeling about him.\I trust my instincts.\He's probably being beaten to a pulp by that Juromaru.\You saw Inuyasha?\Well yeah...\Umm... Koga... response:	we may be out of line about this...
context: but that thing he brought along looked so dumb.\I got a really bad feeling about him.\I trust my instincts.\He's probably being beaten to a pulp by that Juromaru.\You saw Inuyasha?\Well yeah...\Umm... Koga...\we may be out of line about this... response:	But doesn't it mean that Kagome who's with Inuyasha is in danger?
context: I got a really bad feeling about him.\I trust my instincts.\He's probably being beaten to a pulp by that Juromaru.\You saw Inuyasha?\Well yeah...\Umm... Koga...\we may be out of line about this...\But doesn't it mean that Kagome who's with Inuyasha is in danger? response:	Huh?! Stupid! Why didn't you say so earlier?!
context: I trust my instincts.\He's probably being beaten to a pulp by that Juromaru.\You saw Inuyasha?\Well yeah...\Umm... Koga...\we may be out of line about this...\But doesn't it mean that Kagome who's with Inuyasha is in danger?\Huh?! Stupid! Why didn't you say so earlier?! response:	You should've realized it yourself!!
context: He's probably being beaten to a pulp by that Juromaru.\You saw Inuyasha?\Well yeah...\Umm... Koga...\we may be out of line about this...\But doesn't it mean that Kagome who's with Inuyasha is in danger?\Huh?! Stupid! Why didn't you say so earlier?!\You should've realized it yourself!! response:	Why you!
context: You saw Inuyasha?\Well yeah...\Umm... Koga...\we may be out of line about this...\But doesn't it mean that Kagome who's with Inuyasha is in danger?\Huh?! Stupid! Why didn't you say so earlier?!\You should've realized it yourself!!\Why you! response:	What's going on?!
context: Well yeah...\Umm... Koga...\we may be out of line about this...\But doesn't it mean that Kagome who's with Inuyasha is in danger?\Huh?! Stupid! Why didn't you say so earlier?!\You should've realized it yourself!!\Why you!\What's going on?! response:	I didn't feel the arm sever!
context: Umm... Koga...\we may be out of line about this...\But doesn't it mean that Kagome who's with Inuyasha is in danger?\Huh?! Stupid! Why didn't you say so earlier?!\You should've realized it yourself!!\Why you!\What's going on?!\I didn't feel the arm sever! response:	It just sort of separated from Juromaru...
context: we may be out of line about this...\But doesn't it mean that Kagome who's with Inuyasha is in danger?\Huh?! Stupid! Why didn't you say so earlier?!\You should've realized it yourself!!\Why you!\What's going on?!\I didn't feel the arm sever!\It just sort of separated from Juromaru... response:	The arm's intact!
context: But doesn't it mean that Kagome who's with Inuyasha is in danger?\Huh?! Stupid! Why didn't you say so earlier?!\You should've realized it yourself!!\Why you!\What's going on?!\I didn't feel the arm sever!\It just sort of separated from Juromaru...\The arm's intact! response:	I knew it! That wasn't his arm that got cut off!
context: Huh?! Stupid! Why didn't you say so earlier?!\You should've realized it yourself!!\Why you!\What's going on?!\I didn't feel the arm sever!\It just sort of separated from Juromaru...\The arm's intact!\I knew it! That wasn't his arm that got cut off! response:	Huh?! The ground!
context: You should've realized it yourself!!\Why you!\What's going on?!\I didn't feel the arm sever!\It just sort of separated from Juromaru...\The arm's intact!\I knew it! That wasn't his arm that got cut off!\Huh?! The ground! response:	Inuyasha!
context: Why you!\What's going on?!\I didn't feel the arm sever!\It just sort of separated from Juromaru...\The arm's intact!\I knew it! That wasn't his arm that got cut off!\Huh?! The ground!\Inuyasha! response:	W-what's that thing?!
context: What's going on?!\I didn't feel the arm sever!\It just sort of separated from Juromaru...\The arm's intact!\I knew it! That wasn't his arm that got cut off!\Huh?! The ground!\Inuyasha!\W-what's that thing?! response:	The fellow's guts tasted pretty good, Juromaru.
context: I didn't feel the arm sever!\It just sort of separated from Juromaru...\The arm's intact!\I knew it! That wasn't his arm that got cut off!\Huh?! The ground!\Inuyasha!\W-what's that thing?!\The fellow's guts tasted pretty good, Juromaru. response:	Damn! So there's another one!
context: It just sort of separated from Juromaru...\The arm's intact!\I knew it! That wasn't his arm that got cut off!\Huh?! The ground!\Inuyasha!\W-what's that thing?!\The fellow's guts tasted pretty good, Juromaru.\Damn! So there's another one! response:	J-just what are you?!
context: The arm's intact!\I knew it! That wasn't his arm that got cut off!\Huh?! The ground!\Inuyasha!\W-what's that thing?!\The fellow's guts tasted pretty good, Juromaru.\Damn! So there's another one!\J-just what are you?! response:	I am Kageromaru.
context: I knew it! That wasn't his arm that got cut off!\Huh?! The ground!\Inuyasha!\W-what's that thing?!\The fellow's guts tasted pretty good, Juromaru.\Damn! So there's another one!\J-just what are you?!\I am Kageromaru. response:	I was fast asleep inside Juromaru's belly.
context: Huh?! The ground!\Inuyasha!\W-what's that thing?!\The fellow's guts tasted pretty good, Juromaru.\Damn! So there's another one!\J-just what are you?!\I am Kageromaru.\I was fast asleep inside Juromaru's belly. response:	Inside Juromaru's belly?
context: Inuyasha!\W-what's that thing?!\The fellow's guts tasted pretty good, Juromaru.\Damn! So there's another one!\J-just what are you?!\I am Kageromaru.\I was fast asleep inside Juromaru's belly.\Inside Juromaru's belly? response:	Then!
context: W-what's that thing?!\The fellow's guts tasted pretty good, Juromaru.\Damn! So there's another one!\J-just what are you?!\I am Kageromaru.\I was fast asleep inside Juromaru's belly.\Inside Juromaru's belly?\Then! response:	So the bit was to prevent you from coming out!
context: The fellow's guts tasted pretty good, Juromaru.\Damn! So there's another one!\J-just what are you?!\I am Kageromaru.\I was fast asleep inside Juromaru's belly.\Inside Juromaru's belly?\Then!\So the bit was to prevent you from coming out! response:	Juromaru only listens to me.
context: Damn! So there's another one!\J-just what are you?!\I am Kageromaru.\I was fast asleep inside Juromaru's belly.\Inside Juromaru's belly?\Then!\So the bit was to prevent you from coming out!\Juromaru only listens to me. response:	Even if the opponent was Naraku...
context: J-just what are you?!\I am Kageromaru.\I was fast asleep inside Juromaru's belly.\Inside Juromaru's belly?\Then!\So the bit was to prevent you from coming out!\Juromaru only listens to me.\Even if the opponent was Naraku... response:	What?!
context: I am Kageromaru.\I was fast asleep inside Juromaru's belly.\Inside Juromaru's belly?\Then!\So the bit was to prevent you from coming out!\Juromaru only listens to me.\Even if the opponent was Naraku...\What?! response:	Now then, let's feast on the rest of them, Juromaru.
context: I was fast asleep inside Juromaru's belly.\Inside Juromaru's belly?\Then!\So the bit was to prevent you from coming out!\Juromaru only listens to me.\Even if the opponent was Naraku...\What?!\Now then, let's feast on the rest of them, Juromaru. response:	It's all-you-can-eat!
context: Inside Juromaru's belly?\Then!\So the bit was to prevent you from coming out!\Juromaru only listens to me.\Even if the opponent was Naraku...\What?!\Now then, let's feast on the rest of them, Juromaru.\It's all-you-can-eat! response:	Wind Tunnel!
context: Then!\So the bit was to prevent you from coming out!\Juromaru only listens to me.\Even if the opponent was Naraku...\What?!\Now then, let's feast on the rest of them, Juromaru.\It's all-you-can-eat!\Wind Tunnel! response:	Miroku!
context: So the bit was to prevent you from coming out!\Juromaru only listens to me.\Even if the opponent was Naraku...\What?!\Now then, let's feast on the rest of them, Juromaru.\It's all-you-can-eat!\Wind Tunnel!\Miroku! response:	Hiraikotsu!
context: Juromaru only listens to me.\Even if the opponent was Naraku...\What?!\Now then, let's feast on the rest of them, Juromaru.\It's all-you-can-eat!\Wind Tunnel!\Miroku!\Hiraikotsu! response:	Sango!
context: Even if the opponent was Naraku...\What?!\Now then, let's feast on the rest of them, Juromaru.\It's all-you-can-eat!\Wind Tunnel!\Miroku!\Hiraikotsu!\Sango! response:	Wind Tunnel!
context: What?!\Now then, let's feast on the rest of them, Juromaru.\It's all-you-can-eat!\Wind Tunnel!\Miroku!\Hiraikotsu!\Sango!\Wind Tunnel! response:	Just what are you sucking up?
context: Now then, let's feast on the rest of them, Juromaru.\It's all-you-can-eat!\Wind Tunnel!\Miroku!\Hiraikotsu!\Sango!\Wind Tunnel!\Just what are you sucking up? response:	Are you above me?
context: It's all-you-can-eat!\Wind Tunnel!\Miroku!\Hiraikotsu!\Sango!\Wind Tunnel!\Just what are you sucking up?\Are you above me? response:	Too late.
context: Wind Tunnel!\Miroku!\Hiraikotsu!\Sango!\Wind Tunnel!\Just what are you sucking up?\Are you above me?\Too late. response:	And you think you can defeat us with that speed?
context: Miroku!\Hiraikotsu!\Sango!\Wind Tunnel!\Just what are you sucking up?\Are you above me?\Too late.\And you think you can defeat us with that speed? response:	Miroku!
context: Hiraikotsu!\Sango!\Wind Tunnel!\Just what are you sucking up?\Are you above me?\Too late.\And you think you can defeat us with that speed?\Miroku! response:	Why you!
context: Sango!\Wind Tunnel!\Just what are you sucking up?\Are you above me?\Too late.\And you think you can defeat us with that speed?\Miroku!\Why you! response:	Miroku, are you all right?!
context: Wind Tunnel!\Just what are you sucking up?\Are you above me?\Too late.\And you think you can defeat us with that speed?\Miroku!\Why you!\Miroku, are you all right?! response:	I was more afraid of your sword!
context: Just what are you sucking up?\Are you above me?\Too late.\And you think you can defeat us with that speed?\Miroku!\Why you!\Miroku, are you all right?!\I was more afraid of your sword! response:	Then just pull over the covers and sleep it off!
context: Are you above me?\Too late.\And you think you can defeat us with that speed?\Miroku!\Why you!\Miroku, are you all right?!\I was more afraid of your sword!\Then just pull over the covers and sleep it off! response:	I'm coming!
context: Too late.\And you think you can defeat us with that speed?\Miroku!\Why you!\Miroku, are you all right?!\I was more afraid of your sword!\Then just pull over the covers and sleep it off!\I'm coming! response:	Inuyasha, you mustn't move!
context: And you think you can defeat us with that speed?\Miroku!\Why you!\Miroku, are you all right?!\I was more afraid of your sword!\Then just pull over the covers and sleep it off!\I'm coming!\Inuyasha, you mustn't move! response:	You have a hole in your belly!
context: Miroku!\Why you!\Miroku, are you all right?!\I was more afraid of your sword!\Then just pull over the covers and sleep it off!\I'm coming!\Inuyasha, you mustn't move!\You have a hole in your belly! response:	Shaddup! This is nothing unusual...
context: Why you!\Miroku, are you all right?!\I was more afraid of your sword!\Then just pull over the covers and sleep it off!\I'm coming!\Inuyasha, you mustn't move!\You have a hole in your belly!\Shaddup! This is nothing unusual... response:	I'm taking this girl's life.
context: Miroku, are you all right?!\I was more afraid of your sword!\Then just pull over the covers and sleep it off!\I'm coming!\Inuyasha, you mustn't move!\You have a hole in your belly!\Shaddup! This is nothing unusual...\I'm taking this girl's life. response:	Kagome!
context: I was more afraid of your sword!\Then just pull over the covers and sleep it off!\I'm coming!\Inuyasha, you mustn't move!\You have a hole in your belly!\Shaddup! This is nothing unusual...\I'm taking this girl's life.\Kagome! response:	Kagome!
context: Then just pull over the covers and sleep it off!\I'm coming!\Inuyasha, you mustn't move!\You have a hole in your belly!\Shaddup! This is nothing unusual...\I'm taking this girl's life.\Kagome!\Kagome! response:	Huh?!
context: I'm coming!\Inuyasha, you mustn't move!\You have a hole in your belly!\Shaddup! This is nothing unusual...\I'm taking this girl's life.\Kagome!\Kagome!\Huh?! response:	Are you all right, Kagome?
context: Inuyasha, you mustn't move!\You have a hole in your belly!\Shaddup! This is nothing unusual...\I'm taking this girl's life.\Kagome!\Kagome!\Huh?!\Are you all right, Kagome? response:	K-Koga?
context: You have a hole in your belly!\Shaddup! This is nothing unusual...\I'm taking this girl's life.\Kagome!\Kagome!\Huh?!\Are you all right, Kagome?\K-Koga? response:	Dogface! What's going on?!
context: Shaddup! This is nothing unusual...\I'm taking this girl's life.\Kagome!\Kagome!\Huh?!\Are you all right, Kagome?\K-Koga?\Dogface! What's going on?! response:	How dare you put Kagome in danger!?
context: I'm taking this girl's life.\Kagome!\Kagome!\Huh?!\Are you all right, Kagome?\K-Koga?\Dogface! What's going on?!\How dare you put Kagome in danger!? response:	Shaddup!
context: Kagome!\Kagome!\Huh?!\Are you all right, Kagome?\K-Koga?\Dogface! What's going on?!\How dare you put Kagome in danger!?\Shaddup! response:	You ran off with your tail between your legs!
context: Kagome!\Huh?!\Are you all right, Kagome?\K-Koga?\Dogface! What's going on?!\How dare you put Kagome in danger!?\Shaddup!\You ran off with your tail between your legs! response:	But I'll thank you for just now! Stupid!
context: Huh?!\Are you all right, Kagome?\K-Koga?\Dogface! What's going on?!\How dare you put Kagome in danger!?\Shaddup!\You ran off with your tail between your legs!\But I'll thank you for just now! Stupid! response:	Was I in danger just now?
context: Are you all right, Kagome?\K-Koga?\Dogface! What's going on?!\How dare you put Kagome in danger!?\Shaddup!\You ran off with your tail between your legs!\But I'll thank you for just now! Stupid!\Was I in danger just now? response:	Looks like it.
context: K-Koga?\Dogface! What's going on?!\How dare you put Kagome in danger!?\Shaddup!\You ran off with your tail between your legs!\But I'll thank you for just now! Stupid!\Was I in danger just now?\Looks like it. response:	So what is that stupid looking demon?
context: Dogface! What's going on?!\How dare you put Kagome in danger!?\Shaddup!\You ran off with your tail between your legs!\But I'll thank you for just now! Stupid!\Was I in danger just now?\Looks like it.\So what is that stupid looking demon? response:	He came out of Juromaru's gut.
context: How dare you put Kagome in danger!?\Shaddup!\You ran off with your tail between your legs!\But I'll thank you for just now! Stupid!\Was I in danger just now?\Looks like it.\So what is that stupid looking demon?\He came out of Juromaru's gut. response:	No wonder... The cold I sensed coming from Juromaru...
context: Shaddup!\You ran off with your tail between your legs!\But I'll thank you for just now! Stupid!\Was I in danger just now?\Looks like it.\So what is that stupid looking demon?\He came out of Juromaru's gut.\No wonder... The cold I sensed coming from Juromaru... response:	It was him.
context: You ran off with your tail between your legs!\But I'll thank you for just now! Stupid!\Was I in danger just now?\Looks like it.\So what is that stupid looking demon?\He came out of Juromaru's gut.\No wonder... The cold I sensed coming from Juromaru...\It was him. response:	That Kageromaru is so swift, we can't keep up.
context: But I'll thank you for just now! Stupid!\Was I in danger just now?\Looks like it.\So what is that stupid looking demon?\He came out of Juromaru's gut.\No wonder... The cold I sensed coming from Juromaru...\It was him.\That Kageromaru is so swift, we can't keep up. response:	Just who do you think I am?
context: Was I in danger just now?\Looks like it.\So what is that stupid looking demon?\He came out of Juromaru's gut.\No wonder... The cold I sensed coming from Juromaru...\It was him.\That Kageromaru is so swift, we can't keep up.\Just who do you think I am? response:	There's no one who can outrun these legs.
context: Looks like it.\So what is that stupid looking demon?\He came out of Juromaru's gut.\No wonder... The cold I sensed coming from Juromaru...\It was him.\That Kageromaru is so swift, we can't keep up.\Just who do you think I am?\There's no one who can outrun these legs. response:	It seems talk is all you have.
context: So what is that stupid looking demon?\He came out of Juromaru's gut.\No wonder... The cold I sensed coming from Juromaru...\It was him.\That Kageromaru is so swift, we can't keep up.\Just who do you think I am?\There's no one who can outrun these legs.\It seems talk is all you have. response:	Well, that does it!
context: He came out of Juromaru's gut.\No wonder... The cold I sensed coming from Juromaru...\It was him.\That Kageromaru is so swift, we can't keep up.\Just who do you think I am?\There's no one who can outrun these legs.\It seems talk is all you have.\Well, that does it! response:	I'll twist your head off!
context: No wonder... The cold I sensed coming from Juromaru...\It was him.\That Kageromaru is so swift, we can't keep up.\Just who do you think I am?\There's no one who can outrun these legs.\It seems talk is all you have.\Well, that does it!\I'll twist your head off! response:	You're not worth your talk.
context: It was him.\That Kageromaru is so swift, we can't keep up.\Just who do you think I am?\There's no one who can outrun these legs.\It seems talk is all you have.\Well, that does it!\I'll twist your head off!\You're not worth your talk. response:	Is that as fast as you can go?
context: That Kageromaru is so swift, we can't keep up.\Just who do you think I am?\There's no one who can outrun these legs.\It seems talk is all you have.\Well, that does it!\I'll twist your head off!\You're not worth your talk.\Is that as fast as you can go? response:	Damn!
context: Just who do you think I am?\There's no one who can outrun these legs.\It seems talk is all you have.\Well, that does it!\I'll twist your head off!\You're not worth your talk.\Is that as fast as you can go?\Damn! response:	Juromaru! I'm your opponent!
context: There's no one who can outrun these legs.\It seems talk is all you have.\Well, that does it!\I'll twist your head off!\You're not worth your talk.\Is that as fast as you can go?\Damn!\Juromaru! I'm your opponent! response:	Inuyasha!
context: It seems talk is all you have.\Well, that does it!\I'll twist your head off!\You're not worth your talk.\Is that as fast as you can go?\Damn!\Juromaru! I'm your opponent!\Inuyasha! response:	Shame on you, dogface!
context: Well, that does it!\I'll twist your head off!\You're not worth your talk.\Is that as fast as you can go?\Damn!\Juromaru! I'm your opponent!\Inuyasha!\Shame on you, dogface! response:	A stupid demon like that should be an easy prey!
context: I'll twist your head off!\You're not worth your talk.\Is that as fast as you can go?\Damn!\Juromaru! I'm your opponent!\Inuyasha!\Shame on you, dogface!\A stupid demon like that should be an easy prey! response:	What?!
context: You're not worth your talk.\Is that as fast as you can go?\Damn!\Juromaru! I'm your opponent!\Inuyasha!\Shame on you, dogface!\A stupid demon like that should be an easy prey!\What?! response:	You!
context: Is that as fast as you can go?\Damn!\Juromaru! I'm your opponent!\Inuyasha!\Shame on you, dogface!\A stupid demon like that should be an easy prey!\What?!\You! response:	What about you?! Haven't caught Kageromaru yet?
context: Damn!\Juromaru! I'm your opponent!\Inuyasha!\Shame on you, dogface!\A stupid demon like that should be an easy prey!\What?!\You!\What about you?! Haven't caught Kageromaru yet? response:	Don't compare me to you!
context: Juromaru! I'm your opponent!\Inuyasha!\Shame on you, dogface!\A stupid demon like that should be an easy prey!\What?!\You!\What about you?! Haven't caught Kageromaru yet?\Don't compare me to you! response:	Whoa!
context: Inuyasha!\Shame on you, dogface!\A stupid demon like that should be an easy prey!\What?!\You!\What about you?! Haven't caught Kageromaru yet?\Don't compare me to you!\Whoa! response:	I can see you now!
context: Shame on you, dogface!\A stupid demon like that should be an easy prey!\What?!\You!\What about you?! Haven't caught Kageromaru yet?\Don't compare me to you!\Whoa!\I can see you now! response:	Right here!
context: A stupid demon like that should be an easy prey!\What?!\You!\What about you?! Haven't caught Kageromaru yet?\Don't compare me to you!\Whoa!\I can see you now!\Right here! response:	He's anticipating Kageromaru's moves.
context: What?!\You!\What about you?! Haven't caught Kageromaru yet?\Don't compare me to you!\Whoa!\I can see you now!\Right here!\He's anticipating Kageromaru's moves. response:	Amazing!
context: You!\What about you?! Haven't caught Kageromaru yet?\Don't compare me to you!\Whoa!\I can see you now!\Right here!\He's anticipating Kageromaru's moves.\Amazing! response:	Finishing blow!
context: What about you?! Haven't caught Kageromaru yet?\Don't compare me to you!\Whoa!\I can see you now!\Right here!\He's anticipating Kageromaru's moves.\Amazing!\Finishing blow! response:	He did it!
context: Don't compare me to you!\Whoa!\I can see you now!\Right here!\He's anticipating Kageromaru's moves.\Amazing!\Finishing blow!\He did it! response:	Gone! He escaped!
context: Whoa!\I can see you now!\Right here!\He's anticipating Kageromaru's moves.\Amazing!\Finishing blow!\He did it!\Gone! He escaped! response:	W-what! From beneath the soil!
context: I can see you now!\Right here!\He's anticipating Kageromaru's moves.\Amazing!\Finishing blow!\He did it!\Gone! He escaped!\W-what! From beneath the soil! response:	Inuyasha!
context: Right here!\He's anticipating Kageromaru's moves.\Amazing!\Finishing blow!\He did it!\Gone! He escaped!\W-what! From beneath the soil!\Inuyasha! response:	Damn! He went under again!
context: He's anticipating Kageromaru's moves.\Amazing!\Finishing blow!\He did it!\Gone! He escaped!\W-what! From beneath the soil!\Inuyasha!\Damn! He went under again! response:	No! With his leg injured, there's no way he can win!
context: Amazing!\Finishing blow!\He did it!\Gone! He escaped!\W-what! From beneath the soil!\Inuyasha!\Damn! He went under again!\No! With his leg injured, there's no way he can win! response:	Inuyasha is still unconscious.
context: Finishing blow!\He did it!\Gone! He escaped!\W-what! From beneath the soil!\Inuyasha!\Damn! He went under again!\No! With his leg injured, there's no way he can win!\Inuyasha is still unconscious. response:	Now then... I think I'll have that girl's liver.
context: He did it!\Gone! He escaped!\W-what! From beneath the soil!\Inuyasha!\Damn! He went under again!\No! With his leg injured, there's no way he can win!\Inuyasha is still unconscious.\Now then... I think I'll have that girl's liver. response:	W-what?!
context: Gone! He escaped!\W-what! From beneath the soil!\Inuyasha!\Damn! He went under again!\No! With his leg injured, there's no way he can win!\Inuyasha is still unconscious.\Now then... I think I'll have that girl's liver.\W-what?! response:	Kageromaru, don't you dare touch Kagome...!
context: W-what! From beneath the soil!\Inuyasha!\Damn! He went under again!\No! With his leg injured, there's no way he can win!\Inuyasha is still unconscious.\Now then... I think I'll have that girl's liver.\W-what?!\Kageromaru, don't you dare touch Kagome...! response:	I'll eat her bones and all!
context: Inuyasha!\Damn! He went under again!\No! With his leg injured, there's no way he can win!\Inuyasha is still unconscious.\Now then... I think I'll have that girl's liver.\W-what?!\Kageromaru, don't you dare touch Kagome...!\I'll eat her bones and all! response:	No way!
context: Damn! He went under again!\No! With his leg injured, there's no way he can win!\Inuyasha is still unconscious.\Now then... I think I'll have that girl's liver.\W-what?!\Kageromaru, don't you dare touch Kagome...!\I'll eat her bones and all!\No way! response:	Too late!
context: No! With his leg injured, there's no way he can win!\Inuyasha is still unconscious.\Now then... I think I'll have that girl's liver.\W-what?!\Kageromaru, don't you dare touch Kagome...!\I'll eat her bones and all!\No way!\Too late! response:	Inuyasha!
context: Inuyasha is still unconscious.\Now then... I think I'll have that girl's liver.\W-what?!\Kageromaru, don't you dare touch Kagome...!\I'll eat her bones and all!\No way!\Too late!\Inuyasha! response:	Why you...!
context: Now then... I think I'll have that girl's liver.\W-what?!\Kageromaru, don't you dare touch Kagome...!\I'll eat her bones and all!\No way!\Too late!\Inuyasha!\Why you...! response:	Inuyasha... did the sword become light?
context: W-what?!\Kageromaru, don't you dare touch Kagome...!\I'll eat her bones and all!\No way!\Too late!\Inuyasha!\Why you...!\Inuyasha... did the sword become light? response:	He's wielding the Tetsusaiga with one hand.
context: Kageromaru, don't you dare touch Kagome...!\I'll eat her bones and all!\No way!\Too late!\Inuyasha!\Why you...!\Inuyasha... did the sword become light?\He's wielding the Tetsusaiga with one hand. response:	He's so simple-minded.
context: I'll eat her bones and all!\No way!\Too late!\Inuyasha!\Why you...!\Inuyasha... did the sword become light?\He's wielding the Tetsusaiga with one hand.\He's so simple-minded. response:	He got so mad, he forgot how heavy it is.
context: No way!\Too late!\Inuyasha!\Why you...!\Inuyasha... did the sword become light?\He's wielding the Tetsusaiga with one hand.\He's so simple-minded.\He got so mad, he forgot how heavy it is. response:	He heard me?
context: Too late!\Inuyasha!\Why you...!\Inuyasha... did the sword become light?\He's wielding the Tetsusaiga with one hand.\He's so simple-minded.\He got so mad, he forgot how heavy it is.\He heard me? response:	Did he go under again?
context: Inuyasha!\Why you...!\Inuyasha... did the sword become light?\He's wielding the Tetsusaiga with one hand.\He's so simple-minded.\He got so mad, he forgot how heavy it is.\He heard me?\Did he go under again? response:	Inuyasha!
context: Why you...!\Inuyasha... did the sword become light?\He's wielding the Tetsusaiga with one hand.\He's so simple-minded.\He got so mad, he forgot how heavy it is.\He heard me?\Did he go under again?\Inuyasha! response:	Kagome, are you all right?
context: Inuyasha... did the sword become light?\He's wielding the Tetsusaiga with one hand.\He's so simple-minded.\He got so mad, he forgot how heavy it is.\He heard me?\Did he go under again?\Inuyasha!\Kagome, are you all right? response:	Yes... but look at your wound, it looks so terrible.
context: He's wielding the Tetsusaiga with one hand.\He's so simple-minded.\He got so mad, he forgot how heavy it is.\He heard me?\Did he go under again?\Inuyasha!\Kagome, are you all right?\Yes... but look at your wound, it looks so terrible. response:	Dogface, he's still alive?
context: He's so simple-minded.\He got so mad, he forgot how heavy it is.\He heard me?\Did he go under again?\Inuyasha!\Kagome, are you all right?\Yes... but look at your wound, it looks so terrible.\Dogface, he's still alive? response:	Koga's leg has been injured.
context: He got so mad, he forgot how heavy it is.\He heard me?\Did he go under again?\Inuyasha!\Kagome, are you all right?\Yes... but look at your wound, it looks so terrible.\Dogface, he's still alive?\Koga's leg has been injured. response:	Tsk! That guy is so useless!
context: He heard me?\Did he go under again?\Inuyasha!\Kagome, are you all right?\Yes... but look at your wound, it looks so terrible.\Dogface, he's still alive?\Koga's leg has been injured.\Tsk! That guy is so useless! response:	Just watch me, wolf cub! I shall defeat Juromaru...
context: Did he go under again?\Inuyasha!\Kagome, are you all right?\Yes... but look at your wound, it looks so terrible.\Dogface, he's still alive?\Koga's leg has been injured.\Tsk! That guy is so useless!\Just watch me, wolf cub! I shall defeat Juromaru... response:	Did it get heavy again?
context: Inuyasha!\Kagome, are you all right?\Yes... but look at your wound, it looks so terrible.\Dogface, he's still alive?\Koga's leg has been injured.\Tsk! That guy is so useless!\Just watch me, wolf cub! I shall defeat Juromaru...\Did it get heavy again? response:	Earlier, he was so focused on protecting Kagome, but now...
context: Kagome, are you all right?\Yes... but look at your wound, it looks so terrible.\Dogface, he's still alive?\Koga's leg has been injured.\Tsk! That guy is so useless!\Just watch me, wolf cub! I shall defeat Juromaru...\Did it get heavy again?\Earlier, he was so focused on protecting Kagome, but now... response:	What?!
context: Yes... but look at your wound, it looks so terrible.\Dogface, he's still alive?\Koga's leg has been injured.\Tsk! That guy is so useless!\Just watch me, wolf cub! I shall defeat Juromaru...\Did it get heavy again?\Earlier, he was so focused on protecting Kagome, but now...\What?! response:	Coward... Iost your nerve, huh?!
context: Dogface, he's still alive?\Koga's leg has been injured.\Tsk! That guy is so useless!\Just watch me, wolf cub! I shall defeat Juromaru...\Did it get heavy again?\Earlier, he was so focused on protecting Kagome, but now...\What?!\Coward... Iost your nerve, huh?! response:	What?! Shaddup!
context: Koga's leg has been injured.\Tsk! That guy is so useless!\Just watch me, wolf cub! I shall defeat Juromaru...\Did it get heavy again?\Earlier, he was so focused on protecting Kagome, but now...\What?!\Coward... Iost your nerve, huh?!\What?! Shaddup! response:	I'll finish you off, too...
context: Tsk! That guy is so useless!\Just watch me, wolf cub! I shall defeat Juromaru...\Did it get heavy again?\Earlier, he was so focused on protecting Kagome, but now...\What?!\Coward... Iost your nerve, huh?!\What?! Shaddup!\I'll finish you off, too... response:	Why you...!
context: Just watch me, wolf cub! I shall defeat Juromaru...\Did it get heavy again?\Earlier, he was so focused on protecting Kagome, but now...\What?!\Coward... Iost your nerve, huh?!\What?! Shaddup!\I'll finish you off, too...\Why you...! response:	Take this!
context: Did it get heavy again?\Earlier, he was so focused on protecting Kagome, but now...\What?!\Coward... Iost your nerve, huh?!\What?! Shaddup!\I'll finish you off, too...\Why you...!\Take this! response:	I won't thank you!
context: Earlier, he was so focused on protecting Kagome, but now...\What?!\Coward... Iost your nerve, huh?!\What?! Shaddup!\I'll finish you off, too...\Why you...!\Take this!\I won't thank you! response:	I demand a thank-you!
context: What?!\Coward... Iost your nerve, huh?!\What?! Shaddup!\I'll finish you off, too...\Why you...!\Take this!\I won't thank you!\I demand a thank-you! response:	If this fight continues, even Inuyasha can't hold up.
context: Coward... Iost your nerve, huh?!\What?! Shaddup!\I'll finish you off, too...\Why you...!\Take this!\I won't thank you!\I demand a thank-you!\If this fight continues, even Inuyasha can't hold up. response:	There's no way of knowing where underground Kageromaru will attack.
context: What?! Shaddup!\I'll finish you off, too...\Why you...!\Take this!\I won't thank you!\I demand a thank-you!\If this fight continues, even Inuyasha can't hold up.\There's no way of knowing where underground Kageromaru will attack. response:	I know!
context: I'll finish you off, too...\Why you...!\Take this!\I won't thank you!\I demand a thank-you!\If this fight continues, even Inuyasha can't hold up.\There's no way of knowing where underground Kageromaru will attack.\I know! response:	If at least Kageromaru can be restrained...
context: Why you...!\Take this!\I won't thank you!\I demand a thank-you!\If this fight continues, even Inuyasha can't hold up.\There's no way of knowing where underground Kageromaru will attack.\I know!\If at least Kageromaru can be restrained... response:	Miroku, give me your staff.
context: Take this!\I won't thank you!\I demand a thank-you!\If this fight continues, even Inuyasha can't hold up.\There's no way of knowing where underground Kageromaru will attack.\I know!\If at least Kageromaru can be restrained...\Miroku, give me your staff. response:	Do you have a plan?
context: I won't thank you!\I demand a thank-you!\If this fight continues, even Inuyasha can't hold up.\There's no way of knowing where underground Kageromaru will attack.\I know!\If at least Kageromaru can be restrained...\Miroku, give me your staff.\Do you have a plan? response:	This poison... won't work too long...
context: I demand a thank-you!\If this fight continues, even Inuyasha can't hold up.\There's no way of knowing where underground Kageromaru will attack.\I know!\If at least Kageromaru can be restrained...\Miroku, give me your staff.\Do you have a plan?\This poison... won't work too long... response:	but it should force Kageromaru out into the open.
context: If this fight continues, even Inuyasha can't hold up.\There's no way of knowing where underground Kageromaru will attack.\I know!\If at least Kageromaru can be restrained...\Miroku, give me your staff.\Do you have a plan?\This poison... won't work too long...\but it should force Kageromaru out into the open. response:	The soil is turning red!
context: There's no way of knowing where underground Kageromaru will attack.\I know!\If at least Kageromaru can be restrained...\Miroku, give me your staff.\Do you have a plan?\This poison... won't work too long...\but it should force Kageromaru out into the open.\The soil is turning red! response:	You did it!
context: I know!\If at least Kageromaru can be restrained...\Miroku, give me your staff.\Do you have a plan?\This poison... won't work too long...\but it should force Kageromaru out into the open.\The soil is turning red!\You did it! response:	Capture Kageromaru!
context: If at least Kageromaru can be restrained...\Miroku, give me your staff.\Do you have a plan?\This poison... won't work too long...\but it should force Kageromaru out into the open.\The soil is turning red!\You did it!\Capture Kageromaru! response:	The poison must have slowed him down!
context: Miroku, give me your staff.\Do you have a plan?\This poison... won't work too long...\but it should force Kageromaru out into the open.\The soil is turning red!\You did it!\Capture Kageromaru!\The poison must have slowed him down! response:	Why you!
context: Do you have a plan?\This poison... won't work too long...\but it should force Kageromaru out into the open.\The soil is turning red!\You did it!\Capture Kageromaru!\The poison must have slowed him down!\Why you! response:	You!
context: This poison... won't work too long...\but it should force Kageromaru out into the open.\The soil is turning red!\You did it!\Capture Kageromaru!\The poison must have slowed him down!\Why you!\You! response:	Shame on you, dogface! You gonna die this time?
context: but it should force Kageromaru out into the open.\The soil is turning red!\You did it!\Capture Kageromaru!\The poison must have slowed him down!\Why you!\You!\Shame on you, dogface! You gonna die this time? response:	Inuyasha!
context: The soil is turning red!\You did it!\Capture Kageromaru!\The poison must have slowed him down!\Why you!\You!\Shame on you, dogface! You gonna die this time?\Inuyasha! response:	Hang on!
context: You did it!\Capture Kageromaru!\The poison must have slowed him down!\Why you!\You!\Shame on you, dogface! You gonna die this time?\Inuyasha!\Hang on! response:	Don't panic, Kagome.
context: Capture Kageromaru!\The poison must have slowed him down!\Why you!\You!\Shame on you, dogface! You gonna die this time?\Inuyasha!\Hang on!\Don't panic, Kagome. response:	I can handle the rest all by myself.
context: The poison must have slowed him down!\Why you!\You!\Shame on you, dogface! You gonna die this time?\Inuyasha!\Hang on!\Don't panic, Kagome.\I can handle the rest all by myself. response:	W-what!
context: Why you!\You!\Shame on you, dogface! You gonna die this time?\Inuyasha!\Hang on!\Don't panic, Kagome.\I can handle the rest all by myself.\W-what! response:	Without Kageromaru's tricks...
context: You!\Shame on you, dogface! You gonna die this time?\Inuyasha!\Hang on!\Don't panic, Kagome.\I can handle the rest all by myself.\W-what!\Without Kageromaru's tricks... response:	this stupid demon is easy to handle.
context: Shame on you, dogface! You gonna die this time?\Inuyasha!\Hang on!\Don't panic, Kagome.\I can handle the rest all by myself.\W-what!\Without Kageromaru's tricks...\this stupid demon is easy to handle. response:	I can destroy one of his kind!
context: Inuyasha!\Hang on!\Don't panic, Kagome.\I can handle the rest all by myself.\W-what!\Without Kageromaru's tricks...\this stupid demon is easy to handle.\I can destroy one of his kind! response:	I don't sense Kageromaru's presence.
context: Hang on!\Don't panic, Kagome.\I can handle the rest all by myself.\W-what!\Without Kageromaru's tricks...\this stupid demon is easy to handle.\I can destroy one of his kind!\I don't sense Kageromaru's presence. response:	Has he hidden himself in the shadows?
context: Don't panic, Kagome.\I can handle the rest all by myself.\W-what!\Without Kageromaru's tricks...\this stupid demon is easy to handle.\I can destroy one of his kind!\I don't sense Kageromaru's presence.\Has he hidden himself in the shadows? response:	Or... could he be?!
context: I can handle the rest all by myself.\W-what!\Without Kageromaru's tricks...\this stupid demon is easy to handle.\I can destroy one of his kind!\I don't sense Kageromaru's presence.\Has he hidden himself in the shadows?\Or... could he be?! response:	Fool! Koga, come back!
context: W-what!\Without Kageromaru's tricks...\this stupid demon is easy to handle.\I can destroy one of his kind!\I don't sense Kageromaru's presence.\Has he hidden himself in the shadows?\Or... could he be?!\Fool! Koga, come back! response:	Stay back, dogface!
context: Without Kageromaru's tricks...\this stupid demon is easy to handle.\I can destroy one of his kind!\I don't sense Kageromaru's presence.\Has he hidden himself in the shadows?\Or... could he be?!\Fool! Koga, come back!\Stay back, dogface! response:	Inuyasha, not in your condition...
context: this stupid demon is easy to handle.\I can destroy one of his kind!\I don't sense Kageromaru's presence.\Has he hidden himself in the shadows?\Or... could he be?!\Fool! Koga, come back!\Stay back, dogface!\Inuyasha, not in your condition... response:	Move, Koga!
context: I can destroy one of his kind!\I don't sense Kageromaru's presence.\Has he hidden himself in the shadows?\Or... could he be?!\Fool! Koga, come back!\Stay back, dogface!\Inuyasha, not in your condition...\Move, Koga! response:	If you don't move, I'll kill you, too!
context: I don't sense Kageromaru's presence.\Has he hidden himself in the shadows?\Or... could he be?!\Fool! Koga, come back!\Stay back, dogface!\Inuyasha, not in your condition...\Move, Koga!\If you don't move, I'll kill you, too! response:	Got you!
context: Has he hidden himself in the shadows?\Or... could he be?!\Fool! Koga, come back!\Stay back, dogface!\Inuyasha, not in your condition...\Move, Koga!\If you don't move, I'll kill you, too!\Got you! response:	What?!
context: Or... could he be?!\Fool! Koga, come back!\Stay back, dogface!\Inuyasha, not in your condition...\Move, Koga!\If you don't move, I'll kill you, too!\Got you!\What?! response:	It's too late for you to notice.
context: Fool! Koga, come back!\Stay back, dogface!\Inuyasha, not in your condition...\Move, Koga!\If you don't move, I'll kill you, too!\Got you!\What?!\It's too late for you to notice. response:	Shaddup!
context: Stay back, dogface!\Inuyasha, not in your condition...\Move, Koga!\If you don't move, I'll kill you, too!\Got you!\What?!\It's too late for you to notice.\Shaddup! response:	Smithereens.
context: Inuyasha, not in your condition...\Move, Koga!\If you don't move, I'll kill you, too!\Got you!\What?!\It's too late for you to notice.\Shaddup!\Smithereens. response:	He did it.
context: Move, Koga!\If you don't move, I'll kill you, too!\Got you!\What?!\It's too late for you to notice.\Shaddup!\Smithereens.\He did it. response:	It's over.
context: If you don't move, I'll kill you, too!\Got you!\What?!\It's too late for you to notice.\Shaddup!\Smithereens.\He did it.\It's over. response:	You got in my way!
context: Got you!\What?!\It's too late for you to notice.\Shaddup!\Smithereens.\He did it.\It's over.\You got in my way! response:	Why you! You meant to kill me, too, didn't you?!
context: What?!\It's too late for you to notice.\Shaddup!\Smithereens.\He did it.\It's over.\You got in my way!\Why you! You meant to kill me, too, didn't you?! response:	So you were serious!
context: It's too late for you to notice.\Shaddup!\Smithereens.\He did it.\It's over.\You got in my way!\Why you! You meant to kill me, too, didn't you?!\So you were serious! response:	Who knows?
context: Shaddup!\Smithereens.\He did it.\It's over.\You got in my way!\Why you! You meant to kill me, too, didn't you?!\So you were serious!\Who knows? response:	I'll kill you!
context: Smithereens.\He did it.\It's over.\You got in my way!\Why you! You meant to kill me, too, didn't you?!\So you were serious!\Who knows?\I'll kill you! response:	W-wait!
context: He did it.\It's over.\You got in my way!\Why you! You meant to kill me, too, didn't you?!\So you were serious!\Who knows?\I'll kill you!\W-wait! response:	You don't even give a damn... You just flinging down your sword!
context: It's over.\You got in my way!\Why you! You meant to kill me, too, didn't you?!\So you were serious!\Who knows?\I'll kill you!\W-wait!\You don't even give a damn... You just flinging down your sword! response:	Well, he knew that with your speed, you'd get out of the way in time.
context: You got in my way!\Why you! You meant to kill me, too, didn't you?!\So you were serious!\Who knows?\I'll kill you!\W-wait!\You don't even give a damn... You just flinging down your sword!\Well, he knew that with your speed, you'd get out of the way in time. response:	Right, Inuyasha?
context: Why you! You meant to kill me, too, didn't you?!\So you were serious!\Who knows?\I'll kill you!\W-wait!\You don't even give a damn... You just flinging down your sword!\Well, he knew that with your speed, you'd get out of the way in time.\Right, Inuyasha? response:	Damn! He's just a pesky wolf cub!
context: So you were serious!\Who knows?\I'll kill you!\W-wait!\You don't even give a damn... You just flinging down your sword!\Well, he knew that with your speed, you'd get out of the way in time.\Right, Inuyasha?\Damn! He's just a pesky wolf cub! response:	Listen up! If you get in the way again, I'll really kill you!
context: Who knows?\I'll kill you!\W-wait!\You don't even give a damn... You just flinging down your sword!\Well, he knew that with your speed, you'd get out of the way in time.\Right, Inuyasha?\Damn! He's just a pesky wolf cub!\Listen up! If you get in the way again, I'll really kill you! response:	Fine! Just try it! You stupid mutt!
context: I'll kill you!\W-wait!\You don't even give a damn... You just flinging down your sword!\Well, he knew that with your speed, you'd get out of the way in time.\Right, Inuyasha?\Damn! He's just a pesky wolf cub!\Listen up! If you get in the way again, I'll really kill you!\Fine! Just try it! You stupid mutt! response:	W-what?!
context: W-wait!\You don't even give a damn... You just flinging down your sword!\Well, he knew that with your speed, you'd get out of the way in time.\Right, Inuyasha?\Damn! He's just a pesky wolf cub!\Listen up! If you get in the way again, I'll really kill you!\Fine! Just try it! You stupid mutt!\W-what?! response:	Inuyasha, sit!
context: You don't even give a damn... You just flinging down your sword!\Well, he knew that with your speed, you'd get out of the way in time.\Right, Inuyasha?\Damn! He's just a pesky wolf cub!\Listen up! If you get in the way again, I'll really kill you!\Fine! Just try it! You stupid mutt!\W-what?!\Inuyasha, sit! response:	Koga, please just go today.
context: Well, he knew that with your speed, you'd get out of the way in time.\Right, Inuyasha?\Damn! He's just a pesky wolf cub!\Listen up! If you get in the way again, I'll really kill you!\Fine! Just try it! You stupid mutt!\W-what?!\Inuyasha, sit!\Koga, please just go today. response:	Why'd you do that, Kagome?!
context: Right, Inuyasha?\Damn! He's just a pesky wolf cub!\Listen up! If you get in the way again, I'll really kill you!\Fine! Just try it! You stupid mutt!\W-what?!\Inuyasha, sit!\Koga, please just go today.\Why'd you do that, Kagome?! response:	You're badly injured!
context: Damn! He's just a pesky wolf cub!\Listen up! If you get in the way again, I'll really kill you!\Fine! Just try it! You stupid mutt!\W-what?!\Inuyasha, sit!\Koga, please just go today.\Why'd you do that, Kagome?!\You're badly injured! response:	If you fight any more, what do you think will happen?!
context: Listen up! If you get in the way again, I'll really kill you!\Fine! Just try it! You stupid mutt!\W-what?!\Inuyasha, sit!\Koga, please just go today.\Why'd you do that, Kagome?!\You're badly injured!\If you fight any more, what do you think will happen?! response:	Koga, thank you for today.
context: Fine! Just try it! You stupid mutt!\W-what?!\Inuyasha, sit!\Koga, please just go today.\Why'd you do that, Kagome?!\You're badly injured!\If you fight any more, what do you think will happen?!\Koga, thank you for today. response:	You really saved us. We're so grateful.
context: W-what?!\Inuyasha, sit!\Koga, please just go today.\Why'd you do that, Kagome?!\You're badly injured!\If you fight any more, what do you think will happen?!\Koga, thank you for today.\You really saved us. We're so grateful. response:	I don't think Koga will back off.
context: Inuyasha, sit!\Koga, please just go today.\Why'd you do that, Kagome?!\You're badly injured!\If you fight any more, what do you think will happen?!\Koga, thank you for today.\You really saved us. We're so grateful.\I don't think Koga will back off. response:	Kagome...
context: Koga, please just go today.\Why'd you do that, Kagome?!\You're badly injured!\If you fight any more, what do you think will happen?!\Koga, thank you for today.\You really saved us. We're so grateful.\I don't think Koga will back off.\Kagome... response:	Huh?
context: Why'd you do that, Kagome?!\You're badly injured!\If you fight any more, what do you think will happen?!\Koga, thank you for today.\You really saved us. We're so grateful.\I don't think Koga will back off.\Kagome...\Huh? response:	You're my woman.
context: You're badly injured!\If you fight any more, what do you think will happen?!\Koga, thank you for today.\You really saved us. We're so grateful.\I don't think Koga will back off.\Kagome...\Huh?\You're my woman. response:	I can't leave you in the hands of that incompetent dogface.
context: If you fight any more, what do you think will happen?!\Koga, thank you for today.\You really saved us. We're so grateful.\I don't think Koga will back off.\Kagome...\Huh?\You're my woman.\I can't leave you in the hands of that incompetent dogface. response:	Huh?
context: Koga, thank you for today.\You really saved us. We're so grateful.\I don't think Koga will back off.\Kagome...\Huh?\You're my woman.\I can't leave you in the hands of that incompetent dogface.\Huh? response:	Damn, how dare he...!
context: You really saved us. We're so grateful.\I don't think Koga will back off.\Kagome...\Huh?\You're my woman.\I can't leave you in the hands of that incompetent dogface.\Huh?\Damn, how dare he...! response:	Whenever you're in danger, I will come to the rescue.
context: I don't think Koga will back off.\Kagome...\Huh?\You're my woman.\I can't leave you in the hands of that incompetent dogface.\Huh?\Damn, how dare he...!\Whenever you're in danger, I will come to the rescue. response:	See ya!
context: Kagome...\Huh?\You're my woman.\I can't leave you in the hands of that incompetent dogface.\Huh?\Damn, how dare he...!\Whenever you're in danger, I will come to the rescue.\See ya! response:	- Huh? - He left.
context: Huh?\You're my woman.\I can't leave you in the hands of that incompetent dogface.\Huh?\Damn, how dare he...!\Whenever you're in danger, I will come to the rescue.\See ya!\- Huh? - He left. response:	You wait!
context: You're my woman.\I can't leave you in the hands of that incompetent dogface.\Huh?\Damn, how dare he...!\Whenever you're in danger, I will come to the rescue.\See ya!\- Huh? - He left.\You wait! response:	Sit!
context: I can't leave you in the hands of that incompetent dogface.\Huh?\Damn, how dare he...!\Whenever you're in danger, I will come to the rescue.\See ya!\- Huh? - He left.\You wait!\Sit! response:	You let Koga get away again!
context: Huh?\Damn, how dare he...!\Whenever you're in danger, I will come to the rescue.\See ya!\- Huh? - He left.\You wait!\Sit!\You let Koga get away again! response:	Well, Inuyasha, in your condition...
context: Damn, how dare he...!\Whenever you're in danger, I will come to the rescue.\See ya!\- Huh? - He left.\You wait!\Sit!\You let Koga get away again!\Well, Inuyasha, in your condition... response:	Do you think I'd lose to that scrawny wolf cub?!
context: Whenever you're in danger, I will come to the rescue.\See ya!\- Huh? - He left.\You wait!\Sit!\You let Koga get away again!\Well, Inuyasha, in your condition...\Do you think I'd lose to that scrawny wolf cub?! response:	Look, let's just treat your injury.
context: See ya!\- Huh? - He left.\You wait!\Sit!\You let Koga get away again!\Well, Inuyasha, in your condition...\Do you think I'd lose to that scrawny wolf cub?!\Look, let's just treat your injury. response:	Never mind! And what's with that attitude of yours?
context: - Huh? - He left.\You wait!\Sit!\You let Koga get away again!\Well, Inuyasha, in your condition...\Do you think I'd lose to that scrawny wolf cub?!\Look, let's just treat your injury.\Never mind! And what's with that attitude of yours? response:	Trying to make him feel good and flirting with him!
context: You wait!\Sit!\You let Koga get away again!\Well, Inuyasha, in your condition...\Do you think I'd lose to that scrawny wolf cub?!\Look, let's just treat your injury.\Never mind! And what's with that attitude of yours?\Trying to make him feel good and flirting with him! response:	It was so disgusting, I couldn't watch!
context: Sit!\You let Koga get away again!\Well, Inuyasha, in your condition...\Do you think I'd lose to that scrawny wolf cub?!\Look, let's just treat your injury.\Never mind! And what's with that attitude of yours?\Trying to make him feel good and flirting with him!\It was so disgusting, I couldn't watch! response:	Besides, you're...
context: You let Koga get away again!\Well, Inuyasha, in your condition...\Do you think I'd lose to that scrawny wolf cub?!\Look, let's just treat your injury.\Never mind! And what's with that attitude of yours?\Trying to make him feel good and flirting with him!\It was so disgusting, I couldn't watch!\Besides, you're... response:	W-why're you looking at me like that?
context: Well, Inuyasha, in your condition...\Do you think I'd lose to that scrawny wolf cub?!\Look, let's just treat your injury.\Never mind! And what's with that attitude of yours?\Trying to make him feel good and flirting with him!\It was so disgusting, I couldn't watch!\Besides, you're...\W-why're you looking at me like that? response:	I'm going home.
context: Do you think I'd lose to that scrawny wolf cub?!\Look, let's just treat your injury.\Never mind! And what's with that attitude of yours?\Trying to make him feel good and flirting with him!\It was so disgusting, I couldn't watch!\Besides, you're...\W-why're you looking at me like that?\I'm going home. response:	Huh?
context: Look, let's just treat your injury.\Never mind! And what's with that attitude of yours?\Trying to make him feel good and flirting with him!\It was so disgusting, I couldn't watch!\Besides, you're...\W-why're you looking at me like that?\I'm going home.\Huh? response:	I'm going home!
context: Never mind! And what's with that attitude of yours?\Trying to make him feel good and flirting with him!\It was so disgusting, I couldn't watch!\Besides, you're...\W-why're you looking at me like that?\I'm going home.\Huh?\I'm going home! response:	Oh, go home! I won't stop you!
context: Trying to make him feel good and flirting with him!\It was so disgusting, I couldn't watch!\Besides, you're...\W-why're you looking at me like that?\I'm going home.\Huh?\I'm going home!\Oh, go home! I won't stop you! response:	Oh dear... Now that that's settled, shall we go?
context: It was so disgusting, I couldn't watch!\Besides, you're...\W-why're you looking at me like that?\I'm going home.\Huh?\I'm going home!\Oh, go home! I won't stop you!\Oh dear... Now that that's settled, shall we go? response:	We must tend to your wounds, too, Miroku.
context: Besides, you're...\W-why're you looking at me like that?\I'm going home.\Huh?\I'm going home!\Oh, go home! I won't stop you!\Oh dear... Now that that's settled, shall we go?\We must tend to your wounds, too, Miroku. response:	Huh?
context: W-why're you looking at me like that?\I'm going home.\Huh?\I'm going home!\Oh, go home! I won't stop you!\Oh dear... Now that that's settled, shall we go?\We must tend to your wounds, too, Miroku.\Huh? response:	You two have to grow up like them.
context: I'm going home.\Huh?\I'm going home!\Oh, go home! I won't stop you!\Oh dear... Now that that's settled, shall we go?\We must tend to your wounds, too, Miroku.\Huh?\You two have to grow up like them. response:	Naraku who had killed Kikyo once 50 years ago...
context: Huh?\I'm going home!\Oh, go home! I won't stop you!\Oh dear... Now that that's settled, shall we go?\We must tend to your wounds, too, Miroku.\Huh?\You two have to grow up like them.\Naraku who had killed Kikyo once 50 years ago... response:	comes again to get rid of her.
context: I'm going home!\Oh, go home! I won't stop you!\Oh dear... Now that that's settled, shall we go?\We must tend to your wounds, too, Miroku.\Huh?\You two have to grow up like them.\Naraku who had killed Kikyo once 50 years ago...\comes again to get rid of her. response:	Onigumo's heart which beats inside him yearns for Kikyo.
context: Oh, go home! I won't stop you!\Oh dear... Now that that's settled, shall we go?\We must tend to your wounds, too, Miroku.\Huh?\You two have to grow up like them.\Naraku who had killed Kikyo once 50 years ago...\comes again to get rid of her.\Onigumo's heart which beats inside him yearns for Kikyo. response:	That's what has Naraku so vexed.
context: Oh dear... Now that that's settled, shall we go?\We must tend to your wounds, too, Miroku.\Huh?\You two have to grow up like them.\Naraku who had killed Kikyo once 50 years ago...\comes again to get rid of her.\Onigumo's heart which beats inside him yearns for Kikyo.\That's what has Naraku so vexed. response:	With Kikyo in danger...
context: We must tend to your wounds, too, Miroku.\Huh?\You two have to grow up like them.\Naraku who had killed Kikyo once 50 years ago...\comes again to get rid of her.\Onigumo's heart which beats inside him yearns for Kikyo.\That's what has Naraku so vexed.\With Kikyo in danger... response:	there's no way Inuyasha can ignore it.
context: Huh?\You two have to grow up like them.\Naraku who had killed Kikyo once 50 years ago...\comes again to get rid of her.\Onigumo's heart which beats inside him yearns for Kikyo.\That's what has Naraku so vexed.\With Kikyo in danger...\there's no way Inuyasha can ignore it. response:	But why, Inuyasha?!
context: You two have to grow up like them.\Naraku who had killed Kikyo once 50 years ago...\comes again to get rid of her.\Onigumo's heart which beats inside him yearns for Kikyo.\That's what has Naraku so vexed.\With Kikyo in danger...\there's no way Inuyasha can ignore it.\But why, Inuyasha?! response:	Why are you embracing her like that?
context: Naraku who had killed Kikyo once 50 years ago...\comes again to get rid of her.\Onigumo's heart which beats inside him yearns for Kikyo.\That's what has Naraku so vexed.\With Kikyo in danger...\there's no way Inuyasha can ignore it.\But why, Inuyasha?!\Why are you embracing her like that? response:	Next on Inuyasha: Onigumo's Heart Still Beats Within Naraku
context: comes again to get rid of her.\Onigumo's heart which beats inside him yearns for Kikyo.\That's what has Naraku so vexed.\With Kikyo in danger...\there's no way Inuyasha can ignore it.\But why, Inuyasha?!\Why are you embracing her like that?\Next on Inuyasha: Onigumo's Heart Still Beats Within Naraku response:	Don't miss it!