context: Tnby Academy, response:	Where people with special powers. As elements was recognized as the accumulation period
context: Tnby Academy,\Where people with special powers. As elements was recognized as the accumulation period response:	However, destruction, when some of the students,
context: Tnby Academy,\Where people with special powers. As elements was recognized as the accumulation period\However, destruction, when some of the students, response:	Nasrshvn for evil purposes of use, began.
context: Tnby Academy,\Where people with special powers. As elements was recognized as the accumulation period\However, destruction, when some of the students,\Nasrshvn for evil purposes of use, began. response:	Academy knew the current state of the
context: Tnby Academy,\Where people with special powers. As elements was recognized as the accumulation period\However, destruction, when some of the students,\Nasrshvn for evil purposes of use, began.\Academy knew the current state of the response:	Security.kmyth consisting of students formed
context: Tnby Academy,\Where people with special powers. As elements was recognized as the accumulation period\However, destruction, when some of the students,\Nasrshvn for evil purposes of use, began.\Academy knew the current state of the\Security.kmyth consisting of students formed response:	They specialize in the use of weapons Makn holy name,
context: Tnby Academy,\Where people with special powers. As elements was recognized as the accumulation period\However, destruction, when some of the students,\Nasrshvn for evil purposes of use, began.\Academy knew the current state of the\Security.kmyth consisting of students formed\They specialize in the use of weapons Makn holy name, response:	To control and prevent others were
context: Tnby Academy,\Where people with special powers. As elements was recognized as the accumulation period\However, destruction, when some of the students,\Nasrshvn for evil purposes of use, began.\Academy knew the current state of the\Security.kmyth consisting of students formed\They specialize in the use of weapons Makn holy name,\To control and prevent others were response:	It was fate?
context: Where people with special powers. As elements was recognized as the accumulation period\However, destruction, when some of the students,\Nasrshvn for evil purposes of use, began.\Academy knew the current state of the\Security.kmyth consisting of students formed\They specialize in the use of weapons Makn holy name,\To control and prevent others were\It was fate? response:	Or am I making this up?
context: However, destruction, when some of the students,\Nasrshvn for evil purposes of use, began.\Academy knew the current state of the\Security.kmyth consisting of students formed\They specialize in the use of weapons Makn holy name,\To control and prevent others were\It was fate?\Or am I making this up? response:	All of the laundry I was
context: Nasrshvn for evil purposes of use, began.\Academy knew the current state of the\Security.kmyth consisting of students formed\They specialize in the use of weapons Makn holy name,\To control and prevent others were\It was fate?\Or am I making this up?\All of the laundry I was response:	So, which do you choose?
context: Academy knew the current state of the\Security.kmyth consisting of students formed\They specialize in the use of weapons Makn holy name,\To control and prevent others were\It was fate?\Or am I making this up?\All of the laundry I was\So, which do you choose? response:	All of the buying
context: Security.kmyth consisting of students formed\They specialize in the use of weapons Makn holy name,\To control and prevent others were\It was fate?\Or am I making this up?\All of the laundry I was\So, which do you choose?\All of the buying response:	That's what Rvskyh bear?
context: They specialize in the use of weapons Makn holy name,\To control and prevent others were\It was fate?\Or am I making this up?\All of the laundry I was\So, which do you choose?\All of the buying\That's what Rvskyh bear? response:	For collectors like me who collect teddy bears from around the world was
context: To control and prevent others were\It was fate?\Or am I making this up?\All of the laundry I was\So, which do you choose?\All of the buying\That's what Rvskyh bear?\For collectors like me who collect teddy bears from around the world was response:	How about this one I've lost...
context: It was fate?\Or am I making this up?\All of the laundry I was\So, which do you choose?\All of the buying\That's what Rvskyh bear?\For collectors like me who collect teddy bears from around the world was\How about this one I've lost... response:	You enjoyed it?
context: Or am I making this up?\All of the laundry I was\So, which do you choose?\All of the buying\That's what Rvskyh bear?\For collectors like me who collect teddy bears from around the world was\How about this one I've lost...\You enjoyed it? response:	It bears a Vyntyjh
context: All of the laundry I was\So, which do you choose?\All of the buying\That's what Rvskyh bear?\For collectors like me who collect teddy bears from around the world was\How about this one I've lost...\You enjoyed it?\It bears a Vyntyjh response:	But with a fair price you sell
context: So, which do you choose?\All of the buying\That's what Rvskyh bear?\For collectors like me who collect teddy bears from around the world was\How about this one I've lost...\You enjoyed it?\It bears a Vyntyjh\But with a fair price you sell response:	I really got it
context: All of the buying\That's what Rvskyh bear?\For collectors like me who collect teddy bears from around the world was\How about this one I've lost...\You enjoyed it?\It bears a Vyntyjh\But with a fair price you sell\I really got it response:	Antique German.khrsh
context: That's what Rvskyh bear?\For collectors like me who collect teddy bears from around the world was\How about this one I've lost...\You enjoyed it?\It bears a Vyntyjh\But with a fair price you sell\I really got it\Antique German.khrsh response:	Vintage.bavr do not like the price is 78 thousand yen
context: For collectors like me who collect teddy bears from around the world was\How about this one I've lost...\You enjoyed it?\It bears a Vyntyjh\But with a fair price you sell\I really got it\Antique German.khrsh\Vintage.bavr do not like the price is 78 thousand yen response:	Maybe I have a lot of money Balazs
context: How about this one I've lost...\You enjoyed it?\It bears a Vyntyjh\But with a fair price you sell\I really got it\Antique German.khrsh\Vintage.bavr do not like the price is 78 thousand yen\Maybe I have a lot of money Balazs response:	But the signing was
context: You enjoyed it?\It bears a Vyntyjh\But with a fair price you sell\I really got it\Antique German.khrsh\Vintage.bavr do not like the price is 78 thousand yen\Maybe I have a lot of money Balazs\But the signing was response:	JRT peek How are you doing?
context: It bears a Vyntyjh\But with a fair price you sell\I really got it\Antique German.khrsh\Vintage.bavr do not like the price is 78 thousand yen\Maybe I have a lot of money Balazs\But the signing was\JRT peek How are you doing? response:	More importantly, why are you moving?
context: But with a fair price you sell\I really got it\Antique German.khrsh\Vintage.bavr do not like the price is 78 thousand yen\Maybe I have a lot of money Balazs\But the signing was\JRT peek How are you doing?\More importantly, why are you moving? response:	Hrbh?
context: I really got it\Antique German.khrsh\Vintage.bavr do not like the price is 78 thousand yen\Maybe I have a lot of money Balazs\But the signing was\JRT peek How are you doing?\More importantly, why are you moving?\Hrbh? response:	A robot?
context: Antique German.khrsh\Vintage.bavr do not like the price is 78 thousand yen\Maybe I have a lot of money Balazs\But the signing was\JRT peek How are you doing?\More importantly, why are you moving?\Hrbh?\A robot? response:	I thought after 70 years I found a new master properly
context: Vintage.bavr do not like the price is 78 thousand yen\Maybe I have a lot of money Balazs\But the signing was\JRT peek How are you doing?\More importantly, why are you moving?\Hrbh?\A robot?\I thought after 70 years I found a new master properly response:	But she's a girl Leather chest
context: Maybe I have a lot of money Balazs\But the signing was\JRT peek How are you doing?\More importantly, why are you moving?\Hrbh?\A robot?\I thought after 70 years I found a new master properly\But she's a girl Leather chest response:	In any case I do not have any interest
context: But the signing was\JRT peek How are you doing?\More importantly, why are you moving?\Hrbh?\A robot?\I thought after 70 years I found a new master properly\But she's a girl Leather chest\In any case I do not have any interest response:	So, perhaps, the least you could let me see shorts
context: JRT peek How are you doing?\More importantly, why are you moving?\Hrbh?\A robot?\I thought after 70 years I found a new master properly\But she's a girl Leather chest\In any case I do not have any interest\So, perhaps, the least you could let me see shorts response:	How can he talk like this deviant beauty bear such a team?
context: More importantly, why are you moving?\Hrbh?\A robot?\I thought after 70 years I found a new master properly\But she's a girl Leather chest\In any case I do not have any interest\So, perhaps, the least you could let me see shorts\How can he talk like this deviant beauty bear such a team? response:	I was hurt, why do not you try to make breasts bigger Hato?
context: Hrbh?\A robot?\I thought after 70 years I found a new master properly\But she's a girl Leather chest\In any case I do not have any interest\So, perhaps, the least you could let me see shorts\How can he talk like this deviant beauty bear such a team?\I was hurt, why do not you try to make breasts bigger Hato? response:	What are you doing?
context: A robot?\I thought after 70 years I found a new master properly\But she's a girl Leather chest\In any case I do not have any interest\So, perhaps, the least you could let me see shorts\How can he talk like this deviant beauty bear such a team?\I was hurt, why do not you try to make breasts bigger Hato?\What are you doing? response:	This crazy
context: I thought after 70 years I found a new master properly\But she's a girl Leather chest\In any case I do not have any interest\So, perhaps, the least you could let me see shorts\How can he talk like this deviant beauty bear such a team?\I was hurt, why do not you try to make breasts bigger Hato?\What are you doing?\This crazy response:	This certainly Byrhmyh
context: But she's a girl Leather chest\In any case I do not have any interest\So, perhaps, the least you could let me see shorts\How can he talk like this deviant beauty bear such a team?\I was hurt, why do not you try to make breasts bigger Hato?\What are you doing?\This crazy\This certainly Byrhmyh response:	See larger breasts stay.hmynja dream mistress
context: In any case I do not have any interest\So, perhaps, the least you could let me see shorts\How can he talk like this deviant beauty bear such a team?\I was hurt, why do not you try to make breasts bigger Hato?\What are you doing?\This crazy\This certainly Byrhmyh\See larger breasts stay.hmynja dream mistress response:	The teddy bear was how he died?
context: So, perhaps, the least you could let me see shorts\How can he talk like this deviant beauty bear such a team?\I was hurt, why do not you try to make breasts bigger Hato?\What are you doing?\This crazy\This certainly Byrhmyh\See larger breasts stay.hmynja dream mistress\The teddy bear was how he died? response:	How do you...?
context: How can he talk like this deviant beauty bear such a team?\I was hurt, why do not you try to make breasts bigger Hato?\What are you doing?\This crazy\This certainly Byrhmyh\See larger breasts stay.hmynja dream mistress\The teddy bear was how he died?\How do you...? response:	You're a magician?
context: I was hurt, why do not you try to make breasts bigger Hato?\What are you doing?\This crazy\This certainly Byrhmyh\See larger breasts stay.hmynja dream mistress\The teddy bear was how he died?\How do you...?\You're a magician? response:	When the field Very Babe're serious Qyaft
context: What are you doing?\This crazy\This certainly Byrhmyh\See larger breasts stay.hmynja dream mistress\The teddy bear was how he died?\How do you...?\You're a magician?\When the field Very Babe're serious Qyaft response:	What
context: This crazy\This certainly Byrhmyh\See larger breasts stay.hmynja dream mistress\The teddy bear was how he died?\How do you...?\You're a magician?\When the field Very Babe're serious Qyaft\What response:	What kind of looked like Thriller?
context: This certainly Byrhmyh\See larger breasts stay.hmynja dream mistress\The teddy bear was how he died?\How do you...?\You're a magician?\When the field Very Babe're serious Qyaft\What\What kind of looked like Thriller? response:	Blh.mnv Kurdish voice, Heyme SAMA?
context: See larger breasts stay.hmynja dream mistress\The teddy bear was how he died?\How do you...?\You're a magician?\When the field Very Babe're serious Qyaft\What\What kind of looked like Thriller?\Blh.mnv Kurdish voice, Heyme SAMA? response:	What - what did you say?
context: The teddy bear was how he died?\How do you...?\You're a magician?\When the field Very Babe're serious Qyaft\What\What kind of looked like Thriller?\Blh.mnv Kurdish voice, Heyme SAMA?\What - what did you say? response:	Quick.What
context: How do you...?\You're a magician?\When the field Very Babe're serious Qyaft\What\What kind of looked like Thriller?\Blh.mnv Kurdish voice, Heyme SAMA?\What - what did you say?\Quick.What response:	This procedure is much more other
context: You're a magician?\When the field Very Babe're serious Qyaft\What\What kind of looked like Thriller?\Blh.mnv Kurdish voice, Heyme SAMA?\What - what did you say?\Quick.What\This procedure is much more other response:	Please prepare yourself now
context: When the field Very Babe're serious Qyaft\What\What kind of looked like Thriller?\Blh.mnv Kurdish voice, Heyme SAMA?\What - what did you say?\Quick.What\This procedure is much more other\Please prepare yourself now response:	The Academy of Tnby makes sober up?
context: What\What kind of looked like Thriller?\Blh.mnv Kurdish voice, Heyme SAMA?\What - what did you say?\Quick.What\This procedure is much more other\Please prepare yourself now\The Academy of Tnby makes sober up? response:	However, the situation is not good
context: What kind of looked like Thriller?\Blh.mnv Kurdish voice, Heyme SAMA?\What - what did you say?\Quick.What\This procedure is much more other\Please prepare yourself now\The Academy of Tnby makes sober up?\However, the situation is not good response:	what about you?
context: Blh.mnv Kurdish voice, Heyme SAMA?\What - what did you say?\Quick.What\This procedure is much more other\Please prepare yourself now\The Academy of Tnby makes sober up?\However, the situation is not good\what about you? response:	Bastards! With Nvzvchy What did you do?
context: What - what did you say?\Quick.What\This procedure is much more other\Please prepare yourself now\The Academy of Tnby makes sober up?\However, the situation is not good\what about you?\Bastards! With Nvzvchy What did you do? response:	Only taught him how to enjoy his wife
context: Quick.What\This procedure is much more other\Please prepare yourself now\The Academy of Tnby makes sober up?\However, the situation is not good\what about you?\Bastards! With Nvzvchy What did you do?\Only taught him how to enjoy his wife response:	See my duty as a man
context: This procedure is much more other\Please prepare yourself now\The Academy of Tnby makes sober up?\However, the situation is not good\what about you?\Bastards! With Nvzvchy What did you do?\Only taught him how to enjoy his wife\See my duty as a man response:	what did you say?
context: Please prepare yourself now\The Academy of Tnby makes sober up?\However, the situation is not good\what about you?\Bastards! With Nvzvchy What did you do?\Only taught him how to enjoy his wife\See my duty as a man\what did you say? response:	I had not the same thing
context: The Academy of Tnby makes sober up?\However, the situation is not good\what about you?\Bastards! With Nvzvchy What did you do?\Only taught him how to enjoy his wife\See my duty as a man\what did you say?\I had not the same thing response:	Kelly had got.mnm
context: However, the situation is not good\what about you?\Bastards! With Nvzvchy What did you do?\Only taught him how to enjoy his wife\See my duty as a man\what did you say?\I had not the same thing\Kelly had got.mnm response:	O corrupt
context: what about you?\Bastards! With Nvzvchy What did you do?\Only taught him how to enjoy his wife\See my duty as a man\what did you say?\I had not the same thing\Kelly had got.mnm\O corrupt response:	He is cotton Give You
context: Bastards! With Nvzvchy What did you do?\Only taught him how to enjoy his wife\See my duty as a man\what did you say?\I had not the same thing\Kelly had got.mnm\O corrupt\He is cotton Give You response:	That Ayntvr.fhmydm
context: Only taught him how to enjoy his wife\See my duty as a man\what did you say?\I had not the same thing\Kelly had got.mnm\O corrupt\He is cotton Give You\That Ayntvr.fhmydm response:	Even self Nmykshy
context: See my duty as a man\what did you say?\I had not the same thing\Kelly had got.mnm\O corrupt\He is cotton Give You\That Ayntvr.fhmydm\Even self Nmykshy response:	That way, I can not wait
context: what did you say?\I had not the same thing\Kelly had got.mnm\O corrupt\He is cotton Give You\That Ayntvr.fhmydm\Even self Nmykshy\That way, I can not wait response:	Heyme step Senpai, is so?
context: I had not the same thing\Kelly had got.mnm\O corrupt\He is cotton Give You\That Ayntvr.fhmydm\Even self Nmykshy\That way, I can not wait\Heyme step Senpai, is so? response:	M - What do you mean?
context: Kelly had got.mnm\O corrupt\He is cotton Give You\That Ayntvr.fhmydm\Even self Nmykshy\That way, I can not wait\Heyme step Senpai, is so?\M - What do you mean? response:	No, not really
context: O corrupt\He is cotton Give You\That Ayntvr.fhmydm\Even self Nmykshy\That way, I can not wait\Heyme step Senpai, is so?\M - What do you mean?\No, not really response:	So no matter.khvb
context: He is cotton Give You\That Ayntvr.fhmydm\Even self Nmykshy\That way, I can not wait\Heyme step Senpai, is so?\M - What do you mean?\No, not really\So no matter.khvb response:	Kodama Senpai, buy a new teddy bear?
context: That Ayntvr.fhmydm\Even self Nmykshy\That way, I can not wait\Heyme step Senpai, is so?\M - What do you mean?\No, not really\So no matter.khvb\Kodama Senpai, buy a new teddy bear? response:	I told you to stay right there
context: Even self Nmykshy\That way, I can not wait\Heyme step Senpai, is so?\M - What do you mean?\No, not really\So no matter.khvb\Kodama Senpai, buy a new teddy bear?\I told you to stay right there response:	I bear a maker of.radar 85 - Cup and a size 95 H - detected's Cup
context: That way, I can not wait\Heyme step Senpai, is so?\M - What do you mean?\No, not really\So no matter.khvb\Kodama Senpai, buy a new teddy bear?\I told you to stay right there\I bear a maker of.radar 85 - Cup and a size 95 H - detected's Cup response:	It is truly amazing
context: Heyme step Senpai, is so?\M - What do you mean?\No, not really\So no matter.khvb\Kodama Senpai, buy a new teddy bear?\I told you to stay right there\I bear a maker of.radar 85 - Cup and a size 95 H - detected's Cup\It is truly amazing response:	Even great
context: M - What do you mean?\No, not really\So no matter.khvb\Kodama Senpai, buy a new teddy bear?\I told you to stay right there\I bear a maker of.radar 85 - Cup and a size 95 H - detected's Cup\It is truly amazing\Even great response:	Kodama Senpai, can I hold him?
context: No, not really\So no matter.khvb\Kodama Senpai, buy a new teddy bear?\I told you to stay right there\I bear a maker of.radar 85 - Cup and a size 95 H - detected's Cup\It is truly amazing\Even great\Kodama Senpai, can I hold him? response:	If the.bdnm
context: So no matter.khvb\Kodama Senpai, buy a new teddy bear?\I told you to stay right there\I bear a maker of.radar 85 - Cup and a size 95 H - detected's Cup\It is truly amazing\Even great\Kodama Senpai, can I hold him?\If the.bdnm response:	what is this?
context: Kodama Senpai, buy a new teddy bear?\I told you to stay right there\I bear a maker of.radar 85 - Cup and a size 95 H - detected's Cup\It is truly amazing\Even great\Kodama Senpai, can I hold him?\If the.bdnm\what is this? response:	Why?
context: I told you to stay right there\I bear a maker of.radar 85 - Cup and a size 95 H - detected's Cup\It is truly amazing\Even great\Kodama Senpai, can I hold him?\If the.bdnm\what is this?\Why? response:	Oh? So he called Rvdvlfh teddy bear?
context: I bear a maker of.radar 85 - Cup and a size 95 H - detected's Cup\It is truly amazing\Even great\Kodama Senpai, can I hold him?\If the.bdnm\what is this?\Why?\Oh? So he called Rvdvlfh teddy bear? response:	This Chshvnh breasts?
context: It is truly amazing\Even great\Kodama Senpai, can I hold him?\If the.bdnm\what is this?\Why?\Oh? So he called Rvdvlfh teddy bear?\This Chshvnh breasts? response:	I do not feel is nothing, not even comparable with them
context: Even great\Kodama Senpai, can I hold him?\If the.bdnm\what is this?\Why?\Oh? So he called Rvdvlfh teddy bear?\This Chshvnh breasts?\I do not feel is nothing, not even comparable with them response:	For kids, Rudolf my closet
context: Kodama Senpai, can I hold him?\If the.bdnm\what is this?\Why?\Oh? So he called Rvdvlfh teddy bear?\This Chshvnh breasts?\I do not feel is nothing, not even comparable with them\For kids, Rudolf my closet response:	You have to keep your.nmytvnyn
context: If the.bdnm\what is this?\Why?\Oh? So he called Rvdvlfh teddy bear?\This Chshvnh breasts?\I do not feel is nothing, not even comparable with them\For kids, Rudolf my closet\You have to keep your.nmytvnyn response:	Understand?
context: what is this?\Why?\Oh? So he called Rvdvlfh teddy bear?\This Chshvnh breasts?\I do not feel is nothing, not even comparable with them\For kids, Rudolf my closet\You have to keep your.nmytvnyn\Understand? response:	JRT.agh you to another pot and let out of the room
context: Why?\Oh? So he called Rvdvlfh teddy bear?\This Chshvnh breasts?\I do not feel is nothing, not even comparable with them\For kids, Rudolf my closet\You have to keep your.nmytvnyn\Understand?\JRT.agh you to another pot and let out of the room response:	I swear spirits. The soil Baghchmvn
context: Oh? So he called Rvdvlfh teddy bear?\This Chshvnh breasts?\I do not feel is nothing, not even comparable with them\For kids, Rudolf my closet\You have to keep your.nmytvnyn\Understand?\JRT.agh you to another pot and let out of the room\I swear spirits. The soil Baghchmvn response:	Think I am?
context: This Chshvnh breasts?\I do not feel is nothing, not even comparable with them\For kids, Rudolf my closet\You have to keep your.nmytvnyn\Understand?\JRT.agh you to another pot and let out of the room\I swear spirits. The soil Baghchmvn\Think I am? response:	Here.mra Nmymvnm
context: I do not feel is nothing, not even comparable with them\For kids, Rudolf my closet\You have to keep your.nmytvnyn\Understand?\JRT.agh you to another pot and let out of the room\I swear spirits. The soil Baghchmvn\Think I am?\Here.mra Nmymvnm response:	The first section of the map Astadanmh
context: For kids, Rudolf my closet\You have to keep your.nmytvnyn\Understand?\JRT.agh you to another pot and let out of the room\I swear spirits. The soil Baghchmvn\Think I am?\Here.mra Nmymvnm\The first section of the map Astadanmh response:	He teddy bear
context: You have to keep your.nmytvnyn\Understand?\JRT.agh you to another pot and let out of the room\I swear spirits. The soil Baghchmvn\Think I am?\Here.mra Nmymvnm\The first section of the map Astadanmh\He teddy bear response:	Harvkv, Aynahv?
context: Understand?\JRT.agh you to another pot and let out of the room\I swear spirits. The soil Baghchmvn\Think I am?\Here.mra Nmymvnm\The first section of the map Astadanmh\He teddy bear\Harvkv, Aynahv? response:	Really gone?
context: JRT.agh you to another pot and let out of the room\I swear spirits. The soil Baghchmvn\Think I am?\Here.mra Nmymvnm\The first section of the map Astadanmh\He teddy bear\Harvkv, Aynahv?\Really gone? response:	He is Harvkv distract the bear and gave the comfort but not Aynahv
context: I swear spirits. The soil Baghchmvn\Think I am?\Here.mra Nmymvnm\The first section of the map Astadanmh\He teddy bear\Harvkv, Aynahv?\Really gone?\He is Harvkv distract the bear and gave the comfort but not Aynahv response:	Just want this so bad
context: Think I am?\Here.mra Nmymvnm\The first section of the map Astadanmh\He teddy bear\Harvkv, Aynahv?\Really gone?\He is Harvkv distract the bear and gave the comfort but not Aynahv\Just want this so bad response:	I do not.qbvl
context: Here.mra Nmymvnm\The first section of the map Astadanmh\He teddy bear\Harvkv, Aynahv?\Really gone?\He is Harvkv distract the bear and gave the comfort but not Aynahv\Just want this so bad\I do not.qbvl response:	Wait, I got it because of their identity Frvkhtysh Did you know?
context: The first section of the map Astadanmh\He teddy bear\Harvkv, Aynahv?\Really gone?\He is Harvkv distract the bear and gave the comfort but not Aynahv\Just want this so bad\I do not.qbvl\Wait, I got it because of their identity Frvkhtysh Did you know? response:	Therefore I want to give it back
context: He teddy bear\Harvkv, Aynahv?\Really gone?\He is Harvkv distract the bear and gave the comfort but not Aynahv\Just want this so bad\I do not.qbvl\Wait, I got it because of their identity Frvkhtysh Did you know?\Therefore I want to give it back response:	Treated me with violence
context: Harvkv, Aynahv?\Really gone?\He is Harvkv distract the bear and gave the comfort but not Aynahv\Just want this so bad\I do not.qbvl\Wait, I got it because of their identity Frvkhtysh Did you know?\Therefore I want to give it back\Treated me with violence response:	Played with feeling
context: Really gone?\He is Harvkv distract the bear and gave the comfort but not Aynahv\Just want this so bad\I do not.qbvl\Wait, I got it because of their identity Frvkhtysh Did you know?\Therefore I want to give it back\Treated me with violence\Played with feeling response:	And things were cruel to me.
context: He is Harvkv distract the bear and gave the comfort but not Aynahv\Just want this so bad\I do not.qbvl\Wait, I got it because of their identity Frvkhtysh Did you know?\Therefore I want to give it back\Treated me with violence\Played with feeling\And things were cruel to me. response:	No.... Stop
context: Just want this so bad\I do not.qbvl\Wait, I got it because of their identity Frvkhtysh Did you know?\Therefore I want to give it back\Treated me with violence\Played with feeling\And things were cruel to me.\No.... Stop response:	Please Take her with you
context: I do not.qbvl\Wait, I got it because of their identity Frvkhtysh Did you know?\Therefore I want to give it back\Treated me with violence\Played with feeling\And things were cruel to me.\No.... Stop\Please Take her with you response:	Just have to give up this door and the misery in which you are caught you accept
context: Wait, I got it because of their identity Frvkhtysh Did you know?\Therefore I want to give it back\Treated me with violence\Played with feeling\And things were cruel to me.\No.... Stop\Please Take her with you\Just have to give up this door and the misery in which you are caught you accept response:	Nitrogen hear something.nmykhvam
context: Therefore I want to give it back\Treated me with violence\Played with feeling\And things were cruel to me.\No.... Stop\Please Take her with you\Just have to give up this door and the misery in which you are caught you accept\Nitrogen hear something.nmykhvam response:	But like I Kmyabh teddy bear
context: Treated me with violence\Played with feeling\And things were cruel to me.\No.... Stop\Please Take her with you\Just have to give up this door and the misery in which you are caught you accept\Nitrogen hear something.nmykhvam\But like I Kmyabh teddy bear response:	Do not you think I'm interesting?
context: Played with feeling\And things were cruel to me.\No.... Stop\Please Take her with you\Just have to give up this door and the misery in which you are caught you accept\Nitrogen hear something.nmykhvam\But like I Kmyabh teddy bear\Do not you think I'm interesting? response:	Well, apart from that part being perverted
context: And things were cruel to me.\No.... Stop\Please Take her with you\Just have to give up this door and the misery in which you are caught you accept\Nitrogen hear something.nmykhvam\But like I Kmyabh teddy bear\Do not you think I'm interesting?\Well, apart from that part being perverted response:	Really cute bear and the beauty
context: No.... Stop\Please Take her with you\Just have to give up this door and the misery in which you are caught you accept\Nitrogen hear something.nmykhvam\But like I Kmyabh teddy bear\Do not you think I'm interesting?\Well, apart from that part being perverted\Really cute bear and the beauty response:	He is, so that should be
context: Please Take her with you\Just have to give up this door and the misery in which you are caught you accept\Nitrogen hear something.nmykhvam\But like I Kmyabh teddy bear\Do not you think I'm interesting?\Well, apart from that part being perverted\Really cute bear and the beauty\He is, so that should be response:	Natural.aynkh be
context: Just have to give up this door and the misery in which you are caught you accept\Nitrogen hear something.nmykhvam\But like I Kmyabh teddy bear\Do not you think I'm interesting?\Well, apart from that part being perverted\Really cute bear and the beauty\He is, so that should be\Natural.aynkh be response:	Just to be cute, huh?
context: Nitrogen hear something.nmykhvam\But like I Kmyabh teddy bear\Do not you think I'm interesting?\Well, apart from that part being perverted\Really cute bear and the beauty\He is, so that should be\Natural.aynkh be\Just to be cute, huh? response:	In fact, most people want it
context: But like I Kmyabh teddy bear\Do not you think I'm interesting?\Well, apart from that part being perverted\Really cute bear and the beauty\He is, so that should be\Natural.aynkh be\Just to be cute, huh?\In fact, most people want it response:	Sometimes they visit your play or your head slowly to the.mykshn while they stay cute define positions
context: Do not you think I'm interesting?\Well, apart from that part being perverted\Really cute bear and the beauty\He is, so that should be\Natural.aynkh be\Just to be cute, huh?\In fact, most people want it\Sometimes they visit your play or your head slowly to the.mykshn while they stay cute define positions response:	But, with all those cute Cardona could not do anything
context: Well, apart from that part being perverted\Really cute bear and the beauty\He is, so that should be\Natural.aynkh be\Just to be cute, huh?\In fact, most people want it\Sometimes they visit your play or your head slowly to the.mykshn while they stay cute define positions\But, with all those cute Cardona could not do anything response:	And if something happened to my master
context: Really cute bear and the beauty\He is, so that should be\Natural.aynkh be\Just to be cute, huh?\In fact, most people want it\Sometimes they visit your play or your head slowly to the.mykshn while they stay cute define positions\But, with all those cute Cardona could not do anything\And if something happened to my master response:	I do.nmytvnstm
context: He is, so that should be\Natural.aynkh be\Just to be cute, huh?\In fact, most people want it\Sometimes they visit your play or your head slowly to the.mykshn while they stay cute define positions\But, with all those cute Cardona could not do anything\And if something happened to my master\I do.nmytvnstm response:	Only I could sit and watch
context: Natural.aynkh be\Just to be cute, huh?\In fact, most people want it\Sometimes they visit your play or your head slowly to the.mykshn while they stay cute define positions\But, with all those cute Cardona could not do anything\And if something happened to my master\I do.nmytvnstm\Only I could sit and watch response:	Rudolf, what happened to you?
context: Just to be cute, huh?\In fact, most people want it\Sometimes they visit your play or your head slowly to the.mykshn while they stay cute define positions\But, with all those cute Cardona could not do anything\And if something happened to my master\I do.nmytvnstm\Only I could sit and watch\Rudolf, what happened to you? response:	Why back to life?
context: In fact, most people want it\Sometimes they visit your play or your head slowly to the.mykshn while they stay cute define positions\But, with all those cute Cardona could not do anything\And if something happened to my master\I do.nmytvnstm\Only I could sit and watch\Rudolf, what happened to you?\Why back to life? response:	70 Sal before
context: Sometimes they visit your play or your head slowly to the.mykshn while they stay cute define positions\But, with all those cute Cardona could not do anything\And if something happened to my master\I do.nmytvnstm\Only I could sit and watch\Rudolf, what happened to you?\Why back to life?\70 Sal before response:	There was a terrible.jng
context: But, with all those cute Cardona could not do anything\And if something happened to my master\I do.nmytvnstm\Only I could sit and watch\Rudolf, what happened to you?\Why back to life?\70 Sal before\There was a terrible.jng response:	The Lord was fighting my previous.kshvr
context: And if something happened to my master\I do.nmytvnstm\Only I could sit and watch\Rudolf, what happened to you?\Why back to life?\70 Sal before\There was a terrible.jng\The Lord was fighting my previous.kshvr response:	You've missed a snap, the village was razed
context: I do.nmytvnstm\Only I could sit and watch\Rudolf, what happened to you?\Why back to life?\70 Sal before\There was a terrible.jng\The Lord was fighting my previous.kshvr\You've missed a snap, the village was razed response:	I was thrown on the floor
context: Only I could sit and watch\Rudolf, what happened to you?\Why back to life?\70 Sal before\There was a terrible.jng\The Lord was fighting my previous.kshvr\You've missed a snap, the village was razed\I was thrown on the floor response:	And I just could suffer master watch
context: Rudolf, what happened to you?\Why back to life?\70 Sal before\There was a terrible.jng\The Lord was fighting my previous.kshvr\You've missed a snap, the village was razed\I was thrown on the floor\And I just could suffer master watch response:	I do.nmytvnstm
context: Why back to life?\70 Sal before\There was a terrible.jng\The Lord was fighting my previous.kshvr\You've missed a snap, the village was razed\I was thrown on the floor\And I just could suffer master watch\I do.nmytvnstm response:	After this head over you.
context: 70 Sal before\There was a terrible.jng\The Lord was fighting my previous.kshvr\You've missed a snap, the village was razed\I was thrown on the floor\And I just could suffer master watch\I do.nmytvnstm\After this head over you. response:	Heart pain came, right?
context: There was a terrible.jng\The Lord was fighting my previous.kshvr\You've missed a snap, the village was razed\I was thrown on the floor\And I just could suffer master watch\I do.nmytvnstm\After this head over you.\Heart pain came, right? response:	And turning to ash up
context: The Lord was fighting my previous.kshvr\You've missed a snap, the village was razed\I was thrown on the floor\And I just could suffer master watch\I do.nmytvnstm\After this head over you.\Heart pain came, right?\And turning to ash up response:	I overreacting?
context: You've missed a snap, the village was razed\I was thrown on the floor\And I just could suffer master watch\I do.nmytvnstm\After this head over you.\Heart pain came, right?\And turning to ash up\I overreacting? response:	Wait, where are you going? Significant?
context: I was thrown on the floor\And I just could suffer master watch\I do.nmytvnstm\After this head over you.\Heart pain came, right?\And turning to ash up\I overreacting?\Wait, where are you going? Significant? response:	No, I can not let him
context: And I just could suffer master watch\I do.nmytvnstm\After this head over you.\Heart pain came, right?\And turning to ash up\I overreacting?\Wait, where are you going? Significant?\No, I can not let him response:	Who knows what might happen if you let it go?
context: I do.nmytvnstm\After this head over you.\Heart pain came, right?\And turning to ash up\I overreacting?\Wait, where are you going? Significant?\No, I can not let him\Who knows what might happen if you let it go? response:	Where is Rudolph?
context: After this head over you.\Heart pain came, right?\And turning to ash up\I overreacting?\Wait, where are you going? Significant?\No, I can not let him\Who knows what might happen if you let it go?\Where is Rudolph? response:	It should be.ayna
context: Heart pain came, right?\And turning to ash up\I overreacting?\Wait, where are you going? Significant?\No, I can not let him\Who knows what might happen if you let it go?\Where is Rudolph?\It should be.ayna response:	So here Rudolf?
context: And turning to ash up\I overreacting?\Wait, where are you going? Significant?\No, I can not let him\Who knows what might happen if you let it go?\Where is Rudolph?\It should be.ayna\So here Rudolf? response:	Please stop!
context: I overreacting?\Wait, where are you going? Significant?\No, I can not let him\Who knows what might happen if you let it go?\Where is Rudolph?\It should be.ayna\So here Rudolf?\Please stop! response:	Aki...
context: Wait, where are you going? Significant?\No, I can not let him\Who knows what might happen if you let it go?\Where is Rudolph?\It should be.ayna\So here Rudolf?\Please stop!\Aki... response:	I fainted.alan
context: No, I can not let him\Who knows what might happen if you let it go?\Where is Rudolph?\It should be.ayna\So here Rudolf?\Please stop!\Aki...\I fainted.alan response:	Kodama-san, do you hear me?
context: Who knows what might happen if you let it go?\Where is Rudolph?\It should be.ayna\So here Rudolf?\Please stop!\Aki...\I fainted.alan\Kodama-san, do you hear me? response:	No. reference element
context: Where is Rudolph?\It should be.ayna\So here Rudolf?\Please stop!\Aki...\I fainted.alan\Kodama-san, do you hear me?\No. reference element response:	You're such a position?
context: It should be.ayna\So here Rudolf?\Please stop!\Aki...\I fainted.alan\Kodama-san, do you hear me?\No. reference element\You're such a position? response:	Where is the crime?
context: So here Rudolf?\Please stop!\Aki...\I fainted.alan\Kodama-san, do you hear me?\No. reference element\You're such a position?\Where is the crime? response:	I caught his.mydvnm
context: Please stop!\Aki...\I fainted.alan\Kodama-san, do you hear me?\No. reference element\You're such a position?\Where is the crime?\I caught his.mydvnm response:	ABC noise surrender yourself now
context: Aki...\I fainted.alan\Kodama-san, do you hear me?\No. reference element\You're such a position?\Where is the crime?\I caught his.mydvnm\ABC noise surrender yourself now response:	For example, what to do?
context: I fainted.alan\Kodama-san, do you hear me?\No. reference element\You're such a position?\Where is the crime?\I caught his.mydvnm\ABC noise surrender yourself now\For example, what to do? response:	Flat nipples do not value.dkhtray
context: Kodama-san, do you hear me?\No. reference element\You're such a position?\Where is the crime?\I caught his.mydvnm\ABC noise surrender yourself now\For example, what to do?\Flat nipples do not value.dkhtray response:	You've used the last few hours too Nsrm
context: No. reference element\You're such a position?\Where is the crime?\I caught his.mydvnm\ABC noise surrender yourself now\For example, what to do?\Flat nipples do not value.dkhtray\You've used the last few hours too Nsrm response:	After the Shkstt I, as an ordinary character start next week
context: You're such a position?\Where is the crime?\I caught his.mydvnm\ABC noise surrender yourself now\For example, what to do?\Flat nipples do not value.dkhtray\You've used the last few hours too Nsrm\After the Shkstt I, as an ordinary character start next week response:	So! Rudolf
context: Where is the crime?\I caught his.mydvnm\ABC noise surrender yourself now\For example, what to do?\Flat nipples do not value.dkhtray\You've used the last few hours too Nsrm\After the Shkstt I, as an ordinary character start next week\So! Rudolf response:	Do not know his abode, and normalization are you talking about?
context: I caught his.mydvnm\ABC noise surrender yourself now\For example, what to do?\Flat nipples do not value.dkhtray\You've used the last few hours too Nsrm\After the Shkstt I, as an ordinary character start next week\So! Rudolf\Do not know his abode, and normalization are you talking about? response:	Hyvvnh filled?
context: ABC noise surrender yourself now\For example, what to do?\Flat nipples do not value.dkhtray\You've used the last few hours too Nsrm\After the Shkstt I, as an ordinary character start next week\So! Rudolf\Do not know his abode, and normalization are you talking about?\Hyvvnh filled? response:	Yeah, a Hyvvnh filled, and a teddy bear Delight
context: For example, what to do?\Flat nipples do not value.dkhtray\You've used the last few hours too Nsrm\After the Shkstt I, as an ordinary character start next week\So! Rudolf\Do not know his abode, and normalization are you talking about?\Hyvvnh filled?\Yeah, a Hyvvnh filled, and a teddy bear Delight response:	But you know what the menu was different?
context: Flat nipples do not value.dkhtray\You've used the last few hours too Nsrm\After the Shkstt I, as an ordinary character start next week\So! Rudolf\Do not know his abode, and normalization are you talking about?\Hyvvnh filled?\Yeah, a Hyvvnh filled, and a teddy bear Delight\But you know what the menu was different? response:	I've filled Hyvvnh that can not service your mouth
context: You've used the last few hours too Nsrm\After the Shkstt I, as an ordinary character start next week\So! Rudolf\Do not know his abode, and normalization are you talking about?\Hyvvnh filled?\Yeah, a Hyvvnh filled, and a teddy bear Delight\But you know what the menu was different?\I've filled Hyvvnh that can not service your mouth response:	All my brothers around the world
context: After the Shkstt I, as an ordinary character start next week\So! Rudolf\Do not know his abode, and normalization are you talking about?\Hyvvnh filled?\Yeah, a Hyvvnh filled, and a teddy bear Delight\But you know what the menu was different?\I've filled Hyvvnh that can not service your mouth\All my brothers around the world response:	what is this?
context: So! Rudolf\Do not know his abode, and normalization are you talking about?\Hyvvnh filled?\Yeah, a Hyvvnh filled, and a teddy bear Delight\But you know what the menu was different?\I've filled Hyvvnh that can not service your mouth\All my brothers around the world\what is this? response:	Young
context: Do not know his abode, and normalization are you talking about?\Hyvvnh filled?\Yeah, a Hyvvnh filled, and a teddy bear Delight\But you know what the menu was different?\I've filled Hyvvnh that can not service your mouth\All my brothers around the world\what is this?\Young response:	Do you want to be normal even though your name is not the final list?
context: Hyvvnh filled?\Yeah, a Hyvvnh filled, and a teddy bear Delight\But you know what the menu was different?\I've filled Hyvvnh that can not service your mouth\All my brothers around the world\what is this?\Young\Do you want to be normal even though your name is not the final list? response:	Rudolph?
context: Yeah, a Hyvvnh filled, and a teddy bear Delight\But you know what the menu was different?\I've filled Hyvvnh that can not service your mouth\All my brothers around the world\what is this?\Young\Do you want to be normal even though your name is not the final list?\Rudolph? response:	Why?
context: But you know what the menu was different?\I've filled Hyvvnh that can not service your mouth\All my brothers around the world\what is this?\Young\Do you want to be normal even though your name is not the final list?\Rudolph?\Why? response:	Why Nsrt much did you use?
context: I've filled Hyvvnh that can not service your mouth\All my brothers around the world\what is this?\Young\Do you want to be normal even though your name is not the final list?\Rudolph?\Why?\Why Nsrt much did you use? response:	I wanted to do and always do
context: All my brothers around the world\what is this?\Young\Do you want to be normal even though your name is not the final list?\Rudolph?\Why?\Why Nsrt much did you use?\I wanted to do and always do response:	But, I did not want to be just Love
context: what is this?\Young\Do you want to be normal even though your name is not the final list?\Rudolph?\Why?\Why Nsrt much did you use?\I wanted to do and always do\But, I did not want to be just Love response:	I managed to do it.blakhrh
context: Young\Do you want to be normal even though your name is not the final list?\Rudolph?\Why?\Why Nsrt much did you use?\I wanted to do and always do\But, I did not want to be just Love\I managed to do it.blakhrh response:	Yeah, must be somewhere nearby
context: Do you want to be normal even though your name is not the final list?\Rudolph?\Why?\Why Nsrt much did you use?\I wanted to do and always do\But, I did not want to be just Love\I managed to do it.blakhrh\Yeah, must be somewhere nearby response:	Is guilty?
context: Rudolph?\Why?\Why Nsrt much did you use?\I wanted to do and always do\But, I did not want to be just Love\I managed to do it.blakhrh\Yeah, must be somewhere nearby\Is guilty? response:	Why sprawled across the floor?
context: Why?\Why Nsrt much did you use?\I wanted to do and always do\But, I did not want to be just Love\I managed to do it.blakhrh\Yeah, must be somewhere nearby\Is guilty?\Why sprawled across the floor? response:	Card. It was great Rudolf
context: Why Nsrt much did you use?\I wanted to do and always do\But, I did not want to be just Love\I managed to do it.blakhrh\Yeah, must be somewhere nearby\Is guilty?\Why sprawled across the floor?\Card. It was great Rudolf response:	If you were human
context: I wanted to do and always do\But, I did not want to be just Love\I managed to do it.blakhrh\Yeah, must be somewhere nearby\Is guilty?\Why sprawled across the floor?\Card. It was great Rudolf\If you were human response:	I love.qta
context: But, I did not want to be just Love\I managed to do it.blakhrh\Yeah, must be somewhere nearby\Is guilty?\Why sprawled across the floor?\Card. It was great Rudolf\If you were human\I love.qta response:	We're going
context: I managed to do it.blakhrh\Yeah, must be somewhere nearby\Is guilty?\Why sprawled across the floor?\Card. It was great Rudolf\If you were human\I love.qta\We're going response:	Its name was Rudolf!
context: Yeah, must be somewhere nearby\Is guilty?\Why sprawled across the floor?\Card. It was great Rudolf\If you were human\I love.qta\We're going\Its name was Rudolf! response:	Cho
context: Is guilty?\Why sprawled across the floor?\Card. It was great Rudolf\If you were human\I love.qta\We're going\Its name was Rudolf!\Cho response:	For
context: Why sprawled across the floor?\Card. It was great Rudolf\If you were human\I love.qta\We're going\Its name was Rudolf!\Cho\For response:	Have
context: Card. It was great Rudolf\If you were human\I love.qta\We're going\Its name was Rudolf!\Cho\For\Have response:	When
context: If you were human\I love.qta\We're going\Its name was Rudolf!\Cho\For\Have\When response:	to
context: I love.qta\We're going\Its name was Rudolf!\Cho\For\Have\When\to response:	Ku
context: We're going\Its name was Rudolf!\Cho\For\Have\When\to\Ku response:	that
context: Its name was Rudolf!\Cho\For\Have\When\to\Ku\that response:	Et al.
context: Cho\For\Have\When\to\Ku\that\Et al. response:	out
context: For\Have\When\to\Ku\that\Et al.\out response:	Have
context: Have\When\to\Ku\that\Et al.\out\Have response:	Ma
context: When\to\Ku\that\Et al.\out\Have\Ma response:	ma
context: to\Ku\that\Et al.\out\Have\Ma\ma response:	expenditure
context: Ku\that\Et al.\out\Have\Ma\ma\expenditure response:	Also
context: that\Et al.\out\Have\Ma\ma\expenditure\Also response:	ga
context: Et al.\out\Have\Ma\ma\expenditure\Also\ga response:	Good
context: out\Have\Ma\ma\expenditure\Also\ga\Good response:	tte
context: Have\Ma\ma\expenditure\Also\ga\Good\tte response:	you
context: Ma\ma\expenditure\Also\ga\Good\tte\you response:	ii
context: ma\expenditure\Also\ga\Good\tte\you\ii response:	It's okay to make a few mistakes.
context: expenditure\Also\ga\Good\tte\you\ii\It's okay to make a few mistakes. response:	Cho
context: Also\ga\Good\tte\you\ii\It's okay to make a few mistakes.\Cho response:	For
context: ga\Good\tte\you\ii\It's okay to make a few mistakes.\Cho\For response:	Chi
context: Good\tte\you\ii\It's okay to make a few mistakes.\Cho\For\Chi response:	Yo
context: tte\you\ii\It's okay to make a few mistakes.\Cho\For\Chi\Yo response:	Have
context: you\ii\It's okay to make a few mistakes.\Cho\For\Chi\Yo\Have response:	Have
context: ii\It's okay to make a few mistakes.\Cho\For\Chi\Yo\Have\Have response:	When
context: It's okay to make a few mistakes.\Cho\For\Chi\Yo\Have\Have\When response:	to
context: Cho\For\Chi\Yo\Have\Have\When\to response:	When
context: For\Chi\Yo\Have\Have\When\to\When response:	Ku
context: Chi\Yo\Have\Have\When\to\When\Ku response:	that
context: Yo\Have\Have\When\to\When\Ku\that response:	Ku
context: Have\Have\When\to\When\Ku\that\Ku response:	Et al.
context: Have\When\to\When\Ku\that\Ku\Et al. response:	in
context: When\to\When\Ku\that\Ku\Et al.\in response:	out
context: to\When\Ku\that\Ku\Et al.\in\out response:	Et al.
context: When\Ku\that\Ku\Et al.\in\out\Et al. response:	Have
context: Ku\that\Ku\Et al.\in\out\Et al.\Have response:	Have
context: that\Ku\Et al.\in\out\Et al.\Have\Have response:	Ma
context: Ku\Et al.\in\out\Et al.\Have\Have\Ma response:	ma
context: Et al.\in\out\Et al.\Have\Have\Ma\ma response:	expenditure
context: in\out\Et al.\Have\Have\Ma\ma\expenditure response:	ga
context: out\Et al.\Have\Have\Ma\ma\expenditure\ga response:	between
context: Et al.\Have\Have\Ma\ma\expenditure\ga\between response:	Violate
context: Have\Have\Ma\ma\expenditure\ga\between\Violate response:	tte
context: Have\Ma\ma\expenditure\ga\between\Violate\tte response:	Tsu
context: Ma\ma\expenditure\ga\between\Violate\tte\Tsu response:	Te
context: ma\expenditure\ga\between\Violate\tte\Tsu\Te response:	Also
context: expenditure\ga\between\Violate\tte\Tsu\Te\Also response:	you
context: ga\between\Violate\tte\Tsu\Te\Also\you response:	Also
context: between\Violate\tte\Tsu\Te\Also\you\Also response:	Good
context: Violate\tte\Tsu\Te\Also\you\Also\Good response:	ii
context: tte\Tsu\Te\Also\you\Also\Good\ii response:	fly
context: Tsu\Te\Also\you\Also\Good\ii\fly response:	To
context: Te\Also\you\Also\Good\ii\fly\To response:	Beauty
context: Also\you\Also\Good\ii\fly\To\Beauty response:	with a
context: you\Also\Good\ii\fly\To\Beauty\with a response:	Included
context: Also\Good\ii\fly\To\Beauty\with a\Included response:	my
context: Good\ii\fly\To\Beauty\with a\Included\my response:	No
context: ii\fly\To\Beauty\with a\Included\my\No response:	mu
context: fly\To\Beauty\with a\Included\my\No\mu response:	Hmm
context: To\Beauty\with a\Included\my\No\mu\Hmm response:	'n
context: Beauty\with a\Included\my\No\mu\Hmm\'n response:	gives
context: with a\Included\my\No\mu\Hmm\'n\gives response:	Have
context: Included\my\No\mu\Hmm\'n\gives\Have response:	Have
context: my\No\mu\Hmm\'n\gives\Have\Have response:	We're going into it.
context: No\mu\Hmm\'n\gives\Have\Have\We're going into it. response:	fly
context: mu\Hmm\'n\gives\Have\Have\We're going into it.\fly response:	To
context: Hmm\'n\gives\Have\Have\We're going into it.\fly\To response:	fly
context: 'n\gives\Have\Have\We're going into it.\fly\To\fly response:	Beauty
context: gives\Have\Have\We're going into it.\fly\To\fly\Beauty response:	with a
context: Have\Have\We're going into it.\fly\To\fly\Beauty\with a response:	Beauty
context: Have\We're going into it.\fly\To\fly\Beauty\with a\Beauty response:	Included
context: We're going into it.\fly\To\fly\Beauty\with a\Beauty\Included response:	my
context: fly\To\fly\Beauty\with a\Beauty\Included\my response:	Included
context: To\fly\Beauty\with a\Beauty\Included\my\Included response:	No
context: fly\Beauty\with a\Beauty\Included\my\Included\No response:	mu
context: Beauty\with a\Beauty\Included\my\Included\No\mu response:	No
context: with a\Beauty\Included\my\Included\No\mu\No response:	Hmm
context: Beauty\Included\my\Included\No\mu\No\Hmm response:	in
context: Included\my\Included\No\mu\No\Hmm\in response:	'n
context: my\Included\No\mu\No\Hmm\in\'n response:	Hmm
context: Included\No\mu\No\Hmm\in\'n\Hmm response:	gives
context: No\mu\No\Hmm\in\'n\Hmm\gives response:	all
context: mu\No\Hmm\in\'n\Hmm\gives\all response:	That
context: No\Hmm\in\'n\Hmm\gives\all\That response:	force
context: Hmm\in\'n\Hmm\gives\all\That\force response:	so
context: in\'n\Hmm\gives\all\That\force\so response:	ryo
context: 'n\Hmm\gives\all\That\force\so\ryo response:	Make
context: Hmm\gives\all\That\force\so\ryo\Make response:	that
context: gives\all\That\force\so\ryo\Make\that response:	Tcha
context: all\That\force\so\ryo\Make\that\Tcha response:	of
context: That\force\so\ryo\Make\that\Tcha\of response:	Huh
context: force\so\ryo\Make\that\Tcha\of\Huh response:	tsu
context: so\ryo\Make\that\Tcha\of\Huh\tsu response:	Place
context: ryo\Make\that\Tcha\of\Huh\tsu\Place response:	ka
context: Make\that\Tcha\of\Huh\tsu\Place\ka response:	Ho
context: that\Tcha\of\Huh\tsu\Place\ka\Ho response:	ccha
context: Tcha\of\Huh\tsu\Place\ka\Ho\ccha response:	Et al.
context: of\Huh\tsu\Place\ka\Ho\ccha\Et al. response:	ba
context: Huh\tsu\Place\ka\Ho\ccha\Et al.\ba response:	ho
context: tsu\Place\ka\Ho\ccha\Et al.\ba\ho response:	out
context: Place\ka\Ho\ccha\Et al.\ba\ho\out response:	See, if you use everything you've got,
context: ka\Ho\ccha\Et al.\ba\ho\out\See, if you use everything you've got, response:	all
context: Ho\ccha\Et al.\ba\ho\out\See, if you use everything you've got,\all response:	That
context: ccha\Et al.\ba\ho\out\See, if you use everything you've got,\all\That response:	WITH
context: Et al.\ba\ho\out\See, if you use everything you've got,\all\That\WITH response:	all
context: ba\ho\out\See, if you use everything you've got,\all\That\WITH\all response:	force
context: ho\out\See, if you use everything you've got,\all\That\WITH\all\force response:	ryo
context: out\See, if you use everything you've got,\all\That\WITH\all\force\ryo response:	that
context: See, if you use everything you've got,\all\That\WITH\all\force\ryo\that response:	force
context: all\That\WITH\all\force\ryo\that\force response:	so
context: That\WITH\all\force\ryo\that\force\so response:	in
context: WITH\all\force\ryo\that\force\so\in response:	of
context: all\force\ryo\that\force\so\in\of response:	so
context: force\ryo\that\force\so\in\of\so response:	Make
context: ryo\that\force\so\in\of\so\Make response:	tsu
context: that\force\so\in\of\so\Make\tsu response:	in
context: force\so\in\of\so\Make\tsu\in response:	ka
context: so\in\of\so\Make\tsu\in\ka response:	Make
context: in\of\so\Make\tsu\in\ka\Make response:	Tcha
context: of\so\Make\tsu\in\ka\Make\Tcha response:	ccha
context: so\Make\tsu\in\ka\Make\Tcha\ccha response:	Tsu
context: Make\tsu\in\ka\Make\Tcha\ccha\Tsu response:	Chi
context: tsu\in\ka\Make\Tcha\ccha\Tsu\Chi response:	Huh
context: in\ka\Make\Tcha\ccha\Tsu\Chi\Huh response:	Huh
context: ka\Make\Tcha\ccha\Tsu\Chi\Huh\Huh response:	Place
context: Make\Tcha\ccha\Tsu\Chi\Huh\Huh\Place response:	ba
context: Tcha\ccha\Tsu\Chi\Huh\Huh\Place\ba response:	Place
context: ccha\Tsu\Chi\Huh\Huh\Place\ba\Place response:	Ho
context: Tsu\Chi\Huh\Huh\Place\ba\Place\Ho response:	ho
context: Chi\Huh\Huh\Place\ba\Place\Ho\ho response:	Ho
context: Huh\Huh\Place\ba\Place\Ho\ho\Ho response:	Et al.
context: Huh\Place\ba\Place\Ho\ho\Ho\Et al. response:	out
context: Place\ba\Place\Ho\ho\Ho\Et al.\out response:	De
context: ba\Place\Ho\ho\Ho\Et al.\out\De response:	Do
context: Place\Ho\ho\Ho\Et al.\out\De\Do response:	The
context: Ho\ho\Ho\Et al.\out\De\Do\The response:	Where
context: ho\Ho\Et al.\out\De\Do\The\Where response:	open
context: Ho\Et al.\out\De\Do\The\Where\open response:	hi
context: Et al.\out\De\Do\The\Where\open\hi response:	Ku
context: out\De\Do\The\Where\open\hi\Ku response:	out
context: De\Do\The\Where\open\hi\Ku\out response:	that
context: Do\The\Where\open\hi\Ku\out\that response:	Et al.
context: The\Where\open\hi\Ku\out\that\Et al. response:	the door will open.
context: Where\open\hi\Ku\out\that\Et al.\the door will open. response:	De
context: open\hi\Ku\out\that\Et al.\the door will open.\De response:	Do
context: hi\Ku\out\that\Et al.\the door will open.\De\Do response:	De
context: Ku\out\that\Et al.\the door will open.\De\Do\De response:	The
context: out\that\Et al.\the door will open.\De\Do\De\The response:	Where
context: that\Et al.\the door will open.\De\Do\De\The\Where response:	The
context: Et al.\the door will open.\De\Do\De\The\Where\The response:	open
context: the door will open.\De\Do\De\The\Where\The\open response:	hi
context: De\Do\De\The\Where\The\open\hi response:	out
context: Do\De\The\Where\The\open\hi\out response:	open
context: De\The\Where\The\open\hi\out\open response:	Ku
context: The\Where\The\open\hi\out\open\Ku response:	that
context: Where\The\open\hi\out\open\Ku\that response:	You
context: The\open\hi\out\open\Ku\that\You response:	Of
context: open\hi\out\open\Ku\that\You\Of response:	When
context: hi\out\open\Ku\that\You\Of\When response:	my
context: out\open\Ku\that\You\Of\When\my response:	Me
context: open\Ku\that\You\Of\When\my\Me response:	to
context: Ku\that\You\Of\When\my\Me\to response:	wa
context: that\You\Of\When\my\Me\to\wa response:	ta
context: You\Of\When\my\Me\to\wa\ta response:	shi
context: Of\When\my\Me\to\wa\ta\shi response:	Ku
context: When\my\Me\to\wa\ta\shi\Ku response:	in
context: my\Me\to\wa\ta\shi\Ku\in response:	You and I,
context: Me\to\wa\ta\shi\Ku\in\You and I, response:	You
context: to\wa\ta\shi\Ku\in\You and I,\You response:	Of
context: wa\ta\shi\Ku\in\You and I,\You\Of response:	my
context: ta\shi\Ku\in\You and I,\You\Of\my response:	You
context: shi\Ku\in\You and I,\You\Of\my\You response:	When
context: Ku\in\You and I,\You\Of\my\You\When response:	to
context: in\You and I,\You\Of\my\You\When\to response:	When
context: You and I,\You\Of\my\You\When\to\When response:	Me
context: You\Of\my\You\When\to\When\Me response:	wa
context: Of\my\You\When\to\When\Me\wa response:	two
context: my\You\When\to\When\Me\wa\two response:	ta
context: You\When\to\When\Me\wa\two\ta response:	Fu
context: When\to\When\Me\wa\two\ta\Fu response:	people
context: to\When\Me\wa\two\ta\Fu\people response:	ta
context: When\Me\wa\two\ta\Fu\people\ta response:	ri
context: Me\wa\two\ta\Fu\people\ta\ri response:	Et al.
context: wa\two\ta\Fu\people\ta\ri\Et al. response:	na
context: two\ta\Fu\people\ta\ri\Et al.\na response:	shi
context: ta\Fu\people\ta\ri\Et al.\na\shi response:	Place
context: Fu\people\ta\ri\Et al.\na\shi\Place response:	out
context: people\ta\ri\Et al.\na\shi\Place\out response:	ba
context: ta\ri\Et al.\na\shi\Place\out\ba response:	if we're together,
context: ri\Et al.\na\shi\Place\out\ba\if we're together, response:	Me
context: Et al.\na\shi\Place\out\ba\if we're together,\Me response:	two
context: na\shi\Place\out\ba\if we're together,\Me\two response:	Fu
context: shi\Place\out\ba\if we're together,\Me\two\Fu response:	in
context: Place\out\ba\if we're together,\Me\two\Fu\in response:	ta
context: out\ba\if we're together,\Me\two\Fu\in\ta response:	two
context: ba\if we're together,\Me\two\Fu\in\ta\two response:	people
context: if we're together,\Me\two\Fu\in\ta\two\people response:	ri
context: Me\two\Fu\in\ta\two\people\ri response:	Etc.
context: two\Fu\in\ta\two\people\ri\Etc. response:	Do
context: Fu\in\ta\two\people\ri\Etc.\Do response:	Hmm
context: in\ta\two\people\ri\Etc.\Do\Hmm response:	na
context: ta\two\people\ri\Etc.\Do\Hmm\na response:	people
context: two\people\ri\Etc.\Do\Hmm\na\people response:	na
context: people\ri\Etc.\Do\Hmm\na\people\na response:	dream
context: ri\Etc.\Do\Hmm\na\people\na\dream response:	yu
context: Etc.\Do\Hmm\na\people\na\dream\yu response:	Also
context: Do\Hmm\na\people\na\dream\yu\Also response:	me
context: Hmm\na\people\na\dream\yu\Also\me response:	you
context: na\people\na\dream\yu\Also\me\you response:	Et al.
context: people\na\dream\yu\Also\me\you\Et al. response:	out
context: na\dream\yu\Also\me\you\Et al.\out response:	Et al.
context: dream\yu\Also\me\you\Et al.\out\Et al. response:	Place
context: yu\Also\me\you\Et al.\out\Et al.\Place response:	ba
context: Also\me\you\Et al.\out\Et al.\Place\ba response:	we can grasp.
context: me\you\Et al.\out\Et al.\Place\ba\we can grasp. response:	Place
context: you\Et al.\out\Et al.\Place\ba\we can grasp.\Place response:	Etc.
context: Et al.\out\Et al.\Place\ba\we can grasp.\Place\Etc. response:	Do
context: out\Et al.\Place\ba\we can grasp.\Place\Etc.\Do response:	Etc.
context: Et al.\Place\ba\we can grasp.\Place\Etc.\Do\Etc. response:	Hmm
context: Place\ba\we can grasp.\Place\Etc.\Do\Etc.\Hmm response:	Hmm
context: ba\we can grasp.\Place\Etc.\Do\Etc.\Hmm\Hmm response:	na
context: we can grasp.\Place\Etc.\Do\Etc.\Hmm\Hmm\na response:	slap
context: Place\Etc.\Do\Etc.\Hmm\Hmm\na\slap response:	Tsu
context: Etc.\Do\Etc.\Hmm\Hmm\na\slap\Tsu response:	Because
context: Do\Etc.\Hmm\Hmm\na\slap\Tsu\Because response:	ka
context: Etc.\Hmm\Hmm\na\slap\Tsu\Because\ka response:	That
context: Hmm\Hmm\na\slap\Tsu\Because\ka\That response:	me
context: Hmm\na\slap\Tsu\Because\ka\That\me response:	Or
context: na\slap\Tsu\Because\ka\That\me\Or response:	ru
context: slap\Tsu\Because\ka\That\me\Or\ru response:	Et al.
context: Tsu\Because\ka\That\me\Or\ru\Et al. response:	ka
context: Because\ka\That\me\Or\ru\Et al.\ka response:	out
context: ka\That\me\Or\ru\Et al.\ka\out response:	dream
context: That\me\Or\ru\Et al.\ka\out\dream response:	yu
context: me\Or\ru\Et al.\ka\out\dream\yu response:	in
context: Or\ru\Et al.\ka\out\dream\yu\in response:	me
context: ru\Et al.\ka\out\dream\yu\in\me response:	dream
context: Et al.\ka\out\dream\yu\in\me\dream response:	Also
context: ka\out\dream\yu\in\me\dream\Also response:	you
context: out\dream\yu\in\me\dream\Also\you response:	Whatever dreams we have,
context: dream\yu\in\me\dream\Also\you\Whatever dreams we have, response:	slap
context: yu\in\me\dream\Also\you\Whatever dreams we have,\slap response:	Tsu
context: in\me\dream\Also\you\Whatever dreams we have,\slap\Tsu response:	in
context: me\dream\Also\you\Whatever dreams we have,\slap\Tsu\in response:	ka
context: dream\Also\you\Whatever dreams we have,\slap\Tsu\in\ka response:	slap
context: Also\you\Whatever dreams we have,\slap\Tsu\in\ka\slap response:	Because
context: you\Whatever dreams we have,\slap\Tsu\in\ka\slap\Because response:	me
context: Whatever dreams we have,\slap\Tsu\in\ka\slap\Because\me response:	what
context: slap\Tsu\in\ka\slap\Because\me\what response:	Na
context: Tsu\in\ka\slap\Because\me\what\Na response:	Also
context: in\ka\slap\Because\me\what\Na\Also response:	ni
context: ka\slap\Because\me\what\Na\Also\ni response:	fan
context: slap\Because\me\what\Na\Also\ni\fan response:	you
context: Because\me\what\Na\Also\ni\fan\you response:	ma
context: me\what\Na\Also\ni\fan\you\ma response:	Not
context: what\Na\Also\ni\fan\you\ma\Not response:	To
context: Na\Also\ni\fan\you\ma\Not\To response:	Because
context: Also\ni\fan\you\ma\Not\To\Because response:	That
context: ni\fan\you\ma\Not\To\Because\That response:	wa
context: fan\you\ma\Not\To\Because\That\wa response:	ru
context: you\ma\Not\To\Because\That\wa\ru response:	Row
context: ma\Not\To\Because\That\wa\ru\Row response:	to
context: Not\To\Because\That\wa\ru\Row\to response:	like this
context: To\Because\That\wa\ru\Row\to\like this response:	ni
context: Because\That\wa\ru\Row\to\like this\ni response:	Also
context: That\wa\ru\Row\to\like this\ni\Also response:	yu
context: wa\ru\Row\to\like this\ni\Also\yu response:	kou
context: ru\Row\to\like this\ni\Also\yu\kou response:	That
context: Row\to\like this\ni\Also\yu\kou\That response:	Or
context: to\like this\ni\Also\yu\kou\That\Or response:	in
context: like this\ni\Also\yu\kou\That\Or\in response:	ka
context: ni\Also\yu\kou\That\Or\in\ka response:	Or
context: Also\yu\kou\That\Or\in\ka\Or response:	Et al.
context: yu\kou\That\Or\in\ka\Or\Et al. response:	out
context: kou\That\Or\in\ka\Or\Et al.\out response:	Throw away your doubts and move forth,
context: That\Or\in\ka\Or\Et al.\out\Throw away your doubts and move forth, response:	what
context: Or\in\ka\Or\Et al.\out\Throw away your doubts and move forth,\what response:	Na
context: in\ka\Or\Et al.\out\Throw away your doubts and move forth,\what\Na response:	ni
context: ka\Or\Et al.\out\Throw away your doubts and move forth,\what\Na\ni response:	what
context: Or\Et al.\out\Throw away your doubts and move forth,\what\Na\ni\what response:	Also
context: Et al.\out\Throw away your doubts and move forth,\what\Na\ni\what\Also response:	you
context: out\Throw away your doubts and move forth,\what\Na\ni\what\Also\you response:	Et al.
context: Throw away your doubts and move forth,\what\Na\ni\what\Also\you\Et al. response:	Also
context: what\Na\ni\what\Also\you\Et al.\Also response:	fan
context: Na\ni\what\Also\you\Et al.\Also\fan response:	ma
context: ni\what\Also\you\Et al.\Also\fan\ma response:	fan
context: what\Also\you\Et al.\Also\fan\ma\fan response:	wa
context: Also\you\Et al.\Also\fan\ma\fan\wa response:	Not
context: you\Et al.\Also\fan\ma\fan\wa\Not response:	to
context: Et al.\Also\fan\ma\fan\wa\Not\to response:	Not
context: Also\fan\ma\fan\wa\Not\to\Not response:	To
context: fan\ma\fan\wa\Not\to\Not\To response:	with
context: ma\fan\wa\Not\to\Not\To\with response:	in
context: fan\wa\Not\to\Not\To\with\in response:	ni
context: wa\Not\to\Not\To\with\in\ni response:	To
context: Not\to\Not\To\with\in\ni\To response:	Row
context: to\Not\To\with\in\ni\To\Row response:	yu
context: Not\To\with\in\ni\To\Row\yu response:	Light
context: To\with\in\ni\To\Row\yu\Light response:	Hi
context: with\in\ni\To\Row\yu\Light\Hi response:	Row
context: in\ni\To\Row\yu\Light\Hi\Row response:	like this
context: ni\To\Row\yu\Light\Hi\Row\like this response:	in
context: To\Row\yu\Light\Hi\Row\like this\in response:	kou
context: Row\yu\Light\Hi\Row\like this\in\kou response:	To
context: yu\Light\Hi\Row\like this\in\kou\To response:	ka
context: Light\Hi\Row\like this\in\kou\To\ka response:	hand
context: Hi\Row\like this\in\kou\To\ka\hand response:	ri
context: Row\like this\in\kou\To\ka\hand\ri response:	The
context: like this\in\kou\To\ka\hand\ri\The response:	ni
context: in\kou\To\ka\hand\ri\The\ni response:	Stretch
context: kou\To\ka\hand\ri\The\ni\Stretch response:	to
context: To\ka\hand\ri\The\ni\Stretch\to response:	Place
context: ka\hand\ri\The\ni\Stretch\to\Place response:	Where
context: hand\ri\The\ni\Stretch\to\Place\Where response:	To
context: ri\The\ni\Stretch\to\Place\Where\To response:	no
context: The\ni\Stretch\to\Place\Where\To\no response:	ba
context: ni\Stretch\to\Place\Where\To\no\ba response:	he
context: Stretch\to\Place\Where\To\no\ba\he response:	This
context: to\Place\Where\To\no\ba\he\This response:	Cormorant
context: Place\Where\To\no\ba\he\This\Cormorant response:	in
context: Where\To\no\ba\he\This\Cormorant\in response:	and reach out for the light.
context: To\no\ba\he\This\Cormorant\in\and reach out for the light. response:	Light
context: no\ba\he\This\Cormorant\in\and reach out for the light.\Light response:	Hi
context: ba\he\This\Cormorant\in\and reach out for the light.\Light\Hi response:	ka
context: he\This\Cormorant\in\and reach out for the light.\Light\Hi\ka response:	ri
context: This\Cormorant\in\and reach out for the light.\Light\Hi\ka\ri response:	Light
context: Cormorant\in\and reach out for the light.\Light\Hi\ka\ri\Light response:	To
context: in\and reach out for the light.\Light\Hi\ka\ri\Light\To response:	ni
context: and reach out for the light.\Light\Hi\ka\ri\Light\To\ni response:	To
context: Light\Hi\ka\ri\Light\To\ni\To response:	hand
context: Hi\ka\ri\Light\To\ni\To\hand response:	to
context: ka\ri\Light\To\ni\To\hand\to response:	hand
context: ri\Light\To\ni\To\hand\to\hand response:	The
context: Light\To\ni\To\hand\to\hand\The response:	Where
context: To\ni\To\hand\to\hand\The\Where response:	The
context: ni\To\hand\to\hand\The\Where\The response:	Stretch
context: To\hand\to\hand\The\Where\The\Stretch response:	no
context: hand\to\hand\The\Where\The\Stretch\no response:	Stretch
context: to\hand\The\Where\The\Stretch\no\Stretch response:	Place
context: hand\The\Where\The\Stretch\no\Stretch\Place response:	ba
context: The\Where\The\Stretch\no\Stretch\Place\ba response:	Place
context: Where\The\Stretch\no\Stretch\Place\ba\Place response:	To
context: The\Stretch\no\Stretch\Place\ba\Place\To response:	he
context: Stretch\no\Stretch\Place\ba\Place\To\he response:	I'm
context: no\Stretch\Place\ba\Place\To\he\I'm response:	ready
context: Stretch\Place\ba\Place\To\he\I'm\ready response:	I'm
context: Place\ba\Place\To\he\I'm\ready\I'm response:	ready
context: ba\Place\To\he\I'm\ready\I'm\ready response:	Contact
context: Place\To\he\I'm\ready\I'm\ready\Contact response:	of
context: To\he\I'm\ready\I'm\ready\Contact\of response:	no
context: he\I'm\ready\I'm\ready\Contact\of\no response:	But
context: I'm\ready\I'm\ready\Contact\of\no\But response:	ga
context: ready\I'm\ready\Contact\of\no\But\ga response:	This
context: I'm\ready\Contact\of\no\But\ga\This response:	my
context: ready\Contact\of\no\But\ga\This\my response:	of
context: Contact\of\no\But\ga\This\my\of response:	no
context: of\no\But\ga\This\my\of\no response:	Road
context: no\But\ga\This\my\of\no\Road response:	my
context: But\ga\This\my\of\no\Road\my response:	Sudden
context: ga\This\my\of\no\Road\my\Sudden response:	expenditure
context: This\my\of\no\Road\my\Sudden\expenditure response:	Can
context: my\of\no\Road\my\Sudden\expenditure\Can response:	tsu
context: of\no\Road\my\Sudden\expenditure\Can\tsu response:	Enter
context: no\Road\my\Sudden\expenditure\Can\tsu\Enter response:	Of
context: Road\my\Sudden\expenditure\Can\tsu\Enter\Of response:	To
context: my\Sudden\expenditure\Can\tsu\Enter\Of\To response:	No
context: Sudden\expenditure\Can\tsu\Enter\Of\To\No response:	its
context: expenditure\Can\tsu\Enter\Of\To\No\its response:	When
context: Can\tsu\Enter\Of\To\No\its\When response:	its
context: tsu\Enter\Of\To\No\its\When\its response:	mu
context: Enter\Of\To\No\its\When\its\mu response:	to
context: Of\To\No\its\When\its\mu\to response:	As you walk along this path,
context: To\No\its\When\its\mu\to\As you walk along this path, response:	Contact
context: No\its\When\its\mu\to\As you walk along this path,\Contact response:	Contact
context: its\When\its\mu\to\As you walk along this path,\Contact\Contact response:	of
context: When\its\mu\to\As you walk along this path,\Contact\Contact\of response:	no
context: its\mu\to\As you walk along this path,\Contact\Contact\of\no response:	of
context: mu\to\As you walk along this path,\Contact\Contact\of\no\of response:	But
context: to\As you walk along this path,\Contact\Contact\of\no\of\But response:	ga
context: As you walk along this path,\Contact\Contact\of\no\of\But\ga response:	But
context: Contact\Contact\of\no\of\But\ga\But response:	This
context: Contact\of\no\of\But\ga\But\This response:	my
context: of\no\of\But\ga\But\This\my response:	This
context: no\of\But\ga\But\This\my\This response:	of
context: of\But\ga\But\This\my\This\of response:	no
context: But\ga\But\This\my\This\of\no response:	of
context: ga\But\This\my\This\of\no\of response:	Road
context: But\This\my\This\of\no\of\Road response:	my
context: This\my\This\of\no\of\Road\my response:	expenditure
context: my\This\of\no\of\Road\my\expenditure response:	Road
context: This\of\no\of\Road\my\expenditure\Road response:	Sudden
context: of\no\of\Road\my\expenditure\Road\Sudden response:	tsu
context: no\of\Road\my\expenditure\Road\Sudden\tsu response:	Sudden
context: of\Road\my\expenditure\Road\Sudden\tsu\Sudden response:	Can
context: Road\my\expenditure\Road\Sudden\tsu\Sudden\Can response:	in
context: my\expenditure\Road\Sudden\tsu\Sudden\Can\in response:	Of
context: expenditure\Road\Sudden\tsu\Sudden\Can\in\Of response:	Can
context: Road\Sudden\tsu\Sudden\Can\in\Of\Can response:	Enter
context: Sudden\tsu\Sudden\Can\in\Of\Can\Enter response:	its
context: tsu\Sudden\Can\in\Of\Can\Enter\its response:	in
context: Sudden\Can\in\Of\Can\Enter\its\in response:	its
context: Can\in\Of\Can\Enter\its\in\its response:	Yura
context: in\Of\Can\Enter\its\in\its\Yura response:	Yu
context: Of\Can\Enter\its\in\its\Yura\Yu response:	Et al.
context: Can\Enter\its\in\its\Yura\Yu\Et al. response:	out
context: Enter\its\in\its\Yura\Yu\Et al.\out response:	na
context: its\in\its\Yura\Yu\Et al.\out\na response:	Have
context: in\its\Yura\Yu\Et al.\out\na\Have response:	Decide
context: its\Yura\Yu\Et al.\out\na\Have\Decide response:	The
context: Yura\Yu\Et al.\out\na\Have\Decide\The response:	Enter
context: Yu\Et al.\out\na\Have\Decide\The\Enter response:	No
context: Et al.\out\na\Have\Decide\The\Enter\No response:	in
context: out\na\Have\Decide\The\Enter\No\in response:	mu
context: na\Have\Decide\The\Enter\No\in\mu response:	meaning
context: Have\Decide\The\Enter\No\in\mu\meaning response:	tsu
context: Decide\The\Enter\No\in\mu\meaning\tsu response:	The
context: The\Enter\No\in\mu\meaning\tsu\The response:	breast
context: Enter\No\in\mu\meaning\tsu\The\breast response:	Where
context: No\in\mu\meaning\tsu\The\breast\Where response:	No
context: in\mu\meaning\tsu\The\breast\Where\No response:	When
context: mu\meaning\tsu\The\breast\Where\No\When response:	in
context: meaning\tsu\The\breast\Where\No\When\in response:	to
context: tsu\The\breast\Where\No\When\in\to response:	To
context: The\breast\Where\No\When\in\to\To response:	mu
context: breast\Where\No\When\in\to\To\mu response:	born
context: Where\No\When\in\to\To\mu\born response:	ni
context: No\When\in\to\To\mu\born\ni response:	When
context: When\in\to\To\mu\born\ni\When response:	keep your unwavering determination in you,
context: in\to\To\mu\born\ni\When\keep your unwavering determination in you, response:	Yura
context: to\To\mu\born\ni\When\keep your unwavering determination in you,\Yura response:	Yu
context: To\mu\born\ni\When\keep your unwavering determination in you,\Yura\Yu response:	Yura
context: mu\born\ni\When\keep your unwavering determination in you,\Yura\Yu\Yura response:	Et al.
context: born\ni\When\keep your unwavering determination in you,\Yura\Yu\Yura\Et al. response:	in
context: ni\When\keep your unwavering determination in you,\Yura\Yu\Yura\Et al.\in response:	out
context: When\keep your unwavering determination in you,\Yura\Yu\Yura\Et al.\in\out response:	Et al.
context: keep your unwavering determination in you,\Yura\Yu\Yura\Et al.\in\out\Et al. response:	na
context: Yura\Yu\Yura\Et al.\in\out\Et al.\na response:	Have
context: Yu\Yura\Et al.\in\out\Et al.\na\Have response:	Have
context: Yura\Et al.\in\out\Et al.\na\Have\Have response:	Decide
context: Et al.\in\out\Et al.\na\Have\Have\Decide response:	The
context: in\out\Et al.\na\Have\Have\Decide\The response:	tsu
context: out\Et al.\na\Have\Have\Decide\The\tsu response:	Decide
context: Et al.\na\Have\Have\Decide\The\tsu\Decide response:	meaning
context: na\Have\Have\Decide\The\tsu\Decide\meaning response:	in
context: Have\Have\Decide\The\tsu\Decide\meaning\in response:	meaning
context: Have\Decide\The\tsu\Decide\meaning\in\meaning response:	The
context: Decide\The\tsu\Decide\meaning\in\meaning\The response:	Where
context: The\tsu\Decide\meaning\in\meaning\The\Where response:	The
context: tsu\Decide\meaning\in\meaning\The\Where\The response:	breast
context: Decide\meaning\in\meaning\The\Where\The\breast response:	mu
context: meaning\in\meaning\The\Where\The\breast\mu response:	in
context: in\meaning\The\Where\The\breast\mu\in response:	born
context: meaning\The\Where\The\breast\mu\in\born response:	love
context: The\Where\The\breast\mu\in\born\love response:	my
context: Where\The\breast\mu\in\born\love\my response:	focal
context: The\breast\mu\in\born\love\my\focal response:	But
context: breast\mu\in\born\love\my\focal\But response:	my
context: mu\in\born\love\my\focal\But\my response:	Re
context: in\born\love\my\focal\But\my\Re response:	ga
context: born\love\my\focal\But\my\Re\ga response:	Te
context: love\my\focal\But\my\Re\ga\Te response:	re
context: my\focal\But\my\Re\ga\Te\re response:	breast
context: focal\But\my\Re\ga\Te\re\breast response:	To
context: But\my\Re\ga\Te\re\breast\To response:	ni
context: my\Re\ga\Te\re\breast\To\ni response:	It was
context: Re\ga\Te\re\breast\To\ni\It was response:	to
context: ga\Te\re\breast\To\ni\It was\to response:	new
context: Te\re\breast\To\ni\It was\to\new response:	ta
context: re\breast\To\ni\It was\to\new\ta response:	It was
context: breast\To\ni\It was\to\new\ta\It was response:	out
context: To\ni\It was\to\new\ta\It was\out response:	not
context: ni\It was\to\new\ta\It was\out\not response:	ta
context: It was\to\new\ta\It was\out\not\ta response:	Come
context: to\new\ta\It was\out\not\ta\Come response:	-na
context: new\ta\It was\out\not\ta\Come\-na response:	of
context: ta\It was\out\not\ta\Come\-na\of response:	my
context: It was\out\not\ta\Come\-na\of\my response:	One
context: out\not\ta\Come\-na\of\my\One response:	out
context: not\ta\Come\-na\of\my\One\out response:	Page
context: ta\Come\-na\of\my\One\out\Page response:	Di
context: Come\-na\of\my\One\out\Page\Di response:	no
context: -na\of\my\One\out\Page\Di\no response:	The
context: of\my\One\out\Page\Di\no\The response:	and let's go and find together,
context: my\One\out\Page\Di\no\The\and let's go and find together, response:	To
context: One\out\Page\Di\no\The\and let's go and find together,\To response:	love
context: out\Page\Di\no\The\and let's go and find together,\To\love response:	my
context: Page\Di\no\The\and let's go and find together,\To\love\my response:	expenditure
context: Di\no\The\and let's go and find together,\To\love\my\expenditure response:	pee
context: no\The\and let's go and find together,\To\love\my\expenditure\pee response:	show up
context: The\and let's go and find together,\To\love\my\expenditure\pee\show up response:	Where
context: and let's go and find together,\To\love\my\expenditure\pee\show up\Where response:	love
context: To\love\my\expenditure\pee\show up\Where\love response:	focal
context: love\my\expenditure\pee\show up\Where\love\focal response:	my
context: my\expenditure\pee\show up\Where\love\focal\my response:	focal
context: expenditure\pee\show up\Where\love\focal\my\focal response:	But
context: pee\show up\Where\love\focal\my\focal\But response:	ga
context: show up\Where\love\focal\my\focal\But\ga response:	But
context: Where\love\focal\my\focal\But\ga\But response:	Re
context: love\focal\my\focal\But\ga\But\Re response:	re
context: focal\my\focal\But\ga\But\Re\re response:	Re
context: my\focal\But\ga\But\Re\re\Re response:	Te
context: focal\But\ga\But\Re\re\Re\Te response:	to
context: But\ga\But\Re\re\Re\Te\to response:	Te
context: ga\But\Re\re\Re\Te\to\Te response:	It was
context: But\Re\re\Re\Te\to\Te\It was response:	ta
context: Re\re\Re\Te\to\Te\It was\ta response:	It was
context: re\Re\Te\to\Te\It was\ta\It was response:	new
context: Re\Te\to\Te\It was\ta\It was\new response:	out
context: Te\to\Te\It was\ta\It was\new\out response:	new
context: to\Te\It was\ta\It was\new\out\new response:	It was
context: Te\It was\ta\It was\new\out\new\It was response:	ta
context: It was\ta\It was\new\out\new\It was\ta response:	It was
context: ta\It was\new\out\new\It was\ta\It was response:	-na
context: It was\new\out\new\It was\ta\It was\-na response:	not
context: new\out\new\It was\ta\It was\-na\not response:	my
context: out\new\It was\ta\It was\-na\not\my response:	out
context: new\It was\ta\It was\-na\not\my\out response:	not
context: It was\ta\It was\-na\not\my\out\not response:	Come
context: ta\It was\-na\not\my\out\not\Come response:	Come
context: It was\-na\not\my\out\not\Come\Come response:	of
context: -na\not\my\out\not\Come\Come\of response:	no
context: not\my\out\not\Come\Come\of\no response:	of
context: my\out\not\Come\Come\of\no\of response:	One
context: out\not\Come\Come\of\no\of\One response:	expenditure
context: not\Come\Come\of\no\of\One\expenditure response:	One
context: Come\Come\of\no\of\One\expenditure\One response:	Page
context: Come\of\no\of\One\expenditure\One\Page response:	pee
context: of\no\of\One\expenditure\One\Page\pee response:	Bae
context: no\of\One\expenditure\One\Page\pee\Bae response:	Di
context: of\One\expenditure\One\Page\pee\Bae\Di response:	show up
context: One\expenditure\One\Page\pee\Bae\Di\show up response:	You
context: expenditure\One\Page\pee\Bae\Di\show up\You response:	Of
context: One\Page\pee\Bae\Di\show up\You\Of response:	When
context: Page\pee\Bae\Di\show up\You\Of\When response:	my
context: pee\Bae\Di\show up\You\Of\When\my response:	Altogether
context: Bae\Di\show up\You\Of\When\my\Altogether response:	to
context: Di\show up\You\Of\When\my\Altogether\to response:	Di
context: show up\You\Of\When\my\Altogether\to\Di response:	The
context: You\Of\When\my\Altogether\to\Di\The response:	Where
context: Of\When\my\Altogether\to\Di\The\Where response:	To,
context: When\my\Altogether\to\Di\The\Where\To, response:	to
context: my\Altogether\to\Di\The\Where\To,\to response:	You see
context: Altogether\to\Di\The\Where\To,\to\You see response:	you
context: to\Di\The\Where\To,\to\You see\you response:	One
context: Di\The\Where\To,\to\You see\you\One response:	ni,
context: The\Where\To,\to\You see\you\One\ni, response:	my
context: Where\To,\to\You see\you\One\ni,\my response:	To
context: To,\to\You see\you\One\ni,\my\To response:	tsu
context: to\You see\you\One\ni,\my\To\tsu response:	Row
context: You see\you\One\ni,\my\To\tsu\Row response:	The
context: you\One\ni,\my\To\tsu\Row\The response:	like this
context: One\ni,\my\To\tsu\Row\The\like this response:	ni
context: ni,\my\To\tsu\Row\The\like this\ni response:	yu
context: my\To\tsu\Row\The\like this\ni\yu response:	kou
context: To\tsu\Row\The\like this\ni\yu\kou response:	The
context: tsu\Row\The\like this\ni\yu\kou\The response:	that single page that will lead us to the new future we wish for.
context: Row\The\like this\ni\yu\kou\The\that single page that will lead us to the new future we wish for. response:	You
context: The\like this\ni\yu\kou\The\that single page that will lead us to the new future we wish for.\You response:	Of
context: like this\ni\yu\kou\The\that single page that will lead us to the new future we wish for.\You\Of response:	my
context: ni\yu\kou\The\that single page that will lead us to the new future we wish for.\You\Of\my response:	You
context: yu\kou\The\that single page that will lead us to the new future we wish for.\You\Of\my\You response:	When
context: kou\The\that single page that will lead us to the new future we wish for.\You\Of\my\You\When response:	to
context: The\that single page that will lead us to the new future we wish for.\You\Of\my\You\When\to response:	When
context: that single page that will lead us to the new future we wish for.\You\Of\my\You\When\to\When response:	Altogether
context: You\Of\my\You\When\to\When\Altogether response:	to
context: Of\my\You\When\to\When\Altogether\to response:	you
context: my\You\When\to\When\Altogether\to\you response:	Altogether
context: You\When\to\When\Altogether\to\you\Altogether response:	To,
context: When\to\When\Altogether\to\you\Altogether\To, response:	ni,
context: to\When\Altogether\to\you\Altogether\To,\ni, response:	To
context: When\Altogether\to\you\Altogether\To,\ni,\To response:	You see
context: Altogether\to\you\Altogether\To,\ni,\To\You see response:	my
context: to\you\Altogether\To,\ni,\To\You see\my response:	You see
context: you\Altogether\To,\ni,\To\You see\my\You see response:	One
context: Altogether\To,\ni,\To\You see\my\You see\One response:	tsu
context: To,\ni,\To\You see\my\You see\One\tsu response:	One
context: ni,\To\You see\my\You see\One\tsu\One response:	in
context: To\You see\my\You see\One\tsu\One\in response:	The
context: You see\my\You see\One\tsu\One\in\The response:	To
context: my\You see\One\tsu\One\in\The\To response:	ni
context: You see\One\tsu\One\in\The\To\ni response:	Let's
context: One\tsu\One\in\The\To\ni\Let's response:	To
context: tsu\One\in\The\To\ni\Let's\To response:	Row
context: One\in\The\To\ni\Let's\To\Row response:	yu
context: in\The\To\ni\Let's\To\Row\yu response:	go
context: The\To\ni\Let's\To\Row\yu\go response:	Row
context: To\ni\Let's\To\Row\yu\go\Row response:	like this
context: ni\Let's\To\Row\yu\go\Row\like this response:	in
context: Let's\To\Row\yu\go\Row\like this\in response:	kou
context: To\Row\yu\go\Row\like this\in\kou response:	This
context: Row\yu\go\Row\like this\in\kou\This response:	Cormorant
context: yu\go\Row\like this\in\kou\This\Cormorant response:	in
context: go\Row\like this\in\kou\This\Cormorant\in response:	Let's
context: Row\like this\in\kou\This\Cormorant\in\Let's response:	Let's
context: like this\in\kou\This\Cormorant\in\Let's\Let's response:	go
context: in\kou\This\Cormorant\in\Let's\Let's\go response:	go
context: kou\This\Cormorant\in\Let's\Let's\go\go response:	Let's
context: This\Cormorant\in\Let's\Let's\go\go\Let's response:	go
context: Cormorant\in\Let's\Let's\go\go\Let's\go response:	Sound
context: in\Let's\Let's\go\go\Let's\go\Sound response:	Na
context: Let's\Let's\go\go\Let's\go\Sound\Na response:	Ri
context: Let's\go\go\Let's\go\Sound\Na\Ri response:	ri
context: go\go\Let's\go\Sound\Na\Ri\ri response:	ring
context: go\Let's\go\Sound\Na\Ri\ri\ring response:	hi
context: Let's\go\Sound\Na\Ri\ri\ring\hi response:	Ku
context: go\Sound\Na\Ri\ri\ring\hi\Ku response:	with a
context: Sound\Na\Ri\ri\ring\hi\Ku\with a response:	breast
context: Na\Ri\ri\ring\hi\Ku\with a\breast response:	that
context: Ri\ri\ring\hi\Ku\with a\breast\that response:	Uproar
context: ri\ring\hi\Ku\with a\breast\that\Uproar response:	mu
context: ring\hi\Ku\with a\breast\that\Uproar\mu response:	Technique
context: hi\Ku\with a\breast\that\Uproar\mu\Technique response:	na
context: Ku\with a\breast\that\Uproar\mu\Technique\na response:	so
context: with a\breast\that\Uproar\mu\Technique\na\so response:	saddle
context: breast\that\Uproar\mu\Technique\na\so\saddle response:	Bright
context: that\Uproar\mu\Technique\na\so\saddle\Bright response:	wa
context: Uproar\mu\Technique\na\so\saddle\Bright\wa response:	day
context: mu\Technique\na\so\saddle\Bright\wa\day response:	give
context: Technique\na\so\saddle\Bright\wa\day\give response:	What
context: na\so\saddle\Bright\wa\day\give\What response:	of
context: so\saddle\Bright\wa\day\give\What\of response:	shi
context: saddle\Bright\wa\day\give\What\of\shi response:	ta
context: Bright\wa\day\give\What\of\shi\ta response:	he
context: wa\day\give\What\of\shi\ta\he response:	Towards tomorrow with our echoing excitement.
context: day\give\What\of\shi\ta\he\Towards tomorrow with our echoing excitement. response:	Sound
context: give\What\of\shi\ta\he\Towards tomorrow with our echoing excitement.\Sound response:	Na
context: What\of\shi\ta\he\Towards tomorrow with our echoing excitement.\Sound\Na response:	Sound
context: of\shi\ta\he\Towards tomorrow with our echoing excitement.\Sound\Na\Sound response:	Ri
context: shi\ta\he\Towards tomorrow with our echoing excitement.\Sound\Na\Sound\Ri response:	ri
context: ta\he\Towards tomorrow with our echoing excitement.\Sound\Na\Sound\Ri\ri response:	Ri
context: he\Towards tomorrow with our echoing excitement.\Sound\Na\Sound\Ri\ri\Ri response:	ring
context: Towards tomorrow with our echoing excitement.\Sound\Na\Sound\Ri\ri\Ri\ring response:	hi
context: Sound\Na\Sound\Ri\ri\Ri\ring\hi response:	with a
context: Na\Sound\Ri\ri\Ri\ring\hi\with a response:	ring
context: Sound\Ri\ri\Ri\ring\hi\with a\ring response:	Ku
context: Ri\ri\Ri\ring\hi\with a\ring\Ku response:	that
context: ri\Ri\ring\hi\with a\ring\Ku\that response:	Ku
context: Ri\ring\hi\with a\ring\Ku\that\Ku response:	breast
context: ring\hi\with a\ring\Ku\that\Ku\breast response:	in
context: hi\with a\ring\Ku\that\Ku\breast\in response:	mu
context: with a\ring\Ku\that\Ku\breast\in\mu response:	in
context: ring\Ku\that\Ku\breast\in\mu\in response:	na
context: Ku\that\Ku\breast\in\mu\in\na response:	breast
context: that\Ku\breast\in\mu\in\na\breast response:	Uproar
context: Ku\breast\in\mu\in\na\breast\Uproar response:	saddle
context: breast\in\mu\in\na\breast\Uproar\saddle response:	wa
context: in\mu\in\na\breast\Uproar\saddle\wa response:	Uproar
context: mu\in\na\breast\Uproar\saddle\wa\Uproar response:	Technique
context: in\na\breast\Uproar\saddle\wa\Uproar\Technique response:	give
context: na\breast\Uproar\saddle\wa\Uproar\Technique\give response:	Technique
context: breast\Uproar\saddle\wa\Uproar\Technique\give\Technique response:	so
context: Uproar\saddle\wa\Uproar\Technique\give\Technique\so response:	of
context: saddle\wa\Uproar\Technique\give\Technique\so\of response:	so
context: wa\Uproar\Technique\give\Technique\so\of\so response:	Bright
context: Uproar\Technique\give\Technique\so\of\so\Bright response:	shi
context: Technique\give\Technique\so\of\so\Bright\shi response:	Bright
context: give\Technique\so\of\so\Bright\shi\Bright response:	day
context: Technique\so\of\so\Bright\shi\Bright\day response:	ta
context: so\of\so\Bright\shi\Bright\day\ta response:	day
context: of\so\Bright\shi\Bright\day\ta\day response:	What
context: so\Bright\shi\Bright\day\ta\day\What response:	he
context: Bright\shi\Bright\day\ta\day\What\he response:	What
context: shi\Bright\day\ta\day\What\he\What response:	This Rvkvjv Mynvryh
context: Bright\day\ta\day\What\he\What\This Rvkvjv Mynvryh response:	This Yvsvyy Kngvyh
context: day\ta\day\What\he\What\This Rvkvjv Mynvryh\This Yvsvyy Kngvyh response:	I was elected as the new director of the Academy Tnby
context: ta\day\What\he\What\This Rvkvjv Mynvryh\This Yvsvyy Kngvyh\I was elected as the new director of the Academy Tnby response:	I rule! My servants
context: day\What\he\What\This Rvkvjv Mynvryh\This Yvsvyy Kngvyh\I was elected as the new director of the Academy Tnby\I rule! My servants response:	Demona: Next
context: What\he\What\This Rvkvjv Mynvryh\This Yvsvyy Kngvyh\I was elected as the new director of the Academy Tnby\I rule! My servants\Demona: Next response:	I got your wish come true.mykhvam
context: he\What\This Rvkvjv Mynvryh\This Yvsvyy Kngvyh\I was elected as the new director of the Academy Tnby\I rule! My servants\Demona: Next\I got your wish come true.mykhvam response:	Academy Harem
context: What\This Rvkvjv Mynvryh\This Yvsvyy Kngvyh\I was elected as the new director of the Academy Tnby\I rule! My servants\Demona: Next\I got your wish come true.mykhvam\Academy Harem response:	Translated by : end_boy
context: This Rvkvjv Mynvryh\This Yvsvyy Kngvyh\I was elected as the new director of the Academy Tnby\I rule! My servants\Demona: Next\I got your wish come true.mykhvam\Academy Harem\Translated by : end_boy response:	Forums.animworld.net
context: This Yvsvyy Kngvyh\I was elected as the new director of the Academy Tnby\I rule! My servants\Demona: Next\I got your wish come true.mykhvam\Academy Harem\Translated by : end_boy\Forums.animworld.net response:	Translated by : end_boy
context: I was elected as the new director of the Academy Tnby\I rule! My servants\Demona: Next\I got your wish come true.mykhvam\Academy Harem\Translated by : end_boy\Forums.animworld.net\Translated by : end_boy response:	Forums.animworld.net