context: Again, huh? response:	Episode 10 Slight Fever
context: Again, huh?\Episode 10 Slight Fever response:	I hear Ohana's been
context: Again, huh?\Episode 10 Slight Fever\I hear Ohana's been response:	getting up really early these past few days.
context: Again, huh?\Episode 10 Slight Fever\I hear Ohana's been\getting up really early these past few days. response:	Yeah, when I arrive in the morning,
context: Again, huh?\Episode 10 Slight Fever\I hear Ohana's been\getting up really early these past few days.\Yeah, when I arrive in the morning, response:	the entrance is already clean.
context: Again, huh?\Episode 10 Slight Fever\I hear Ohana's been\getting up really early these past few days.\Yeah, when I arrive in the morning,\the entrance is already clean. response:	She's taking the initiative to clean early every day, huh...
context: Again, huh?\Episode 10 Slight Fever\I hear Ohana's been\getting up really early these past few days.\Yeah, when I arrive in the morning,\the entrance is already clean.\She's taking the initiative to clean early every day, huh... response:	Yes.
context: Again, huh?\Episode 10 Slight Fever\I hear Ohana's been\getting up really early these past few days.\Yeah, when I arrive in the morning,\the entrance is already clean.\She's taking the initiative to clean early every day, huh...\Yes. response:	Even the duckboards, the window frames, and the wooden floors.
context: Episode 10 Slight Fever\I hear Ohana's been\getting up really early these past few days.\Yeah, when I arrive in the morning,\the entrance is already clean.\She's taking the initiative to clean early every day, huh...\Yes.\Even the duckboards, the window frames, and the wooden floors. response:	By herself?!
context: I hear Ohana's been\getting up really early these past few days.\Yeah, when I arrive in the morning,\the entrance is already clean.\She's taking the initiative to clean early every day, huh...\Yes.\Even the duckboards, the window frames, and the wooden floors.\By herself?! response:	Oh, and she cleans the front desk, too.
context: getting up really early these past few days.\Yeah, when I arrive in the morning,\the entrance is already clean.\She's taking the initiative to clean early every day, huh...\Yes.\Even the duckboards, the window frames, and the wooden floors.\By herself?!\Oh, and she cleans the front desk, too. response:	And you didn't stop her?
context: Yeah, when I arrive in the morning,\the entrance is already clean.\She's taking the initiative to clean early every day, huh...\Yes.\Even the duckboards, the window frames, and the wooden floors.\By herself?!\Oh, and she cleans the front desk, too.\And you didn't stop her? response:	I didn't want to take the fight out of her.
context: the entrance is already clean.\She's taking the initiative to clean early every day, huh...\Yes.\Even the duckboards, the window frames, and the wooden floors.\By herself?!\Oh, and she cleans the front desk, too.\And you didn't stop her?\I didn't want to take the fight out of her. response:	So, why was she collapsed on the hallway...?
context: She's taking the initiative to clean early every day, huh...\Yes.\Even the duckboards, the window frames, and the wooden floors.\By herself?!\Oh, and she cleans the front desk, too.\And you didn't stop her?\I didn't want to take the fight out of her.\So, why was she collapsed on the hallway...? response:	No idea.
context: Yes.\Even the duckboards, the window frames, and the wooden floors.\By herself?!\Oh, and she cleans the front desk, too.\And you didn't stop her?\I didn't want to take the fight out of her.\So, why was she collapsed on the hallway...?\No idea. response:	Umm...
context: Even the duckboards, the window frames, and the wooden floors.\By herself?!\Oh, and she cleans the front desk, too.\And you didn't stop her?\I didn't want to take the fight out of her.\So, why was she collapsed on the hallway...?\No idea.\Umm... response:	Anyway, let's let her rest for a while.
context: By herself?!\Oh, and she cleans the front desk, too.\And you didn't stop her?\I didn't want to take the fight out of her.\So, why was she collapsed on the hallway...?\No idea.\Umm...\Anyway, let's let her rest for a while. response:	Yeah.
context: Oh, and she cleans the front desk, too.\And you didn't stop her?\I didn't want to take the fight out of her.\So, why was she collapsed on the hallway...?\No idea.\Umm...\Anyway, let's let her rest for a while.\Yeah. response:	Okay.
context: And you didn't stop her?\I didn't want to take the fight out of her.\So, why was she collapsed on the hallway...?\No idea.\Umm...\Anyway, let's let her rest for a while.\Yeah.\Okay. response:	How was she?
context: I didn't want to take the fight out of her.\So, why was she collapsed on the hallway...?\No idea.\Umm...\Anyway, let's let her rest for a while.\Yeah.\Okay.\How was she? response:	She was asleep.
context: So, why was she collapsed on the hallway...?\No idea.\Umm...\Anyway, let's let her rest for a while.\Yeah.\Okay.\How was she?\She was asleep. response:	Has her fever gone down?
context: No idea.\Umm...\Anyway, let's let her rest for a while.\Yeah.\Okay.\How was she?\She was asleep.\Has her fever gone down? response:	The doctor said that her fever
context: Umm...\Anyway, let's let her rest for a while.\Yeah.\Okay.\How was she?\She was asleep.\Has her fever gone down?\The doctor said that her fever response:	might stay a bit for the rest of the day.
context: Anyway, let's let her rest for a while.\Yeah.\Okay.\How was she?\She was asleep.\Has her fever gone down?\The doctor said that her fever\might stay a bit for the rest of the day. response:	Oh...
context: Yeah.\Okay.\How was she?\She was asleep.\Has her fever gone down?\The doctor said that her fever\might stay a bit for the rest of the day.\Oh... response:	But apparently, after she rests for the entire day,
context: Okay.\How was she?\She was asleep.\Has her fever gone down?\The doctor said that her fever\might stay a bit for the rest of the day.\Oh...\But apparently, after she rests for the entire day, response:	she should be able to work tomorrow.
context: How was she?\She was asleep.\Has her fever gone down?\The doctor said that her fever\might stay a bit for the rest of the day.\Oh...\But apparently, after she rests for the entire day,\she should be able to work tomorrow. response:	Oh...
context: She was asleep.\Has her fever gone down?\The doctor said that her fever\might stay a bit for the rest of the day.\Oh...\But apparently, after she rests for the entire day,\she should be able to work tomorrow.\Oh... response:	She was just overworked, he says.
context: Has her fever gone down?\The doctor said that her fever\might stay a bit for the rest of the day.\Oh...\But apparently, after she rests for the entire day,\she should be able to work tomorrow.\Oh...\She was just overworked, he says. response:	Oh...
context: The doctor said that her fever\might stay a bit for the rest of the day.\Oh...\But apparently, after she rests for the entire day,\she should be able to work tomorrow.\Oh...\She was just overworked, he says.\Oh... response:	She's been working really hard lately.
context: might stay a bit for the rest of the day.\Oh...\But apparently, after she rests for the entire day,\she should be able to work tomorrow.\Oh...\She was just overworked, he says.\Oh...\She's been working really hard lately. response:	Perhaps I should cook something for her.
context: Oh...\But apparently, after she rests for the entire day,\she should be able to work tomorrow.\Oh...\She was just overworked, he says.\Oh...\She's been working really hard lately.\Perhaps I should cook something for her. response:	Minko, have Tohru teach you more about broiling.
context: But apparently, after she rests for the entire day,\she should be able to work tomorrow.\Oh...\She was just overworked, he says.\Oh...\She's been working really hard lately.\Perhaps I should cook something for her.\Minko, have Tohru teach you more about broiling. response:	Okay!
context: she should be able to work tomorrow.\Oh...\She was just overworked, he says.\Oh...\She's been working really hard lately.\Perhaps I should cook something for her.\Minko, have Tohru teach you more about broiling.\Okay! response:	Rice porridge, maybe?
context: Oh...\She was just overworked, he says.\Oh...\She's been working really hard lately.\Perhaps I should cook something for her.\Minko, have Tohru teach you more about broiling.\Okay!\Rice porridge, maybe? response:	Here.
context: She was just overworked, he says.\Oh...\She's been working really hard lately.\Perhaps I should cook something for her.\Minko, have Tohru teach you more about broiling.\Okay!\Rice porridge, maybe?\Here. response:	Give it back!
context: Oh...\She's been working really hard lately.\Perhaps I should cook something for her.\Minko, have Tohru teach you more about broiling.\Okay!\Rice porridge, maybe?\Here.\Give it back! response:	Try and get it back.
context: She's been working really hard lately.\Perhaps I should cook something for her.\Minko, have Tohru teach you more about broiling.\Okay!\Rice porridge, maybe?\Here.\Give it back!\Try and get it back. response:	How about something like this?
context: Perhaps I should cook something for her.\Minko, have Tohru teach you more about broiling.\Okay!\Rice porridge, maybe?\Here.\Give it back!\Try and get it back.\How about something like this? response:	What?!
context: Minko, have Tohru teach you more about broiling.\Okay!\Rice porridge, maybe?\Here.\Give it back!\Try and get it back.\How about something like this?\What?! response:	First, the Madam Manager, and now, one of the waitresses?!
context: Okay!\Rice porridge, maybe?\Here.\Give it back!\Try and get it back.\How about something like this?\What?!\First, the Madam Manager, and now, one of the waitresses?! response:	What's wrong with this inn?!
context: Rice porridge, maybe?\Here.\Give it back!\Try and get it back.\How about something like this?\What?!\First, the Madam Manager, and now, one of the waitresses?!\What's wrong with this inn?! response:	Listen, Saturday is an important day for the Kissuiso!
context: Here.\Give it back!\Try and get it back.\How about something like this?\What?!\First, the Madam Manager, and now, one of the waitresses?!\What's wrong with this inn?!\Listen, Saturday is an important day for the Kissuiso! response:	Taking care of your own body is a part of being a professional!
context: Give it back!\Try and get it back.\How about something like this?\What?!\First, the Madam Manager, and now, one of the waitresses?!\What's wrong with this inn?!\Listen, Saturday is an important day for the Kissuiso!\Taking care of your own body is a part of being a professional! response:	Well, umm...
context: Try and get it back.\How about something like this?\What?!\First, the Madam Manager, and now, one of the waitresses?!\What's wrong with this inn?!\Listen, Saturday is an important day for the Kissuiso!\Taking care of your own body is a part of being a professional!\Well, umm... response:	Yes?
context: How about something like this?\What?!\First, the Madam Manager, and now, one of the waitresses?!\What's wrong with this inn?!\Listen, Saturday is an important day for the Kissuiso!\Taking care of your own body is a part of being a professional!\Well, umm...\Yes? response:	Ohana was working hard for the sake of Kissuiso...
context: What?!\First, the Madam Manager, and now, one of the waitresses?!\What's wrong with this inn?!\Listen, Saturday is an important day for the Kissuiso!\Taking care of your own body is a part of being a professional!\Well, umm...\Yes?\Ohana was working hard for the sake of Kissuiso... response:	What?
context: First, the Madam Manager, and now, one of the waitresses?!\What's wrong with this inn?!\Listen, Saturday is an important day for the Kissuiso!\Taking care of your own body is a part of being a professional!\Well, umm...\Yes?\Ohana was working hard for the sake of Kissuiso...\What? response:	Even though this inn is small,
context: What's wrong with this inn?!\Listen, Saturday is an important day for the Kissuiso!\Taking care of your own body is a part of being a professional!\Well, umm...\Yes?\Ohana was working hard for the sake of Kissuiso...\What?\Even though this inn is small, response:	you need to put effort into risk management-
context: Listen, Saturday is an important day for the Kissuiso!\Taking care of your own body is a part of being a professional!\Well, umm...\Yes?\Ohana was working hard for the sake of Kissuiso...\What?\Even though this inn is small,\you need to put effort into risk management- response:	Right, risk management.
context: Taking care of your own body is a part of being a professional!\Well, umm...\Yes?\Ohana was working hard for the sake of Kissuiso...\What?\Even though this inn is small,\you need to put effort into risk management-\Right, risk management. response:	Risk management is a very important skill.
context: Well, umm...\Yes?\Ohana was working hard for the sake of Kissuiso...\What?\Even though this inn is small,\you need to put effort into risk management-\Right, risk management.\Risk management is a very important skill. response:	Thankfully, the Madam Manager was ill the other day,
context: Yes?\Ohana was working hard for the sake of Kissuiso...\What?\Even though this inn is small,\you need to put effort into risk management-\Right, risk management.\Risk management is a very important skill.\Thankfully, the Madam Manager was ill the other day, response:	which led to a good experi-
context: Ohana was working hard for the sake of Kissuiso...\What?\Even though this inn is small,\you need to put effort into risk management-\Right, risk management.\Risk management is a very important skill.\Thankfully, the Madam Manager was ill the other day,\which led to a good experi- response:	I mean, a very unfortunate event.
context: What?\Even though this inn is small,\you need to put effort into risk management-\Right, risk management.\Risk management is a very important skill.\Thankfully, the Madam Manager was ill the other day,\which led to a good experi-\I mean, a very unfortunate event. response:	So even you have something
context: Even though this inn is small,\you need to put effort into risk management-\Right, risk management.\Risk management is a very important skill.\Thankfully, the Madam Manager was ill the other day,\which led to a good experi-\I mean, a very unfortunate event.\So even you have something response:	good to say every once in a while, Miss Kawajiri.
context: you need to put effort into risk management-\Right, risk management.\Risk management is a very important skill.\Thankfully, the Madam Manager was ill the other day,\which led to a good experi-\I mean, a very unfortunate event.\So even you have something\good to say every once in a while, Miss Kawajiri. response:	So you were listening, Mom?
context: Right, risk management.\Risk management is a very important skill.\Thankfully, the Madam Manager was ill the other day,\which led to a good experi-\I mean, a very unfortunate event.\So even you have something\good to say every once in a while, Miss Kawajiri.\So you were listening, Mom? response:	Madam Manager.
context: Risk management is a very important skill.\Thankfully, the Madam Manager was ill the other day,\which led to a good experi-\I mean, a very unfortunate event.\So even you have something\good to say every once in a while, Miss Kawajiri.\So you were listening, Mom?\Madam Manager. response:	I have no hidden agenda.
context: Thankfully, the Madam Manager was ill the other day,\which led to a good experi-\I mean, a very unfortunate event.\So even you have something\good to say every once in a while, Miss Kawajiri.\So you were listening, Mom?\Madam Manager.\I have no hidden agenda. response:	That's right.
context: which led to a good experi-\I mean, a very unfortunate event.\So even you have something\good to say every once in a while, Miss Kawajiri.\So you were listening, Mom?\Madam Manager.\I have no hidden agenda.\That's right. response:	We shouldn't let what we learned the
context: I mean, a very unfortunate event.\So even you have something\good to say every once in a while, Miss Kawajiri.\So you were listening, Mom?\Madam Manager.\I have no hidden agenda.\That's right.\We shouldn't let what we learned the response:	other day go to waste.
context: So even you have something\good to say every once in a while, Miss Kawajiri.\So you were listening, Mom?\Madam Manager.\I have no hidden agenda.\That's right.\We shouldn't let what we learned the\other day go to waste. response:	What we learned the other day?
context: good to say every once in a while, Miss Kawajiri.\So you were listening, Mom?\Madam Manager.\I have no hidden agenda.\That's right.\We shouldn't let what we learned the\other day go to waste.\What we learned the other day? response:	To do your job accurately.
context: So you were listening, Mom?\Madam Manager.\I have no hidden agenda.\That's right.\We shouldn't let what we learned the\other day go to waste.\What we learned the other day?\To do your job accurately. response:	Oh.
context: Madam Manager.\I have no hidden agenda.\That's right.\We shouldn't let what we learned the\other day go to waste.\What we learned the other day?\To do your job accurately.\Oh. response:	Yup.
context: I have no hidden agenda.\That's right.\We shouldn't let what we learned the\other day go to waste.\What we learned the other day?\To do your job accurately.\Oh.\Yup. response:	Serial TV Drama The Hotel King
context: That's right.\We shouldn't let what we learned the\other day go to waste.\What we learned the other day?\To do your job accurately.\Oh.\Yup.\Serial TV Drama The Hotel King response:	That's for the Moon Room, right?
context: We shouldn't let what we learned the\other day go to waste.\What we learned the other day?\To do your job accurately.\Oh.\Yup.\Serial TV Drama The Hotel King\That's for the Moon Room, right? response:	Could you bring two bottles
context: other day go to waste.\What we learned the other day?\To do your job accurately.\Oh.\Yup.\Serial TV Drama The Hotel King\That's for the Moon Room, right?\Could you bring two bottles response:	of oolong tea and two cups to the Wave Room?
context: What we learned the other day?\To do your job accurately.\Oh.\Yup.\Serial TV Drama The Hotel King\That's for the Moon Room, right?\Could you bring two bottles\of oolong tea and two cups to the Wave Room? response:	Even though it's your first time doing it yourself,
context: To do your job accurately.\Oh.\Yup.\Serial TV Drama The Hotel King\That's for the Moon Room, right?\Could you bring two bottles\of oolong tea and two cups to the Wave Room?\Even though it's your first time doing it yourself, response:	you've watched me broil fish before, right?
context: Oh.\Yup.\Serial TV Drama The Hotel King\That's for the Moon Room, right?\Could you bring two bottles\of oolong tea and two cups to the Wave Room?\Even though it's your first time doing it yourself,\you've watched me broil fish before, right? response:	Yes.
context: Yup.\Serial TV Drama The Hotel King\That's for the Moon Room, right?\Could you bring two bottles\of oolong tea and two cups to the Wave Room?\Even though it's your first time doing it yourself,\you've watched me broil fish before, right?\Yes. response:	Then go for it.
context: Serial TV Drama The Hotel King\That's for the Moon Room, right?\Could you bring two bottles\of oolong tea and two cups to the Wave Room?\Even though it's your first time doing it yourself,\you've watched me broil fish before, right?\Yes.\Then go for it. response:	Yes.
context: That's for the Moon Room, right?\Could you bring two bottles\of oolong tea and two cups to the Wave Room?\Even though it's your first time doing it yourself,\you've watched me broil fish before, right?\Yes.\Then go for it.\Yes. response:	Yo.
context: Could you bring two bottles\of oolong tea and two cups to the Wave Room?\Even though it's your first time doing it yourself,\you've watched me broil fish before, right?\Yes.\Then go for it.\Yes.\Yo. response:	The customers in the
context: of oolong tea and two cups to the Wave Room?\Even though it's your first time doing it yourself,\you've watched me broil fish before, right?\Yes.\Then go for it.\Yes.\Yo.\The customers in the response:	Camellia Room don't need chicken, right?
context: Even though it's your first time doing it yourself,\you've watched me broil fish before, right?\Yes.\Then go for it.\Yes.\Yo.\The customers in the\Camellia Room don't need chicken, right? response:	Yup, that's right.
context: you've watched me broil fish before, right?\Yes.\Then go for it.\Yes.\Yo.\The customers in the\Camellia Room don't need chicken, right?\Yup, that's right. response:	Hey, we don't need that much fire!
context: Yes.\Then go for it.\Yes.\Yo.\The customers in the\Camellia Room don't need chicken, right?\Yup, that's right.\Hey, we don't need that much fire! response:	I'm sorry.
context: Then go for it.\Yes.\Yo.\The customers in the\Camellia Room don't need chicken, right?\Yup, that's right.\Hey, we don't need that much fire!\I'm sorry. response:	This is how it's done.
context: Yes.\Yo.\The customers in the\Camellia Room don't need chicken, right?\Yup, that's right.\Hey, we don't need that much fire!\I'm sorry.\This is how it's done. response:	Demon Disturbance?
context: Yo.\The customers in the\Camellia Room don't need chicken, right?\Yup, that's right.\Hey, we don't need that much fire!\I'm sorry.\This is how it's done.\Demon Disturbance? response:	What?
context: The customers in the\Camellia Room don't need chicken, right?\Yup, that's right.\Hey, we don't need that much fire!\I'm sorry.\This is how it's done.\Demon Disturbance?\What? response:	Nothing.
context: Camellia Room don't need chicken, right?\Yup, that's right.\Hey, we don't need that much fire!\I'm sorry.\This is how it's done.\Demon Disturbance?\What?\Nothing. response:	I'm glad you're feeling better.
context: Yup, that's right.\Hey, we don't need that much fire!\I'm sorry.\This is how it's done.\Demon Disturbance?\What?\Nothing.\I'm glad you're feeling better. response:	Anyway, I'm sorry to ask you of this
context: Hey, we don't need that much fire!\I'm sorry.\This is how it's done.\Demon Disturbance?\What?\Nothing.\I'm glad you're feeling better.\Anyway, I'm sorry to ask you of this response:	when you're still a bit sick,
context: I'm sorry.\This is how it's done.\Demon Disturbance?\What?\Nothing.\I'm glad you're feeling better.\Anyway, I'm sorry to ask you of this\when you're still a bit sick, response:	but I was hoping you might be willing to listen to my new work.
context: This is how it's done.\Demon Disturbance?\What?\Nothing.\I'm glad you're feeling better.\Anyway, I'm sorry to ask you of this\when you're still a bit sick,\but I was hoping you might be willing to listen to my new work. response:	Did you know that there's a theory that
context: Demon Disturbance?\What?\Nothing.\I'm glad you're feeling better.\Anyway, I'm sorry to ask you of this\when you're still a bit sick,\but I was hoping you might be willing to listen to my new work.\Did you know that there's a theory that response:	hearing sexual words
context: What?\Nothing.\I'm glad you're feeling better.\Anyway, I'm sorry to ask you of this\when you're still a bit sick,\but I was hoping you might be willing to listen to my new work.\Did you know that there's a theory that\hearing sexual words response:	invigorates your brain and makes you livelier?
context: Nothing.\I'm glad you're feeling better.\Anyway, I'm sorry to ask you of this\when you're still a bit sick,\but I was hoping you might be willing to listen to my new work.\Did you know that there's a theory that\hearing sexual words\invigorates your brain and makes you livelier? response:	Okay, here we go.
context: I'm glad you're feeling better.\Anyway, I'm sorry to ask you of this\when you're still a bit sick,\but I was hoping you might be willing to listen to my new work.\Did you know that there's a theory that\hearing sexual words\invigorates your brain and makes you livelier?\Okay, here we go. response:	The Wet Madam Manager at the Gambling Den.
context: Anyway, I'm sorry to ask you of this\when you're still a bit sick,\but I was hoping you might be willing to listen to my new work.\Did you know that there's a theory that\hearing sexual words\invigorates your brain and makes you livelier?\Okay, here we go.\The Wet Madam Manager at the Gambling Den. response:	This is how it begins, but...
context: when you're still a bit sick,\but I was hoping you might be willing to listen to my new work.\Did you know that there's a theory that\hearing sexual words\invigorates your brain and makes you livelier?\Okay, here we go.\The Wet Madam Manager at the Gambling Den.\This is how it begins, but... response:	Is this supposed to be a get-well visit
context: but I was hoping you might be willing to listen to my new work.\Did you know that there's a theory that\hearing sexual words\invigorates your brain and makes you livelier?\Okay, here we go.\The Wet Madam Manager at the Gambling Den.\This is how it begins, but...\Is this supposed to be a get-well visit response:	to a sick person's room, Mr. Jiromaru?
context: Did you know that there's a theory that\hearing sexual words\invigorates your brain and makes you livelier?\Okay, here we go.\The Wet Madam Manager at the Gambling Den.\This is how it begins, but...\Is this supposed to be a get-well visit\to a sick person's room, Mr. Jiromaru? response:	The red lanterns reflect upon the lustrous canal.
context: hearing sexual words\invigorates your brain and makes you livelier?\Okay, here we go.\The Wet Madam Manager at the Gambling Den.\This is how it begins, but...\Is this supposed to be a get-well visit\to a sick person's room, Mr. Jiromaru?\The red lanterns reflect upon the lustrous canal. response:	On the back of the woman who held
context: invigorates your brain and makes you livelier?\Okay, here we go.\The Wet Madam Manager at the Gambling Den.\This is how it begins, but...\Is this supposed to be a get-well visit\to a sick person's room, Mr. Jiromaru?\The red lanterns reflect upon the lustrous canal.\On the back of the woman who held response:	two dice and a jar in her hand
context: Okay, here we go.\The Wet Madam Manager at the Gambling Den.\This is how it begins, but...\Is this supposed to be a get-well visit\to a sick person's room, Mr. Jiromaru?\The red lanterns reflect upon the lustrous canal.\On the back of the woman who held\two dice and a jar in her hand response:	were two more dice. Snake eyes.
context: The Wet Madam Manager at the Gambling Den.\This is how it begins, but...\Is this supposed to be a get-well visit\to a sick person's room, Mr. Jiromaru?\The red lanterns reflect upon the lustrous canal.\On the back of the woman who held\two dice and a jar in her hand\were two more dice. Snake eyes. response:	The shades and stray hair that go
context: This is how it begins, but...\Is this supposed to be a get-well visit\to a sick person's room, Mr. Jiromaru?\The red lanterns reflect upon the lustrous canal.\On the back of the woman who held\two dice and a jar in her hand\were two more dice. Snake eyes.\The shades and stray hair that go response:	from those pink shoulders to her nape.
context: Is this supposed to be a get-well visit\to a sick person's room, Mr. Jiromaru?\The red lanterns reflect upon the lustrous canal.\On the back of the woman who held\two dice and a jar in her hand\were two more dice. Snake eyes.\The shades and stray hair that go\from those pink shoulders to her nape. response:	The portion between the bottom of her kimono
context: to a sick person's room, Mr. Jiromaru?\The red lanterns reflect upon the lustrous canal.\On the back of the woman who held\two dice and a jar in her hand\were two more dice. Snake eyes.\The shades and stray hair that go\from those pink shoulders to her nape.\The portion between the bottom of her kimono response:	and her white socks caught the attention of the men.
context: The red lanterns reflect upon the lustrous canal.\On the back of the woman who held\two dice and a jar in her hand\were two more dice. Snake eyes.\The shades and stray hair that go\from those pink shoulders to her nape.\The portion between the bottom of her kimono\and her white socks caught the attention of the men. response:	Excuse me...
context: On the back of the woman who held\two dice and a jar in her hand\were two more dice. Snake eyes.\The shades and stray hair that go\from those pink shoulders to her nape.\The portion between the bottom of her kimono\and her white socks caught the attention of the men.\Excuse me... response:	Is the Madam Manager supposed to be the model for this?
context: two dice and a jar in her hand\were two more dice. Snake eyes.\The shades and stray hair that go\from those pink shoulders to her nape.\The portion between the bottom of her kimono\and her white socks caught the attention of the men.\Excuse me...\Is the Madam Manager supposed to be the model for this? response:	Crane Room... sandwich... with ham...
context: were two more dice. Snake eyes.\The shades and stray hair that go\from those pink shoulders to her nape.\The portion between the bottom of her kimono\and her white socks caught the attention of the men.\Excuse me...\Is the Madam Manager supposed to be the model for this?\Crane Room... sandwich... with ham... response:	Yes...?
context: The shades and stray hair that go\from those pink shoulders to her nape.\The portion between the bottom of her kimono\and her white socks caught the attention of the men.\Excuse me...\Is the Madam Manager supposed to be the model for this?\Crane Room... sandwich... with ham...\Yes...? response:	Oh, you can get up now?
context: from those pink shoulders to her nape.\The portion between the bottom of her kimono\and her white socks caught the attention of the men.\Excuse me...\Is the Madam Manager supposed to be the model for this?\Crane Room... sandwich... with ham...\Yes...?\Oh, you can get up now? response:	Making me cook food for sick people...
context: The portion between the bottom of her kimono\and her white socks caught the attention of the men.\Excuse me...\Is the Madam Manager supposed to be the model for this?\Crane Room... sandwich... with ham...\Yes...?\Oh, you can get up now?\Making me cook food for sick people... response:	It might still be hot, so be careful.
context: and her white socks caught the attention of the men.\Excuse me...\Is the Madam Manager supposed to be the model for this?\Crane Room... sandwich... with ham...\Yes...?\Oh, you can get up now?\Making me cook food for sick people...\It might still be hot, so be careful. response:	It's delicious...
context: Excuse me...\Is the Madam Manager supposed to be the model for this?\Crane Room... sandwich... with ham...\Yes...?\Oh, you can get up now?\Making me cook food for sick people...\It might still be hot, so be careful.\It's delicious... response:	Of course it is.
context: Is the Madam Manager supposed to be the model for this?\Crane Room... sandwich... with ham...\Yes...?\Oh, you can get up now?\Making me cook food for sick people...\It might still be hot, so be careful.\It's delicious...\Of course it is. response:	There's no other sick person food in
context: Crane Room... sandwich... with ham...\Yes...?\Oh, you can get up now?\Making me cook food for sick people...\It might still be hot, so be careful.\It's delicious...\Of course it is.\There's no other sick person food in response:	the world with such good broth.
context: Yes...?\Oh, you can get up now?\Making me cook food for sick people...\It might still be hot, so be careful.\It's delicious...\Of course it is.\There's no other sick person food in\the world with such good broth. response:	Yeah.
context: Oh, you can get up now?\Making me cook food for sick people...\It might still be hot, so be careful.\It's delicious...\Of course it is.\There's no other sick person food in\the world with such good broth.\Yeah. response:	Wow, strawberries...
context: Making me cook food for sick people...\It might still be hot, so be careful.\It's delicious...\Of course it is.\There's no other sick person food in\the world with such good broth.\Yeah.\Wow, strawberries... response:	Oh, those are from Minko.
context: It might still be hot, so be careful.\It's delicious...\Of course it is.\There's no other sick person food in\the world with such good broth.\Yeah.\Wow, strawberries...\Oh, those are from Minko. response:	You've still got a fever, right?
context: It's delicious...\Of course it is.\There's no other sick person food in\the world with such good broth.\Yeah.\Wow, strawberries...\Oh, those are from Minko.\You've still got a fever, right? response:	Let me feel your forehead.
context: Of course it is.\There's no other sick person food in\the world with such good broth.\Yeah.\Wow, strawberries...\Oh, those are from Minko.\You've still got a fever, right?\Let me feel your forehead. response:	I-I'm not really sure.
context: There's no other sick person food in\the world with such good broth.\Yeah.\Wow, strawberries...\Oh, those are from Minko.\You've still got a fever, right?\Let me feel your forehead.\I-I'm not really sure. response:	Maybe I'm also a bit feverish.
context: the world with such good broth.\Yeah.\Wow, strawberries...\Oh, those are from Minko.\You've still got a fever, right?\Let me feel your forehead.\I-I'm not really sure.\Maybe I'm also a bit feverish. response:	I added ham for the sandwiches for the Crane Room.
context: Yeah.\Wow, strawberries...\Oh, those are from Minko.\You've still got a fever, right?\Let me feel your forehead.\I-I'm not really sure.\Maybe I'm also a bit feverish.\I added ham for the sandwiches for the Crane Room. response:	That's what you'd asked for, right?
context: Wow, strawberries...\Oh, those are from Minko.\You've still got a fever, right?\Let me feel your forehead.\I-I'm not really sure.\Maybe I'm also a bit feverish.\I added ham for the sandwiches for the Crane Room.\That's what you'd asked for, right? response:	Oh well.
context: Oh, those are from Minko.\You've still got a fever, right?\Let me feel your forehead.\I-I'm not really sure.\Maybe I'm also a bit feverish.\I added ham for the sandwiches for the Crane Room.\That's what you'd asked for, right?\Oh well. response:	You're okay now, Ohana?!
context: You've still got a fever, right?\Let me feel your forehead.\I-I'm not really sure.\Maybe I'm also a bit feverish.\I added ham for the sandwiches for the Crane Room.\That's what you'd asked for, right?\Oh well.\You're okay now, Ohana?! response:	Nakochi.
context: Let me feel your forehead.\I-I'm not really sure.\Maybe I'm also a bit feverish.\I added ham for the sandwiches for the Crane Room.\That's what you'd asked for, right?\Oh well.\You're okay now, Ohana?!\Nakochi. response:	Well, I need to be getting to work.
context: I-I'm not really sure.\Maybe I'm also a bit feverish.\I added ham for the sandwiches for the Crane Room.\That's what you'd asked for, right?\Oh well.\You're okay now, Ohana?!\Nakochi.\Well, I need to be getting to work. response:	Sick people don't need to think of such things!
context: Maybe I'm also a bit feverish.\I added ham for the sandwiches for the Crane Room.\That's what you'd asked for, right?\Oh well.\You're okay now, Ohana?!\Nakochi.\Well, I need to be getting to work.\Sick people don't need to think of such things! response:	What?
context: I added ham for the sandwiches for the Crane Room.\That's what you'd asked for, right?\Oh well.\You're okay now, Ohana?!\Nakochi.\Well, I need to be getting to work.\Sick people don't need to think of such things!\What? response:	What do you mean, what?
context: That's what you'd asked for, right?\Oh well.\You're okay now, Ohana?!\Nakochi.\Well, I need to be getting to work.\Sick people don't need to think of such things!\What?\What do you mean, what? response:	See?
context: Oh well.\You're okay now, Ohana?!\Nakochi.\Well, I need to be getting to work.\Sick people don't need to think of such things!\What?\What do you mean, what?\See? response:	You're still not well enough to work.
context: You're okay now, Ohana?!\Nakochi.\Well, I need to be getting to work.\Sick people don't need to think of such things!\What?\What do you mean, what?\See?\You're still not well enough to work. response:	You need to sleep.
context: Nakochi.\Well, I need to be getting to work.\Sick people don't need to think of such things!\What?\What do you mean, what?\See?\You're still not well enough to work.\You need to sleep. response:	It's cold and good.
context: Well, I need to be getting to work.\Sick people don't need to think of such things!\What?\What do you mean, what?\See?\You're still not well enough to work.\You need to sleep.\It's cold and good. response:	Right?
context: Sick people don't need to think of such things!\What?\What do you mean, what?\See?\You're still not well enough to work.\You need to sleep.\It's cold and good.\Right? response:	This is what we always feed my brothers
context: What?\What do you mean, what?\See?\You're still not well enough to work.\You need to sleep.\It's cold and good.\Right?\This is what we always feed my brothers response:	whenever they have a fever.
context: What do you mean, what?\See?\You're still not well enough to work.\You need to sleep.\It's cold and good.\Right?\This is what we always feed my brothers\whenever they have a fever. response:	The younger one
context: See?\You're still not well enough to work.\You need to sleep.\It's cold and good.\Right?\This is what we always feed my brothers\whenever they have a fever.\The younger one response:	catches colds on purpose just to eat this.
context: You're still not well enough to work.\You need to sleep.\It's cold and good.\Right?\This is what we always feed my brothers\whenever they have a fever.\The younger one\catches colds on purpose just to eat this. response:	Nakochi.
context: You need to sleep.\It's cold and good.\Right?\This is what we always feed my brothers\whenever they have a fever.\The younger one\catches colds on purpose just to eat this.\Nakochi. response:	You're like an older sister.
context: It's cold and good.\Right?\This is what we always feed my brothers\whenever they have a fever.\The younger one\catches colds on purpose just to eat this.\Nakochi.\You're like an older sister. response:	I really am an older sister.
context: Right?\This is what we always feed my brothers\whenever they have a fever.\The younger one\catches colds on purpose just to eat this.\Nakochi.\You're like an older sister.\I really am an older sister. response:	I need to be working, too.
context: This is what we always feed my brothers\whenever they have a fever.\The younger one\catches colds on purpose just to eat this.\Nakochi.\You're like an older sister.\I really am an older sister.\I need to be working, too. response:	It's fine.
context: whenever they have a fever.\The younger one\catches colds on purpose just to eat this.\Nakochi.\You're like an older sister.\I really am an older sister.\I need to be working, too.\It's fine. response:	We're doing fine without you.
context: The younger one\catches colds on purpose just to eat this.\Nakochi.\You're like an older sister.\I really am an older sister.\I need to be working, too.\It's fine.\We're doing fine without you. response:	Tomoe and I ran everything together
context: catches colds on purpose just to eat this.\Nakochi.\You're like an older sister.\I really am an older sister.\I need to be working, too.\It's fine.\We're doing fine without you.\Tomoe and I ran everything together response:	before you came here, remember?
context: Nakochi.\You're like an older sister.\I really am an older sister.\I need to be working, too.\It's fine.\We're doing fine without you.\Tomoe and I ran everything together\before you came here, remember? response:	Get well soon, okay?
context: You're like an older sister.\I really am an older sister.\I need to be working, too.\It's fine.\We're doing fine without you.\Tomoe and I ran everything together\before you came here, remember?\Get well soon, okay? response:	I'll stop by later to check up on you.
context: I really am an older sister.\I need to be working, too.\It's fine.\We're doing fine without you.\Tomoe and I ran everything together\before you came here, remember?\Get well soon, okay?\I'll stop by later to check up on you. response:	The Kissuiso can run without me?
context: I need to be working, too.\It's fine.\We're doing fine without you.\Tomoe and I ran everything together\before you came here, remember?\Get well soon, okay?\I'll stop by later to check up on you.\The Kissuiso can run without me? response:	How many times have
context: It's fine.\We're doing fine without you.\Tomoe and I ran everything together\before you came here, remember?\Get well soon, okay?\I'll stop by later to check up on you.\The Kissuiso can run without me?\How many times have response:	I been escorted back to my bed today...
context: We're doing fine without you.\Tomoe and I ran everything together\before you came here, remember?\Get well soon, okay?\I'll stop by later to check up on you.\The Kissuiso can run without me?\How many times have\I been escorted back to my bed today... response:	You should get
context: Tomoe and I ran everything together\before you came here, remember?\Get well soon, okay?\I'll stop by later to check up on you.\The Kissuiso can run without me?\How many times have\I been escorted back to my bed today...\You should get response:	the hint that we want you to rest, then.
context: before you came here, remember?\Get well soon, okay?\I'll stop by later to check up on you.\The Kissuiso can run without me?\How many times have\I been escorted back to my bed today...\You should get\the hint that we want you to rest, then. response:	Her nape...
context: Get well soon, okay?\I'll stop by later to check up on you.\The Kissuiso can run without me?\How many times have\I been escorted back to my bed today...\You should get\the hint that we want you to rest, then.\Her nape... response:	her stray hair...
context: I'll stop by later to check up on you.\The Kissuiso can run without me?\How many times have\I been escorted back to my bed today...\You should get\the hint that we want you to rest, then.\Her nape...\her stray hair... response:	What was the other one?
context: The Kissuiso can run without me?\How many times have\I been escorted back to my bed today...\You should get\the hint that we want you to rest, then.\Her nape...\her stray hair...\What was the other one? response:	The portion between her skirt and her socks?
context: How many times have\I been escorted back to my bed today...\You should get\the hint that we want you to rest, then.\Her nape...\her stray hair...\What was the other one?\The portion between her skirt and her socks? response:	Ko...
context: I been escorted back to my bed today...\You should get\the hint that we want you to rest, then.\Her nape...\her stray hair...\What was the other one?\The portion between her skirt and her socks?\Ko... response:	Come home, Ohana.
context: You should get\the hint that we want you to rest, then.\Her nape...\her stray hair...\What was the other one?\The portion between her skirt and her socks?\Ko...\Come home, Ohana. response:	The Kissuiso will be fine without you.
context: the hint that we want you to rest, then.\Her nape...\her stray hair...\What was the other one?\The portion between her skirt and her socks?\Ko...\Come home, Ohana.\The Kissuiso will be fine without you. response:	Ko...
context: Her nape...\her stray hair...\What was the other one?\The portion between her skirt and her socks?\Ko...\Come home, Ohana.\The Kissuiso will be fine without you.\Ko... response:	Send Text To: Ko Ko. Ko, I think I'm going to
context: her stray hair...\What was the other one?\The portion between her skirt and her socks?\Ko...\Come home, Ohana.\The Kissuiso will be fine without you.\Ko...\Send Text To: Ko Ko. Ko, I think I'm going to response:	Rice porridge with broth, huh?
context: What was the other one?\The portion between her skirt and her socks?\Ko...\Come home, Ohana.\The Kissuiso will be fine without you.\Ko...\Send Text To: Ko Ko. Ko, I think I'm going to\Rice porridge with broth, huh? response:	Minko, you still have the fish bones you separated this morning?
context: The portion between her skirt and her socks?\Ko...\Come home, Ohana.\The Kissuiso will be fine without you.\Ko...\Send Text To: Ko Ko. Ko, I think I'm going to\Rice porridge with broth, huh?\Minko, you still have the fish bones you separated this morning? response:	Yes.
context: Ko...\Come home, Ohana.\The Kissuiso will be fine without you.\Ko...\Send Text To: Ko Ko. Ko, I think I'm going to\Rice porridge with broth, huh?\Minko, you still have the fish bones you separated this morning?\Yes. response:	She looked like she was really enjoying the rice porridge,
context: Come home, Ohana.\The Kissuiso will be fine without you.\Ko...\Send Text To: Ko Ko. Ko, I think I'm going to\Rice porridge with broth, huh?\Minko, you still have the fish bones you separated this morning?\Yes.\She looked like she was really enjoying the rice porridge, response:	so I figured we might be able to serve it to the customers.
context: The Kissuiso will be fine without you.\Ko...\Send Text To: Ko Ko. Ko, I think I'm going to\Rice porridge with broth, huh?\Minko, you still have the fish bones you separated this morning?\Yes.\She looked like she was really enjoying the rice porridge,\so I figured we might be able to serve it to the customers. response:	Oh yeah,
context: Ko...\Send Text To: Ko Ko. Ko, I think I'm going to\Rice porridge with broth, huh?\Minko, you still have the fish bones you separated this morning?\Yes.\She looked like she was really enjoying the rice porridge,\so I figured we might be able to serve it to the customers.\Oh yeah, response:	Minko.
context: Send Text To: Ko Ko. Ko, I think I'm going to\Rice porridge with broth, huh?\Minko, you still have the fish bones you separated this morning?\Yes.\She looked like she was really enjoying the rice porridge,\so I figured we might be able to serve it to the customers.\Oh yeah,\Minko. response:	I think she liked your strawberries... too...?
context: Rice porridge with broth, huh?\Minko, you still have the fish bones you separated this morning?\Yes.\She looked like she was really enjoying the rice porridge,\so I figured we might be able to serve it to the customers.\Oh yeah,\Minko.\I think she liked your strawberries... too...? response:	It needs some minor adjustments.
context: Minko, you still have the fish bones you separated this morning?\Yes.\She looked like she was really enjoying the rice porridge,\so I figured we might be able to serve it to the customers.\Oh yeah,\Minko.\I think she liked your strawberries... too...?\It needs some minor adjustments. response:	Let's do this.
context: Yes.\She looked like she was really enjoying the rice porridge,\so I figured we might be able to serve it to the customers.\Oh yeah,\Minko.\I think she liked your strawberries... too...?\It needs some minor adjustments.\Let's do this. response:	Right.
context: She looked like she was really enjoying the rice porridge,\so I figured we might be able to serve it to the customers.\Oh yeah,\Minko.\I think she liked your strawberries... too...?\It needs some minor adjustments.\Let's do this.\Right. response:	To: Ko I can't really move my body very well. Your body was glowing. Kissuiso has good staff, and it's not like an ordinary person like me can just take a position here.
context: so I figured we might be able to serve it to the customers.\Oh yeah,\Minko.\I think she liked your strawberries... too...?\It needs some minor adjustments.\Let's do this.\Right.\To: Ko I can't really move my body very well. Your body was glowing. Kissuiso has good staff, and it's not like an ordinary person like me can just take a position here. response:	Could you bring this fruit medley and guide map
context: Oh yeah,\Minko.\I think she liked your strawberries... too...?\It needs some minor adjustments.\Let's do this.\Right.\To: Ko I can't really move my body very well. Your body was glowing. Kissuiso has good staff, and it's not like an ordinary person like me can just take a position here.\Could you bring this fruit medley and guide map response:	to the Wisteria Room?
context: Minko.\I think she liked your strawberries... too...?\It needs some minor adjustments.\Let's do this.\Right.\To: Ko I can't really move my body very well. Your body was glowing. Kissuiso has good staff, and it's not like an ordinary person like me can just take a position here.\Could you bring this fruit medley and guide map\to the Wisteria Room? response:	Okay.
context: I think she liked your strawberries... too...?\It needs some minor adjustments.\Let's do this.\Right.\To: Ko I can't really move my body very well. Your body was glowing. Kissuiso has good staff, and it's not like an ordinary person like me can just take a position here.\Could you bring this fruit medley and guide map\to the Wisteria Room?\Okay. response:	Nako.
context: It needs some minor adjustments.\Let's do this.\Right.\To: Ko I can't really move my body very well. Your body was glowing. Kissuiso has good staff, and it's not like an ordinary person like me can just take a position here.\Could you bring this fruit medley and guide map\to the Wisteria Room?\Okay.\Nako. response:	Yes?
context: Let's do this.\Right.\To: Ko I can't really move my body very well. Your body was glowing. Kissuiso has good staff, and it's not like an ordinary person like me can just take a position here.\Could you bring this fruit medley and guide map\to the Wisteria Room?\Okay.\Nako.\Yes? response:	Are you okay?
context: Right.\To: Ko I can't really move my body very well. Your body was glowing. Kissuiso has good staff, and it's not like an ordinary person like me can just take a position here.\Could you bring this fruit medley and guide map\to the Wisteria Room?\Okay.\Nako.\Yes?\Are you okay? response:	I don't want you to overwork yourself too.
context: To: Ko I can't really move my body very well. Your body was glowing. Kissuiso has good staff, and it's not like an ordinary person like me can just take a position here.\Could you bring this fruit medley and guide map\to the Wisteria Room?\Okay.\Nako.\Yes?\Are you okay?\I don't want you to overwork yourself too. response:	I'm fine.
context: Could you bring this fruit medley and guide map\to the Wisteria Room?\Okay.\Nako.\Yes?\Are you okay?\I don't want you to overwork yourself too.\I'm fine. response:	I need to pick up Ohana's slack, too.
context: to the Wisteria Room?\Okay.\Nako.\Yes?\Are you okay?\I don't want you to overwork yourself too.\I'm fine.\I need to pick up Ohana's slack, too. response:	Because, remember? Before she got here,
context: Okay.\Nako.\Yes?\Are you okay?\I don't want you to overwork yourself too.\I'm fine.\I need to pick up Ohana's slack, too.\Because, remember? Before she got here, response:	us two were doing everything.
context: Nako.\Yes?\Are you okay?\I don't want you to overwork yourself too.\I'm fine.\I need to pick up Ohana's slack, too.\Because, remember? Before she got here,\us two were doing everything. response:	So you're saying you don't need Ohana anymore, huh?
context: Yes?\Are you okay?\I don't want you to overwork yourself too.\I'm fine.\I need to pick up Ohana's slack, too.\Because, remember? Before she got here,\us two were doing everything.\So you're saying you don't need Ohana anymore, huh? response:	You've grown up, Nako.
context: Are you okay?\I don't want you to overwork yourself too.\I'm fine.\I need to pick up Ohana's slack, too.\Because, remember? Before she got here,\us two were doing everything.\So you're saying you don't need Ohana anymore, huh?\You've grown up, Nako. response:	Th-That's not what I...
context: I don't want you to overwork yourself too.\I'm fine.\I need to pick up Ohana's slack, too.\Because, remember? Before she got here,\us two were doing everything.\So you're saying you don't need Ohana anymore, huh?\You've grown up, Nako.\Th-That's not what I... response:	Please enjoy your stay.
context: I'm fine.\I need to pick up Ohana's slack, too.\Because, remember? Before she got here,\us two were doing everything.\So you're saying you don't need Ohana anymore, huh?\You've grown up, Nako.\Th-That's not what I...\Please enjoy your stay. response:	Say...
context: I need to pick up Ohana's slack, too.\Because, remember? Before she got here,\us two were doing everything.\So you're saying you don't need Ohana anymore, huh?\You've grown up, Nako.\Th-That's not what I...\Please enjoy your stay.\Say... response:	What happened to the waitress from yesterday?
context: Because, remember? Before she got here,\us two were doing everything.\So you're saying you don't need Ohana anymore, huh?\You've grown up, Nako.\Th-That's not what I...\Please enjoy your stay.\Say...\What happened to the waitress from yesterday? response:	I haven't been seeing her around.
context: us two were doing everything.\So you're saying you don't need Ohana anymore, huh?\You've grown up, Nako.\Th-That's not what I...\Please enjoy your stay.\Say...\What happened to the waitress from yesterday?\I haven't been seeing her around. response:	Oh, Ohana isn't feeling very well right now.
context: So you're saying you don't need Ohana anymore, huh?\You've grown up, Nako.\Th-That's not what I...\Please enjoy your stay.\Say...\What happened to the waitress from yesterday?\I haven't been seeing her around.\Oh, Ohana isn't feeling very well right now. response:	Oh, so her name is Ohana.
context: You've grown up, Nako.\Th-That's not what I...\Please enjoy your stay.\Say...\What happened to the waitress from yesterday?\I haven't been seeing her around.\Oh, Ohana isn't feeling very well right now.\Oh, so her name is Ohana. response:	She just has a slight fever.
context: Th-That's not what I...\Please enjoy your stay.\Say...\What happened to the waitress from yesterday?\I haven't been seeing her around.\Oh, Ohana isn't feeling very well right now.\Oh, so her name is Ohana.\She just has a slight fever. response:	You shouldn't worry too much.
context: Please enjoy your stay.\Say...\What happened to the waitress from yesterday?\I haven't been seeing her around.\Oh, Ohana isn't feeling very well right now.\Oh, so her name is Ohana.\She just has a slight fever.\You shouldn't worry too much. response:	You two make such a good team.
context: Say...\What happened to the waitress from yesterday?\I haven't been seeing her around.\Oh, Ohana isn't feeling very well right now.\Oh, so her name is Ohana.\She just has a slight fever.\You shouldn't worry too much.\You two make such a good team. response:	You seem to like each other so much.
context: What happened to the waitress from yesterday?\I haven't been seeing her around.\Oh, Ohana isn't feeling very well right now.\Oh, so her name is Ohana.\She just has a slight fever.\You shouldn't worry too much.\You two make such a good team.\You seem to like each other so much. response:	And you're both so lively,
context: I haven't been seeing her around.\Oh, Ohana isn't feeling very well right now.\Oh, so her name is Ohana.\She just has a slight fever.\You shouldn't worry too much.\You two make such a good team.\You seem to like each other so much.\And you're both so lively, response:	that it makes breakfast taste even better.
context: Oh, Ohana isn't feeling very well right now.\Oh, so her name is Ohana.\She just has a slight fever.\You shouldn't worry too much.\You two make such a good team.\You seem to like each other so much.\And you're both so lively,\that it makes breakfast taste even better. response:	Thank you!
context: Oh, so her name is Ohana.\She just has a slight fever.\You shouldn't worry too much.\You two make such a good team.\You seem to like each other so much.\And you're both so lively,\that it makes breakfast taste even better.\Thank you! response:	That was a good bath.
context: She just has a slight fever.\You shouldn't worry too much.\You two make such a good team.\You seem to like each other so much.\And you're both so lively,\that it makes breakfast taste even better.\Thank you!\That was a good bath. response:	Yeah, I feel refreshed!
context: You shouldn't worry too much.\You two make such a good team.\You seem to like each other so much.\And you're both so lively,\that it makes breakfast taste even better.\Thank you!\That was a good bath.\Yeah, I feel refreshed! response:	Look, I'm all wrinkly!
context: You two make such a good team.\You seem to like each other so much.\And you're both so lively,\that it makes breakfast taste even better.\Thank you!\That was a good bath.\Yeah, I feel refreshed!\Look, I'm all wrinkly! response:	Wow!
context: You seem to like each other so much.\And you're both so lively,\that it makes breakfast taste even better.\Thank you!\That was a good bath.\Yeah, I feel refreshed!\Look, I'm all wrinkly!\Wow! response:	What are you being so scared for?!
context: And you're both so lively,\that it makes breakfast taste even better.\Thank you!\That was a good bath.\Yeah, I feel refreshed!\Look, I'm all wrinkly!\Wow!\What are you being so scared for?! response:	I-I'm sorry!
context: that it makes breakfast taste even better.\Thank you!\That was a good bath.\Yeah, I feel refreshed!\Look, I'm all wrinkly!\Wow!\What are you being so scared for?!\I-I'm sorry! response:	You touch the fish too much.
context: Thank you!\That was a good bath.\Yeah, I feel refreshed!\Look, I'm all wrinkly!\Wow!\What are you being so scared for?!\I-I'm sorry!\You touch the fish too much. response:	You need to minimize that.
context: That was a good bath.\Yeah, I feel refreshed!\Look, I'm all wrinkly!\Wow!\What are you being so scared for?!\I-I'm sorry!\You touch the fish too much.\You need to minimize that. response:	I'm sorry.
context: Yeah, I feel refreshed!\Look, I'm all wrinkly!\Wow!\What are you being so scared for?!\I-I'm sorry!\You touch the fish too much.\You need to minimize that.\I'm sorry. response:	Minchi!
context: Look, I'm all wrinkly!\Wow!\What are you being so scared for?!\I-I'm sorry!\You touch the fish too much.\You need to minimize that.\I'm sorry.\Minchi! response:	It's too early in the morning to be yelling.
context: Wow!\What are you being so scared for?!\I-I'm sorry!\You touch the fish too much.\You need to minimize that.\I'm sorry.\Minchi!\It's too early in the morning to be yelling. response:	I-I'm sorry!
context: What are you being so scared for?!\I-I'm sorry!\You touch the fish too much.\You need to minimize that.\I'm sorry.\Minchi!\It's too early in the morning to be yelling.\I-I'm sorry! response:	What's up, Nako?
context: I-I'm sorry!\You touch the fish too much.\You need to minimize that.\I'm sorry.\Minchi!\It's too early in the morning to be yelling.\I-I'm sorry!\What's up, Nako? response:	Ohana collapsed!
context: You touch the fish too much.\You need to minimize that.\I'm sorry.\Minchi!\It's too early in the morning to be yelling.\I-I'm sorry!\What's up, Nako?\Ohana collapsed! response:	What?!
context: You need to minimize that.\I'm sorry.\Minchi!\It's too early in the morning to be yelling.\I-I'm sorry!\What's up, Nako?\Ohana collapsed!\What?! response:	Minchi...
context: I'm sorry.\Minchi!\It's too early in the morning to be yelling.\I-I'm sorry!\What's up, Nako?\Ohana collapsed!\What?!\Minchi... response:	You looked like you were really enjoying your sleep.
context: Minchi!\It's too early in the morning to be yelling.\I-I'm sorry!\What's up, Nako?\Ohana collapsed!\What?!\Minchi...\You looked like you were really enjoying your sleep. response:	I feel a bit more relieved.
context: It's too early in the morning to be yelling.\I-I'm sorry!\What's up, Nako?\Ohana collapsed!\What?!\Minchi...\You looked like you were really enjoying your sleep.\I feel a bit more relieved. response:	You were worried about me?
context: I-I'm sorry!\What's up, Nako?\Ohana collapsed!\What?!\Minchi...\You looked like you were really enjoying your sleep.\I feel a bit more relieved.\You were worried about me? response:	Don't worry, the inn is running okay.
context: What's up, Nako?\Ohana collapsed!\What?!\Minchi...\You looked like you were really enjoying your sleep.\I feel a bit more relieved.\You were worried about me?\Don't worry, the inn is running okay. response:	What? What's wrong?!
context: Ohana collapsed!\What?!\Minchi...\You looked like you were really enjoying your sleep.\I feel a bit more relieved.\You were worried about me?\Don't worry, the inn is running okay.\What? What's wrong?! response:	I'm glad...
context: What?!\Minchi...\You looked like you were really enjoying your sleep.\I feel a bit more relieved.\You were worried about me?\Don't worry, the inn is running okay.\What? What's wrong?!\I'm glad... response:	The Kissuiso can run without me, right?
context: Minchi...\You looked like you were really enjoying your sleep.\I feel a bit more relieved.\You were worried about me?\Don't worry, the inn is running okay.\What? What's wrong?!\I'm glad...\The Kissuiso can run without me, right? response:	No-
context: You looked like you were really enjoying your sleep.\I feel a bit more relieved.\You were worried about me?\Don't worry, the inn is running okay.\What? What's wrong?!\I'm glad...\The Kissuiso can run without me, right?\No- response:	No.
context: I feel a bit more relieved.\You were worried about me?\Don't worry, the inn is running okay.\What? What's wrong?!\I'm glad...\The Kissuiso can run without me, right?\No-\No. response:	That's not true.
context: You were worried about me?\Don't worry, the inn is running okay.\What? What's wrong?!\I'm glad...\The Kissuiso can run without me, right?\No-\No.\That's not true. response:	Huh?
context: Don't worry, the inn is running okay.\What? What's wrong?!\I'm glad...\The Kissuiso can run without me, right?\No-\No.\That's not true.\Huh? response:	It's not true.
context: What? What's wrong?!\I'm glad...\The Kissuiso can run without me, right?\No-\No.\That's not true.\Huh?\It's not true. response:	You tried to get rid of the bat in the hall
context: I'm glad...\The Kissuiso can run without me, right?\No-\No.\That's not true.\Huh?\It's not true.\You tried to get rid of the bat in the hall response:	to the bath by yourself, didn't you?
context: The Kissuiso can run without me, right?\No-\No.\That's not true.\Huh?\It's not true.\You tried to get rid of the bat in the hall\to the bath by yourself, didn't you? response:	Madam Manager told you girls to get rid of it.
context: No-\No.\That's not true.\Huh?\It's not true.\You tried to get rid of the bat in the hall\to the bath by yourself, didn't you?\Madam Manager told you girls to get rid of it. response:	You girls refers to you, Nako, and I.
context: No.\That's not true.\Huh?\It's not true.\You tried to get rid of the bat in the hall\to the bath by yourself, didn't you?\Madam Manager told you girls to get rid of it.\You girls refers to you, Nako, and I. response:	Nako can't stand bats, so it's up to us.
context: That's not true.\Huh?\It's not true.\You tried to get rid of the bat in the hall\to the bath by yourself, didn't you?\Madam Manager told you girls to get rid of it.\You girls refers to you, Nako, and I.\Nako can't stand bats, so it's up to us. response:	You can't do everything by yourself!
context: Huh?\It's not true.\You tried to get rid of the bat in the hall\to the bath by yourself, didn't you?\Madam Manager told you girls to get rid of it.\You girls refers to you, Nako, and I.\Nako can't stand bats, so it's up to us.\You can't do everything by yourself! response:	But I can't do it by myself, either.
context: It's not true.\You tried to get rid of the bat in the hall\to the bath by yourself, didn't you?\Madam Manager told you girls to get rid of it.\You girls refers to you, Nako, and I.\Nako can't stand bats, so it's up to us.\You can't do everything by yourself!\But I can't do it by myself, either. response:	I need your help.
context: You tried to get rid of the bat in the hall\to the bath by yourself, didn't you?\Madam Manager told you girls to get rid of it.\You girls refers to you, Nako, and I.\Nako can't stand bats, so it's up to us.\You can't do everything by yourself!\But I can't do it by myself, either.\I need your help. response:	Okay?!
context: to the bath by yourself, didn't you?\Madam Manager told you girls to get rid of it.\You girls refers to you, Nako, and I.\Nako can't stand bats, so it's up to us.\You can't do everything by yourself!\But I can't do it by myself, either.\I need your help.\Okay?! response:	Once you're better,
context: Madam Manager told you girls to get rid of it.\You girls refers to you, Nako, and I.\Nako can't stand bats, so it's up to us.\You can't do everything by yourself!\But I can't do it by myself, either.\I need your help.\Okay?!\Once you're better, response:	we need to think of a plan to get rid of the bat!
context: You girls refers to you, Nako, and I.\Nako can't stand bats, so it's up to us.\You can't do everything by yourself!\But I can't do it by myself, either.\I need your help.\Okay?!\Once you're better,\we need to think of a plan to get rid of the bat! response:	O-Okay.
context: Nako can't stand bats, so it's up to us.\You can't do everything by yourself!\But I can't do it by myself, either.\I need your help.\Okay?!\Once you're better,\we need to think of a plan to get rid of the bat!\O-Okay. response:	Ohana? I'm coming in.
context: You can't do everything by yourself!\But I can't do it by myself, either.\I need your help.\Okay?!\Once you're better,\we need to think of a plan to get rid of the bat!\O-Okay.\Ohana? I'm coming in. response:	You're here, Minchi.
context: But I can't do it by myself, either.\I need your help.\Okay?!\Once you're better,\we need to think of a plan to get rid of the bat!\O-Okay.\Ohana? I'm coming in.\You're here, Minchi. response:	Don't turn the TV on.
context: I need your help.\Okay?!\Once you're better,\we need to think of a plan to get rid of the bat!\O-Okay.\Ohana? I'm coming in.\You're here, Minchi.\Don't turn the TV on. response:	Huh?
context: Okay?!\Once you're better,\we need to think of a plan to get rid of the bat!\O-Okay.\Ohana? I'm coming in.\You're here, Minchi.\Don't turn the TV on.\Huh? response:	But isn't it lonely when you wake up
context: Once you're better,\we need to think of a plan to get rid of the bat!\O-Okay.\Ohana? I'm coming in.\You're here, Minchi.\Don't turn the TV on.\Huh?\But isn't it lonely when you wake up response:	and you don't hear any voices?
context: we need to think of a plan to get rid of the bat!\O-Okay.\Ohana? I'm coming in.\You're here, Minchi.\Don't turn the TV on.\Huh?\But isn't it lonely when you wake up\and you don't hear any voices? response:	I've got a large family,
context: O-Okay.\Ohana? I'm coming in.\You're here, Minchi.\Don't turn the TV on.\Huh?\But isn't it lonely when you wake up\and you don't hear any voices?\I've got a large family, response:	so it's really lonely for me.
context: Ohana? I'm coming in.\You're here, Minchi.\Don't turn the TV on.\Huh?\But isn't it lonely when you wake up\and you don't hear any voices?\I've got a large family,\so it's really lonely for me. response:	Hey, the customers in the
context: You're here, Minchi.\Don't turn the TV on.\Huh?\But isn't it lonely when you wake up\and you don't hear any voices?\I've got a large family,\so it's really lonely for me.\Hey, the customers in the response:	Wisteria Room said that breakfast served
context: Don't turn the TV on.\Huh?\But isn't it lonely when you wake up\and you don't hear any voices?\I've got a large family,\so it's really lonely for me.\Hey, the customers in the\Wisteria Room said that breakfast served response:	by you is really good.
context: Huh?\But isn't it lonely when you wake up\and you don't hear any voices?\I've got a large family,\so it's really lonely for me.\Hey, the customers in the\Wisteria Room said that breakfast served\by you is really good. response:	Come on!
context: But isn't it lonely when you wake up\and you don't hear any voices?\I've got a large family,\so it's really lonely for me.\Hey, the customers in the\Wisteria Room said that breakfast served\by you is really good.\Come on! response:	You shouldn't be playing with your
context: and you don't hear any voices?\I've got a large family,\so it's really lonely for me.\Hey, the customers in the\Wisteria Room said that breakfast served\by you is really good.\Come on!\You shouldn't be playing with your response:	phone when you've got a fever.
context: I've got a large family,\so it's really lonely for me.\Hey, the customers in the\Wisteria Room said that breakfast served\by you is really good.\Come on!\You shouldn't be playing with your\phone when you've got a fever. response:	To: Ko I can't really move my body very well. Your body was glowing. Kissuiso has good staff, and it's not like an ordinary person like me can just take a position here. This place should be fine without
context: so it's really lonely for me.\Hey, the customers in the\Wisteria Room said that breakfast served\by you is really good.\Come on!\You shouldn't be playing with your\phone when you've got a fever.\To: Ko I can't really move my body very well. Your body was glowing. Kissuiso has good staff, and it's not like an ordinary person like me can just take a position here. This place should be fine without response:	Huh?
context: Hey, the customers in the\Wisteria Room said that breakfast served\by you is really good.\Come on!\You shouldn't be playing with your\phone when you've got a fever.\To: Ko I can't really move my body very well. Your body was glowing. Kissuiso has good staff, and it's not like an ordinary person like me can just take a position here. This place should be fine without\Huh? response:	What's...
context: Wisteria Room said that breakfast served\by you is really good.\Come on!\You shouldn't be playing with your\phone when you've got a fever.\To: Ko I can't really move my body very well. Your body was glowing. Kissuiso has good staff, and it's not like an ordinary person like me can just take a position here. This place should be fine without\Huh?\What's... response:	No!
context: by you is really good.\Come on!\You shouldn't be playing with your\phone when you've got a fever.\To: Ko I can't really move my body very well. Your body was glowing. Kissuiso has good staff, and it's not like an ordinary person like me can just take a position here. This place should be fine without\Huh?\What's...\No! response:	That's not true, Ohana!
context: Come on!\You shouldn't be playing with your\phone when you've got a fever.\To: Ko I can't really move my body very well. Your body was glowing. Kissuiso has good staff, and it's not like an ordinary person like me can just take a position here. This place should be fine without\Huh?\What's...\No!\That's not true, Ohana! response:	There are times I honestly feel like
context: You shouldn't be playing with your\phone when you've got a fever.\To: Ko I can't really move my body very well. Your body was glowing. Kissuiso has good staff, and it's not like an ordinary person like me can just take a position here. This place should be fine without\Huh?\What's...\No!\That's not true, Ohana!\There are times I honestly feel like response:	we can't afford to lose anyone!
context: phone when you've got a fever.\To: Ko I can't really move my body very well. Your body was glowing. Kissuiso has good staff, and it's not like an ordinary person like me can just take a position here. This place should be fine without\Huh?\What's...\No!\That's not true, Ohana!\There are times I honestly feel like\we can't afford to lose anyone! response:	But today, you were out, and for some miraculous reason,
context: To: Ko I can't really move my body very well. Your body was glowing. Kissuiso has good staff, and it's not like an ordinary person like me can just take a position here. This place should be fine without\Huh?\What's...\No!\That's not true, Ohana!\There are times I honestly feel like\we can't afford to lose anyone!\But today, you were out, and for some miraculous reason, response:	things weren't hectic and our jobs were done.
context: Huh?\What's...\No!\That's not true, Ohana!\There are times I honestly feel like\we can't afford to lose anyone!\But today, you were out, and for some miraculous reason,\things weren't hectic and our jobs were done. response:	I hope this isn't the end of the world or something.
context: What's...\No!\That's not true, Ohana!\There are times I honestly feel like\we can't afford to lose anyone!\But today, you were out, and for some miraculous reason,\things weren't hectic and our jobs were done.\I hope this isn't the end of the world or something. response:	But, but, it doesn't mean
context: No!\That's not true, Ohana!\There are times I honestly feel like\we can't afford to lose anyone!\But today, you were out, and for some miraculous reason,\things weren't hectic and our jobs were done.\I hope this isn't the end of the world or something.\But, but, it doesn't mean response:	that we don't need that person!
context: That's not true, Ohana!\There are times I honestly feel like\we can't afford to lose anyone!\But today, you were out, and for some miraculous reason,\things weren't hectic and our jobs were done.\I hope this isn't the end of the world or something.\But, but, it doesn't mean\that we don't need that person! response:	It means that since that person is so important to us,
context: There are times I honestly feel like\we can't afford to lose anyone!\But today, you were out, and for some miraculous reason,\things weren't hectic and our jobs were done.\I hope this isn't the end of the world or something.\But, but, it doesn't mean\that we don't need that person!\It means that since that person is so important to us, response:	we work harder to fill in her gap!
context: we can't afford to lose anyone!\But today, you were out, and for some miraculous reason,\things weren't hectic and our jobs were done.\I hope this isn't the end of the world or something.\But, but, it doesn't mean\that we don't need that person!\It means that since that person is so important to us,\we work harder to fill in her gap! response:	So we really want that person back!
context: But today, you were out, and for some miraculous reason,\things weren't hectic and our jobs were done.\I hope this isn't the end of the world or something.\But, but, it doesn't mean\that we don't need that person!\It means that since that person is so important to us,\we work harder to fill in her gap!\So we really want that person back! response:	Sorry.
context: things weren't hectic and our jobs were done.\I hope this isn't the end of the world or something.\But, but, it doesn't mean\that we don't need that person!\It means that since that person is so important to us,\we work harder to fill in her gap!\So we really want that person back!\Sorry. response:	Geez...
context: I hope this isn't the end of the world or something.\But, but, it doesn't mean\that we don't need that person!\It means that since that person is so important to us,\we work harder to fill in her gap!\So we really want that person back!\Sorry.\Geez... response:	Looks like she didn't hear you.
context: But, but, it doesn't mean\that we don't need that person!\It means that since that person is so important to us,\we work harder to fill in her gap!\So we really want that person back!\Sorry.\Geez...\Looks like she didn't hear you. response:	Huh?
context: that we don't need that person!\It means that since that person is so important to us,\we work harder to fill in her gap!\So we really want that person back!\Sorry.\Geez...\Looks like she didn't hear you.\Huh? response:	Huh?
context: It means that since that person is so important to us,\we work harder to fill in her gap!\So we really want that person back!\Sorry.\Geez...\Looks like she didn't hear you.\Huh?\Huh? response:	W-What?
context: we work harder to fill in her gap!\So we really want that person back!\Sorry.\Geez...\Looks like she didn't hear you.\Huh?\Huh?\W-What? response:	Have you decided?
context: So we really want that person back!\Sorry.\Geez...\Looks like she didn't hear you.\Huh?\Huh?\W-What?\Have you decided? response:	I love this place.
context: Sorry.\Geez...\Looks like she didn't hear you.\Huh?\Huh?\W-What?\Have you decided?\I love this place. response:	I love the Kissuiso.
context: Geez...\Looks like she didn't hear you.\Huh?\Huh?\W-What?\Have you decided?\I love this place.\I love the Kissuiso. response:	I see.
context: Looks like she didn't hear you.\Huh?\Huh?\W-What?\Have you decided?\I love this place.\I love the Kissuiso.\I see. response:	I love everyone here.
context: Huh?\Huh?\W-What?\Have you decided?\I love this place.\I love the Kissuiso.\I see.\I love everyone here. response:	Okay.
context: Huh?\W-What?\Have you decided?\I love this place.\I love the Kissuiso.\I see.\I love everyone here.\Okay. response:	What ya doin'?
context: W-What?\Have you decided?\I love this place.\I love the Kissuiso.\I see.\I love everyone here.\Okay.\What ya doin'? response:	Ohana went looking for a fight?!
context: Have you decided?\I love this place.\I love the Kissuiso.\I see.\I love everyone here.\Okay.\What ya doin'?\Ohana went looking for a fight?! response:	Ohana!
context: I love this place.\I love the Kissuiso.\I see.\I love everyone here.\Okay.\What ya doin'?\Ohana went looking for a fight?!\Ohana! response:	Help me...
context: I love the Kissuiso.\I see.\I love everyone here.\Okay.\What ya doin'?\Ohana went looking for a fight?!\Ohana!\Help me... response:	Help me, Ko!
context: I see.\I love everyone here.\Okay.\What ya doin'?\Ohana went looking for a fight?!\Ohana!\Help me...\Help me, Ko! response:	Episode 11 Bark at the Night