context: I'm Gouda Takeo, a first-year in high school. response:	He's Sunakawa Makoto, a friend of mine.
context: I'm Gouda Takeo, a first-year in high school.\He's Sunakawa Makoto, a friend of mine. response:	And that's my girlfriend, Yamato.
context: I'm Gouda Takeo, a first-year in high school.\He's Sunakawa Makoto, a friend of mine.\And that's my girlfriend, Yamato. response:	Takeo-kun!
context: I'm Gouda Takeo, a first-year in high school.\He's Sunakawa Makoto, a friend of mine.\And that's my girlfriend, Yamato.\Takeo-kun! response:	Yamato!
context: I'm Gouda Takeo, a first-year in high school.\He's Sunakawa Makoto, a friend of mine.\And that's my girlfriend, Yamato.\Takeo-kun!\Yamato! response:	Shuuei
context: I'm Gouda Takeo, a first-year in high school.\He's Sunakawa Makoto, a friend of mine.\And that's my girlfriend, Yamato.\Takeo-kun!\Yamato!\Shuuei response:	You must be the first-year, Gouda Takeo.
context: I'm Gouda Takeo, a first-year in high school.\He's Sunakawa Makoto, a friend of mine.\And that's my girlfriend, Yamato.\Takeo-kun!\Yamato!\Shuuei\You must be the first-year, Gouda Takeo. response:	We need to talk to you.
context: I'm Gouda Takeo, a first-year in high school.\He's Sunakawa Makoto, a friend of mine.\And that's my girlfriend, Yamato.\Takeo-kun!\Yamato!\Shuuei\You must be the first-year, Gouda Takeo.\We need to talk to you. response:	Don't worry, Yamato.
context: He's Sunakawa Makoto, a friend of mine.\And that's my girlfriend, Yamato.\Takeo-kun!\Yamato!\Shuuei\You must be the first-year, Gouda Takeo.\We need to talk to you.\Don't worry, Yamato. response:	I will protect you.
context: And that's my girlfriend, Yamato.\Takeo-kun!\Yamato!\Shuuei\You must be the first-year, Gouda Takeo.\We need to talk to you.\Don't worry, Yamato.\I will protect you. response:	I'll be your shield.
context: Takeo-kun!\Yamato!\Shuuei\You must be the first-year, Gouda Takeo.\We need to talk to you.\Don't worry, Yamato.\I will protect you.\I'll be your shield. response:	My Strength
context: Yamato!\Shuuei\You must be the first-year, Gouda Takeo.\We need to talk to you.\Don't worry, Yamato.\I will protect you.\I'll be your shield.\My Strength response:	Please, Gouda!
context: Shuuei\You must be the first-year, Gouda Takeo.\We need to talk to you.\Don't worry, Yamato.\I will protect you.\I'll be your shield.\My Strength\Please, Gouda! response:	Help us!
context: You must be the first-year, Gouda Takeo.\We need to talk to you.\Don't worry, Yamato.\I will protect you.\I'll be your shield.\My Strength\Please, Gouda!\Help us! response:	Okay!
context: We need to talk to you.\Don't worry, Yamato.\I will protect you.\I'll be your shield.\My Strength\Please, Gouda!\Help us!\Okay! response:	You will?
context: Don't worry, Yamato.\I will protect you.\I'll be your shield.\My Strength\Please, Gouda!\Help us!\Okay!\You will? response:	But you have no idea what help you'll be giving.
context: I will protect you.\I'll be your shield.\My Strength\Please, Gouda!\Help us!\Okay!\You will?\But you have no idea what help you'll be giving. response:	Men are bowing down to me.
context: I'll be your shield.\My Strength\Please, Gouda!\Help us!\Okay!\You will?\But you have no idea what help you'll be giving.\Men are bowing down to me. response:	How could I refuse?
context: My Strength\Please, Gouda!\Help us!\Okay!\You will?\But you have no idea what help you'll be giving.\Men are bowing down to me.\How could I refuse? response:	And they're second-years, too.
context: Please, Gouda!\Help us!\Okay!\You will?\But you have no idea what help you'll be giving.\Men are bowing down to me.\How could I refuse?\And they're second-years, too. response:	You're so cool, Takeo-kun.
context: Help us!\Okay!\You will?\But you have no idea what help you'll be giving.\Men are bowing down to me.\How could I refuse?\And they're second-years, too.\You're so cool, Takeo-kun. response:	So what did you need help with?
context: Okay!\You will?\But you have no idea what help you'll be giving.\Men are bowing down to me.\How could I refuse?\And they're second-years, too.\You're so cool, Takeo-kun.\So what did you need help with? response:	Join the judo club.
context: You will?\But you have no idea what help you'll be giving.\Men are bowing down to me.\How could I refuse?\And they're second-years, too.\You're so cool, Takeo-kun.\So what did you need help with?\Join the judo club. response:	Just for a month.
context: But you have no idea what help you'll be giving.\Men are bowing down to me.\How could I refuse?\And they're second-years, too.\You're so cool, Takeo-kun.\So what did you need help with?\Join the judo club.\Just for a month. response:	We're begging you!
context: Men are bowing down to me.\How could I refuse?\And they're second-years, too.\You're so cool, Takeo-kun.\So what did you need help with?\Join the judo club.\Just for a month.\We're begging you! response:	At the end of this month,
context: How could I refuse?\And they're second-years, too.\You're so cool, Takeo-kun.\So what did you need help with?\Join the judo club.\Just for a month.\We're begging you!\At the end of this month, response:	our judo club will participate in the Shuu-Bi Match.
context: And they're second-years, too.\You're so cool, Takeo-kun.\So what did you need help with?\Join the judo club.\Just for a month.\We're begging you!\At the end of this month,\our judo club will participate in the Shuu-Bi Match. response:	Shuu-Bi Match?
context: You're so cool, Takeo-kun.\So what did you need help with?\Join the judo club.\Just for a month.\We're begging you!\At the end of this month,\our judo club will participate in the Shuu-Bi Match.\Shuu-Bi Match? response:	It's an annual tradition
context: So what did you need help with?\Join the judo club.\Just for a month.\We're begging you!\At the end of this month,\our judo club will participate in the Shuu-Bi Match.\Shuu-Bi Match?\It's an annual tradition response:	where we compete with Bianka High School,
context: Join the judo club.\Just for a month.\We're begging you!\At the end of this month,\our judo club will participate in the Shuu-Bi Match.\Shuu-Bi Match?\It's an annual tradition\where we compete with Bianka High School, response:	our long-time rivals.
context: Just for a month.\We're begging you!\At the end of this month,\our judo club will participate in the Shuu-Bi Match.\Shuu-Bi Match?\It's an annual tradition\where we compete with Bianka High School,\our long-time rivals. response:	So far, our score is 9-9.
context: We're begging you!\At the end of this month,\our judo club will participate in the Shuu-Bi Match.\Shuu-Bi Match?\It's an annual tradition\where we compete with Bianka High School,\our long-time rivals.\So far, our score is 9-9. response:	We must secure victory in the 10th match for glory!
context: At the end of this month,\our judo club will participate in the Shuu-Bi Match.\Shuu-Bi Match?\It's an annual tradition\where we compete with Bianka High School,\our long-time rivals.\So far, our score is 9-9.\We must secure victory in the 10th match for glory! response:	Indeed!
context: our judo club will participate in the Shuu-Bi Match.\Shuu-Bi Match?\It's an annual tradition\where we compete with Bianka High School,\our long-time rivals.\So far, our score is 9-9.\We must secure victory in the 10th match for glory!\Indeed! response:	There's even a superstition that the years we lose the match,
context: Shuu-Bi Match?\It's an annual tradition\where we compete with Bianka High School,\our long-time rivals.\So far, our score is 9-9.\We must secure victory in the 10th match for glory!\Indeed!\There's even a superstition that the years we lose the match, response:	we won't make it to nationals!
context: It's an annual tradition\where we compete with Bianka High School,\our long-time rivals.\So far, our score is 9-9.\We must secure victory in the 10th match for glory!\Indeed!\There's even a superstition that the years we lose the match,\we won't make it to nationals! response:	It's pretty much our Battle of Mt. Tennou!
context: where we compete with Bianka High School,\our long-time rivals.\So far, our score is 9-9.\We must secure victory in the 10th match for glory!\Indeed!\There's even a superstition that the years we lose the match,\we won't make it to nationals!\It's pretty much our Battle of Mt. Tennou! response:	It's a team competition where we need to win three out of five matches,
context: our long-time rivals.\So far, our score is 9-9.\We must secure victory in the 10th match for glory!\Indeed!\There's even a superstition that the years we lose the match,\we won't make it to nationals!\It's pretty much our Battle of Mt. Tennou!\It's a team competition where we need to win three out of five matches, response:	but our champion's been injured,
context: So far, our score is 9-9.\We must secure victory in the 10th match for glory!\Indeed!\There's even a superstition that the years we lose the match,\we won't make it to nationals!\It's pretty much our Battle of Mt. Tennou!\It's a team competition where we need to win three out of five matches,\but our champion's been injured, response:	and we have no one to take his place.
context: We must secure victory in the 10th match for glory!\Indeed!\There's even a superstition that the years we lose the match,\we won't make it to nationals!\It's pretty much our Battle of Mt. Tennou!\It's a team competition where we need to win three out of five matches,\but our champion's been injured,\and we have no one to take his place. response:	Please fight for me!
context: Indeed!\There's even a superstition that the years we lose the match,\we won't make it to nationals!\It's pretty much our Battle of Mt. Tennou!\It's a team competition where we need to win three out of five matches,\but our champion's been injured,\and we have no one to take his place.\Please fight for me! response:	The explanation's so long
context: There's even a superstition that the years we lose the match,\we won't make it to nationals!\It's pretty much our Battle of Mt. Tennou!\It's a team competition where we need to win three out of five matches,\but our champion's been injured,\and we have no one to take his place.\Please fight for me!\The explanation's so long response:	that you weren't able to take it in, right?
context: we won't make it to nationals!\It's pretty much our Battle of Mt. Tennou!\It's a team competition where we need to win three out of five matches,\but our champion's been injured,\and we have no one to take his place.\Please fight for me!\The explanation's so long\that you weren't able to take it in, right? response:	So I just have to try to win the match happening in a month?
context: It's pretty much our Battle of Mt. Tennou!\It's a team competition where we need to win three out of five matches,\but our champion's been injured,\and we have no one to take his place.\Please fight for me!\The explanation's so long\that you weren't able to take it in, right?\So I just have to try to win the match happening in a month? response:	That's right.
context: It's a team competition where we need to win three out of five matches,\but our champion's been injured,\and we have no one to take his place.\Please fight for me!\The explanation's so long\that you weren't able to take it in, right?\So I just have to try to win the match happening in a month?\That's right. response:	Oh, guess you got the gist of it.
context: but our champion's been injured,\and we have no one to take his place.\Please fight for me!\The explanation's so long\that you weren't able to take it in, right?\So I just have to try to win the match happening in a month?\That's right.\Oh, guess you got the gist of it. response:	Thanks, Gouda!
context: and we have no one to take his place.\Please fight for me!\The explanation's so long\that you weren't able to take it in, right?\So I just have to try to win the match happening in a month?\That's right.\Oh, guess you got the gist of it.\Thanks, Gouda! response:	I'll do it!
context: Please fight for me!\The explanation's so long\that you weren't able to take it in, right?\So I just have to try to win the match happening in a month?\That's right.\Oh, guess you got the gist of it.\Thanks, Gouda!\I'll do it! response:	See you at morning practice tomorrow!
context: The explanation's so long\that you weren't able to take it in, right?\So I just have to try to win the match happening in a month?\That's right.\Oh, guess you got the gist of it.\Thanks, Gouda!\I'll do it!\See you at morning practice tomorrow! response:	Right!
context: that you weren't able to take it in, right?\So I just have to try to win the match happening in a month?\That's right.\Oh, guess you got the gist of it.\Thanks, Gouda!\I'll do it!\See you at morning practice tomorrow!\Right! response:	We're counting on you!
context: So I just have to try to win the match happening in a month?\That's right.\Oh, guess you got the gist of it.\Thanks, Gouda!\I'll do it!\See you at morning practice tomorrow!\Right!\We're counting on you! response:	It's amazing that they'd ask you for help.
context: That's right.\Oh, guess you got the gist of it.\Thanks, Gouda!\I'll do it!\See you at morning practice tomorrow!\Right!\We're counting on you!\It's amazing that they'd ask you for help. response:	I didn't know you did judo, Takeo-kun.
context: Oh, guess you got the gist of it.\Thanks, Gouda!\I'll do it!\See you at morning practice tomorrow!\Right!\We're counting on you!\It's amazing that they'd ask you for help.\I didn't know you did judo, Takeo-kun. response:	Up till the end of junior high.
context: Thanks, Gouda!\I'll do it!\See you at morning practice tomorrow!\Right!\We're counting on you!\It's amazing that they'd ask you for help.\I didn't know you did judo, Takeo-kun.\Up till the end of junior high. response:	You even competed in the nationals.
context: I'll do it!\See you at morning practice tomorrow!\Right!\We're counting on you!\It's amazing that they'd ask you for help.\I didn't know you did judo, Takeo-kun.\Up till the end of junior high.\You even competed in the nationals. response:	Eh? Wow!
context: See you at morning practice tomorrow!\Right!\We're counting on you!\It's amazing that they'd ask you for help.\I didn't know you did judo, Takeo-kun.\Up till the end of junior high.\You even competed in the nationals.\Eh? Wow! response:	That's so cool!
context: Right!\We're counting on you!\It's amazing that they'd ask you for help.\I didn't know you did judo, Takeo-kun.\Up till the end of junior high.\You even competed in the nationals.\Eh? Wow!\That's so cool! response:	Why did you stop in high school?
context: We're counting on you!\It's amazing that they'd ask you for help.\I didn't know you did judo, Takeo-kun.\Up till the end of junior high.\You even competed in the nationals.\Eh? Wow!\That's so cool!\Why did you stop in high school? response:	I forgot to join...
context: It's amazing that they'd ask you for help.\I didn't know you did judo, Takeo-kun.\Up till the end of junior high.\You even competed in the nationals.\Eh? Wow!\That's so cool!\Why did you stop in high school?\I forgot to join... response:	Why bother?
context: I didn't know you did judo, Takeo-kun.\Up till the end of junior high.\You even competed in the nationals.\Eh? Wow!\That's so cool!\Why did you stop in high school?\I forgot to join...\Why bother? response:	You're strong enough.
context: Up till the end of junior high.\You even competed in the nationals.\Eh? Wow!\That's so cool!\Why did you stop in high school?\I forgot to join...\Why bother?\You're strong enough. response:	No, there are many more who are stronger than I!
context: You even competed in the nationals.\Eh? Wow!\That's so cool!\Why did you stop in high school?\I forgot to join...\Why bother?\You're strong enough.\No, there are many more who are stronger than I! response:	I'm sure you'd rank pretty high,
context: Eh? Wow!\That's so cool!\Why did you stop in high school?\I forgot to join...\Why bother?\You're strong enough.\No, there are many more who are stronger than I!\I'm sure you'd rank pretty high, response:	if anyone ranked all humanity in order of their strength.
context: That's so cool!\Why did you stop in high school?\I forgot to join...\Why bother?\You're strong enough.\No, there are many more who are stronger than I!\I'm sure you'd rank pretty high,\if anyone ranked all humanity in order of their strength. response:	I wonder where you'd place...
context: Why did you stop in high school?\I forgot to join...\Why bother?\You're strong enough.\No, there are many more who are stronger than I!\I'm sure you'd rank pretty high,\if anyone ranked all humanity in order of their strength.\I wonder where you'd place... response:	I've got a way to go.
context: I forgot to join...\Why bother?\You're strong enough.\No, there are many more who are stronger than I!\I'm sure you'd rank pretty high,\if anyone ranked all humanity in order of their strength.\I wonder where you'd place...\I've got a way to go. response:	Strongest Primate
context: Why bother?\You're strong enough.\No, there are many more who are stronger than I!\I'm sure you'd rank pretty high,\if anyone ranked all humanity in order of their strength.\I wonder where you'd place...\I've got a way to go.\Strongest Primate response:	After all, there are people like Karelin.
context: You're strong enough.\No, there are many more who are stronger than I!\I'm sure you'd rank pretty high,\if anyone ranked all humanity in order of their strength.\I wonder where you'd place...\I've got a way to go.\Strongest Primate\After all, there are people like Karelin. response:	I see
context: No, there are many more who are stronger than I!\I'm sure you'd rank pretty high,\if anyone ranked all humanity in order of their strength.\I wonder where you'd place...\I've got a way to go.\Strongest Primate\After all, there are people like Karelin.\I see response:	Yup
context: I'm sure you'd rank pretty high,\if anyone ranked all humanity in order of their strength.\I wonder where you'd place...\I've got a way to go.\Strongest Primate\After all, there are people like Karelin.\I see\Yup response:	That's good and all, but...
context: if anyone ranked all humanity in order of their strength.\I wonder where you'd place...\I've got a way to go.\Strongest Primate\After all, there are people like Karelin.\I see\Yup\That's good and all, but... response:	If you're going to train for the match,
context: I wonder where you'd place...\I've got a way to go.\Strongest Primate\After all, there are people like Karelin.\I see\Yup\That's good and all, but...\If you're going to train for the match, response:	doesn't that mean you won't be able to see Yamato-san
context: I've got a way to go.\Strongest Primate\After all, there are people like Karelin.\I see\Yup\That's good and all, but...\If you're going to train for the match,\doesn't that mean you won't be able to see Yamato-san response:	for about a month?
context: Strongest Primate\After all, there are people like Karelin.\I see\Yup\That's good and all, but...\If you're going to train for the match,\doesn't that mean you won't be able to see Yamato-san\for about a month? response:	I see...
context: After all, there are people like Karelin.\I see\Yup\That's good and all, but...\If you're going to train for the match,\doesn't that mean you won't be able to see Yamato-san\for about a month?\I see... response:	I'm sorry, Yamato.
context: I see\Yup\That's good and all, but...\If you're going to train for the match,\doesn't that mean you won't be able to see Yamato-san\for about a month?\I see...\I'm sorry, Yamato. response:	I'll be fine, Takeo-kun!
context: Yup\That's good and all, but...\If you're going to train for the match,\doesn't that mean you won't be able to see Yamato-san\for about a month?\I see...\I'm sorry, Yamato.\I'll be fine, Takeo-kun! response:	Help the judo club.
context: That's good and all, but...\If you're going to train for the match,\doesn't that mean you won't be able to see Yamato-san\for about a month?\I see...\I'm sorry, Yamato.\I'll be fine, Takeo-kun!\Help the judo club. response:	It's great that they'd come to you for help.
context: If you're going to train for the match,\doesn't that mean you won't be able to see Yamato-san\for about a month?\I see...\I'm sorry, Yamato.\I'll be fine, Takeo-kun!\Help the judo club.\It's great that they'd come to you for help. response:	Yamato...
context: doesn't that mean you won't be able to see Yamato-san\for about a month?\I see...\I'm sorry, Yamato.\I'll be fine, Takeo-kun!\Help the judo club.\It's great that they'd come to you for help.\Yamato... response:	Besides, I want to see you do judo.
context: for about a month?\I see...\I'm sorry, Yamato.\I'll be fine, Takeo-kun!\Help the judo club.\It's great that they'd come to you for help.\Yamato...\Besides, I want to see you do judo. response:	I love her!
context: I see...\I'm sorry, Yamato.\I'll be fine, Takeo-kun!\Help the judo club.\It's great that they'd come to you for help.\Yamato...\Besides, I want to see you do judo.\I love her! response:	If you really want to see me,
context: I'm sorry, Yamato.\I'll be fine, Takeo-kun!\Help the judo club.\It's great that they'd come to you for help.\Yamato...\Besides, I want to see you do judo.\I love her!\If you really want to see me, response:	just say the word.
context: I'll be fine, Takeo-kun!\Help the judo club.\It's great that they'd come to you for help.\Yamato...\Besides, I want to see you do judo.\I love her!\If you really want to see me,\just say the word. response:	I'll come right away.
context: Help the judo club.\It's great that they'd come to you for help.\Yamato...\Besides, I want to see you do judo.\I love her!\If you really want to see me,\just say the word.\I'll come right away. response:	You will?
context: It's great that they'd come to you for help.\Yamato...\Besides, I want to see you do judo.\I love her!\If you really want to see me,\just say the word.\I'll come right away.\You will? response:	Okay!
context: Yamato...\Besides, I want to see you do judo.\I love her!\If you really want to see me,\just say the word.\I'll come right away.\You will?\Okay! response:	I'll be cheering you on, so I'll be fine.
context: Besides, I want to see you do judo.\I love her!\If you really want to see me,\just say the word.\I'll come right away.\You will?\Okay!\I'll be cheering you on, so I'll be fine. response:	Good luck, Takeo-kun!
context: I love her!\If you really want to see me,\just say the word.\I'll come right away.\You will?\Okay!\I'll be cheering you on, so I'll be fine.\Good luck, Takeo-kun! response:	Yamato,
context: If you really want to see me,\just say the word.\I'll come right away.\You will?\Okay!\I'll be cheering you on, so I'll be fine.\Good luck, Takeo-kun!\Yamato, response:	I know you're looking out for me!
context: just say the word.\I'll come right away.\You will?\Okay!\I'll be cheering you on, so I'll be fine.\Good luck, Takeo-kun!\Yamato,\I know you're looking out for me! response:	Begin!
context: I'll come right away.\You will?\Okay!\I'll be cheering you on, so I'll be fine.\Good luck, Takeo-kun!\Yamato,\I know you're looking out for me!\Begin! response:	Okay! I'm next!
context: You will?\Okay!\I'll be cheering you on, so I'll be fine.\Good luck, Takeo-kun!\Yamato,\I know you're looking out for me!\Begin!\Okay! I'm next! response:	'Kay!
context: Okay!\I'll be cheering you on, so I'll be fine.\Good luck, Takeo-kun!\Yamato,\I know you're looking out for me!\Begin!\Okay! I'm next!\'Kay! response:	I've...
context: I'll be cheering you on, so I'll be fine.\Good luck, Takeo-kun!\Yamato,\I know you're looking out for me!\Begin!\Okay! I'm next!\'Kay!\I've... response:	got this...
context: Good luck, Takeo-kun!\Yamato,\I know you're looking out for me!\Begin!\Okay! I'm next!\'Kay!\I've...\got this... response:	Yamato!
context: Yamato,\I know you're looking out for me!\Begin!\Okay! I'm next!\'Kay!\I've...\got this...\Yamato! response:	Gouda...
context: I know you're looking out for me!\Begin!\Okay! I'm next!\'Kay!\I've...\got this...\Yamato!\Gouda... response:	All for us...
context: Begin!\Okay! I'm next!\'Kay!\I've...\got this...\Yamato!\Gouda...\All for us... response:	C'mon, guys!
context: Okay! I'm next!\'Kay!\I've...\got this...\Yamato!\Gouda...\All for us...\C'mon, guys! response:	Right!
context: 'Kay!\I've...\got this...\Yamato!\Gouda...\All for us...\C'mon, guys!\Right! response:	Thank you!
context: I've...\got this...\Yamato!\Gouda...\All for us...\C'mon, guys!\Right!\Thank you! response:	Yamato!
context: got this...\Yamato!\Gouda...\All for us...\C'mon, guys!\Right!\Thank you!\Yamato! response:	Oh, Takeo-kun!
context: Yamato!\Gouda...\All for us...\C'mon, guys!\Right!\Thank you!\Yamato!\Oh, Takeo-kun! response:	Good job!
context: Gouda...\All for us...\C'mon, guys!\Right!\Thank you!\Yamato!\Oh, Takeo-kun!\Good job! response:	Sorry I came without telling you.
context: All for us...\C'mon, guys!\Right!\Thank you!\Yamato!\Oh, Takeo-kun!\Good job!\Sorry I came without telling you. response:	Something's in your hair.
context: C'mon, guys!\Right!\Thank you!\Yamato!\Oh, Takeo-kun!\Good job!\Sorry I came without telling you.\Something's in your hair. response:	Oh.
context: Right!\Thank you!\Yamato!\Oh, Takeo-kun!\Good job!\Sorry I came without telling you.\Something's in your hair.\Oh. response:	Earlier...
context: Thank you!\Yamato!\Oh, Takeo-kun!\Good job!\Sorry I came without telling you.\Something's in your hair.\Oh.\Earlier... response:	I thought about keeping it a secret,
context: Yamato!\Oh, Takeo-kun!\Good job!\Sorry I came without telling you.\Something's in your hair.\Oh.\Earlier...\I thought about keeping it a secret, response:	but I peeked into your practice session.
context: Oh, Takeo-kun!\Good job!\Sorry I came without telling you.\Something's in your hair.\Oh.\Earlier...\I thought about keeping it a secret,\but I peeked into your practice session. response:	You were so cool!
context: Good job!\Sorry I came without telling you.\Something's in your hair.\Oh.\Earlier...\I thought about keeping it a secret,\but I peeked into your practice session.\You were so cool! response:	Yamato...
context: Sorry I came without telling you.\Something's in your hair.\Oh.\Earlier...\I thought about keeping it a secret,\but I peeked into your practice session.\You were so cool!\Yamato... response:	Oh, here. I made this for you.
context: Something's in your hair.\Oh.\Earlier...\I thought about keeping it a secret,\but I peeked into your practice session.\You were so cool!\Yamato...\Oh, here. I made this for you. response:	They're rice balls.
context: Oh.\Earlier...\I thought about keeping it a secret,\but I peeked into your practice session.\You were so cool!\Yamato...\Oh, here. I made this for you.\They're rice balls. response:	I can make other things, see?
context: Earlier...\I thought about keeping it a secret,\but I peeked into your practice session.\You were so cool!\Yamato...\Oh, here. I made this for you.\They're rice balls.\I can make other things, see? response:	Yamato...
context: I thought about keeping it a secret,\but I peeked into your practice session.\You were so cool!\Yamato...\Oh, here. I made this for you.\They're rice balls.\I can make other things, see?\Yamato... response:	I got a little too into it this morning and made a ton.
context: but I peeked into your practice session.\You were so cool!\Yamato...\Oh, here. I made this for you.\They're rice balls.\I can make other things, see?\Yamato...\I got a little too into it this morning and made a ton. response:	I might have made too much.
context: You were so cool!\Yamato...\Oh, here. I made this for you.\They're rice balls.\I can make other things, see?\Yamato...\I got a little too into it this morning and made a ton.\I might have made too much. response:	Beware of Gropers
context: Yamato...\Oh, here. I made this for you.\They're rice balls.\I can make other things, see?\Yamato...\I got a little too into it this morning and made a ton.\I might have made too much.\Beware of Gropers response:	Takeo-kun?
context: Oh, here. I made this for you.\They're rice balls.\I can make other things, see?\Yamato...\I got a little too into it this morning and made a ton.\I might have made too much.\Beware of Gropers\Takeo-kun? response:	Thank you, Yamato.
context: They're rice balls.\I can make other things, see?\Yamato...\I got a little too into it this morning and made a ton.\I might have made too much.\Beware of Gropers\Takeo-kun?\Thank you, Yamato. response:	But you shouldn't come here again.
context: I can make other things, see?\Yamato...\I got a little too into it this morning and made a ton.\I might have made too much.\Beware of Gropers\Takeo-kun?\Thank you, Yamato.\But you shouldn't come here again. response:	Eh?
context: Yamato...\I got a little too into it this morning and made a ton.\I might have made too much.\Beware of Gropers\Takeo-kun?\Thank you, Yamato.\But you shouldn't come here again.\Eh? response:	Let's go.
context: I got a little too into it this morning and made a ton.\I might have made too much.\Beware of Gropers\Takeo-kun?\Thank you, Yamato.\But you shouldn't come here again.\Eh?\Let's go. response:	I'll walk you home.
context: I might have made too much.\Beware of Gropers\Takeo-kun?\Thank you, Yamato.\But you shouldn't come here again.\Eh?\Let's go.\I'll walk you home. response:	Oh, okay...
context: Beware of Gropers\Takeo-kun?\Thank you, Yamato.\But you shouldn't come here again.\Eh?\Let's go.\I'll walk you home.\Oh, okay... response:	It's dark and unsafe.
context: Takeo-kun?\Thank you, Yamato.\But you shouldn't come here again.\Eh?\Let's go.\I'll walk you home.\Oh, okay...\It's dark and unsafe. response:	If anything were to happen to Yamato,
context: Thank you, Yamato.\But you shouldn't come here again.\Eh?\Let's go.\I'll walk you home.\Oh, okay...\It's dark and unsafe.\If anything were to happen to Yamato, response:	I'd never forgive myself.
context: But you shouldn't come here again.\Eh?\Let's go.\I'll walk you home.\Oh, okay...\It's dark and unsafe.\If anything were to happen to Yamato,\I'd never forgive myself. response:	Thanks for the food!
context: Eh?\Let's go.\I'll walk you home.\Oh, okay...\It's dark and unsafe.\If anything were to happen to Yamato,\I'd never forgive myself.\Thanks for the food! response:	This is salmon.
context: Let's go.\I'll walk you home.\Oh, okay...\It's dark and unsafe.\If anything were to happen to Yamato,\I'd never forgive myself.\Thanks for the food!\This is salmon. response:	This one's pickled plum.
context: I'll walk you home.\Oh, okay...\It's dark and unsafe.\If anything were to happen to Yamato,\I'd never forgive myself.\Thanks for the food!\This is salmon.\This one's pickled plum. response:	Cod roe.
context: Oh, okay...\It's dark and unsafe.\If anything were to happen to Yamato,\I'd never forgive myself.\Thanks for the food!\This is salmon.\This one's pickled plum.\Cod roe. response:	Salmon roe.
context: It's dark and unsafe.\If anything were to happen to Yamato,\I'd never forgive myself.\Thanks for the food!\This is salmon.\This one's pickled plum.\Cod roe.\Salmon roe. response:	BBQ beef.
context: If anything were to happen to Yamato,\I'd never forgive myself.\Thanks for the food!\This is salmon.\This one's pickled plum.\Cod roe.\Salmon roe.\BBQ beef. response:	Tuna with mayo!
context: I'd never forgive myself.\Thanks for the food!\This is salmon.\This one's pickled plum.\Cod roe.\Salmon roe.\BBQ beef.\Tuna with mayo! response:	She made all these different kinds
context: Thanks for the food!\This is salmon.\This one's pickled plum.\Cod roe.\Salmon roe.\BBQ beef.\Tuna with mayo!\She made all these different kinds response:	with those tiny hands of hers.
context: This is salmon.\This one's pickled plum.\Cod roe.\Salmon roe.\BBQ beef.\Tuna with mayo!\She made all these different kinds\with those tiny hands of hers. response:	The rice must've been piping hot, too.
context: This one's pickled plum.\Cod roe.\Salmon roe.\BBQ beef.\Tuna with mayo!\She made all these different kinds\with those tiny hands of hers.\The rice must've been piping hot, too. response:	They're delicious.
context: Cod roe.\Salmon roe.\BBQ beef.\Tuna with mayo!\She made all these different kinds\with those tiny hands of hers.\The rice must've been piping hot, too.\They're delicious. response:	They're delicious, Yamato!
context: Salmon roe.\BBQ beef.\Tuna with mayo!\She made all these different kinds\with those tiny hands of hers.\The rice must've been piping hot, too.\They're delicious.\They're delicious, Yamato! response:	I love her!
context: BBQ beef.\Tuna with mayo!\She made all these different kinds\with those tiny hands of hers.\The rice must've been piping hot, too.\They're delicious.\They're delicious, Yamato!\I love her! response:	The rice balls are awesome!
context: Tuna with mayo!\She made all these different kinds\with those tiny hands of hers.\The rice must've been piping hot, too.\They're delicious.\They're delicious, Yamato!\I love her!\The rice balls are awesome! response:	Thank you.
context: She made all these different kinds\with those tiny hands of hers.\The rice must've been piping hot, too.\They're delicious.\They're delicious, Yamato!\I love her!\The rice balls are awesome!\Thank you. response:	Thanks for the food.
context: with those tiny hands of hers.\The rice must've been piping hot, too.\They're delicious.\They're delicious, Yamato!\I love her!\The rice balls are awesome!\Thank you.\Thanks for the food. response:	Great!
context: The rice must've been piping hot, too.\They're delicious.\They're delicious, Yamato!\I love her!\The rice balls are awesome!\Thank you.\Thanks for the food.\Great! response:	I thought you might get hungry.
context: They're delicious.\They're delicious, Yamato!\I love her!\The rice balls are awesome!\Thank you.\Thanks for the food.\Great!\I thought you might get hungry. response:	Eat up and good luck!
context: They're delicious, Yamato!\I love her!\The rice balls are awesome!\Thank you.\Thanks for the food.\Great!\I thought you might get hungry.\Eat up and good luck! response:	I'm gonna give it everything I've got!
context: I love her!\The rice balls are awesome!\Thank you.\Thanks for the food.\Great!\I thought you might get hungry.\Eat up and good luck!\I'm gonna give it everything I've got! response:	Takeo-kun, how's it going?
context: The rice balls are awesome!\Thank you.\Thanks for the food.\Great!\I thought you might get hungry.\Eat up and good luck!\I'm gonna give it everything I've got!\Takeo-kun, how's it going? response:	Today, there are lots of flowers blooming at school.
context: Thank you.\Thanks for the food.\Great!\I thought you might get hungry.\Eat up and good luck!\I'm gonna give it everything I've got!\Takeo-kun, how's it going?\Today, there are lots of flowers blooming at school. response:	I only know the name of flowers like tulips and stuff,
context: Thanks for the food.\Great!\I thought you might get hungry.\Eat up and good luck!\I'm gonna give it everything I've got!\Takeo-kun, how's it going?\Today, there are lots of flowers blooming at school.\I only know the name of flowers like tulips and stuff, response:	but I'd like to go with you to a botanical garden sometime.
context: Great!\I thought you might get hungry.\Eat up and good luck!\I'm gonna give it everything I've got!\Takeo-kun, how's it going?\Today, there are lots of flowers blooming at school.\I only know the name of flowers like tulips and stuff,\but I'd like to go with you to a botanical garden sometime. response:	Let's do that!!
context: I thought you might get hungry.\Eat up and good luck!\I'm gonna give it everything I've got!\Takeo-kun, how's it going?\Today, there are lots of flowers blooming at school.\I only know the name of flowers like tulips and stuff,\but I'd like to go with you to a botanical garden sometime.\Let's do that!! response:	Take, you're perfect for this.
context: Eat up and good luck!\I'm gonna give it everything I've got!\Takeo-kun, how's it going?\Today, there are lots of flowers blooming at school.\I only know the name of flowers like tulips and stuff,\but I'd like to go with you to a botanical garden sometime.\Let's do that!!\Take, you're perfect for this. response:	I can't see any stars today.
context: I'm gonna give it everything I've got!\Takeo-kun, how's it going?\Today, there are lots of flowers blooming at school.\I only know the name of flowers like tulips and stuff,\but I'd like to go with you to a botanical garden sometime.\Let's do that!!\Take, you're perfect for this.\I can't see any stars today. response:	I wonder if it's going to rain tomorrow.
context: Takeo-kun, how's it going?\Today, there are lots of flowers blooming at school.\I only know the name of flowers like tulips and stuff,\but I'd like to go with you to a botanical garden sometime.\Let's do that!!\Take, you're perfect for this.\I can't see any stars today.\I wonder if it's going to rain tomorrow. response:	Takeo-kun, don't forget to take an umbrella.
context: Today, there are lots of flowers blooming at school.\I only know the name of flowers like tulips and stuff,\but I'd like to go with you to a botanical garden sometime.\Let's do that!!\Take, you're perfect for this.\I can't see any stars today.\I wonder if it's going to rain tomorrow.\Takeo-kun, don't forget to take an umbrella. response:	What kind of umbrella do you have?
context: I only know the name of flowers like tulips and stuff,\but I'd like to go with you to a botanical garden sometime.\Let's do that!!\Take, you're perfect for this.\I can't see any stars today.\I wonder if it's going to rain tomorrow.\Takeo-kun, don't forget to take an umbrella.\What kind of umbrella do you have? response:	It's black and huge.
context: but I'd like to go with you to a botanical garden sometime.\Let's do that!!\Take, you're perfect for this.\I can't see any stars today.\I wonder if it's going to rain tomorrow.\Takeo-kun, don't forget to take an umbrella.\What kind of umbrella do you have?\It's black and huge. response:	Hey, that's a beach umbrella, isn't it?
context: Let's do that!!\Take, you're perfect for this.\I can't see any stars today.\I wonder if it's going to rain tomorrow.\Takeo-kun, don't forget to take an umbrella.\What kind of umbrella do you have?\It's black and huge.\Hey, that's a beach umbrella, isn't it? response:	I've always wondered about that.
context: Take, you're perfect for this.\I can't see any stars today.\I wonder if it's going to rain tomorrow.\Takeo-kun, don't forget to take an umbrella.\What kind of umbrella do you have?\It's black and huge.\Hey, that's a beach umbrella, isn't it?\I've always wondered about that. response:	Takeo-kun, don't get hurt, okay?
context: I can't see any stars today.\I wonder if it's going to rain tomorrow.\Takeo-kun, don't forget to take an umbrella.\What kind of umbrella do you have?\It's black and huge.\Hey, that's a beach umbrella, isn't it?\I've always wondered about that.\Takeo-kun, don't get hurt, okay? response:	I'm going to make a wish right now.
context: I wonder if it's going to rain tomorrow.\Takeo-kun, don't forget to take an umbrella.\What kind of umbrella do you have?\It's black and huge.\Hey, that's a beach umbrella, isn't it?\I've always wondered about that.\Takeo-kun, don't get hurt, okay?\I'm going to make a wish right now. response:	Don't get hurt! Don't get hurt!
context: Takeo-kun, don't forget to take an umbrella.\What kind of umbrella do you have?\It's black and huge.\Hey, that's a beach umbrella, isn't it?\I've always wondered about that.\Takeo-kun, don't get hurt, okay?\I'm going to make a wish right now.\Don't get hurt! Don't get hurt! response:	I can feel the good vibes!
context: What kind of umbrella do you have?\It's black and huge.\Hey, that's a beach umbrella, isn't it?\I've always wondered about that.\Takeo-kun, don't get hurt, okay?\I'm going to make a wish right now.\Don't get hurt! Don't get hurt!\I can feel the good vibes! response:	Thanks!
context: It's black and huge.\Hey, that's a beach umbrella, isn't it?\I've always wondered about that.\Takeo-kun, don't get hurt, okay?\I'm going to make a wish right now.\Don't get hurt! Don't get hurt!\I can feel the good vibes!\Thanks! response:	Good luck, Takeo-kun!
context: Hey, that's a beach umbrella, isn't it?\I've always wondered about that.\Takeo-kun, don't get hurt, okay?\I'm going to make a wish right now.\Don't get hurt! Don't get hurt!\I can feel the good vibes!\Thanks!\Good luck, Takeo-kun! response:	I'm cheering you on 24/7.
context: I've always wondered about that.\Takeo-kun, don't get hurt, okay?\I'm going to make a wish right now.\Don't get hurt! Don't get hurt!\I can feel the good vibes!\Thanks!\Good luck, Takeo-kun!\I'm cheering you on 24/7. response:	Thanks!
context: Takeo-kun, don't get hurt, okay?\I'm going to make a wish right now.\Don't get hurt! Don't get hurt!\I can feel the good vibes!\Thanks!\Good luck, Takeo-kun!\I'm cheering you on 24/7.\Thanks! response:	What's all that?
context: I'm going to make a wish right now.\Don't get hurt! Don't get hurt!\I can feel the good vibes!\Thanks!\Good luck, Takeo-kun!\I'm cheering you on 24/7.\Thanks!\What's all that? response:	What is it?
context: Don't get hurt! Don't get hurt!\I can feel the good vibes!\Thanks!\Good luck, Takeo-kun!\I'm cheering you on 24/7.\Thanks!\What's all that?\What is it? response:	They're scones.
context: I can feel the good vibes!\Thanks!\Good luck, Takeo-kun!\I'm cheering you on 24/7.\Thanks!\What's all that?\What is it?\They're scones. response:	I found myself baking a ton when I was thinking about Takeo-kun.
context: Thanks!\Good luck, Takeo-kun!\I'm cheering you on 24/7.\Thanks!\What's all that?\What is it?\They're scones.\I found myself baking a ton when I was thinking about Takeo-kun. response:	That's a bit scary...
context: Good luck, Takeo-kun!\I'm cheering you on 24/7.\Thanks!\What's all that?\What is it?\They're scones.\I found myself baking a ton when I was thinking about Takeo-kun.\That's a bit scary... response:	Please have some, too, Sunakawa-kun.
context: I'm cheering you on 24/7.\Thanks!\What's all that?\What is it?\They're scones.\I found myself baking a ton when I was thinking about Takeo-kun.\That's a bit scary...\Please have some, too, Sunakawa-kun. response:	Oh, sorry, I guess it might feel like leftovers.
context: Thanks!\What's all that?\What is it?\They're scones.\I found myself baking a ton when I was thinking about Takeo-kun.\That's a bit scary...\Please have some, too, Sunakawa-kun.\Oh, sorry, I guess it might feel like leftovers. response:	I mean, they are, but...
context: What's all that?\What is it?\They're scones.\I found myself baking a ton when I was thinking about Takeo-kun.\That's a bit scary...\Please have some, too, Sunakawa-kun.\Oh, sorry, I guess it might feel like leftovers.\I mean, they are, but... response:	Well, why not just give them to Takeo?
context: What is it?\They're scones.\I found myself baking a ton when I was thinking about Takeo-kun.\That's a bit scary...\Please have some, too, Sunakawa-kun.\Oh, sorry, I guess it might feel like leftovers.\I mean, they are, but...\Well, why not just give them to Takeo? response:	He wouldn't have a problem eating them all, would he?
context: They're scones.\I found myself baking a ton when I was thinking about Takeo-kun.\That's a bit scary...\Please have some, too, Sunakawa-kun.\Oh, sorry, I guess it might feel like leftovers.\I mean, they are, but...\Well, why not just give them to Takeo?\He wouldn't have a problem eating them all, would he? response:	I don't know if Takeo-kun likes me anymore.
context: I found myself baking a ton when I was thinking about Takeo-kun.\That's a bit scary...\Please have some, too, Sunakawa-kun.\Oh, sorry, I guess it might feel like leftovers.\I mean, they are, but...\Well, why not just give them to Takeo?\He wouldn't have a problem eating them all, would he?\I don't know if Takeo-kun likes me anymore. response:	No way
context: That's a bit scary...\Please have some, too, Sunakawa-kun.\Oh, sorry, I guess it might feel like leftovers.\I mean, they are, but...\Well, why not just give them to Takeo?\He wouldn't have a problem eating them all, would he?\I don't know if Takeo-kun likes me anymore.\No way response:	No way.
context: Please have some, too, Sunakawa-kun.\Oh, sorry, I guess it might feel like leftovers.\I mean, they are, but...\Well, why not just give them to Takeo?\He wouldn't have a problem eating them all, would he?\I don't know if Takeo-kun likes me anymore.\No way\No way. response:	But he told me not to come.
context: Oh, sorry, I guess it might feel like leftovers.\I mean, they are, but...\Well, why not just give them to Takeo?\He wouldn't have a problem eating them all, would he?\I don't know if Takeo-kun likes me anymore.\No way\No way.\But he told me not to come. response:	It might be because I got ahead of myself and showed up with food!
context: I mean, they are, but...\Well, why not just give them to Takeo?\He wouldn't have a problem eating them all, would he?\I don't know if Takeo-kun likes me anymore.\No way\No way.\But he told me not to come.\It might be because I got ahead of myself and showed up with food! response:	Maybe it crossed a line...
context: Well, why not just give them to Takeo?\He wouldn't have a problem eating them all, would he?\I don't know if Takeo-kun likes me anymore.\No way\No way.\But he told me not to come.\It might be because I got ahead of myself and showed up with food!\Maybe it crossed a line... response:	No, I think it's just a misunderstanding or you're overthinking it.
context: He wouldn't have a problem eating them all, would he?\I don't know if Takeo-kun likes me anymore.\No way\No way.\But he told me not to come.\It might be because I got ahead of myself and showed up with food!\Maybe it crossed a line...\No, I think it's just a misunderstanding or you're overthinking it. response:	He totally isn't the type of guy to get mad about stuff like that.
context: I don't know if Takeo-kun likes me anymore.\No way\No way.\But he told me not to come.\It might be because I got ahead of myself and showed up with food!\Maybe it crossed a line...\No, I think it's just a misunderstanding or you're overthinking it.\He totally isn't the type of guy to get mad about stuff like that. response:	Right...
context: No way\No way.\But he told me not to come.\It might be because I got ahead of myself and showed up with food!\Maybe it crossed a line...\No, I think it's just a misunderstanding or you're overthinking it.\He totally isn't the type of guy to get mad about stuff like that.\Right... response:	You're right.
context: No way.\But he told me not to come.\It might be because I got ahead of myself and showed up with food!\Maybe it crossed a line...\No, I think it's just a misunderstanding or you're overthinking it.\He totally isn't the type of guy to get mad about stuff like that.\Right...\You're right. response:	Takeo-kun's not like that, yeah.
context: But he told me not to come.\It might be because I got ahead of myself and showed up with food!\Maybe it crossed a line...\No, I think it's just a misunderstanding or you're overthinking it.\He totally isn't the type of guy to get mad about stuff like that.\Right...\You're right.\Takeo-kun's not like that, yeah. response:	Yeah, yeah
context: It might be because I got ahead of myself and showed up with food!\Maybe it crossed a line...\No, I think it's just a misunderstanding or you're overthinking it.\He totally isn't the type of guy to get mad about stuff like that.\Right...\You're right.\Takeo-kun's not like that, yeah.\Yeah, yeah response:	Now that I'm calmer about it, I see it now.
context: Maybe it crossed a line...\No, I think it's just a misunderstanding or you're overthinking it.\He totally isn't the type of guy to get mad about stuff like that.\Right...\You're right.\Takeo-kun's not like that, yeah.\Yeah, yeah\Now that I'm calmer about it, I see it now. response:	Right?
context: No, I think it's just a misunderstanding or you're overthinking it.\He totally isn't the type of guy to get mad about stuff like that.\Right...\You're right.\Takeo-kun's not like that, yeah.\Yeah, yeah\Now that I'm calmer about it, I see it now.\Right? response:	Thanks, Sunakawa-kun.
context: He totally isn't the type of guy to get mad about stuff like that.\Right...\You're right.\Takeo-kun's not like that, yeah.\Yeah, yeah\Now that I'm calmer about it, I see it now.\Right?\Thanks, Sunakawa-kun. response:	I don't think you have to work yourself up over this.
context: Right...\You're right.\Takeo-kun's not like that, yeah.\Yeah, yeah\Now that I'm calmer about it, I see it now.\Right?\Thanks, Sunakawa-kun.\I don't think you have to work yourself up over this. response:	It's the first time I've fallen for anyone.
context: You're right.\Takeo-kun's not like that, yeah.\Yeah, yeah\Now that I'm calmer about it, I see it now.\Right?\Thanks, Sunakawa-kun.\I don't think you have to work yourself up over this.\It's the first time I've fallen for anyone. response:	Meeting Takeo-kun was the first time
context: Takeo-kun's not like that, yeah.\Yeah, yeah\Now that I'm calmer about it, I see it now.\Right?\Thanks, Sunakawa-kun.\I don't think you have to work yourself up over this.\It's the first time I've fallen for anyone.\Meeting Takeo-kun was the first time response:	that I felt this rush coming up from the bottom of my heart, you know?
context: Yeah, yeah\Now that I'm calmer about it, I see it now.\Right?\Thanks, Sunakawa-kun.\I don't think you have to work yourself up over this.\It's the first time I've fallen for anyone.\Meeting Takeo-kun was the first time\that I felt this rush coming up from the bottom of my heart, you know? response:	That's when I realized it's what love's like.
context: Now that I'm calmer about it, I see it now.\Right?\Thanks, Sunakawa-kun.\I don't think you have to work yourself up over this.\It's the first time I've fallen for anyone.\Meeting Takeo-kun was the first time\that I felt this rush coming up from the bottom of my heart, you know?\That's when I realized it's what love's like. response:	Every day, I'm excited about him and can't stop smiling.
context: Right?\Thanks, Sunakawa-kun.\I don't think you have to work yourself up over this.\It's the first time I've fallen for anyone.\Meeting Takeo-kun was the first time\that I felt this rush coming up from the bottom of my heart, you know?\That's when I realized it's what love's like.\Every day, I'm excited about him and can't stop smiling. response:	Every time I see him, I know I love him.
context: Thanks, Sunakawa-kun.\I don't think you have to work yourself up over this.\It's the first time I've fallen for anyone.\Meeting Takeo-kun was the first time\that I felt this rush coming up from the bottom of my heart, you know?\That's when I realized it's what love's like.\Every day, I'm excited about him and can't stop smiling.\Every time I see him, I know I love him. response:	Oh, Takeo was my first friend, too.
context: I don't think you have to work yourself up over this.\It's the first time I've fallen for anyone.\Meeting Takeo-kun was the first time\that I felt this rush coming up from the bottom of my heart, you know?\That's when I realized it's what love's like.\Every day, I'm excited about him and can't stop smiling.\Every time I see him, I know I love him.\Oh, Takeo was my first friend, too. response:	Wow, we're the same
context: It's the first time I've fallen for anyone.\Meeting Takeo-kun was the first time\that I felt this rush coming up from the bottom of my heart, you know?\That's when I realized it's what love's like.\Every day, I'm excited about him and can't stop smiling.\Every time I see him, I know I love him.\Oh, Takeo was my first friend, too.\Wow, we're the same response:	Having him as your first is pretty intense, huh?
context: Meeting Takeo-kun was the first time\that I felt this rush coming up from the bottom of my heart, you know?\That's when I realized it's what love's like.\Every day, I'm excited about him and can't stop smiling.\Every time I see him, I know I love him.\Oh, Takeo was my first friend, too.\Wow, we're the same\Having him as your first is pretty intense, huh? response:	I love him so much, I even creep myself out!
context: that I felt this rush coming up from the bottom of my heart, you know?\That's when I realized it's what love's like.\Every day, I'm excited about him and can't stop smiling.\Every time I see him, I know I love him.\Oh, Takeo was my first friend, too.\Wow, we're the same\Having him as your first is pretty intense, huh?\I love him so much, I even creep myself out! response:	I want to calm down already!
context: That's when I realized it's what love's like.\Every day, I'm excited about him and can't stop smiling.\Every time I see him, I know I love him.\Oh, Takeo was my first friend, too.\Wow, we're the same\Having him as your first is pretty intense, huh?\I love him so much, I even creep myself out!\I want to calm down already! response:	I wonder if it'll ever calm down...
context: Every day, I'm excited about him and can't stop smiling.\Every time I see him, I know I love him.\Oh, Takeo was my first friend, too.\Wow, we're the same\Having him as your first is pretty intense, huh?\I love him so much, I even creep myself out!\I want to calm down already!\I wonder if it'll ever calm down... response:	I've been friends with him for over a decade,
context: Every time I see him, I know I love him.\Oh, Takeo was my first friend, too.\Wow, we're the same\Having him as your first is pretty intense, huh?\I love him so much, I even creep myself out!\I want to calm down already!\I wonder if it'll ever calm down...\I've been friends with him for over a decade, response:	but he hasn't bored me yet.
context: Oh, Takeo was my first friend, too.\Wow, we're the same\Having him as your first is pretty intense, huh?\I love him so much, I even creep myself out!\I want to calm down already!\I wonder if it'll ever calm down...\I've been friends with him for over a decade,\but he hasn't bored me yet. response:	Oh, my god... What am I going to do?
context: Wow, we're the same\Having him as your first is pretty intense, huh?\I love him so much, I even creep myself out!\I want to calm down already!\I wonder if it'll ever calm down...\I've been friends with him for over a decade,\but he hasn't bored me yet.\Oh, my god... What am I going to do? response:	Maybe I'll feel nervous for the rest of my life!
context: Having him as your first is pretty intense, huh?\I love him so much, I even creep myself out!\I want to calm down already!\I wonder if it'll ever calm down...\I've been friends with him for over a decade,\but he hasn't bored me yet.\Oh, my god... What am I going to do?\Maybe I'll feel nervous for the rest of my life! response:	Maybe Takeo'd feel that way with you for the rest of his life, too.
context: I love him so much, I even creep myself out!\I want to calm down already!\I wonder if it'll ever calm down...\I've been friends with him for over a decade,\but he hasn't bored me yet.\Oh, my god... What am I going to do?\Maybe I'll feel nervous for the rest of my life!\Maybe Takeo'd feel that way with you for the rest of his life, too. response:	Gouda!!
context: I want to calm down already!\I wonder if it'll ever calm down...\I've been friends with him for over a decade,\but he hasn't bored me yet.\Oh, my god... What am I going to do?\Maybe I'll feel nervous for the rest of my life!\Maybe Takeo'd feel that way with you for the rest of his life, too.\Gouda!! response:	I really want to see him.
context: I wonder if it'll ever calm down...\I've been friends with him for over a decade,\but he hasn't bored me yet.\Oh, my god... What am I going to do?\Maybe I'll feel nervous for the rest of my life!\Maybe Takeo'd feel that way with you for the rest of his life, too.\Gouda!!\I really want to see him. response:	Why don't you wait for him?
context: I've been friends with him for over a decade,\but he hasn't bored me yet.\Oh, my god... What am I going to do?\Maybe I'll feel nervous for the rest of my life!\Maybe Takeo'd feel that way with you for the rest of his life, too.\Gouda!!\I really want to see him.\Why don't you wait for him? response:	No, seeing him will only make me want to see him more often.
context: but he hasn't bored me yet.\Oh, my god... What am I going to do?\Maybe I'll feel nervous for the rest of my life!\Maybe Takeo'd feel that way with you for the rest of his life, too.\Gouda!!\I really want to see him.\Why don't you wait for him?\No, seeing him will only make me want to see him more often. response:	I'll just have to hold back!
context: Oh, my god... What am I going to do?\Maybe I'll feel nervous for the rest of my life!\Maybe Takeo'd feel that way with you for the rest of his life, too.\Gouda!!\I really want to see him.\Why don't you wait for him?\No, seeing him will only make me want to see him more often.\I'll just have to hold back! response:	I don't want to get in his way!
context: Maybe I'll feel nervous for the rest of my life!\Maybe Takeo'd feel that way with you for the rest of his life, too.\Gouda!!\I really want to see him.\Why don't you wait for him?\No, seeing him will only make me want to see him more often.\I'll just have to hold back!\I don't want to get in his way! response:	I don't think he's the type to think that way, but okay.
context: Maybe Takeo'd feel that way with you for the rest of his life, too.\Gouda!!\I really want to see him.\Why don't you wait for him?\No, seeing him will only make me want to see him more often.\I'll just have to hold back!\I don't want to get in his way!\I don't think he's the type to think that way, but okay. response:	When he was training, Takeo-kun was so cool.
context: Gouda!!\I really want to see him.\Why don't you wait for him?\No, seeing him will only make me want to see him more often.\I'll just have to hold back!\I don't want to get in his way!\I don't think he's the type to think that way, but okay.\When he was training, Takeo-kun was so cool. response:	He'll be even cooler at the actual match.
context: I really want to see him.\Why don't you wait for him?\No, seeing him will only make me want to see him more often.\I'll just have to hold back!\I don't want to get in his way!\I don't think he's the type to think that way, but okay.\When he was training, Takeo-kun was so cool.\He'll be even cooler at the actual match. response:	I've seen him at a match
context: Why don't you wait for him?\No, seeing him will only make me want to see him more often.\I'll just have to hold back!\I don't want to get in his way!\I don't think he's the type to think that way, but okay.\When he was training, Takeo-kun was so cool.\He'll be even cooler at the actual match.\I've seen him at a match response:	Huh?
context: No, seeing him will only make me want to see him more often.\I'll just have to hold back!\I don't want to get in his way!\I don't think he's the type to think that way, but okay.\When he was training, Takeo-kun was so cool.\He'll be even cooler at the actual match.\I've seen him at a match\Huh? response:	More than he already is?
context: I'll just have to hold back!\I don't want to get in his way!\I don't think he's the type to think that way, but okay.\When he was training, Takeo-kun was so cool.\He'll be even cooler at the actual match.\I've seen him at a match\Huh?\More than he already is? response:	He's like a ball of concentration.
context: I don't want to get in his way!\I don't think he's the type to think that way, but okay.\When he was training, Takeo-kun was so cool.\He'll be even cooler at the actual match.\I've seen him at a match\Huh?\More than he already is?\He's like a ball of concentration. response:	He's the type that never misses a penalty kick
context: I don't think he's the type to think that way, but okay.\When he was training, Takeo-kun was so cool.\He'll be even cooler at the actual match.\I've seen him at a match\Huh?\More than he already is?\He's like a ball of concentration.\He's the type that never misses a penalty kick response:	Wow!
context: When he was training, Takeo-kun was so cool.\He'll be even cooler at the actual match.\I've seen him at a match\Huh?\More than he already is?\He's like a ball of concentration.\He's the type that never misses a penalty kick\Wow! response:	That'd be incredible!
context: He'll be even cooler at the actual match.\I've seen him at a match\Huh?\More than he already is?\He's like a ball of concentration.\He's the type that never misses a penalty kick\Wow!\That'd be incredible! response:	I wonder if I'll be okay!
context: I've seen him at a match\Huh?\More than he already is?\He's like a ball of concentration.\He's the type that never misses a penalty kick\Wow!\That'd be incredible!\I wonder if I'll be okay! response:	Oh!
context: Huh?\More than he already is?\He's like a ball of concentration.\He's the type that never misses a penalty kick\Wow!\That'd be incredible!\I wonder if I'll be okay!\Oh! response:	That star's just like Takeo-kun.
context: More than he already is?\He's like a ball of concentration.\He's the type that never misses a penalty kick\Wow!\That'd be incredible!\I wonder if I'll be okay!\Oh!\That star's just like Takeo-kun. response:	Huh?
context: He's like a ball of concentration.\He's the type that never misses a penalty kick\Wow!\That'd be incredible!\I wonder if I'll be okay!\Oh!\That star's just like Takeo-kun.\Huh? response:	Look... If you draw a line between that star and the other star,
context: He's the type that never misses a penalty kick\Wow!\That'd be incredible!\I wonder if I'll be okay!\Oh!\That star's just like Takeo-kun.\Huh?\Look... If you draw a line between that star and the other star, response:	it looks like Takeo-kun laughing!
context: Wow!\That'd be incredible!\I wonder if I'll be okay!\Oh!\That star's just like Takeo-kun.\Huh?\Look... If you draw a line between that star and the other star,\it looks like Takeo-kun laughing! response:	Huh... So it's like the Takeo constellation.
context: That'd be incredible!\I wonder if I'll be okay!\Oh!\That star's just like Takeo-kun.\Huh?\Look... If you draw a line between that star and the other star,\it looks like Takeo-kun laughing!\Huh... So it's like the Takeo constellation. response:	Yeah!
context: I wonder if I'll be okay!\Oh!\That star's just like Takeo-kun.\Huh?\Look... If you draw a line between that star and the other star,\it looks like Takeo-kun laughing!\Huh... So it's like the Takeo constellation.\Yeah! response:	Takeo Constellation
context: Oh!\That star's just like Takeo-kun.\Huh?\Look... If you draw a line between that star and the other star,\it looks like Takeo-kun laughing!\Huh... So it's like the Takeo constellation.\Yeah!\Takeo Constellation response:	Oh, those seven stars look just like Takeo-kun when he was doing a shoulder throw!
context: That star's just like Takeo-kun.\Huh?\Look... If you draw a line between that star and the other star,\it looks like Takeo-kun laughing!\Huh... So it's like the Takeo constellation.\Yeah!\Takeo Constellation\Oh, those seven stars look just like Takeo-kun when he was doing a shoulder throw! response:	Huh...
context: Huh?\Look... If you draw a line between that star and the other star,\it looks like Takeo-kun laughing!\Huh... So it's like the Takeo constellation.\Yeah!\Takeo Constellation\Oh, those seven stars look just like Takeo-kun when he was doing a shoulder throw!\Huh... response:	Takeo 2
context: Look... If you draw a line between that star and the other star,\it looks like Takeo-kun laughing!\Huh... So it's like the Takeo constellation.\Yeah!\Takeo Constellation\Oh, those seven stars look just like Takeo-kun when he was doing a shoulder throw!\Huh...\Takeo 2 response:	Guess that'd be Takeo 2.
context: it looks like Takeo-kun laughing!\Huh... So it's like the Takeo constellation.\Yeah!\Takeo Constellation\Oh, those seven stars look just like Takeo-kun when he was doing a shoulder throw!\Huh...\Takeo 2\Guess that'd be Takeo 2. response:	And those over there are when he saved me on the train.
context: Huh... So it's like the Takeo constellation.\Yeah!\Takeo Constellation\Oh, those seven stars look just like Takeo-kun when he was doing a shoulder throw!\Huh...\Takeo 2\Guess that'd be Takeo 2.\And those over there are when he saved me on the train. response:	Takeo 3, then.
context: Yeah!\Takeo Constellation\Oh, those seven stars look just like Takeo-kun when he was doing a shoulder throw!\Huh...\Takeo 2\Guess that'd be Takeo 2.\And those over there are when he saved me on the train.\Takeo 3, then. response:	I think you can see anything you want in the stars.
context: Takeo Constellation\Oh, those seven stars look just like Takeo-kun when he was doing a shoulder throw!\Huh...\Takeo 2\Guess that'd be Takeo 2.\And those over there are when he saved me on the train.\Takeo 3, then.\I think you can see anything you want in the stars. response:	Right...
context: Oh, those seven stars look just like Takeo-kun when he was doing a shoulder throw!\Huh...\Takeo 2\Guess that'd be Takeo 2.\And those over there are when he saved me on the train.\Takeo 3, then.\I think you can see anything you want in the stars.\Right... response:	Oh, that one is when Takeo-kun escaped from the fire!
context: Huh...\Takeo 2\Guess that'd be Takeo 2.\And those over there are when he saved me on the train.\Takeo 3, then.\I think you can see anything you want in the stars.\Right...\Oh, that one is when Takeo-kun escaped from the fire! response:	I'm starting to see him in the stars, too.
context: Takeo 2\Guess that'd be Takeo 2.\And those over there are when he saved me on the train.\Takeo 3, then.\I think you can see anything you want in the stars.\Right...\Oh, that one is when Takeo-kun escaped from the fire!\I'm starting to see him in the stars, too. response:	Next!
context: Guess that'd be Takeo 2.\And those over there are when he saved me on the train.\Takeo 3, then.\I think you can see anything you want in the stars.\Right...\Oh, that one is when Takeo-kun escaped from the fire!\I'm starting to see him in the stars, too.\Next! response:	Next!
context: And those over there are when he saved me on the train.\Takeo 3, then.\I think you can see anything you want in the stars.\Right...\Oh, that one is when Takeo-kun escaped from the fire!\I'm starting to see him in the stars, too.\Next!\Next! response:	Takeo-kun, please spar with me next.
context: Takeo 3, then.\I think you can see anything you want in the stars.\Right...\Oh, that one is when Takeo-kun escaped from the fire!\I'm starting to see him in the stars, too.\Next!\Next!\Takeo-kun, please spar with me next. response:	And me, after that.
context: I think you can see anything you want in the stars.\Right...\Oh, that one is when Takeo-kun escaped from the fire!\I'm starting to see him in the stars, too.\Next!\Next!\Takeo-kun, please spar with me next.\And me, after that. response:	Then me.
context: Right...\Oh, that one is when Takeo-kun escaped from the fire!\I'm starting to see him in the stars, too.\Next!\Next!\Takeo-kun, please spar with me next.\And me, after that.\Then me. response:	Gouda, you're doing this for us...
context: Oh, that one is when Takeo-kun escaped from the fire!\I'm starting to see him in the stars, too.\Next!\Next!\Takeo-kun, please spar with me next.\And me, after that.\Then me.\Gouda, you're doing this for us... response:	All for us...
context: I'm starting to see him in the stars, too.\Next!\Next!\Takeo-kun, please spar with me next.\And me, after that.\Then me.\Gouda, you're doing this for us...\All for us... response:	All right! We'll follow suit, men!
context: Next!\Next!\Takeo-kun, please spar with me next.\And me, after that.\Then me.\Gouda, you're doing this for us...\All for us...\All right! We'll follow suit, men! response:	Got it!
context: Next!\Takeo-kun, please spar with me next.\And me, after that.\Then me.\Gouda, you're doing this for us...\All for us...\All right! We'll follow suit, men!\Got it! response:	It's true that I want to give everything I have to this,
context: Takeo-kun, please spar with me next.\And me, after that.\Then me.\Gouda, you're doing this for us...\All for us...\All right! We'll follow suit, men!\Got it!\It's true that I want to give everything I have to this, response:	given that a man bowed his head to me
context: And me, after that.\Then me.\Gouda, you're doing this for us...\All for us...\All right! We'll follow suit, men!\Got it!\It's true that I want to give everything I have to this,\given that a man bowed his head to me response:	and I've agreed to help.
context: Then me.\Gouda, you're doing this for us...\All for us...\All right! We'll follow suit, men!\Got it!\It's true that I want to give everything I have to this,\given that a man bowed his head to me\and I've agreed to help. response:	But it's more because Yamato wished me good luck.
context: Gouda, you're doing this for us...\All for us...\All right! We'll follow suit, men!\Got it!\It's true that I want to give everything I have to this,\given that a man bowed his head to me\and I've agreed to help.\But it's more because Yamato wished me good luck. response:	Yamato...
context: All for us...\All right! We'll follow suit, men!\Got it!\It's true that I want to give everything I have to this,\given that a man bowed his head to me\and I've agreed to help.\But it's more because Yamato wished me good luck.\Yamato... response:	I haven't heard her voice in a while.
context: All right! We'll follow suit, men!\Got it!\It's true that I want to give everything I have to this,\given that a man bowed his head to me\and I've agreed to help.\But it's more because Yamato wished me good luck.\Yamato...\I haven't heard her voice in a while. response:	Fight
context: Got it!\It's true that I want to give everything I have to this,\given that a man bowed his head to me\and I've agreed to help.\But it's more because Yamato wished me good luck.\Yamato...\I haven't heard her voice in a while.\Fight response:	It's the first time I've gone this long without talking to her.
context: It's true that I want to give everything I have to this,\given that a man bowed his head to me\and I've agreed to help.\But it's more because Yamato wished me good luck.\Yamato...\I haven't heard her voice in a while.\Fight\It's the first time I've gone this long without talking to her. response:	Evening.
context: given that a man bowed his head to me\and I've agreed to help.\But it's more because Yamato wished me good luck.\Yamato...\I haven't heard her voice in a while.\Fight\It's the first time I've gone this long without talking to her.\Evening. response:	Evening. Can I call you?
context: and I've agreed to help.\But it's more because Yamato wished me good luck.\Yamato...\I haven't heard her voice in a while.\Fight\It's the first time I've gone this long without talking to her.\Evening.\Evening. Can I call you? response:	Send
context: But it's more because Yamato wished me good luck.\Yamato...\I haven't heard her voice in a while.\Fight\It's the first time I've gone this long without talking to her.\Evening.\Evening. Can I call you?\Send response:	Takeo-kun?
context: Yamato...\I haven't heard her voice in a while.\Fight\It's the first time I've gone this long without talking to her.\Evening.\Evening. Can I call you?\Send\Takeo-kun? response:	It's me!
context: I haven't heard her voice in a while.\Fight\It's the first time I've gone this long without talking to her.\Evening.\Evening. Can I call you?\Send\Takeo-kun?\It's me! response:	Yeah.
context: Fight\It's the first time I've gone this long without talking to her.\Evening.\Evening. Can I call you?\Send\Takeo-kun?\It's me!\Yeah. response:	Is something wrong?
context: It's the first time I've gone this long without talking to her.\Evening.\Evening. Can I call you?\Send\Takeo-kun?\It's me!\Yeah.\Is something wrong? response:	I just wanted to hear your voice.
context: Evening.\Evening. Can I call you?\Send\Takeo-kun?\It's me!\Yeah.\Is something wrong?\I just wanted to hear your voice. response:	Huh? My voice?
context: Evening. Can I call you?\Send\Takeo-kun?\It's me!\Yeah.\Is something wrong?\I just wanted to hear your voice.\Huh? My voice? response:	My voice... Okay.
context: Send\Takeo-kun?\It's me!\Yeah.\Is something wrong?\I just wanted to hear your voice.\Huh? My voice?\My voice... Okay. response:	Okay, I'll talk.
context: Takeo-kun?\It's me!\Yeah.\Is something wrong?\I just wanted to hear your voice.\Huh? My voice?\My voice... Okay.\Okay, I'll talk. response:	Um, this is Yamato.
context: It's me!\Yeah.\Is something wrong?\I just wanted to hear your voice.\Huh? My voice?\My voice... Okay.\Okay, I'll talk.\Um, this is Yamato. response:	How are you, Takeo-kun?
context: Yeah.\Is something wrong?\I just wanted to hear your voice.\Huh? My voice?\My voice... Okay.\Okay, I'll talk.\Um, this is Yamato.\How are you, Takeo-kun? response:	I'm fine!
context: Is something wrong?\I just wanted to hear your voice.\Huh? My voice?\My voice... Okay.\Okay, I'll talk.\Um, this is Yamato.\How are you, Takeo-kun?\I'm fine! response:	Yamato...
context: I just wanted to hear your voice.\Huh? My voice?\My voice... Okay.\Okay, I'll talk.\Um, this is Yamato.\How are you, Takeo-kun?\I'm fine!\Yamato... response:	And, um...
context: Huh? My voice?\My voice... Okay.\Okay, I'll talk.\Um, this is Yamato.\How are you, Takeo-kun?\I'm fine!\Yamato...\And, um... response:	Oh, man...
context: My voice... Okay.\Okay, I'll talk.\Um, this is Yamato.\How are you, Takeo-kun?\I'm fine!\Yamato...\And, um...\Oh, man... response:	It's hard to talk!
context: Okay, I'll talk.\Um, this is Yamato.\How are you, Takeo-kun?\I'm fine!\Yamato...\And, um...\Oh, man...\It's hard to talk! response:	Yamato...
context: Um, this is Yamato.\How are you, Takeo-kun?\I'm fine!\Yamato...\And, um...\Oh, man...\It's hard to talk!\Yamato... response:	Oh, your match is tomorrow, right?
context: How are you, Takeo-kun?\I'm fine!\Yamato...\And, um...\Oh, man...\It's hard to talk!\Yamato...\Oh, your match is tomorrow, right? response:	Come with Suna.
context: I'm fine!\Yamato...\And, um...\Oh, man...\It's hard to talk!\Yamato...\Oh, your match is tomorrow, right?\Come with Suna. response:	Okay, I will.
context: Yamato...\And, um...\Oh, man...\It's hard to talk!\Yamato...\Oh, your match is tomorrow, right?\Come with Suna.\Okay, I will. response:	I'm looking forward to it.
context: And, um...\Oh, man...\It's hard to talk!\Yamato...\Oh, your match is tomorrow, right?\Come with Suna.\Okay, I will.\I'm looking forward to it. response:	Watch me fight.
context: Oh, man...\It's hard to talk!\Yamato...\Oh, your match is tomorrow, right?\Come with Suna.\Okay, I will.\I'm looking forward to it.\Watch me fight. response:	You're done with training?
context: It's hard to talk!\Yamato...\Oh, your match is tomorrow, right?\Come with Suna.\Okay, I will.\I'm looking forward to it.\Watch me fight.\You're done with training? response:	Yeah.
context: Yamato...\Oh, your match is tomorrow, right?\Come with Suna.\Okay, I will.\I'm looking forward to it.\Watch me fight.\You're done with training?\Yeah. response:	The match will be 6 PM tomorrow, at the arena.
context: Oh, your match is tomorrow, right?\Come with Suna.\Okay, I will.\I'm looking forward to it.\Watch me fight.\You're done with training?\Yeah.\The match will be 6 PM tomorrow, at the arena. response:	Takeo, here.
context: Come with Suna.\Okay, I will.\I'm looking forward to it.\Watch me fight.\You're done with training?\Yeah.\The match will be 6 PM tomorrow, at the arena.\Takeo, here. response:	These are Yamato's!
context: Okay, I will.\I'm looking forward to it.\Watch me fight.\You're done with training?\Yeah.\The match will be 6 PM tomorrow, at the arena.\Takeo, here.\These are Yamato's! response:	You're perceptive.
context: I'm looking forward to it.\Watch me fight.\You're done with training?\Yeah.\The match will be 6 PM tomorrow, at the arena.\Takeo, here.\These are Yamato's!\You're perceptive. response:	She said she made too much when she was thinking about you.
context: Watch me fight.\You're done with training?\Yeah.\The match will be 6 PM tomorrow, at the arena.\Takeo, here.\These are Yamato's!\You're perceptive.\She said she made too much when she was thinking about you. response:	Why didn't she bring them to me?
context: You're done with training?\Yeah.\The match will be 6 PM tomorrow, at the arena.\Takeo, here.\These are Yamato's!\You're perceptive.\She said she made too much when she was thinking about you.\Why didn't she bring them to me? response:	She said she didn't want to bother you.
context: Yeah.\The match will be 6 PM tomorrow, at the arena.\Takeo, here.\These are Yamato's!\You're perceptive.\She said she made too much when she was thinking about you.\Why didn't she bring them to me?\She said she didn't want to bother you. response:	Like she could!
context: The match will be 6 PM tomorrow, at the arena.\Takeo, here.\These are Yamato's!\You're perceptive.\She said she made too much when she was thinking about you.\Why didn't she bring them to me?\She said she didn't want to bother you.\Like she could! response:	Right?
context: Takeo, here.\These are Yamato's!\You're perceptive.\She said she made too much when she was thinking about you.\Why didn't she bring them to me?\She said she didn't want to bother you.\Like she could!\Right? response:	You almost lost me there.
context: These are Yamato's!\You're perceptive.\She said she made too much when she was thinking about you.\Why didn't she bring them to me?\She said she didn't want to bother you.\Like she could!\Right?\You almost lost me there. response:	Yamato-san was almost passing out from excitement about the match.
context: You're perceptive.\She said she made too much when she was thinking about you.\Why didn't she bring them to me?\She said she didn't want to bother you.\Like she could!\Right?\You almost lost me there.\Yamato-san was almost passing out from excitement about the match. response:	Show off for her, okay?
context: She said she made too much when she was thinking about you.\Why didn't she bring them to me?\She said she didn't want to bother you.\Like she could!\Right?\You almost lost me there.\Yamato-san was almost passing out from excitement about the match.\Show off for her, okay? response:	All right, night.
context: Why didn't she bring them to me?\She said she didn't want to bother you.\Like she could!\Right?\You almost lost me there.\Yamato-san was almost passing out from excitement about the match.\Show off for her, okay?\All right, night. response:	Yamato...
context: She said she didn't want to bother you.\Like she could!\Right?\You almost lost me there.\Yamato-san was almost passing out from excitement about the match.\Show off for her, okay?\All right, night.\Yamato... response:	She didn't say anything like that.
context: Like she could!\Right?\You almost lost me there.\Yamato-san was almost passing out from excitement about the match.\Show off for her, okay?\All right, night.\Yamato...\She didn't say anything like that. response:	She just wished me good luck.
context: Right?\You almost lost me there.\Yamato-san was almost passing out from excitement about the match.\Show off for her, okay?\All right, night.\Yamato...\She didn't say anything like that.\She just wished me good luck. response:	Yamato...
context: You almost lost me there.\Yamato-san was almost passing out from excitement about the match.\Show off for her, okay?\All right, night.\Yamato...\She didn't say anything like that.\She just wished me good luck.\Yamato... response:	Good luck, Takeo-kun!
context: Yamato-san was almost passing out from excitement about the match.\Show off for her, okay?\All right, night.\Yamato...\She didn't say anything like that.\She just wished me good luck.\Yamato...\Good luck, Takeo-kun! response:	Yamato, this way.
context: Show off for her, okay?\All right, night.\Yamato...\She didn't say anything like that.\She just wished me good luck.\Yamato...\Good luck, Takeo-kun!\Yamato, this way. response:	I want you watching from up close.
context: All right, night.\Yamato...\She didn't say anything like that.\She just wished me good luck.\Yamato...\Good luck, Takeo-kun!\Yamato, this way.\I want you watching from up close. response:	Takeo-kun...
context: Yamato...\She didn't say anything like that.\She just wished me good luck.\Yamato...\Good luck, Takeo-kun!\Yamato, this way.\I want you watching from up close.\Takeo-kun... response:	Hey, Takeo.
context: She didn't say anything like that.\She just wished me good luck.\Yamato...\Good luck, Takeo-kun!\Yamato, this way.\I want you watching from up close.\Takeo-kun...\Hey, Takeo. response:	Been a while.
context: She just wished me good luck.\Yamato...\Good luck, Takeo-kun!\Yamato, this way.\I want you watching from up close.\Takeo-kun...\Hey, Takeo.\Been a while. response:	Iwayama Tsuyoshi Bianka HS
context: Yamato...\Good luck, Takeo-kun!\Yamato, this way.\I want you watching from up close.\Takeo-kun...\Hey, Takeo.\Been a while.\Iwayama Tsuyoshi Bianka HS response:	Hey, Tsuyoshi.
context: Good luck, Takeo-kun!\Yamato, this way.\I want you watching from up close.\Takeo-kun...\Hey, Takeo.\Been a while.\Iwayama Tsuyoshi Bianka HS\Hey, Tsuyoshi. response:	Long time, no see.
context: Yamato, this way.\I want you watching from up close.\Takeo-kun...\Hey, Takeo.\Been a while.\Iwayama Tsuyoshi Bianka HS\Hey, Tsuyoshi.\Long time, no see. response:	Good luck today.
context: I want you watching from up close.\Takeo-kun...\Hey, Takeo.\Been a while.\Iwayama Tsuyoshi Bianka HS\Hey, Tsuyoshi.\Long time, no see.\Good luck today. response:	He's a buddy of mine. In elementary school, we went to the same dojo.
context: Takeo-kun...\Hey, Takeo.\Been a while.\Iwayama Tsuyoshi Bianka HS\Hey, Tsuyoshi.\Long time, no see.\Good luck today.\He's a buddy of mine. In elementary school, we went to the same dojo. response:	Oh, nice to meet you.
context: Hey, Takeo.\Been a while.\Iwayama Tsuyoshi Bianka HS\Hey, Tsuyoshi.\Long time, no see.\Good luck today.\He's a buddy of mine. In elementary school, we went to the same dojo.\Oh, nice to meet you. response:	I'm Yamato, Takeo-kun's girlfriend.
context: Been a while.\Iwayama Tsuyoshi Bianka HS\Hey, Tsuyoshi.\Long time, no see.\Good luck today.\He's a buddy of mine. In elementary school, we went to the same dojo.\Oh, nice to meet you.\I'm Yamato, Takeo-kun's girlfriend. response:	Girlfriend?!
context: Iwayama Tsuyoshi Bianka HS\Hey, Tsuyoshi.\Long time, no see.\Good luck today.\He's a buddy of mine. In elementary school, we went to the same dojo.\Oh, nice to meet you.\I'm Yamato, Takeo-kun's girlfriend.\Girlfriend?! response:	You've already lost, Takeo!
context: Hey, Tsuyoshi.\Long time, no see.\Good luck today.\He's a buddy of mine. In elementary school, we went to the same dojo.\Oh, nice to meet you.\I'm Yamato, Takeo-kun's girlfriend.\Girlfriend?!\You've already lost, Takeo! response:	You were stronger than me until junior high,
context: Long time, no see.\Good luck today.\He's a buddy of mine. In elementary school, we went to the same dojo.\Oh, nice to meet you.\I'm Yamato, Takeo-kun's girlfriend.\Girlfriend?!\You've already lost, Takeo!\You were stronger than me until junior high, response:	but after starting high school, I've been competing at the national level.
context: Good luck today.\He's a buddy of mine. In elementary school, we went to the same dojo.\Oh, nice to meet you.\I'm Yamato, Takeo-kun's girlfriend.\Girlfriend?!\You've already lost, Takeo!\You were stronger than me until junior high,\but after starting high school, I've been competing at the national level. response:	I won't lose to some guy who's been fooling around with a girlfriend.
context: He's a buddy of mine. In elementary school, we went to the same dojo.\Oh, nice to meet you.\I'm Yamato, Takeo-kun's girlfriend.\Girlfriend?!\You've already lost, Takeo!\You were stronger than me until junior high,\but after starting high school, I've been competing at the national level.\I won't lose to some guy who's been fooling around with a girlfriend. response:	Takeo-kun, I think I'll go watch from the side.
context: Oh, nice to meet you.\I'm Yamato, Takeo-kun's girlfriend.\Girlfriend?!\You've already lost, Takeo!\You were stronger than me until junior high,\but after starting high school, I've been competing at the national level.\I won't lose to some guy who's been fooling around with a girlfriend.\Takeo-kun, I think I'll go watch from the side. response:	I'll be fine outside, too...
context: I'm Yamato, Takeo-kun's girlfriend.\Girlfriend?!\You've already lost, Takeo!\You were stronger than me until junior high,\but after starting high school, I've been competing at the national level.\I won't lose to some guy who's been fooling around with a girlfriend.\Takeo-kun, I think I'll go watch from the side.\I'll be fine outside, too... response:	Tsuyoshi, girlfriends aren't bad.
context: Girlfriend?!\You've already lost, Takeo!\You were stronger than me until junior high,\but after starting high school, I've been competing at the national level.\I won't lose to some guy who's been fooling around with a girlfriend.\Takeo-kun, I think I'll go watch from the side.\I'll be fine outside, too...\Tsuyoshi, girlfriends aren't bad. response:	What?
context: You've already lost, Takeo!\You were stronger than me until junior high,\but after starting high school, I've been competing at the national level.\I won't lose to some guy who's been fooling around with a girlfriend.\Takeo-kun, I think I'll go watch from the side.\I'll be fine outside, too...\Tsuyoshi, girlfriends aren't bad.\What? response:	Watch right in the middle of the room, Yamato.
context: You were stronger than me until junior high,\but after starting high school, I've been competing at the national level.\I won't lose to some guy who's been fooling around with a girlfriend.\Takeo-kun, I think I'll go watch from the side.\I'll be fine outside, too...\Tsuyoshi, girlfriends aren't bad.\What?\Watch right in the middle of the room, Yamato. response:	Okay!
context: but after starting high school, I've been competing at the national level.\I won't lose to some guy who's been fooling around with a girlfriend.\Takeo-kun, I think I'll go watch from the side.\I'll be fine outside, too...\Tsuyoshi, girlfriends aren't bad.\What?\Watch right in the middle of the room, Yamato.\Okay! response:	Good luck, Takeo-kun!
context: I won't lose to some guy who's been fooling around with a girlfriend.\Takeo-kun, I think I'll go watch from the side.\I'll be fine outside, too...\Tsuyoshi, girlfriends aren't bad.\What?\Watch right in the middle of the room, Yamato.\Okay!\Good luck, Takeo-kun! response:	The path of judo is not paved in a single day.
context: Takeo-kun, I think I'll go watch from the side.\I'll be fine outside, too...\Tsuyoshi, girlfriends aren't bad.\What?\Watch right in the middle of the room, Yamato.\Okay!\Good luck, Takeo-kun!\The path of judo is not paved in a single day. response:	Takeo's been led astray, wasting his time on romance.
context: I'll be fine outside, too...\Tsuyoshi, girlfriends aren't bad.\What?\Watch right in the middle of the room, Yamato.\Okay!\Good luck, Takeo-kun!\The path of judo is not paved in a single day.\Takeo's been led astray, wasting his time on romance. response:	He's lost his chance.
context: Tsuyoshi, girlfriends aren't bad.\What?\Watch right in the middle of the room, Yamato.\Okay!\Good luck, Takeo-kun!\The path of judo is not paved in a single day.\Takeo's been led astray, wasting his time on romance.\He's lost his chance. response:	The victory is mine.
context: What?\Watch right in the middle of the room, Yamato.\Okay!\Good luck, Takeo-kun!\The path of judo is not paved in a single day.\Takeo's been led astray, wasting his time on romance.\He's lost his chance.\The victory is mine. response:	Bow!
context: Watch right in the middle of the room, Yamato.\Okay!\Good luck, Takeo-kun!\The path of judo is not paved in a single day.\Takeo's been led astray, wasting his time on romance.\He's lost his chance.\The victory is mine.\Bow! response:	What does it mean to be strong?
context: Okay!\Good luck, Takeo-kun!\The path of judo is not paved in a single day.\Takeo's been led astray, wasting his time on romance.\He's lost his chance.\The victory is mine.\Bow!\What does it mean to be strong? response:	First player, forward.
context: Good luck, Takeo-kun!\The path of judo is not paved in a single day.\Takeo's been led astray, wasting his time on romance.\He's lost his chance.\The victory is mine.\Bow!\What does it mean to be strong?\First player, forward. response:	Put your back into it!
context: The path of judo is not paved in a single day.\Takeo's been led astray, wasting his time on romance.\He's lost his chance.\The victory is mine.\Bow!\What does it mean to be strong?\First player, forward.\Put your back into it! response:	Got it!
context: Takeo's been led astray, wasting his time on romance.\He's lost his chance.\The victory is mine.\Bow!\What does it mean to be strong?\First player, forward.\Put your back into it!\Got it! response:	Fight!
context: He's lost his chance.\The victory is mine.\Bow!\What does it mean to be strong?\First player, forward.\Put your back into it!\Got it!\Fight! response:	You've got this!
context: The victory is mine.\Bow!\What does it mean to be strong?\First player, forward.\Put your back into it!\Got it!\Fight!\You've got this! response:	Yamato...
context: Bow!\What does it mean to be strong?\First player, forward.\Put your back into it!\Got it!\Fight!\You've got this!\Yamato... response:	Everything you make tastes so heartfelt.
context: What does it mean to be strong?\First player, forward.\Put your back into it!\Got it!\Fight!\You've got this!\Yamato...\Everything you make tastes so heartfelt. response:	Fourth, forward!
context: First player, forward.\Put your back into it!\Got it!\Fight!\You've got this!\Yamato...\Everything you make tastes so heartfelt.\Fourth, forward! response:	Good luck, Captain.
context: Put your back into it!\Got it!\Fight!\You've got this!\Yamato...\Everything you make tastes so heartfelt.\Fourth, forward!\Good luck, Captain. response:	Yeah, I'll fight twice as hard in your stead.
context: Got it!\Fight!\You've got this!\Yamato...\Everything you make tastes so heartfelt.\Fourth, forward!\Good luck, Captain.\Yeah, I'll fight twice as hard in your stead. response:	Fight!
context: Fight!\You've got this!\Yamato...\Everything you make tastes so heartfelt.\Fourth, forward!\Good luck, Captain.\Yeah, I'll fight twice as hard in your stead.\Fight! response:	One more win!
context: You've got this!\Yamato...\Everything you make tastes so heartfelt.\Fourth, forward!\Good luck, Captain.\Yeah, I'll fight twice as hard in your stead.\Fight!\One more win! response:	Begin!
context: Yamato...\Everything you make tastes so heartfelt.\Fourth, forward!\Good luck, Captain.\Yeah, I'll fight twice as hard in your stead.\Fight!\One more win!\Begin! response:	Go!
context: Everything you make tastes so heartfelt.\Fourth, forward!\Good luck, Captain.\Yeah, I'll fight twice as hard in your stead.\Fight!\One more win!\Begin!\Go! response:	Fight!
context: Fourth, forward!\Good luck, Captain.\Yeah, I'll fight twice as hard in your stead.\Fight!\One more win!\Begin!\Go!\Fight! response:	Advantage.
context: Good luck, Captain.\Yeah, I'll fight twice as hard in your stead.\Fight!\One more win!\Begin!\Go!\Fight!\Advantage. response:	Bianka Shuuei
context: Yeah, I'll fight twice as hard in your stead.\Fight!\One more win!\Begin!\Go!\Fight!\Advantage.\Bianka Shuuei response:	Majority vote.
context: Fight!\One more win!\Begin!\Go!\Fight!\Advantage.\Bianka Shuuei\Majority vote. response:	Two wins and two losses.
context: One more win!\Begin!\Go!\Fight!\Advantage.\Bianka Shuuei\Majority vote.\Two wins and two losses. response:	The next match will be decisive.
context: Begin!\Go!\Fight!\Advantage.\Bianka Shuuei\Majority vote.\Two wins and two losses.\The next match will be decisive. response:	Shuuei High School's Team Champion, Gouda Takeo, forward!
context: Go!\Fight!\Advantage.\Bianka Shuuei\Majority vote.\Two wins and two losses.\The next match will be decisive.\Shuuei High School's Team Champion, Gouda Takeo, forward! response:	Sorry, Gouda...
context: Fight!\Advantage.\Bianka Shuuei\Majority vote.\Two wins and two losses.\The next match will be decisive.\Shuuei High School's Team Champion, Gouda Takeo, forward!\Sorry, Gouda... response:	I'm counting on you.
context: Advantage.\Bianka Shuuei\Majority vote.\Two wins and two losses.\The next match will be decisive.\Shuuei High School's Team Champion, Gouda Takeo, forward!\Sorry, Gouda...\I'm counting on you. response:	Bianka High School's Team Champion, Iwayama Tsuyoshi!
context: Bianka Shuuei\Majority vote.\Two wins and two losses.\The next match will be decisive.\Shuuei High School's Team Champion, Gouda Takeo, forward!\Sorry, Gouda...\I'm counting on you.\Bianka High School's Team Champion, Iwayama Tsuyoshi! response:	Here!
context: Majority vote.\Two wins and two losses.\The next match will be decisive.\Shuuei High School's Team Champion, Gouda Takeo, forward!\Sorry, Gouda...\I'm counting on you.\Bianka High School's Team Champion, Iwayama Tsuyoshi!\Here! response:	You might be wanting to impress your girlfriend,
context: Two wins and two losses.\The next match will be decisive.\Shuuei High School's Team Champion, Gouda Takeo, forward!\Sorry, Gouda...\I'm counting on you.\Bianka High School's Team Champion, Iwayama Tsuyoshi!\Here!\You might be wanting to impress your girlfriend, response:	but I won't let you.
context: The next match will be decisive.\Shuuei High School's Team Champion, Gouda Takeo, forward!\Sorry, Gouda...\I'm counting on you.\Bianka High School's Team Champion, Iwayama Tsuyoshi!\Here!\You might be wanting to impress your girlfriend,\but I won't let you. response:	Go, Tsuyoshi!
context: Shuuei High School's Team Champion, Gouda Takeo, forward!\Sorry, Gouda...\I'm counting on you.\Bianka High School's Team Champion, Iwayama Tsuyoshi!\Here!\You might be wanting to impress your girlfriend,\but I won't let you.\Go, Tsuyoshi! response:	Go, go, Tsuyoshi!
context: Sorry, Gouda...\I'm counting on you.\Bianka High School's Team Champion, Iwayama Tsuyoshi!\Here!\You might be wanting to impress your girlfriend,\but I won't let you.\Go, Tsuyoshi!\Go, go, Tsuyoshi! response:	You're the best in the prefecture!
context: I'm counting on you.\Bianka High School's Team Champion, Iwayama Tsuyoshi!\Here!\You might be wanting to impress your girlfriend,\but I won't let you.\Go, Tsuyoshi!\Go, go, Tsuyoshi!\You're the best in the prefecture! response:	Push, push, Tsuyoshi!
context: Bianka High School's Team Champion, Iwayama Tsuyoshi!\Here!\You might be wanting to impress your girlfriend,\but I won't let you.\Go, Tsuyoshi!\Go, go, Tsuyoshi!\You're the best in the prefecture!\Push, push, Tsuyoshi! response:	Bow!
context: Here!\You might be wanting to impress your girlfriend,\but I won't let you.\Go, Tsuyoshi!\Go, go, Tsuyoshi!\You're the best in the prefecture!\Push, push, Tsuyoshi!\Bow! response:	Begin!
context: You might be wanting to impress your girlfriend,\but I won't let you.\Go, Tsuyoshi!\Go, go, Tsuyoshi!\You're the best in the prefecture!\Push, push, Tsuyoshi!\Bow!\Begin! response:	All right!
context: but I won't let you.\Go, Tsuyoshi!\Go, go, Tsuyoshi!\You're the best in the prefecture!\Push, push, Tsuyoshi!\Bow!\Begin!\All right! response:	Come at me! Come on!
context: Go, Tsuyoshi!\Go, go, Tsuyoshi!\You're the best in the prefecture!\Push, push, Tsuyoshi!\Bow!\Begin!\All right!\Come at me! Come on! response:	What does it mean to be strong?
context: Go, go, Tsuyoshi!\You're the best in the prefecture!\Push, push, Tsuyoshi!\Bow!\Begin!\All right!\Come at me! Come on!\What does it mean to be strong? response:	Judo's been my life.
context: You're the best in the prefecture!\Push, push, Tsuyoshi!\Bow!\Begin!\All right!\Come at me! Come on!\What does it mean to be strong?\Judo's been my life. response:	There's no way I'll lose to Takeo, now that he's lost his bark!
context: Push, push, Tsuyoshi!\Bow!\Begin!\All right!\Come at me! Come on!\What does it mean to be strong?\Judo's been my life.\There's no way I'll lose to Takeo, now that he's lost his bark! response:	Wow! This is a match to remember!
context: Bow!\Begin!\All right!\Come at me! Come on!\What does it mean to be strong?\Judo's been my life.\There's no way I'll lose to Takeo, now that he's lost his bark!\Wow! This is a match to remember! response:	There's no way I'll lose.
context: Begin!\All right!\Come at me! Come on!\What does it mean to be strong?\Judo's been my life.\There's no way I'll lose to Takeo, now that he's lost his bark!\Wow! This is a match to remember!\There's no way I'll lose. response:	That's a win!
context: All right!\Come at me! Come on!\What does it mean to be strong?\Judo's been my life.\There's no way I'll lose to Takeo, now that he's lost his bark!\Wow! This is a match to remember!\There's no way I'll lose.\That's a win! response:	Not yet!
context: Come at me! Come on!\What does it mean to be strong?\Judo's been my life.\There's no way I'll lose to Takeo, now that he's lost his bark!\Wow! This is a match to remember!\There's no way I'll lose.\That's a win!\Not yet! response:	I can't lose!
context: What does it mean to be strong?\Judo's been my life.\There's no way I'll lose to Takeo, now that he's lost his bark!\Wow! This is a match to remember!\There's no way I'll lose.\That's a win!\Not yet!\I can't lose! response:	Dig in!
context: Judo's been my life.\There's no way I'll lose to Takeo, now that he's lost his bark!\Wow! This is a match to remember!\There's no way I'll lose.\That's a win!\Not yet!\I can't lose!\Dig in! response:	Almost there!
context: There's no way I'll lose to Takeo, now that he's lost his bark!\Wow! This is a match to remember!\There's no way I'll lose.\That's a win!\Not yet!\I can't lose!\Dig in!\Almost there! response:	There's no way I'll lose!
context: Wow! This is a match to remember!\There's no way I'll lose.\That's a win!\Not yet!\I can't lose!\Dig in!\Almost there!\There's no way I'll lose! response:	Takeo-kun...
context: There's no way I'll lose.\That's a win!\Not yet!\I can't lose!\Dig in!\Almost there!\There's no way I'll lose!\Takeo-kun... response:	No way...
context: That's a win!\Not yet!\I can't lose!\Dig in!\Almost there!\There's no way I'll lose!\Takeo-kun...\No way... response:	Wait!
context: Not yet!\I can't lose!\Dig in!\Almost there!\There's no way I'll lose!\Takeo-kun...\No way...\Wait! response:	Penalty!
context: I can't lose!\Dig in!\Almost there!\There's no way I'll lose!\Takeo-kun...\No way...\Wait!\Penalty! response:	Damn it.
context: Dig in!\Almost there!\There's no way I'll lose!\Takeo-kun...\No way...\Wait!\Penalty!\Damn it. response:	My heart...
context: Almost there!\There's no way I'll lose!\Takeo-kun...\No way...\Wait!\Penalty!\Damn it.\My heart... response:	It's on fire.
context: There's no way I'll lose!\Takeo-kun...\No way...\Wait!\Penalty!\Damn it.\My heart...\It's on fire. response:	So this... is your strength...
context: Takeo-kun...\No way...\Wait!\Penalty!\Damn it.\My heart...\It's on fire.\So this... is your strength... response:	Ippon!
context: No way...\Wait!\Penalty!\Damn it.\My heart...\It's on fire.\So this... is your strength...\Ippon! response:	It's over!
context: Wait!\Penalty!\Damn it.\My heart...\It's on fire.\So this... is your strength...\Ippon!\It's over! response:	Thank you!
context: Penalty!\Damn it.\My heart...\It's on fire.\So this... is your strength...\Ippon!\It's over!\Thank you! response:	Well, that was awesome to watch, even for a guy.
context: Damn it.\My heart...\It's on fire.\So this... is your strength...\Ippon!\It's over!\Thank you!\Well, that was awesome to watch, even for a guy. response:	Yamato, I love you.
context: My heart...\It's on fire.\So this... is your strength...\Ippon!\It's over!\Thank you!\Well, that was awesome to watch, even for a guy.\Yamato, I love you. response:	Good job, Takeo-kun!
context: It's on fire.\So this... is your strength...\Ippon!\It's over!\Thank you!\Well, that was awesome to watch, even for a guy.\Yamato, I love you.\Good job, Takeo-kun! response:	It was amazing.
context: So this... is your strength...\Ippon!\It's over!\Thank you!\Well, that was awesome to watch, even for a guy.\Yamato, I love you.\Good job, Takeo-kun!\It was amazing. response:	You were so cool!
context: Ippon!\It's over!\Thank you!\Well, that was awesome to watch, even for a guy.\Yamato, I love you.\Good job, Takeo-kun!\It was amazing.\You were so cool! response:	Thank you, Yamato!
context: It's over!\Thank you!\Well, that was awesome to watch, even for a guy.\Yamato, I love you.\Good job, Takeo-kun!\It was amazing.\You were so cool!\Thank you, Yamato! response:	It's because you were there, cheering me on.
context: Thank you!\Well, that was awesome to watch, even for a guy.\Yamato, I love you.\Good job, Takeo-kun!\It was amazing.\You were so cool!\Thank you, Yamato!\It's because you were there, cheering me on. response:	No, not at all...
context: Well, that was awesome to watch, even for a guy.\Yamato, I love you.\Good job, Takeo-kun!\It was amazing.\You were so cool!\Thank you, Yamato!\It's because you were there, cheering me on.\No, not at all... response:	Takeo, Yamato-san's already about to pass out.
context: Yamato, I love you.\Good job, Takeo-kun!\It was amazing.\You were so cool!\Thank you, Yamato!\It's because you were there, cheering me on.\No, not at all...\Takeo, Yamato-san's already about to pass out. response:	What does it mean to be strong?
context: Good job, Takeo-kun!\It was amazing.\You were so cool!\Thank you, Yamato!\It's because you were there, cheering me on.\No, not at all...\Takeo, Yamato-san's already about to pass out.\What does it mean to be strong? response:	I don't know.
context: It was amazing.\You were so cool!\Thank you, Yamato!\It's because you were there, cheering me on.\No, not at all...\Takeo, Yamato-san's already about to pass out.\What does it mean to be strong?\I don't know. response:	But, Yamato, I want to become a great man.
context: You were so cool!\Thank you, Yamato!\It's because you were there, cheering me on.\No, not at all...\Takeo, Yamato-san's already about to pass out.\What does it mean to be strong?\I don't know.\But, Yamato, I want to become a great man. response:	The stars are beautiful tonight.
context: Thank you, Yamato!\It's because you were there, cheering me on.\No, not at all...\Takeo, Yamato-san's already about to pass out.\What does it mean to be strong?\I don't know.\But, Yamato, I want to become a great man.\The stars are beautiful tonight. response:	Yeah!
context: It's because you were there, cheering me on.\No, not at all...\Takeo, Yamato-san's already about to pass out.\What does it mean to be strong?\I don't know.\But, Yamato, I want to become a great man.\The stars are beautiful tonight.\Yeah! response:	Oh, that reminds me!
context: No, not at all...\Takeo, Yamato-san's already about to pass out.\What does it mean to be strong?\I don't know.\But, Yamato, I want to become a great man.\The stars are beautiful tonight.\Yeah!\Oh, that reminds me! response:	We found the Takeo constellation.
context: Takeo, Yamato-san's already about to pass out.\What does it mean to be strong?\I don't know.\But, Yamato, I want to become a great man.\The stars are beautiful tonight.\Yeah!\Oh, that reminds me!\We found the Takeo constellation. response:	When you draw a line between that star and the other,
context: What does it mean to be strong?\I don't know.\But, Yamato, I want to become a great man.\The stars are beautiful tonight.\Yeah!\Oh, that reminds me!\We found the Takeo constellation.\When you draw a line between that star and the other, response:	it's the one with you laughing.
context: I don't know.\But, Yamato, I want to become a great man.\The stars are beautiful tonight.\Yeah!\Oh, that reminds me!\We found the Takeo constellation.\When you draw a line between that star and the other,\it's the one with you laughing. response:	And that's the one where you're doing a shoulder throw.
context: But, Yamato, I want to become a great man.\The stars are beautiful tonight.\Yeah!\Oh, that reminds me!\We found the Takeo constellation.\When you draw a line between that star and the other,\it's the one with you laughing.\And that's the one where you're doing a shoulder throw. response:	I'm surprised you remember all of them.
context: The stars are beautiful tonight.\Yeah!\Oh, that reminds me!\We found the Takeo constellation.\When you draw a line between that star and the other,\it's the one with you laughing.\And that's the one where you're doing a shoulder throw.\I'm surprised you remember all of them. response:	To me, they look like Yamato.
context: Yeah!\Oh, that reminds me!\We found the Takeo constellation.\When you draw a line between that star and the other,\it's the one with you laughing.\And that's the one where you're doing a shoulder throw.\I'm surprised you remember all of them.\To me, they look like Yamato. response:	Eh?
context: Oh, that reminds me!\We found the Takeo constellation.\When you draw a line between that star and the other,\it's the one with you laughing.\And that's the one where you're doing a shoulder throw.\I'm surprised you remember all of them.\To me, they look like Yamato.\Eh? response:	If you connect that star and the other one...
context: We found the Takeo constellation.\When you draw a line between that star and the other,\it's the one with you laughing.\And that's the one where you're doing a shoulder throw.\I'm surprised you remember all of them.\To me, they look like Yamato.\Eh?\If you connect that star and the other one... response:	See?
context: When you draw a line between that star and the other,\it's the one with you laughing.\And that's the one where you're doing a shoulder throw.\I'm surprised you remember all of them.\To me, they look like Yamato.\Eh?\If you connect that star and the other one...\See? response:	It's Yamato's smiling face.
context: it's the one with you laughing.\And that's the one where you're doing a shoulder throw.\I'm surprised you remember all of them.\To me, they look like Yamato.\Eh?\If you connect that star and the other one...\See?\It's Yamato's smiling face. response:	It's right next to your constellation!
context: And that's the one where you're doing a shoulder throw.\I'm surprised you remember all of them.\To me, they look like Yamato.\Eh?\If you connect that star and the other one...\See?\It's Yamato's smiling face.\It's right next to your constellation! response:	Which one?
context: I'm surprised you remember all of them.\To me, they look like Yamato.\Eh?\If you connect that star and the other one...\See?\It's Yamato's smiling face.\It's right next to your constellation!\Which one? response:	Wow!
context: To me, they look like Yamato.\Eh?\If you connect that star and the other one...\See?\It's Yamato's smiling face.\It's right next to your constellation!\Which one?\Wow! response:	I'm so happy!
context: Eh?\If you connect that star and the other one...\See?\It's Yamato's smiling face.\It's right next to your constellation!\Which one?\Wow!\I'm so happy! response:	That one's the constellation for the macarons you made.
context: If you connect that star and the other one...\See?\It's Yamato's smiling face.\It's right next to your constellation!\Which one?\Wow!\I'm so happy!\That one's the constellation for the macarons you made. response:	That one's for you when we first met.
context: See?\It's Yamato's smiling face.\It's right next to your constellation!\Which one?\Wow!\I'm so happy!\That one's the constellation for the macarons you made.\That one's for you when we first met. response:	Oh, it's next to yours again!
context: It's Yamato's smiling face.\It's right next to your constellation!\Which one?\Wow!\I'm so happy!\That one's the constellation for the macarons you made.\That one's for you when we first met.\Oh, it's next to yours again! response:	Yamato, let's see each other again tomorrow,
context: It's right next to your constellation!\Which one?\Wow!\I'm so happy!\That one's the constellation for the macarons you made.\That one's for you when we first met.\Oh, it's next to yours again!\Yamato, let's see each other again tomorrow, response:	That one's for you when you pushed the beam with me.
context: Which one?\Wow!\I'm so happy!\That one's the constellation for the macarons you made.\That one's for you when we first met.\Oh, it's next to yours again!\Yamato, let's see each other again tomorrow,\That one's for you when you pushed the beam with me. response:	and talk about all the little things, until the sun goes down.
context: Wow!\I'm so happy!\That one's the constellation for the macarons you made.\That one's for you when we first met.\Oh, it's next to yours again!\Yamato, let's see each other again tomorrow,\That one's for you when you pushed the beam with me.\and talk about all the little things, until the sun goes down. response:	There's Suna, too.
context: I'm so happy!\That one's the constellation for the macarons you made.\That one's for you when we first met.\Oh, it's next to yours again!\Yamato, let's see each other again tomorrow,\That one's for you when you pushed the beam with me.\and talk about all the little things, until the sun goes down.\There's Suna, too. response:	My Friend
context: That one's the constellation for the macarons you made.\That one's for you when we first met.\Oh, it's next to yours again!\Yamato, let's see each other again tomorrow,\That one's for you when you pushed the beam with me.\and talk about all the little things, until the sun goes down.\There's Suna, too.\My Friend response:	Next time: My Friend.